run set,number of matches,winning result,game master balance,player balance
3:1:2,1,1,99999,100001
6:1:5,0,-1,100000,100000
1:5:6,0,-1,100001,99999
4:3:3,0,-1,100002,99998
4:1:5,0,-1,100003,99997
4:4:3,0,-1,100004,99996
4:4:4,0,-1,100005,99995
1:6:1,0,-1,100006,99994
3:5:5,0,-1,100007,99993
2:4:6,1,1,100006,99994
5:4:1,0,-1,100007,99993
6:2:5,1,1,100006,99994
3:4:2,1,1,100005,99995
1:6:4,0,-1,100006,99994
4:5:4,0,-1,100007,99993
4:5:3,0,-1,100008,99992
1:1:4,0,-1,100009,99991
4:4:4,0,-1,100010,99990
5:1:2,1,1,100009,99991
5:1:4,0,-1,100010,99990
6:6:1,0,-1,100011,99989
6:3:5,0,-1,100012,99988
6:1:2,1,1,100011,99989
5:1:6,0,-1,100012,99988
4:3:3,0,-1,100013,99987
4:4:5,0,-1,100014,99986
6:2:2,2,2,100012,99988
3:2:6,1,1,100011,99989
5:5:5,0,-1,100012,99988
5:5:1,0,-1,100013,99987
2:5:4,1,1,100012,99988
5:6:1,0,-1,100013,99987
5:5:3,0,-1,100014,99986
5:5:3,0,-1,100015,99985
5:4:1,0,-1,100016,99984
2:5:1,1,1,100015,99985
1:4:3,0,-1,100016,99984
3:3:3,0,-1,100017,99983
5:5:3,0,-1,100018,99982
1:1:1,0,-1,100019,99981
5:2:1,1,1,100018,99982
4:5:6,0,-1,100019,99981
6:1:6,0,-1,100020,99980
6:3:6,0,-1,100021,99979
5:2:3,1,1,100020,99980
4:4:2,1,1,100019,99981
5:4:5,0,-1,100020,99980
4:1:6,0,-1,100021,99979
3:6:6,0,-1,100022,99978
1:2:4,1,1,100021,99979
6:5:2,1,1,100020,99980
4:3:4,0,-1,100021,99979
4:5:1,0,-1,100022,99978
4:3:1,0,-1,100023,99977
5:4:1,0,-1,100024,99976
4:3:1,0,-1,100025,99975
6:5:6,0,-1,100026,99974
4:5:5,0,-1,100027,99973
3:4:1,0,-1,100028,99972
4:5:2,1,1,100027,99973
5:6:5,0,-1,100028,99972
1:6:3,0,-1,100029,99971
5:6:5,0,-1,100030,99970
2:3:2,2,2,100028,99972
3:2:1,1,1,100027,99973
1:2:3,1,1,100026,99974
6:3:5,0,-1,100027,99973
1:6:2,1,1,100026,99974
3:1:1,0,-1,100027,99973
2:1:3,1,1,100026,99974
4:3:3,0,-1,100027,99973
3:1:2,1,1,100026,99974
5:1:4,0,-1,100027,99973
4:2:5,1,1,100026,99974
2:3:1,1,1,100025,99975
2:5:6,1,1,100024,99976
1:4:2,1,1,100023,99977
6:2:3,1,1,100022,99978
3:6:4,0,-1,100023,99977
3:2:6,1,1,100022,99978
5:6:6,0,-1,100023,99977
2:4:4,1,1,100022,99978
2:6:5,1,1,100021,99979
2:4:3,1,1,100020,99980
1:1:3,0,-1,100021,99979
1:4:3,0,-1,100022,99978
1:5:4,0,-1,100023,99977
6:6:1,0,-1,100024,99976
5:4:5,0,-1,100025,99975
6:1:1,0,-1,100026,99974
4:3:5,0,-1,100027,99973
2:5:2,2,2,100025,99975
3:1:3,0,-1,100026,99974
5:6:2,1,1,100025,99975
2:2:3,2,2,100023,99977
5:5:3,0,-1,100024,99976
4:1:5,0,-1,100025,99975
1:4:6,0,-1,100026,99974
4:2:3,1,1,100025,99975
2:1:3,1,1,100024,99976
6:1:6,0,-1,100025,99975
3:2:5,1,1,100024,99976
1:5:2,1,1,100023,99977
6:5:3,0,-1,100024,99976
1:4:4,0,-1,100025,99975
2:6:3,1,1,100024,99976
4:1:1,0,-1,100025,99975
3:5:3,0,-1,100026,99974
5:1:1,0,-1,100027,99973
6:1:6,0,-1,100028,99972
6:3:1,0,-1,100029,99971
4:3:3,0,-1,100030,99970
1:1:3,0,-1,100031,99969
6:4:2,1,1,100030,99970
2:5:4,1,1,100029,99971
4:5:2,1,1,100028,99972
6:4:4,0,-1,100029,99971
4:3:2,1,1,100028,99972
1:5:4,0,-1,100029,99971
5:2:3,1,1,100028,99972
4:4:4,0,-1,100029,99971
1:1:4,0,-1,100030,99970
6:1:2,1,1,100029,99971
6:6:6,0,-1,100030,99970
6:3:1,0,-1,100031,99969
2:6:5,1,1,100030,99970
5:5:6,0,-1,100031,99969
5:5:5,0,-1,100032,99968
2:4:4,1,1,100031,99969
4:6:1,0,-1,100032,99968
1:4:6,0,-1,100033,99967
5:1:1,0,-1,100034,99966
5:3:3,0,-1,100035,99965
3:5:1,0,-1,100036,99964
5:4:1,0,-1,100037,99963
5:5:5,0,-1,100038,99962
2:5:6,1,1,100037,99963
6:4:3,0,-1,100038,99962
3:4:1,0,-1,100039,99961
5:3:1,0,-1,100040,99960
1:5:6,0,-1,100041,99959
6:5:1,0,-1,100042,99958
6:6:6,0,-1,100043,99957
6:3:1,0,-1,100044,99956
3:5:1,0,-1,100045,99955
5:6:1,0,-1,100046,99954
5:5:4,0,-1,100047,99953
4:4:6,0,-1,100048,99952
2:1:5,1,1,100047,99953
2:1:5,1,1,100046,99954
4:6:1,0,-1,100047,99953
4:5:4,0,-1,100048,99952
3:1:2,1,1,100047,99953
6:2:4,1,1,100046,99954
3:3:1,0,-1,100047,99953
2:3:5,1,1,100046,99954
5:4:2,1,1,100045,99955
2:2:5,2,2,100043,99957
6:3:1,0,-1,100044,99956
6:5:1,0,-1,100045,99955
5:2:1,1,1,100044,99956
3:6:4,0,-1,100045,99955
4:2:6,1,1,100044,99956
4:2:2,2,2,100042,99958
5:2:6,1,1,100041,99959
3:5:2,1,1,100040,99960
4:5:1,0,-1,100041,99959
4:3:4,0,-1,100042,99958
4:6:3,0,-1,100043,99957
5:6:2,1,1,100042,99958
3:6:4,0,-1,100043,99957
2:5:4,1,1,100042,99958
2:6:4,1,1,100041,99959
1:1:4,0,-1,100042,99958
1:3:5,0,-1,100043,99957
2:1:4,1,1,100042,99958
3:1:2,1,1,100041,99959
4:6:6,0,-1,100042,99958
2:6:4,1,1,100041,99959
6:6:5,0,-1,100042,99958
2:3:5,1,1,100041,99959
6:2:3,1,1,100040,99960
4:6:2,1,1,100039,99961
6:5:5,0,-1,100040,99960
1:4:1,0,-1,100041,99959
3:4:1,0,-1,100042,99958
5:2:3,1,1,100041,99959
1:6:1,0,-1,100042,99958
1:1:2,1,1,100041,99959
6:5:6,0,-1,100042,99958
1:1:5,0,-1,100043,99957
5:1:4,0,-1,100044,99956
2:3:5,1,1,100043,99957
6:3:2,1,1,100042,99958
1:4:1,0,-1,100043,99957
4:3:3,0,-1,100044,99956
1:2:3,1,1,100043,99957
5:3:5,0,-1,100044,99956
5:3:1,0,-1,100045,99955
1:3:4,0,-1,100046,99954
4:5:2,1,1,100045,99955
1:1:5,0,-1,100046,99954
5:6:1,0,-1,100047,99953
6:3:5,0,-1,100048,99952
3:5:1,0,-1,100049,99951
2:3:5,1,1,100048,99952
5:2:1,1,1,100047,99953
1:6:6,0,-1,100048,99952
6:1:4,0,-1,100049,99951
2:4:6,1,1,100048,99952
5:2:6,1,1,100047,99953
2:5:6,1,1,100046,99954
1:2:4,1,1,100045,99955
5:5:5,0,-1,100046,99954
6:1:5,0,-1,100047,99953
4:5:3,0,-1,100048,99952
4:3:4,0,-1,100049,99951
2:1:6,1,1,100048,99952
4:3:2,1,1,100047,99953
3:5:5,0,-1,100048,99952
4:5:5,0,-1,100049,99951
5:5:6,0,-1,100050,99950
2:2:2,3,3,100047,99953
1:4:4,0,-1,100048,99952
3:1:4,0,-1,100049,99951
1:1:4,0,-1,100050,99950
4:6:2,1,1,100049,99951
6:3:1,0,-1,100050,99950
1:5:4,0,-1,100051,99949
3:4:1,0,-1,100052,99948
4:6:1,0,-1,100053,99947
5:5:6,0,-1,100054,99946
6:4:4,0,-1,100055,99945
6:5:4,0,-1,100056,99944
2:6:3,1,1,100055,99945
2:4:3,1,1,100054,99946
6:1:6,0,-1,100055,99945
1:1:1,0,-1,100056,99944
1:4:6,0,-1,100057,99943
2:2:5,2,2,100055,99945
2:1:2,2,2,100053,99947
5:3:3,0,-1,100054,99946
6:2:3,1,1,100053,99947
5:1:5,0,-1,100054,99946
2:6:2,2,2,100052,99948
4:5:4,0,-1,100053,99947
2:4:6,1,1,100052,99948
1:1:5,0,-1,100053,99947
6:1:3,0,-1,100054,99946
6:6:3,0,-1,100055,99945
6:1:1,0,-1,100056,99944
3:6:6,0,-1,100057,99943
3:5:3,0,-1,100058,99942
4:5:4,0,-1,100059,99941
3:5:1,0,-1,100060,99940
4:5:3,0,-1,100061,99939
1:2:1,1,1,100060,99940
4:4:1,0,-1,100061,99939
2:6:4,1,1,100060,99940
1:4:2,1,1,100059,99941
2:1:6,1,1,100058,99942
6:6:5,0,-1,100059,99941
4:5:2,1,1,100058,99942
6:4:1,0,-1,100059,99941
6:4:2,1,1,100058,99942
3:3:6,0,-1,100059,99941
4:5:3,0,-1,100060,99940
4:2:2,2,2,100058,99942
4:2:2,2,2,100056,99944
1:3:2,1,1,100055,99945
3:6:3,0,-1,100056,99944
3:5:2,1,1,100055,99945
4:4:2,1,1,100054,99946
1:4:1,0,-1,100055,99945
6:3:5,0,-1,100056,99944
1:5:3,0,-1,100057,99943
3:3:1,0,-1,100058,99942
4:5:2,1,1,100057,99943
1:3:3,0,-1,100058,99942
3:3:6,0,-1,100059,99941
2:5:1,1,1,100058,99942
5:3:4,0,-1,100059,99941
5:4:1,0,-1,100060,99940
6:6:1,0,-1,100061,99939
6:4:3,0,-1,100062,99938
3:2:4,1,1,100061,99939
5:6:1,0,-1,100062,99938
1:4:1,0,-1,100063,99937
2:3:2,2,2,100061,99939
2:2:3,2,2,100059,99941
6:6:5,0,-1,100060,99940
6:2:1,1,1,100059,99941
6:1:5,0,-1,100060,99940
2:3:6,1,1,100059,99941
2:1:1,1,1,100058,99942
4:5:4,0,-1,100059,99941
5:4:5,0,-1,100060,99940
4:3:6,0,-1,100061,99939
2:5:4,1,1,100060,99940
4:6:3,0,-1,100061,99939
6:5:5,0,-1,100062,99938
3:1:2,1,1,100061,99939
3:5:5,0,-1,100062,99938
3:3:1,0,-1,100063,99937
4:2:4,1,1,100062,99938
2:4:3,1,1,100061,99939
2:6:3,1,1,100060,99940
2:5:1,1,1,100059,99941
6:1:4,0,-1,100060,99940
6:2:6,1,1,100059,99941
3:3:5,0,-1,100060,99940
3:2:3,1,1,100059,99941
3:2:2,2,2,100057,99943
4:5:1,0,-1,100058,99942
4:1:3,0,-1,100059,99941
5:2:6,1,1,100058,99942
5:1:5,0,-1,100059,99941
2:3:6,1,1,100058,99942
6:2:1,1,1,100057,99943
2:6:5,1,1,100056,99944
6:5:6,0,-1,100057,99943
5:2:5,1,1,100056,99944
1:4:6,0,-1,100057,99943
4:3:3,0,-1,100058,99942
2:4:2,2,2,100056,99944
4:4:6,0,-1,100057,99943
6:6:5,0,-1,100058,99942
3:5:5,0,-1,100059,99941
2:2:4,2,2,100057,99943
5:1:6,0,-1,100058,99942
2:1:2,2,2,100056,99944
2:3:5,1,1,100055,99945
1:2:4,1,1,100054,99946
6:2:2,2,2,100052,99948
3:4:2,1,1,100051,99949
5:5:5,0,-1,100052,99948
6:4:4,0,-1,100053,99947
6:1:4,0,-1,100054,99946
5:2:5,1,1,100053,99947
3:2:4,1,1,100052,99948
6:6:2,1,1,100051,99949
3:3:3,0,-1,100052,99948
2:3:4,1,1,100051,99949
1:5:3,0,-1,100052,99948
3:4:1,0,-1,100053,99947
5:6:3,0,-1,100054,99946
4:3:6,0,-1,100055,99945
6:3:4,0,-1,100056,99944
5:3:1,0,-1,100057,99943
5:3:4,0,-1,100058,99942
1:4:1,0,-1,100059,99941
3:5:2,1,1,100058,99942
1:5:6,0,-1,100059,99941
2:1:1,1,1,100058,99942
3:6:1,0,-1,100059,99941
3:4:2,1,1,100058,99942
6:3:4,0,-1,100059,99941
6:4:6,0,-1,100060,99940
1:4:3,0,-1,100061,99939
6:3:2,1,1,100060,99940
3:6:6,0,-1,100061,99939
1:4:6,0,-1,100062,99938
4:2:2,2,2,100060,99940
2:1:1,1,1,100059,99941
5:2:2,2,2,100057,99943
1:4:4,0,-1,100058,99942
1:4:5,0,-1,100059,99941
4:2:4,1,1,100058,99942
2:6:2,2,2,100056,99944
4:1:2,1,1,100055,99945
3:3:4,0,-1,100056,99944
1:2:1,1,1,100055,99945
4:6:1,0,-1,100056,99944
5:4:5,0,-1,100057,99943
5:1:6,0,-1,100058,99942
5:5:1,0,-1,100059,99941
4:1:4,0,-1,100060,99940
1:1:5,0,-1,100061,99939
4:1:1,0,-1,100062,99938
1:6:3,0,-1,100063,99937
6:1:5,0,-1,100064,99936
5:3:6,0,-1,100065,99935
6:1:1,0,-1,100066,99934
1:1:1,0,-1,100067,99933
3:6:4,0,-1,100068,99932
1:3:6,0,-1,100069,99931
3:5:5,0,-1,100070,99930
4:6:2,1,1,100069,99931
6:2:4,1,1,100068,99932
2:3:1,1,1,100067,99933
4:6:6,0,-1,100068,99932
4:6:4,0,-1,100069,99931
3:3:1,0,-1,100070,99930
6:3:1,0,-1,100071,99929
5:3:1,0,-1,100072,99928
2:4:2,2,2,100070,99930
5:3:5,0,-1,100071,99929
3:1:4,0,-1,100072,99928
2:4:4,1,1,100071,99929
1:5:6,0,-1,100072,99928
1:5:2,1,1,100071,99929
3:2:3,1,1,100070,99930
4:1:6,0,-1,100071,99929
2:4:2,2,2,100069,99931
5:6:3,0,-1,100070,99930
6:5:3,0,-1,100071,99929
5:5:2,1,1,100070,99930
6:6:6,0,-1,100071,99929
3:6:6,0,-1,100072,99928
4:4:5,0,-1,100073,99927
3:2:5,1,1,100072,99928
6:3:6,0,-1,100073,99927
6:3:4,0,-1,100074,99926
6:1:6,0,-1,100075,99925
1:2:6,1,1,100074,99926
3:5:6,0,-1,100075,99925
6:5:6,0,-1,100076,99924
1:1:2,1,1,100075,99925
6:6:3,0,-1,100076,99924
3:6:2,1,1,100075,99925
4:1:6,0,-1,100076,99924
1:4:5,0,-1,100077,99923
1:3:3,0,-1,100078,99922
4:4:6,0,-1,100079,99921
4:6:5,0,-1,100080,99920
1:2:5,1,1,100079,99921
1:2:5,1,1,100078,99922
2:3:2,2,2,100076,99924
6:2:3,1,1,100075,99925
5:1:5,0,-1,100076,99924
4:5:2,1,1,100075,99925
2:6:1,1,1,100074,99926
2:4:6,1,1,100073,99927
4:1:1,0,-1,100074,99926
4:2:2,2,2,100072,99928
3:1:1,0,-1,100073,99927
5:1:6,0,-1,100074,99926
1:2:5,1,1,100073,99927
2:5:5,1,1,100072,99928
3:5:5,0,-1,100073,99927
2:4:5,1,1,100072,99928
1:3:6,0,-1,100073,99927
1:4:5,0,-1,100074,99926
1:3:1,0,-1,100075,99925
2:2:6,2,2,100073,99927
3:6:3,0,-1,100074,99926
1:2:1,1,1,100073,99927
4:5:6,0,-1,100074,99926
6:2:2,2,2,100072,99928
1:1:6,0,-1,100073,99927
4:3:3,0,-1,100074,99926
1:6:1,0,-1,100075,99925
2:6:4,1,1,100074,99926
1:2:3,1,1,100073,99927
3:5:3,0,-1,100074,99926
1:3:4,0,-1,100075,99925
4:5:5,0,-1,100076,99924
2:5:4,1,1,100075,99925
5:6:4,0,-1,100076,99924
6:1:5,0,-1,100077,99923
5:5:4,0,-1,100078,99922
2:5:6,1,1,100077,99923
1:5:4,0,-1,100078,99922
1:6:2,1,1,100077,99923
3:1:3,0,-1,100078,99922
2:2:2,3,3,100075,99925
3:3:2,1,1,100074,99926
1:6:1,0,-1,100075,99925
4:5:6,0,-1,100076,99924
5:3:5,0,-1,100077,99923
5:1:5,0,-1,100078,99922
2:4:1,1,1,100077,99923
3:3:1,0,-1,100078,99922
3:2:1,1,1,100077,99923
2:5:4,1,1,100076,99924
5:1:4,0,-1,100077,99923
3:4:6,0,-1,100078,99922
3:1:4,0,-1,100079,99921
5:5:2,1,1,100078,99922
2:4:4,1,1,100077,99923
1:2:1,1,1,100076,99924
3:6:5,0,-1,100077,99923
2:1:4,1,1,100076,99924
2:6:1,1,1,100075,99925
4:5:5,0,-1,100076,99924
2:4:1,1,1,100075,99925
5:1:3,0,-1,100076,99924
2:5:2,2,2,100074,99926
1:4:6,0,-1,100075,99925
1:3:2,1,1,100074,99926
3:6:3,0,-1,100075,99925
5:6:1,0,-1,100076,99924
6:1:6,0,-1,100077,99923
5:2:4,1,1,100076,99924
5:5:2,1,1,100075,99925
3:6:4,0,-1,100076,99924
4:2:6,1,1,100075,99925
4:4:6,0,-1,100076,99924
4:4:5,0,-1,100077,99923
4:2:4,1,1,100076,99924
2:6:1,1,1,100075,99925
1:3:1,0,-1,100076,99924
5:1:6,0,-1,100077,99923
4:4:5,0,-1,100078,99922
5:2:2,2,2,100076,99924
5:4:2,1,1,100075,99925
5:3:4,0,-1,100076,99924
5:3:5,0,-1,100077,99923
5:5:4,0,-1,100078,99922
3:5:1,0,-1,100079,99921
1:4:1,0,-1,100080,99920
2:3:4,1,1,100079,99921
4:2:6,1,1,100078,99922
2:3:1,1,1,100077,99923
1:1:6,0,-1,100078,99922
2:4:3,1,1,100077,99923
3:6:3,0,-1,100078,99922
6:3:1,0,-1,100079,99921
1:6:6,0,-1,100080,99920
1:3:6,0,-1,100081,99919
2:5:5,1,1,100080,99920
6:6:5,0,-1,100081,99919
3:6:4,0,-1,100082,99918
3:5:3,0,-1,100083,99917
2:2:4,2,2,100081,99919
3:2:2,2,2,100079,99921
3:4:2,1,1,100078,99922
2:1:2,2,2,100076,99924
1:2:5,1,1,100075,99925
6:3:3,0,-1,100076,99924
2:2:4,2,2,100074,99926
4:4:1,0,-1,100075,99925
2:1:1,1,1,100074,99926
6:6:5,0,-1,100075,99925
2:2:4,2,2,100073,99927
2:5:3,1,1,100072,99928
2:1:1,1,1,100071,99929
1:1:4,0,-1,100072,99928
4:3:3,0,-1,100073,99927
4:6:6,0,-1,100074,99926
6:6:2,1,1,100073,99927
2:1:4,1,1,100072,99928
3:6:3,0,-1,100073,99927
5:6:1,0,-1,100074,99926
5:1:3,0,-1,100075,99925
6:3:2,1,1,100074,99926
1:2:6,1,1,100073,99927
5:6:2,1,1,100072,99928
2:3:4,1,1,100071,99929
6:1:1,0,-1,100072,99928
2:1:6,1,1,100071,99929
1:2:3,1,1,100070,99930
4:1:3,0,-1,100071,99929
1:5:6,0,-1,100072,99928
4:3:3,0,-1,100073,99927
5:4:2,1,1,100072,99928
2:2:2,3,3,100069,99931
3:5:3,0,-1,100070,99930
6:2:3,1,1,100069,99931
2:2:3,2,2,100067,99933
3:2:2,2,2,100065,99935
5:6:3,0,-1,100066,99934
3:5:2,1,1,100065,99935
5:3:6,0,-1,100066,99934
3:2:1,1,1,100065,99935
3:1:5,0,-1,100066,99934
6:6:5,0,-1,100067,99933
3:4:2,1,1,100066,99934
5:6:1,0,-1,100067,99933
6:5:3,0,-1,100068,99932
4:5:4,0,-1,100069,99931
3:4:4,0,-1,100070,99930
6:2:3,1,1,100069,99931
5:6:3,0,-1,100070,99930
1:6:5,0,-1,100071,99929
3:4:2,1,1,100070,99930
3:6:6,0,-1,100071,99929
2:6:1,1,1,100070,99930
3:3:1,0,-1,100071,99929
5:4:2,1,1,100070,99930
1:3:6,0,-1,100071,99929
5:2:4,1,1,100070,99930
5:5:6,0,-1,100071,99929
4:6:3,0,-1,100072,99928
5:4:1,0,-1,100073,99927
6:5:5,0,-1,100074,99926
2:6:4,1,1,100073,99927
4:5:1,0,-1,100074,99926
4:4:3,0,-1,100075,99925
6:4:1,0,-1,100076,99924
4:2:5,1,1,100075,99925
6:2:6,1,1,100074,99926
6:6:1,0,-1,100075,99925
2:1:2,2,2,100073,99927
2:1:3,1,1,100072,99928
5:3:1,0,-1,100073,99927
1:2:4,1,1,100072,99928
3:1:2,1,1,100071,99929
1:3:1,0,-1,100072,99928
1:4:2,1,1,100071,99929
1:4:2,1,1,100070,99930
2:2:2,3,3,100067,99933
5:2:3,1,1,100066,99934
6:1:1,0,-1,100067,99933
1:1:3,0,-1,100068,99932
4:2:5,1,1,100067,99933
5:5:5,0,-1,100068,99932
2:4:2,2,2,100066,99934
1:6:3,0,-1,100067,99933
6:1:2,1,1,100066,99934
2:4:6,1,1,100065,99935
6:2:5,1,1,100064,99936
4:1:2,1,1,100063,99937
2:6:2,2,2,100061,99939
5:3:3,0,-1,100062,99938
5:6:5,0,-1,100063,99937
5:1:4,0,-1,100064,99936
1:2:6,1,1,100063,99937
6:1:5,0,-1,100064,99936
1:3:5,0,-1,100065,99935
2:6:1,1,1,100064,99936
3:6:3,0,-1,100065,99935
1:1:1,0,-1,100066,99934
6:3:6,0,-1,100067,99933
3:5:2,1,1,100066,99934
6:5:2,1,1,100065,99935
5:3:6,0,-1,100066,99934
6:5:4,0,-1,100067,99933
5:2:2,2,2,100065,99935
5:1:5,0,-1,100066,99934
4:3:3,0,-1,100067,99933
1:1:5,0,-1,100068,99932
5:1:5,0,-1,100069,99931
6:6:2,1,1,100068,99932
4:3:6,0,-1,100069,99931
3:3:6,0,-1,100070,99930
1:1:5,0,-1,100071,99929
4:4:5,0,-1,100072,99928
5:3:4,0,-1,100073,99927
3:4:5,0,-1,100074,99926
4:6:6,0,-1,100075,99925
4:1:5,0,-1,100076,99924
5:6:4,0,-1,100077,99923
5:2:4,1,1,100076,99924
1:5:4,0,-1,100077,99923
4:3:6,0,-1,100078,99922
1:2:1,1,1,100077,99923
2:3:6,1,1,100076,99924
2:5:1,1,1,100075,99925
4:2:2,2,2,100073,99927
3:1:1,0,-1,100074,99926
6:1:6,0,-1,100075,99925
6:2:6,1,1,100074,99926
1:3:1,0,-1,100075,99925
2:4:4,1,1,100074,99926
3:4:2,1,1,100073,99927
5:2:5,1,1,100072,99928
5:5:2,1,1,100071,99929
4:5:2,1,1,100070,99930
1:1:2,1,1,100069,99931
2:4:2,2,2,100067,99933
3:5:3,0,-1,100068,99932
6:2:1,1,1,100067,99933
3:4:1,0,-1,100068,99932
3:6:2,1,1,100067,99933
4:2:4,1,1,100066,99934
3:3:5,0,-1,100067,99933
3:5:6,0,-1,100068,99932
2:2:1,2,2,100066,99934
5:3:1,0,-1,100067,99933
3:5:2,1,1,100066,99934
5:4:1,0,-1,100067,99933
3:6:5,0,-1,100068,99932
6:4:1,0,-1,100069,99931
2:1:6,1,1,100068,99932
3:5:6,0,-1,100069,99931
6:4:1,0,-1,100070,99930
4:3:4,0,-1,100071,99929
2:2:2,3,3,100068,99932
3:4:1,0,-1,100069,99931
6:1:6,0,-1,100070,99930
1:2:4,1,1,100069,99931
2:6:4,1,1,100068,99932
3:4:1,0,-1,100069,99931
1:4:2,1,1,100068,99932
5:3:1,0,-1,100069,99931
4:1:6,0,-1,100070,99930
1:1:5,0,-1,100071,99929
6:6:3,0,-1,100072,99928
1:4:5,0,-1,100073,99927
5:1:1,0,-1,100074,99926
2:5:2,2,2,100072,99928
5:2:3,1,1,100071,99929
1:1:6,0,-1,100072,99928
6:2:2,2,2,100070,99930
6:1:5,0,-1,100071,99929
6:3:3,0,-1,100072,99928
5:6:6,0,-1,100073,99927
5:6:1,0,-1,100074,99926
1:5:5,0,-1,100075,99925
6:4:6,0,-1,100076,99924
5:4:1,0,-1,100077,99923
1:5:6,0,-1,100078,99922
3:2:2,2,2,100076,99924
4:2:2,2,2,100074,99926
6:6:4,0,-1,100075,99925
2:1:1,1,1,100074,99926
5:4:4,0,-1,100075,99925
6:2:2,2,2,100073,99927
5:1:2,1,1,100072,99928
3:1:3,0,-1,100073,99927
6:2:1,1,1,100072,99928
3:2:5,1,1,100071,99929
3:5:2,1,1,100070,99930
4:4:5,0,-1,100071,99929
4:6:5,0,-1,100072,99928
3:3:4,0,-1,100073,99927
1:6:4,0,-1,100074,99926
3:2:4,1,1,100073,99927
6:2:4,1,1,100072,99928
4:1:5,0,-1,100073,99927
2:1:5,1,1,100072,99928
6:2:3,1,1,100071,99929
4:2:3,1,1,100070,99930
6:3:6,0,-1,100071,99929
6:3:2,1,1,100070,99930
6:1:5,0,-1,100071,99929
1:4:5,0,-1,100072,99928
3:2:6,1,1,100071,99929
3:5:4,0,-1,100072,99928
2:6:6,1,1,100071,99929
5:1:2,1,1,100070,99930
5:4:2,1,1,100069,99931
4:1:6,0,-1,100070,99930
3:3:2,1,1,100069,99931
3:6:6,0,-1,100070,99930
5:4:1,0,-1,100071,99929
4:5:6,0,-1,100072,99928
6:2:3,1,1,100071,99929
4:2:1,1,1,100070,99930
3:5:6,0,-1,100071,99929
1:5:6,0,-1,100072,99928
2:6:1,1,1,100071,99929
2:3:6,1,1,100070,99930
3:4:2,1,1,100069,99931
3:3:6,0,-1,100070,99930
3:3:1,0,-1,100071,99929
3:4:4,0,-1,100072,99928
5:4:2,1,1,100071,99929
1:6:2,1,1,100070,99930
3:6:1,0,-1,100071,99929
2:5:5,1,1,100070,99930
3:2:1,1,1,100069,99931
6:4:1,0,-1,100070,99930
1:2:2,2,2,100068,99932
5:2:3,1,1,100067,99933
2:1:5,1,1,100066,99934
5:3:2,1,1,100065,99935
2:2:4,2,2,100063,99937
4:6:6,0,-1,100064,99936
1:5:5,0,-1,100065,99935
3:4:3,0,-1,100066,99934
5:6:4,0,-1,100067,99933
3:2:4,1,1,100066,99934
1:5:5,0,-1,100067,99933
1:4:3,0,-1,100068,99932
2:1:1,1,1,100067,99933
2:3:1,1,1,100066,99934
5:3:6,0,-1,100067,99933
5:3:4,0,-1,100068,99932
4:6:6,0,-1,100069,99931
1:2:4,1,1,100068,99932
3:6:6,0,-1,100069,99931
4:3:6,0,-1,100070,99930
3:3:1,0,-1,100071,99929
4:4:4,0,-1,100072,99928
2:5:6,1,1,100071,99929
1:6:2,1,1,100070,99930
3:2:3,1,1,100069,99931
1:4:4,0,-1,100070,99930
4:5:4,0,-1,100071,99929
3:1:5,0,-1,100072,99928
1:3:1,0,-1,100073,99927
1:3:6,0,-1,100074,99926
2:2:5,2,2,100072,99928
2:6:2,2,2,100070,99930
5:5:1,0,-1,100071,99929
4:5:5,0,-1,100072,99928
3:4:4,0,-1,100073,99927
3:3:6,0,-1,100074,99926
6:2:4,1,1,100073,99927
2:1:2,2,2,100071,99929
6:4:4,0,-1,100072,99928
5:1:2,1,1,100071,99929
1:6:6,0,-1,100072,99928
3:1:2,1,1,100071,99929
4:1:6,0,-1,100072,99928
5:6:3,0,-1,100073,99927
4:5:4,0,-1,100074,99926
4:6:6,0,-1,100075,99925
6:1:5,0,-1,100076,99924
2:5:5,1,1,100075,99925
5:5:3,0,-1,100076,99924
4:1:5,0,-1,100077,99923
3:6:1,0,-1,100078,99922
5:5:3,0,-1,100079,99921
1:3:4,0,-1,100080,99920
2:1:1,1,1,100079,99921
1:3:4,0,-1,100080,99920
5:1:3,0,-1,100081,99919
6:3:2,1,1,100080,99920
2:6:2,2,2,100078,99922
2:5:5,1,1,100077,99923
4:4:4,0,-1,100078,99922
2:3:5,1,1,100077,99923
2:6:5,1,1,100076,99924
6:2:2,2,2,100074,99926
2:3:4,1,1,100073,99927
3:1:4,0,-1,100074,99926
3:5:3,0,-1,100075,99925
5:5:2,1,1,100074,99926
1:4:2,1,1,100073,99927
3:4:3,0,-1,100074,99926
4:5:6,0,-1,100075,99925
2:6:5,1,1,100074,99926
5:1:3,0,-1,100075,99925
3:4:4,0,-1,100076,99924
3:3:3,0,-1,100077,99923
1:5:6,0,-1,100078,99922
6:5:1,0,-1,100079,99921
6:6:4,0,-1,100080,99920
4:2:3,1,1,100079,99921
4:4:3,0,-1,100080,99920
5:5:4,0,-1,100081,99919
4:3:6,0,-1,100082,99918
4:6:4,0,-1,100083,99917
5:5:2,1,1,100082,99918
3:1:4,0,-1,100083,99917
1:4:4,0,-1,100084,99916
2:1:6,1,1,100083,99917
5:2:3,1,1,100082,99918
3:4:5,0,-1,100083,99917
6:5:5,0,-1,100084,99916
6:5:4,0,-1,100085,99915
6:4:3,0,-1,100086,99914
6:5:2,1,1,100085,99915
2:2:3,2,2,100083,99917
1:2:6,1,1,100082,99918
2:1:1,1,1,100081,99919
2:2:3,2,2,100079,99921
1:6:5,0,-1,100080,99920
3:4:5,0,-1,100081,99919
2:3:4,1,1,100080,99920
3:6:2,1,1,100079,99921
4:1:1,0,-1,100080,99920
4:5:1,0,-1,100081,99919
5:2:4,1,1,100080,99920
6:2:4,1,1,100079,99921
4:2:3,1,1,100078,99922
1:5:3,0,-1,100079,99921
3:1:4,0,-1,100080,99920
3:2:3,1,1,100079,99921
2:4:6,1,1,100078,99922
5:3:1,0,-1,100079,99921
6:5:5,0,-1,100080,99920
6:6:5,0,-1,100081,99919
5:2:2,2,2,100079,99921
3:5:6,0,-1,100080,99920
6:2:6,1,1,100079,99921
3:6:2,1,1,100078,99922
4:4:6,0,-1,100079,99921
2:1:5,1,1,100078,99922
3:2:1,1,1,100077,99923
1:4:5,0,-1,100078,99922
1:4:1,0,-1,100079,99921
5:5:6,0,-1,100080,99920
4:4:6,0,-1,100081,99919
2:4:4,1,1,100080,99920
4:1:3,0,-1,100081,99919
4:1:4,0,-1,100082,99918
4:2:6,1,1,100081,99919
5:5:4,0,-1,100082,99918
6:6:3,0,-1,100083,99917
3:5:3,0,-1,100084,99916
6:6:6,0,-1,100085,99915
3:5:2,1,1,100084,99916
5:1:6,0,-1,100085,99915
2:6:1,1,1,100084,99916
4:4:6,0,-1,100085,99915
3:4:2,1,1,100084,99916
2:5:1,1,1,100083,99917
2:3:5,1,1,100082,99918
3:4:3,0,-1,100083,99917
3:3:5,0,-1,100084,99916
5:1:2,1,1,100083,99917
5:5:1,0,-1,100084,99916
2:6:2,2,2,100082,99918
3:5:1,0,-1,100083,99917
2:2:1,2,2,100081,99919
5:1:6,0,-1,100082,99918
3:1:6,0,-1,100083,99917
4:4:2,1,1,100082,99918
2:6:3,1,1,100081,99919
1:2:3,1,1,100080,99920
4:5:2,1,1,100079,99921
5:3:5,0,-1,100080,99920
3:5:3,0,-1,100081,99919
4:1:2,1,1,100080,99920
3:3:3,0,-1,100081,99919
6:2:2,2,2,100079,99921
6:5:4,0,-1,100080,99920
6:2:6,1,1,100079,99921
4:5:3,0,-1,100080,99920
3:2:3,1,1,100079,99921
6:6:6,0,-1,100080,99920
5:4:4,0,-1,100081,99919
2:3:4,1,1,100080,99920
3:2:2,2,2,100078,99922
3:1:3,0,-1,100079,99921
1:4:6,0,-1,100080,99920
4:5:1,0,-1,100081,99919
3:2:2,2,2,100079,99921
1:4:3,0,-1,100080,99920
5:4:1,0,-1,100081,99919
2:4:2,2,2,100079,99921
1:4:4,0,-1,100080,99920
4:3:3,0,-1,100081,99919
4:2:1,1,1,100080,99920
5:2:2,2,2,100078,99922
2:4:6,1,1,100077,99923
6:4:1,0,-1,100078,99922
2:5:6,1,1,100077,99923
6:5:3,0,-1,100078,99922
5:6:2,1,1,100077,99923
1:4:3,0,-1,100078,99922
2:1:3,1,1,100077,99923
5:5:4,0,-1,100078,99922
1:1:6,0,-1,100079,99921
6:1:4,0,-1,100080,99920
6:4:1,0,-1,100081,99919
2:2:4,2,2,100079,99921
1:5:6,0,-1,100080,99920
6:2:4,1,1,100079,99921
3:6:4,0,-1,100080,99920
6:3:2,1,1,100079,99921
3:3:5,0,-1,100080,99920
2:2:4,2,2,100078,99922
4:4:6,0,-1,100079,99921
6:3:5,0,-1,100080,99920
3:3:6,0,-1,100081,99919
4:4:5,0,-1,100082,99918
2:3:6,1,1,100081,99919
6:3:6,0,-1,100082,99918
1:1:6,0,-1,100083,99917
4:2:5,1,1,100082,99918
6:2:2,2,2,100080,99920
6:3:4,0,-1,100081,99919
6:3:1,0,-1,100082,99918
5:2:4,1,1,100081,99919
2:6:1,1,1,100080,99920
5:4:2,1,1,100079,99921
1:1:3,0,-1,100080,99920
2:4:5,1,1,100079,99921
5:3:4,0,-1,100080,99920
5:2:5,1,1,100079,99921
5:1:1,0,-1,100080,99920
6:5:6,0,-1,100081,99919
6:6:2,1,1,100080,99920
3:6:2,1,1,100079,99921
1:6:5,0,-1,100080,99920
5:3:2,1,1,100079,99921
3:6:3,0,-1,100080,99920
2:1:6,1,1,100079,99921
1:2:5,1,1,100078,99922
5:2:4,1,1,100077,99923
5:3:6,0,-1,100078,99922
4:1:3,0,-1,100079,99921
5:2:1,1,1,100078,99922
4:5:5,0,-1,100079,99921
3:1:1,0,-1,100080,99920
5:1:6,0,-1,100081,99919
3:2:2,2,2,100079,99921
3:2:3,1,1,100078,99922
6:4:6,0,-1,100079,99921
1:5:1,0,-1,100080,99920
4:1:2,1,1,100079,99921
1:2:3,1,1,100078,99922
3:6:2,1,1,100077,99923
6:5:3,0,-1,100078,99922
4:3:6,0,-1,100079,99921
2:6:1,1,1,100078,99922
6:3:6,0,-1,100079,99921
2:6:3,1,1,100078,99922
6:6:1,0,-1,100079,99921
6:6:2,1,1,100078,99922
2:3:3,1,1,100077,99923
2:5:4,1,1,100076,99924
3:2:3,1,1,100075,99925
6:4:4,0,-1,100076,99924
6:5:1,0,-1,100077,99923
3:1:3,0,-1,100078,99922
3:6:3,0,-1,100079,99921
3:6:5,0,-1,100080,99920
1:1:6,0,-1,100081,99919
5:6:4,0,-1,100082,99918
6:1:3,0,-1,100083,99917
4:3:3,0,-1,100084,99916
4:3:4,0,-1,100085,99915
6:3:4,0,-1,100086,99914
1:5:5,0,-1,100087,99913
4:5:2,1,1,100086,99914
3:2:5,1,1,100085,99915
3:1:6,0,-1,100086,99914
6:4:5,0,-1,100087,99913
2:3:1,1,1,100086,99914
3:3:1,0,-1,100087,99913
1:2:4,1,1,100086,99914
4:5:5,0,-1,100087,99913
3:4:5,0,-1,100088,99912
5:4:6,0,-1,100089,99911
6:5:1,0,-1,100090,99910
2:2:3,2,2,100088,99912
1:4:5,0,-1,100089,99911
4:4:6,0,-1,100090,99910
1:6:5,0,-1,100091,99909
3:4:5,0,-1,100092,99908
5:6:5,0,-1,100093,99907
3:6:6,0,-1,100094,99906
2:6:2,2,2,100092,99908
1:2:1,1,1,100091,99909
2:2:2,3,3,100088,99912
4:2:5,1,1,100087,99913
3:2:6,1,1,100086,99914
5:4:4,0,-1,100087,99913
4:6:4,0,-1,100088,99912
6:3:1,0,-1,100089,99911
2:4:5,1,1,100088,99912
5:2:3,1,1,100087,99913
4:2:4,1,1,100086,99914
4:2:3,1,1,100085,99915
1:3:6,0,-1,100086,99914
1:6:3,0,-1,100087,99913
6:2:6,1,1,100086,99914
5:6:3,0,-1,100087,99913
1:2:1,1,1,100086,99914
4:4:6,0,-1,100087,99913
1:5:1,0,-1,100088,99912
4:6:4,0,-1,100089,99911
6:4:6,0,-1,100090,99910
4:4:4,0,-1,100091,99909
2:4:2,2,2,100089,99911
2:5:2,2,2,100087,99913
1:5:5,0,-1,100088,99912
6:2:4,1,1,100087,99913
2:5:4,1,1,100086,99914
6:4:1,0,-1,100087,99913
6:4:1,0,-1,100088,99912
6:4:6,0,-1,100089,99911
6:5:4,0,-1,100090,99910
5:4:3,0,-1,100091,99909
1:4:4,0,-1,100092,99908
3:6:6,0,-1,100093,99907
2:1:2,2,2,100091,99909
4:6:5,0,-1,100092,99908
1:2:6,1,1,100091,99909
2:6:2,2,2,100089,99911
1:5:1,0,-1,100090,99910
2:6:6,1,1,100089,99911
4:4:5,0,-1,100090,99910
4:5:4,0,-1,100091,99909
2:1:6,1,1,100090,99910
2:5:3,1,1,100089,99911
3:5:3,0,-1,100090,99910
6:6:2,1,1,100089,99911
4:4:2,1,1,100088,99912
3:3:6,0,-1,100089,99911
1:1:2,1,1,100088,99912
2:6:2,2,2,100086,99914
4:2:6,1,1,100085,99915
6:3:3,0,-1,100086,99914
3:2:3,1,1,100085,99915
3:5:2,1,1,100084,99916
5:6:2,1,1,100083,99917
2:4:2,2,2,100081,99919
2:1:5,1,1,100080,99920
4:2:6,1,1,100079,99921
2:6:3,1,1,100078,99922
5:3:3,0,-1,100079,99921
2:1:2,2,2,100077,99923
5:4:4,0,-1,100078,99922
4:2:6,1,1,100077,99923
2:1:1,1,1,100076,99924
6:3:5,0,-1,100077,99923
5:6:5,0,-1,100078,99922
4:4:3,0,-1,100079,99921
6:5:4,0,-1,100080,99920
3:6:5,0,-1,100081,99919
6:4:6,0,-1,100082,99918
6:4:5,0,-1,100083,99917
5:6:6,0,-1,100084,99916
2:3:6,1,1,100083,99917
2:1:6,1,1,100082,99918
1:3:5,0,-1,100083,99917
3:1:5,0,-1,100084,99916
4:6:2,1,1,100083,99917
3:4:1,0,-1,100084,99916
6:6:4,0,-1,100085,99915
4:3:2,1,1,100084,99916
2:3:5,1,1,100083,99917
4:5:6,0,-1,100084,99916
3:5:6,0,-1,100085,99915
6:3:1,0,-1,100086,99914
1:1:6,0,-1,100087,99913
4:5:2,1,1,100086,99914
1:4:2,1,1,100085,99915
3:5:5,0,-1,100086,99914
1:2:5,1,1,100085,99915
2:2:1,2,2,100083,99917
4:4:1,0,-1,100084,99916
2:6:1,1,1,100083,99917
1:6:2,1,1,100082,99918
4:1:1,0,-1,100083,99917
5:2:2,2,2,100081,99919
5:3:4,0,-1,100082,99918
4:1:3,0,-1,100083,99917
6:2:3,1,1,100082,99918
6:4:6,0,-1,100083,99917
5:6:6,0,-1,100084,99916
5:1:6,0,-1,100085,99915
6:1:6,0,-1,100086,99914
4:5:5,0,-1,100087,99913
5:2:5,1,1,100086,99914
5:1:1,0,-1,100087,99913
3:6:5,0,-1,100088,99912
5:6:4,0,-1,100089,99911
5:2:6,1,1,100088,99912
6:2:2,2,2,100086,99914
4:5:1,0,-1,100087,99913
4:5:5,0,-1,100088,99912
5:1:5,0,-1,100089,99911
5:3:6,0,-1,100090,99910
4:5:6,0,-1,100091,99909
1:4:2,1,1,100090,99910
2:5:6,1,1,100089,99911
5:1:3,0,-1,100090,99910
3:5:5,0,-1,100091,99909
4:4:5,0,-1,100092,99908
5:2:3,1,1,100091,99909
5:5:1,0,-1,100092,99908
5:6:3,0,-1,100093,99907
5:2:2,2,2,100091,99909
4:2:3,1,1,100090,99910
1:2:2,2,2,100088,99912
6:3:1,0,-1,100089,99911
1:4:6,0,-1,100090,99910
5:6:1,0,-1,100091,99909
6:1:6,0,-1,100092,99908
1:1:5,0,-1,100093,99907
1:4:4,0,-1,100094,99906
3:6:4,0,-1,100095,99905
3:3:2,1,1,100094,99906
1:2:6,1,1,100093,99907
2:6:5,1,1,100092,99908
1:1:3,0,-1,100093,99907
3:2:2,2,2,100091,99909
3:3:4,0,-1,100092,99908
2:1:2,2,2,100090,99910
4:3:5,0,-1,100091,99909
6:3:3,0,-1,100092,99908
6:5:4,0,-1,100093,99907
4:4:3,0,-1,100094,99906
1:5:3,0,-1,100095,99905
5:1:3,0,-1,100096,99904
2:1:6,1,1,100095,99905
3:2:2,2,2,100093,99907
1:5:1,0,-1,100094,99906
2:6:6,1,1,100093,99907
1:5:3,0,-1,100094,99906
4:2:6,1,1,100093,99907
3:4:6,0,-1,100094,99906
4:5:2,1,1,100093,99907
2:2:3,2,2,100091,99909
3:3:6,0,-1,100092,99908
3:2:1,1,1,100091,99909
4:5:3,0,-1,100092,99908
4:5:6,0,-1,100093,99907
1:2:3,1,1,100092,99908
2:4:5,1,1,100091,99909
3:4:5,0,-1,100092,99908
6:2:3,1,1,100091,99909
4:1:2,1,1,100090,99910
1:2:3,1,1,100089,99911
1:5:1,0,-1,100090,99910
6:1:5,0,-1,100091,99909
4:3:3,0,-1,100092,99908
2:4:4,1,1,100091,99909
3:6:1,0,-1,100092,99908
1:4:5,0,-1,100093,99907
2:3:3,1,1,100092,99908
3:5:1,0,-1,100093,99907
5:5:1,0,-1,100094,99906
3:5:1,0,-1,100095,99905
4:6:5,0,-1,100096,99904
6:4:3,0,-1,100097,99903
1:3:3,0,-1,100098,99902
2:1:4,1,1,100097,99903
1:1:6,0,-1,100098,99902
6:1:3,0,-1,100099,99901
4:1:6,0,-1,100100,99900
6:5:4,0,-1,100101,99899
1:1:2,1,1,100100,99900
4:2:4,1,1,100099,99901
5:6:6,0,-1,100100,99900
4:4:5,0,-1,100101,99899
2:5:4,1,1,100100,99900
6:2:3,1,1,100099,99901
1:3:4,0,-1,100100,99900
4:1:3,0,-1,100101,99899
1:5:3,0,-1,100102,99898
5:2:5,1,1,100101,99899
3:2:5,1,1,100100,99900
4:1:2,1,1,100099,99901
2:6:1,1,1,100098,99902
5:1:4,0,-1,100099,99901
6:2:6,1,1,100098,99902
2:5:1,1,1,100097,99903
3:2:5,1,1,100096,99904
2:6:5,1,1,100095,99905
4:5:2,1,1,100094,99906
4:5:5,0,-1,100095,99905
1:3:4,0,-1,100096,99904
6:6:1,0,-1,100097,99903
1:4:1,0,-1,100098,99902
5:5:3,0,-1,100099,99901
5:2:4,1,1,100098,99902
3:1:5,0,-1,100099,99901
1:6:6,0,-1,100100,99900
2:4:5,1,1,100099,99901
4:1:2,1,1,100098,99902
4:5:3,0,-1,100099,99901
5:1:2,1,1,100098,99902
3:1:2,1,1,100097,99903
1:5:3,0,-1,100098,99902
4:1:5,0,-1,100099,99901
4:2:3,1,1,100098,99902
6:3:5,0,-1,100099,99901
6:5:5,0,-1,100100,99900
4:6:5,0,-1,100101,99899
1:1:5,0,-1,100102,99898
5:1:6,0,-1,100103,99897
5:1:4,0,-1,100104,99896
5:4:6,0,-1,100105,99895
6:6:5,0,-1,100106,99894
4:3:1,0,-1,100107,99893
6:2:3,1,1,100106,99894
2:3:1,1,1,100105,99895
2:4:1,1,1,100104,99896
6:5:1,0,-1,100105,99895
1:6:1,0,-1,100106,99894
3:4:3,0,-1,100107,99893
5:6:5,0,-1,100108,99892
5:5:5,0,-1,100109,99891
4:6:1,0,-1,100110,99890
4:5:6,0,-1,100111,99889
6:4:4,0,-1,100112,99888
4:5:2,1,1,100111,99889
4:2:5,1,1,100110,99890
6:1:4,0,-1,100111,99889
2:5:1,1,1,100110,99890
4:3:2,1,1,100109,99891
5:1:3,0,-1,100110,99890
4:2:3,1,1,100109,99891
5:6:2,1,1,100108,99892
1:3:5,0,-1,100109,99891
4:5:1,0,-1,100110,99890
4:2:3,1,1,100109,99891
6:1:6,0,-1,100110,99890
1:5:4,0,-1,100111,99889
1:3:5,0,-1,100112,99888
1:4:1,0,-1,100113,99887
1:3:5,0,-1,100114,99886
3:3:3,0,-1,100115,99885
2:3:6,1,1,100114,99886
2:6:6,1,1,100113,99887
5:1:6,0,-1,100114,99886
5:1:5,0,-1,100115,99885
4:2:5,1,1,100114,99886
5:5:4,0,-1,100115,99885
5:2:3,1,1,100114,99886
5:5:2,1,1,100113,99887
2:5:6,1,1,100112,99888
4:1:3,0,-1,100113,99887
5:3:2,1,1,100112,99888
2:4:4,1,1,100111,99889
5:6:6,0,-1,100112,99888
2:6:4,1,1,100111,99889
5:2:1,1,1,100110,99890
1:6:4,0,-1,100111,99889
4:2:6,1,1,100110,99890
4:1:2,1,1,100109,99891
5:2:6,1,1,100108,99892
2:5:4,1,1,100107,99893
4:1:1,0,-1,100108,99892
5:2:5,1,1,100107,99893
4:3:3,0,-1,100108,99892
2:6:4,1,1,100107,99893
5:3:1,0,-1,100108,99892
3:4:5,0,-1,100109,99891
6:3:1,0,-1,100110,99890
4:4:4,0,-1,100111,99889
2:3:1,1,1,100110,99890
1:6:5,0,-1,100111,99889
5:3:2,1,1,100110,99890
4:6:2,1,1,100109,99891
4:4:1,0,-1,100110,99890
2:3:2,2,2,100108,99892
3:5:3,0,-1,100109,99891
3:3:2,1,1,100108,99892
6:4:4,0,-1,100109,99891
3:4:4,0,-1,100110,99890
1:2:5,1,1,100109,99891
5:5:3,0,-1,100110,99890
5:5:1,0,-1,100111,99889
1:4:1,0,-1,100112,99888
5:6:1,0,-1,100113,99887
3:6:1,0,-1,100114,99886
4:4:5,0,-1,100115,99885
5:5:6,0,-1,100116,99884
4:1:3,0,-1,100117,99883
3:6:1,0,-1,100118,99882
4:6:3,0,-1,100119,99881
5:2:2,2,2,100117,99883
5:6:1,0,-1,100118,99882
4:5:4,0,-1,100119,99881
3:3:6,0,-1,100120,99880
4:6:6,0,-1,100121,99879
2:1:2,2,2,100119,99881
4:5:4,0,-1,100120,99880
3:2:2,2,2,100118,99882
1:3:3,0,-1,100119,99881
5:1:3,0,-1,100120,99880
6:3:6,0,-1,100121,99879
4:3:6,0,-1,100122,99878
2:4:6,1,1,100121,99879
4:4:4,0,-1,100122,99878
2:2:5,2,2,100120,99880
6:1:5,0,-1,100121,99879
6:3:6,0,-1,100122,99878
1:4:2,1,1,100121,99879
2:2:4,2,2,100119,99881
2:2:2,3,3,100116,99884
5:3:1,0,-1,100117,99883
6:5:3,0,-1,100118,99882
5:3:2,1,1,100117,99883
4:5:4,0,-1,100118,99882
5:4:1,0,-1,100119,99881
2:1:2,2,2,100117,99883
3:4:4,0,-1,100118,99882
5:6:2,1,1,100117,99883
2:3:4,1,1,100116,99884
5:3:3,0,-1,100117,99883
4:4:1,0,-1,100118,99882
2:2:4,2,2,100116,99884
4:2:4,1,1,100115,99885
4:1:3,0,-1,100116,99884
6:1:5,0,-1,100117,99883
5:2:2,2,2,100115,99885
5:5:4,0,-1,100116,99884
2:2:4,2,2,100114,99886
1:4:3,0,-1,100115,99885
1:4:2,1,1,100114,99886
4:6:3,0,-1,100115,99885
6:1:1,0,-1,100116,99884
4:2:1,1,1,100115,99885
2:4:3,1,1,100114,99886
5:6:6,0,-1,100115,99885
4:5:4,0,-1,100116,99884
2:3:2,2,2,100114,99886
3:1:6,0,-1,100115,99885
4:2:3,1,1,100114,99886
2:5:4,1,1,100113,99887
5:4:3,0,-1,100114,99886
3:1:1,0,-1,100115,99885
3:1:3,0,-1,100116,99884
3:5:1,0,-1,100117,99883
6:2:3,1,1,100116,99884
2:4:3,1,1,100115,99885
1:1:3,0,-1,100116,99884
4:1:4,0,-1,100117,99883
5:1:4,0,-1,100118,99882
6:2:5,1,1,100117,99883
2:1:6,1,1,100116,99884
4:1:1,0,-1,100117,99883
3:4:1,0,-1,100118,99882
3:3:2,1,1,100117,99883
1:2:4,1,1,100116,99884
3:5:1,0,-1,100117,99883
3:2:1,1,1,100116,99884
1:2:1,1,1,100115,99885
3:6:5,0,-1,100116,99884
6:5:2,1,1,100115,99885
2:4:3,1,1,100114,99886
5:3:6,0,-1,100115,99885
4:2:3,1,1,100114,99886
2:3:3,1,1,100113,99887
1:2:1,1,1,100112,99888
4:6:5,0,-1,100113,99887
3:5:4,0,-1,100114,99886
5:1:4,0,-1,100115,99885
3:1:1,0,-1,100116,99884
6:2:5,1,1,100115,99885
3:4:6,0,-1,100116,99884
5:4:6,0,-1,100117,99883
6:4:1,0,-1,100118,99882
4:2:5,1,1,100117,99883
5:3:3,0,-1,100118,99882
5:3:3,0,-1,100119,99881
1:1:1,0,-1,100120,99880
1:1:1,0,-1,100121,99879
1:4:5,0,-1,100122,99878
2:5:2,2,2,100120,99880
5:4:6,0,-1,100121,99879
5:5:2,1,1,100120,99880
4:5:1,0,-1,100121,99879
6:3:2,1,1,100120,99880
1:1:4,0,-1,100121,99879
4:2:4,1,1,100120,99880
5:2:1,1,1,100119,99881
1:3:1,0,-1,100120,99880
5:2:4,1,1,100119,99881
1:5:4,0,-1,100120,99880
5:3:4,0,-1,100121,99879
2:3:2,2,2,100119,99881
2:5:6,1,1,100118,99882
6:4:6,0,-1,100119,99881
5:3:1,0,-1,100120,99880
1:6:1,0,-1,100121,99879
6:2:5,1,1,100120,99880
5:3:5,0,-1,100121,99879
6:6:2,1,1,100120,99880
1:5:6,0,-1,100121,99879
6:3:3,0,-1,100122,99878
3:2:3,1,1,100121,99879
2:3:2,2,2,100119,99881
1:1:2,1,1,100118,99882
4:6:2,1,1,100117,99883
3:4:3,0,-1,100118,99882
5:3:1,0,-1,100119,99881
2:1:4,1,1,100118,99882
2:6:6,1,1,100117,99883
6:3:2,1,1,100116,99884
4:6:2,1,1,100115,99885
2:1:2,2,2,100113,99887
3:6:1,0,-1,100114,99886
4:4:3,0,-1,100115,99885
5:5:2,1,1,100114,99886
3:2:5,1,1,100113,99887
6:4:4,0,-1,100114,99886
6:4:5,0,-1,100115,99885
6:1:6,0,-1,100116,99884
1:1:5,0,-1,100117,99883
1:1:1,0,-1,100118,99882
6:4:5,0,-1,100119,99881
2:2:1,2,2,100117,99883
3:1:5,0,-1,100118,99882
6:1:6,0,-1,100119,99881
4:1:5,0,-1,100120,99880
3:2:6,1,1,100119,99881
5:1:6,0,-1,100120,99880
6:6:4,0,-1,100121,99879
4:2:4,1,1,100120,99880
5:6:3,0,-1,100121,99879
4:2:5,1,1,100120,99880
4:2:3,1,1,100119,99881
1:2:1,1,1,100118,99882
1:6:3,0,-1,100119,99881
1:5:5,0,-1,100120,99880
5:4:4,0,-1,100121,99879
1:4:2,1,1,100120,99880
1:6:6,0,-1,100121,99879
1:1:6,0,-1,100122,99878
4:4:2,1,1,100121,99879
4:3:2,1,1,100120,99880
6:3:1,0,-1,100121,99879
1:5:1,0,-1,100122,99878
3:6:5,0,-1,100123,99877
4:1:5,0,-1,100124,99876
4:1:6,0,-1,100125,99875
3:2:3,1,1,100124,99876
3:4:3,0,-1,100125,99875
2:4:6,1,1,100124,99876
5:5:1,0,-1,100125,99875
3:2:1,1,1,100124,99876
4:5:3,0,-1,100125,99875
5:1:6,0,-1,100126,99874
6:3:1,0,-1,100127,99873
1:3:1,0,-1,100128,99872
2:5:6,1,1,100127,99873
2:3:1,1,1,100126,99874
2:1:5,1,1,100125,99875
3:1:5,0,-1,100126,99874
1:1:4,0,-1,100127,99873
3:4:6,0,-1,100128,99872
4:5:5,0,-1,100129,99871
5:5:6,0,-1,100130,99870
6:2:1,1,1,100129,99871
6:5:6,0,-1,100130,99870
3:3:6,0,-1,100131,99869
3:5:6,0,-1,100132,99868
4:2:4,1,1,100131,99869
6:1:1,0,-1,100132,99868
4:1:1,0,-1,100133,99867
5:3:6,0,-1,100134,99866
4:5:5,0,-1,100135,99865
4:5:1,0,-1,100136,99864
3:1:2,1,1,100135,99865
2:2:5,2,2,100133,99867
4:5:5,0,-1,100134,99866
3:3:4,0,-1,100135,99865
6:2:5,1,1,100134,99866
6:6:2,1,1,100133,99867
4:1:1,0,-1,100134,99866
5:4:6,0,-1,100135,99865
5:4:1,0,-1,100136,99864
3:3:5,0,-1,100137,99863
2:4:5,1,1,100136,99864
6:4:1,0,-1,100137,99863
6:5:1,0,-1,100138,99862
5:6:4,0,-1,100139,99861
6:1:5,0,-1,100140,99860
6:3:6,0,-1,100141,99859
4:5:3,0,-1,100142,99858
1:6:5,0,-1,100143,99857
2:6:6,1,1,100142,99858
2:5:1,1,1,100141,99859
2:1:4,1,1,100140,99860
3:5:6,0,-1,100141,99859
4:6:2,1,1,100140,99860
4:2:3,1,1,100139,99861
3:2:3,1,1,100138,99862
1:4:1,0,-1,100139,99861
2:2:4,2,2,100137,99863
5:6:5,0,-1,100138,99862
2:2:2,3,3,100135,99865
1:6:4,0,-1,100136,99864
4:2:1,1,1,100135,99865
4:2:3,1,1,100134,99866
1:1:5,0,-1,100135,99865
5:3:2,1,1,100134,99866
3:5:3,0,-1,100135,99865
6:3:5,0,-1,100136,99864
6:6:1,0,-1,100137,99863
5:6:1,0,-1,100138,99862
2:1:4,1,1,100137,99863
4:6:1,0,-1,100138,99862
4:2:3,1,1,100137,99863
3:6:4,0,-1,100138,99862
2:1:4,1,1,100137,99863
3:5:4,0,-1,100138,99862
3:3:1,0,-1,100139,99861
4:5:2,1,1,100138,99862
6:3:1,0,-1,100139,99861
5:6:6,0,-1,100140,99860
4:1:1,0,-1,100141,99859
6:2:1,1,1,100140,99860
1:6:1,0,-1,100141,99859
2:6:1,1,1,100140,99860
3:1:1,0,-1,100141,99859
5:2:6,1,1,100140,99860
3:4:6,0,-1,100141,99859
1:3:5,0,-1,100142,99858
6:4:3,0,-1,100143,99857
1:2:1,1,1,100142,99858
5:1:2,1,1,100141,99859
3:3:4,0,-1,100142,99858
6:3:4,0,-1,100143,99857
3:2:2,2,2,100141,99859
2:4:1,1,1,100140,99860
5:3:5,0,-1,100141,99859
3:3:2,1,1,100140,99860
4:1:3,0,-1,100141,99859
2:4:2,2,2,100139,99861
4:1:4,0,-1,100140,99860
5:6:3,0,-1,100141,99859
4:1:5,0,-1,100142,99858
4:4:3,0,-1,100143,99857
5:6:5,0,-1,100144,99856
4:2:4,1,1,100143,99857
3:3:5,0,-1,100144,99856
4:1:4,0,-1,100145,99855
6:6:4,0,-1,100146,99854
4:2:4,1,1,100145,99855
4:2:1,1,1,100144,99856
1:5:2,1,1,100143,99857
3:5:5,0,-1,100144,99856
4:6:4,0,-1,100145,99855
6:6:2,1,1,100144,99856
4:2:5,1,1,100143,99857
6:2:5,1,1,100142,99858
1:5:1,0,-1,100143,99857
3:5:2,1,1,100142,99858
2:4:2,2,2,100140,99860
2:2:3,2,2,100138,99862
3:6:1,0,-1,100139,99861
4:6:3,0,-1,100140,99860
2:4:1,1,1,100139,99861
4:6:4,0,-1,100140,99860
6:2:5,1,1,100139,99861
4:6:1,0,-1,100140,99860
5:4:3,0,-1,100141,99859
1:2:1,1,1,100140,99860
4:2:1,1,1,100139,99861
5:5:3,0,-1,100140,99860
3:5:6,0,-1,100141,99859
6:6:6,0,-1,100142,99858
2:1:5,1,1,100141,99859
2:2:2,3,3,100138,99862
2:4:3,1,1,100137,99863
2:5:5,1,1,100136,99864
2:6:4,1,1,100135,99865
5:5:5,0,-1,100136,99864
5:6:4,0,-1,100137,99863
3:4:6,0,-1,100138,99862
4:3:1,0,-1,100139,99861
4:1:1,0,-1,100140,99860
6:3:6,0,-1,100141,99859
6:1:4,0,-1,100142,99858
5:1:6,0,-1,100143,99857
3:6:3,0,-1,100144,99856
6:5:6,0,-1,100145,99855
4:6:6,0,-1,100146,99854
2:4:6,1,1,100145,99855
1:3:1,0,-1,100146,99854
2:2:3,2,2,100144,99856
2:3:5,1,1,100143,99857
6:3:6,0,-1,100144,99856
3:3:1,0,-1,100145,99855
5:5:3,0,-1,100146,99854
2:1:3,1,1,100145,99855
6:6:2,1,1,100144,99856
2:2:5,2,2,100142,99858
2:3:3,1,1,100141,99859
2:5:3,1,1,100140,99860
3:2:4,1,1,100139,99861
4:2:3,1,1,100138,99862
3:3:1,0,-1,100139,99861
4:6:1,0,-1,100140,99860
4:5:3,0,-1,100141,99859
3:5:2,1,1,100140,99860
1:2:3,1,1,100139,99861
2:3:1,1,1,100138,99862
1:6:5,0,-1,100139,99861
3:1:4,0,-1,100140,99860
4:4:3,0,-1,100141,99859
6:4:2,1,1,100140,99860
1:3:6,0,-1,100141,99859
6:5:4,0,-1,100142,99858
3:3:1,0,-1,100143,99857
2:5:6,1,1,100142,99858
4:2:5,1,1,100141,99859
6:5:1,0,-1,100142,99858
6:4:1,0,-1,100143,99857
2:2:2,3,3,100140,99860
6:1:4,0,-1,100141,99859
2:1:3,1,1,100140,99860
5:3:4,0,-1,100141,99859
6:6:1,0,-1,100142,99858
5:5:4,0,-1,100143,99857
3:6:1,0,-1,100144,99856
6:3:4,0,-1,100145,99855
6:1:5,0,-1,100146,99854
5:2:3,1,1,100145,99855
1:5:6,0,-1,100146,99854
1:6:2,1,1,100145,99855
1:1:2,1,1,100144,99856
3:2:3,1,1,100143,99857
6:6:2,1,1,100142,99858
1:5:3,0,-1,100143,99857
6:3:2,1,1,100142,99858
1:6:6,0,-1,100143,99857
2:5:6,1,1,100142,99858
4:6:6,0,-1,100143,99857
2:3:1,1,1,100142,99858
1:3:5,0,-1,100143,99857
4:6:5,0,-1,100144,99856
1:2:2,2,2,100142,99858
1:5:3,0,-1,100143,99857
2:5:5,1,1,100142,99858
4:6:4,0,-1,100143,99857
2:2:3,2,2,100141,99859
5:3:6,0,-1,100142,99858
1:2:6,1,1,100141,99859
2:2:6,2,2,100139,99861
1:5:5,0,-1,100140,99860
5:6:2,1,1,100139,99861
4:3:3,0,-1,100140,99860
1:4:3,0,-1,100141,99859
4:1:1,0,-1,100142,99858
6:5:5,0,-1,100143,99857
6:4:4,0,-1,100144,99856
5:2:1,1,1,100143,99857
5:1:3,0,-1,100144,99856
1:3:2,1,1,100143,99857
4:4:6,0,-1,100144,99856
6:1:6,0,-1,100145,99855
6:3:5,0,-1,100146,99854
5:1:2,1,1,100145,99855
2:4:4,1,1,100144,99856
3:5:2,1,1,100143,99857
6:4:3,0,-1,100144,99856
2:4:3,1,1,100143,99857
5:2:3,1,1,100142,99858
6:1:2,1,1,100141,99859
4:2:5,1,1,100140,99860
4:3:2,1,1,100139,99861
6:1:4,0,-1,100140,99860
6:5:3,0,-1,100141,99859
6:4:3,0,-1,100142,99858
1:4:1,0,-1,100143,99857
4:3:4,0,-1,100144,99856
2:2:5,2,2,100142,99858
6:5:2,1,1,100141,99859
6:4:1,0,-1,100142,99858
5:4:6,0,-1,100143,99857
1:3:4,0,-1,100144,99856
5:3:3,0,-1,100145,99855
5:2:6,1,1,100144,99856
2:2:5,2,2,100142,99858
5:4:5,0,-1,100143,99857
3:4:4,0,-1,100144,99856
1:3:2,1,1,100143,99857
2:6:1,1,1,100142,99858
5:1:4,0,-1,100143,99857
3:1:4,0,-1,100144,99856
2:4:2,2,2,100142,99858
6:2:2,2,2,100140,99860
6:1:1,0,-1,100141,99859
2:1:2,2,2,100139,99861
2:2:1,2,2,100137,99863
3:2:3,1,1,100136,99864
5:6:2,1,1,100135,99865
5:4:1,0,-1,100136,99864
5:4:2,1,1,100135,99865
3:4:4,0,-1,100136,99864
1:1:3,0,-1,100137,99863
6:3:1,0,-1,100138,99862
4:4:2,1,1,100137,99863
3:3:3,0,-1,100138,99862
6:3:4,0,-1,100139,99861
4:5:2,1,1,100138,99862
1:1:4,0,-1,100139,99861
3:6:6,0,-1,100140,99860
3:6:2,1,1,100139,99861
1:3:3,0,-1,100140,99860
3:6:4,0,-1,100141,99859
5:5:5,0,-1,100142,99858
1:3:4,0,-1,100143,99857
5:2:5,1,1,100142,99858
4:5:5,0,-1,100143,99857
2:2:4,2,2,100141,99859
6:1:1,0,-1,100142,99858
6:1:6,0,-1,100143,99857
1:5:5,0,-1,100144,99856
1:1:2,1,1,100143,99857
3:2:5,1,1,100142,99858
4:6:4,0,-1,100143,99857
5:2:6,1,1,100142,99858
2:1:6,1,1,100141,99859
6:4:5,0,-1,100142,99858
1:2:6,1,1,100141,99859
4:4:2,1,1,100140,99860
5:6:5,0,-1,100141,99859
4:3:6,0,-1,100142,99858
1:4:4,0,-1,100143,99857
2:5:6,1,1,100142,99858
1:5:6,0,-1,100143,99857
6:1:5,0,-1,100144,99856
2:3:5,1,1,100143,99857
3:4:2,1,1,100142,99858
2:3:3,1,1,100141,99859
3:2:2,2,2,100139,99861
2:2:4,2,2,100137,99863
2:4:4,1,1,100136,99864
1:5:1,0,-1,100137,99863
2:3:4,1,1,100136,99864
2:1:5,1,1,100135,99865
2:6:1,1,1,100134,99866
1:1:5,0,-1,100135,99865
4:3:6,0,-1,100136,99864
6:1:5,0,-1,100137,99863
2:4:5,1,1,100136,99864
1:6:3,0,-1,100137,99863
3:4:3,0,-1,100138,99862
3:6:4,0,-1,100139,99861
5:2:1,1,1,100138,99862
4:1:1,0,-1,100139,99861
2:5:3,1,1,100138,99862
1:6:4,0,-1,100139,99861
4:5:1,0,-1,100140,99860
1:4:2,1,1,100139,99861
6:5:6,0,-1,100140,99860
2:2:1,2,2,100138,99862
4:6:3,0,-1,100139,99861
5:1:6,0,-1,100140,99860
3:6:3,0,-1,100141,99859
1:1:1,0,-1,100142,99858
3:6:1,0,-1,100143,99857
1:1:6,0,-1,100144,99856
4:5:6,0,-1,100145,99855
1:1:6,0,-1,100146,99854
5:2:4,1,1,100145,99855
1:5:4,0,-1,100146,99854
5:6:3,0,-1,100147,99853
1:2:2,2,2,100145,99855
5:1:3,0,-1,100146,99854
2:2:1,2,2,100144,99856
5:4:6,0,-1,100145,99855
1:3:6,0,-1,100146,99854
1:2:6,1,1,100145,99855
4:1:5,0,-1,100146,99854
2:6:5,1,1,100145,99855
5:2:4,1,1,100144,99856
3:5:4,0,-1,100145,99855
5:5:4,0,-1,100146,99854
4:6:5,0,-1,100147,99853
2:6:3,1,1,100146,99854
3:4:2,1,1,100145,99855
6:1:6,0,-1,100146,99854
1:2:1,1,1,100145,99855
4:5:2,1,1,100144,99856
5:6:6,0,-1,100145,99855
5:1:2,1,1,100144,99856
4:5:4,0,-1,100145,99855
3:1:6,0,-1,100146,99854
2:2:4,2,2,100144,99856
2:2:4,2,2,100142,99858
4:1:6,0,-1,100143,99857
6:4:4,0,-1,100144,99856
3:2:5,1,1,100143,99857
6:4:2,1,1,100142,99858
2:4:6,1,1,100141,99859
3:2:5,1,1,100140,99860
5:1:6,0,-1,100141,99859
6:2:1,1,1,100140,99860
4:6:4,0,-1,100141,99859
2:1:1,1,1,100140,99860
1:1:6,0,-1,100141,99859
4:4:6,0,-1,100142,99858
1:6:2,1,1,100141,99859
1:2:4,1,1,100140,99860
3:4:2,1,1,100139,99861
6:5:6,0,-1,100140,99860
6:2:6,1,1,100139,99861
4:2:2,2,2,100137,99863
3:4:4,0,-1,100138,99862
1:1:6,0,-1,100139,99861
3:6:5,0,-1,100140,99860
5:6:2,1,1,100139,99861
1:6:5,0,-1,100140,99860
4:4:2,1,1,100139,99861
1:5:4,0,-1,100140,99860
4:4:6,0,-1,100141,99859
2:6:2,2,2,100139,99861
2:4:3,1,1,100138,99862
6:1:2,1,1,100137,99863
3:1:4,0,-1,100138,99862
3:6:2,1,1,100137,99863
2:3:6,1,1,100136,99864
1:2:6,1,1,100135,99865
6:1:2,1,1,100134,99866
1:2:2,2,2,100132,99868
5:3:1,0,-1,100133,99867
6:6:3,0,-1,100134,99866
4:6:5,0,-1,100135,99865
1:2:3,1,1,100134,99866
3:1:1,0,-1,100135,99865
1:3:5,0,-1,100136,99864
3:2:6,1,1,100135,99865
6:3:6,0,-1,100136,99864
3:6:4,0,-1,100137,99863
5:5:5,0,-1,100138,99862
6:4:1,0,-1,100139,99861
4:3:1,0,-1,100140,99860
1:3:5,0,-1,100141,99859
5:6:5,0,-1,100142,99858
4:1:3,0,-1,100143,99857
4:1:3,0,-1,100144,99856
2:4:1,1,1,100143,99857
6:1:1,0,-1,100144,99856
4:3:6,0,-1,100145,99855
5:3:6,0,-1,100146,99854
2:6:2,2,2,100144,99856
6:3:4,0,-1,100145,99855
3:4:1,0,-1,100146,99854
1:1:4,0,-1,100147,99853
5:1:2,1,1,100146,99854
1:1:2,1,1,100145,99855
2:4:2,2,2,100143,99857
5:3:2,1,1,100142,99858
1:4:3,0,-1,100143,99857
3:2:5,1,1,100142,99858
4:2:5,1,1,100141,99859
6:5:3,0,-1,100142,99858
4:5:4,0,-1,100143,99857
2:4:3,1,1,100142,99858
4:1:3,0,-1,100143,99857
6:6:2,1,1,100142,99858
2:6:1,1,1,100141,99859
6:2:4,1,1,100140,99860
6:6:2,1,1,100139,99861
1:1:6,0,-1,100140,99860
4:4:2,1,1,100139,99861
2:3:6,1,1,100138,99862
4:3:1,0,-1,100139,99861
6:2:6,1,1,100138,99862
1:3:5,0,-1,100139,99861
4:4:4,0,-1,100140,99860
2:1:4,1,1,100139,99861
6:4:4,0,-1,100140,99860
3:3:3,0,-1,100141,99859
5:2:3,1,1,100140,99860
1:3:1,0,-1,100141,99859
2:6:2,2,2,100139,99861
5:3:2,1,1,100138,99862
2:2:2,3,3,100135,99865
5:4:5,0,-1,100136,99864
5:6:3,0,-1,100137,99863
4:3:2,1,1,100136,99864
3:1:1,0,-1,100137,99863
6:6:3,0,-1,100138,99862
2:1:1,1,1,100137,99863
6:6:1,0,-1,100138,99862
5:3:6,0,-1,100139,99861
6:2:2,2,2,100137,99863
4:5:2,1,1,100136,99864
2:6:1,1,1,100135,99865
1:1:5,0,-1,100136,99864
5:3:6,0,-1,100137,99863
5:6:2,1,1,100136,99864
4:1:4,0,-1,100137,99863
2:1:4,1,1,100136,99864
4:1:2,1,1,100135,99865
4:2:5,1,1,100134,99866
6:4:6,0,-1,100135,99865
2:3:4,1,1,100134,99866
5:5:3,0,-1,100135,99865
6:6:2,1,1,100134,99866
5:4:1,0,-1,100135,99865
1:5:2,1,1,100134,99866
6:5:4,0,-1,100135,99865
3:1:5,0,-1,100136,99864
2:2:1,2,2,100134,99866
2:5:3,1,1,100133,99867
3:4:6,0,-1,100134,99866
3:2:1,1,1,100133,99867
3:6:5,0,-1,100134,99866
2:6:6,1,1,100133,99867
6:5:4,0,-1,100134,99866
6:3:2,1,1,100133,99867
2:2:4,2,2,100131,99869
6:3:2,1,1,100130,99870
6:1:5,0,-1,100131,99869
3:3:3,0,-1,100132,99868
5:1:3,0,-1,100133,99867
4:3:1,0,-1,100134,99866
5:2:6,1,1,100133,99867
2:3:6,1,1,100132,99868
2:4:5,1,1,100131,99869
3:2:1,1,1,100130,99870
4:2:3,1,1,100129,99871
6:4:3,0,-1,100130,99870
3:2:5,1,1,100129,99871
1:1:5,0,-1,100130,99870
4:1:2,1,1,100129,99871
2:6:5,1,1,100128,99872
1:6:5,0,-1,100129,99871
3:3:5,0,-1,100130,99870
4:1:1,0,-1,100131,99869
3:2:2,2,2,100129,99871
1:5:2,1,1,100128,99872
2:6:3,1,1,100127,99873
1:1:4,0,-1,100128,99872
4:3:3,0,-1,100129,99871
4:5:5,0,-1,100130,99870
6:5:4,0,-1,100131,99869
4:5:1,0,-1,100132,99868
6:2:4,1,1,100131,99869
4:5:6,0,-1,100132,99868
2:3:1,1,1,100131,99869
5:3:4,0,-1,100132,99868
2:2:2,3,3,100129,99871
3:2:3,1,1,100128,99872
5:4:5,0,-1,100129,99871
6:6:2,1,1,100128,99872
1:3:3,0,-1,100129,99871
4:5:5,0,-1,100130,99870
3:4:1,0,-1,100131,99869
2:3:5,1,1,100130,99870
4:4:1,0,-1,100131,99869
6:5:5,0,-1,100132,99868
6:6:6,0,-1,100133,99867
4:1:6,0,-1,100134,99866
6:3:3,0,-1,100135,99865
5:2:2,2,2,100133,99867
1:2:4,1,1,100132,99868
3:3:6,0,-1,100133,99867
6:5:3,0,-1,100134,99866
5:4:4,0,-1,100135,99865
3:6:4,0,-1,100136,99864
5:3:1,0,-1,100137,99863
6:4:6,0,-1,100138,99862
5:3:6,0,-1,100139,99861
6:3:6,0,-1,100140,99860
2:5:3,1,1,100139,99861
1:1:4,0,-1,100140,99860
2:5:6,1,1,100139,99861
4:1:4,0,-1,100140,99860
5:5:6,0,-1,100141,99859
6:2:5,1,1,100140,99860
5:4:6,0,-1,100141,99859
1:4:5,0,-1,100142,99858
6:5:2,1,1,100141,99859
1:2:4,1,1,100140,99860
6:2:2,2,2,100138,99862
4:4:4,0,-1,100139,99861
5:2:6,1,1,100138,99862
4:4:3,0,-1,100139,99861
2:1:2,2,2,100137,99863
3:6:2,1,1,100136,99864
1:5:6,0,-1,100137,99863
5:6:2,1,1,100136,99864
6:3:2,1,1,100135,99865
5:1:5,0,-1,100136,99864
1:2:4,1,1,100135,99865
4:3:5,0,-1,100136,99864
1:4:2,1,1,100135,99865
6:6:6,0,-1,100136,99864
2:4:1,1,1,100135,99865
2:4:6,1,1,100134,99866
5:1:4,0,-1,100135,99865
5:5:4,0,-1,100136,99864
4:5:2,1,1,100135,99865
5:5:3,0,-1,100136,99864
4:6:2,1,1,100135,99865
4:3:2,1,1,100134,99866
1:3:2,1,1,100133,99867
1:4:2,1,1,100132,99868
2:5:1,1,1,100131,99869
1:5:2,1,1,100130,99870
2:3:4,1,1,100129,99871
6:4:5,0,-1,100130,99870
5:4:2,1,1,100129,99871
3:1:5,0,-1,100130,99870
2:2:2,3,3,100127,99873
2:2:5,2,2,100125,99875
5:4:1,0,-1,100126,99874
2:1:6,1,1,100125,99875
3:6:3,0,-1,100126,99874
6:6:1,0,-1,100127,99873
6:3:1,0,-1,100128,99872
4:4:2,1,1,100127,99873
2:6:3,1,1,100126,99874
6:3:5,0,-1,100127,99873
2:3:5,1,1,100126,99874
6:2:2,2,2,100124,99876
5:4:3,0,-1,100125,99875
2:5:4,1,1,100124,99876
3:2:2,2,2,100122,99878
5:1:2,1,1,100121,99879
5:2:3,1,1,100120,99880
3:5:5,0,-1,100121,99879
5:3:4,0,-1,100122,99878
4:5:5,0,-1,100123,99877
6:5:5,0,-1,100124,99876
4:2:2,2,2,100122,99878
4:3:2,1,1,100121,99879
1:5:2,1,1,100120,99880
3:6:4,0,-1,100121,99879
6:3:3,0,-1,100122,99878
1:6:4,0,-1,100123,99877
5:5:2,1,1,100122,99878
5:6:4,0,-1,100123,99877
1:5:6,0,-1,100124,99876
2:2:2,3,3,100121,99879
3:1:6,0,-1,100122,99878
5:1:5,0,-1,100123,99877
5:3:1,0,-1,100124,99876
3:6:6,0,-1,100125,99875
2:1:4,1,1,100124,99876
3:1:4,0,-1,100125,99875
3:1:1,0,-1,100126,99874
2:2:6,2,2,100124,99876
5:2:3,1,1,100123,99877
6:3:4,0,-1,100124,99876
6:4:4,0,-1,100125,99875
4:3:5,0,-1,100126,99874
4:6:3,0,-1,100127,99873
6:3:2,1,1,100126,99874
2:5:1,1,1,100125,99875
3:4:1,0,-1,100126,99874
3:5:1,0,-1,100127,99873
2:3:6,1,1,100126,99874
1:2:2,2,2,100124,99876
3:5:1,0,-1,100125,99875
5:4:6,0,-1,100126,99874
3:6:2,1,1,100125,99875
6:2:2,2,2,100123,99877
1:5:6,0,-1,100124,99876
1:5:2,1,1,100123,99877
4:5:3,0,-1,100124,99876
5:6:1,0,-1,100125,99875
3:2:2,2,2,100123,99877
4:2:2,2,2,100121,99879
6:4:4,0,-1,100122,99878
5:5:1,0,-1,100123,99877
1:6:1,0,-1,100124,99876
5:6:2,1,1,100123,99877
3:5:6,0,-1,100124,99876
3:3:3,0,-1,100125,99875
3:4:6,0,-1,100126,99874
2:1:1,1,1,100125,99875
2:6:4,1,1,100124,99876
3:5:3,0,-1,100125,99875
6:5:2,1,1,100124,99876
4:5:5,0,-1,100125,99875
1:5:3,0,-1,100126,99874
4:4:4,0,-1,100127,99873
6:4:2,1,1,100126,99874
5:4:1,0,-1,100127,99873
3:6:6,0,-1,100128,99872
3:2:6,1,1,100127,99873
1:1:6,0,-1,100128,99872
3:3:1,0,-1,100129,99871
5:3:1,0,-1,100130,99870
3:2:6,1,1,100129,99871
6:6:3,0,-1,100130,99870
3:4:3,0,-1,100131,99869
3:2:4,1,1,100130,99870
2:2:4,2,2,100128,99872
5:4:3,0,-1,100129,99871
4:3:4,0,-1,100130,99870
4:1:3,0,-1,100131,99869
5:4:6,0,-1,100132,99868
5:5:4,0,-1,100133,99867
3:6:6,0,-1,100134,99866
6:5:5,0,-1,100135,99865
6:3:2,1,1,100134,99866
4:5:4,0,-1,100135,99865
4:6:6,0,-1,100136,99864
3:3:1,0,-1,100137,99863
6:5:2,1,1,100136,99864
6:5:1,0,-1,100137,99863
1:1:5,0,-1,100138,99862
3:5:3,0,-1,100139,99861
2:1:4,1,1,100138,99862
4:5:1,0,-1,100139,99861
3:5:5,0,-1,100140,99860
6:2:5,1,1,100139,99861
3:6:1,0,-1,100140,99860
2:6:5,1,1,100139,99861
4:4:1,0,-1,100140,99860
2:3:1,1,1,100139,99861
4:1:6,0,-1,100140,99860
6:1:6,0,-1,100141,99859
6:5:6,0,-1,100142,99858
4:5:1,0,-1,100143,99857
6:6:6,0,-1,100144,99856
2:2:5,2,2,100142,99858
5:6:6,0,-1,100143,99857
3:3:2,1,1,100142,99858
6:5:3,0,-1,100143,99857
2:4:5,1,1,100142,99858
2:4:5,1,1,100141,99859
6:5:1,0,-1,100142,99858
6:6:4,0,-1,100143,99857
1:1:2,1,1,100142,99858
4:1:3,0,-1,100143,99857
6:4:6,0,-1,100144,99856
2:1:4,1,1,100143,99857
5:2:1,1,1,100142,99858
1:1:2,1,1,100141,99859
2:3:2,2,2,100139,99861
6:6:1,0,-1,100140,99860
3:4:1,0,-1,100141,99859
1:1:1,0,-1,100142,99858
5:1:5,0,-1,100143,99857
4:6:1,0,-1,100144,99856
6:5:6,0,-1,100145,99855
5:5:4,0,-1,100146,99854
3:4:5,0,-1,100147,99853
4:1:1,0,-1,100148,99852
6:1:2,1,1,100147,99853
5:6:2,1,1,100146,99854
6:4:6,0,-1,100147,99853
4:5:2,1,1,100146,99854
4:1:5,0,-1,100147,99853
2:2:4,2,2,100145,99855
1:2:2,2,2,100143,99857
4:3:4,0,-1,100144,99856
5:3:4,0,-1,100145,99855
1:3:2,1,1,100144,99856
1:3:5,0,-1,100145,99855
5:4:3,0,-1,100146,99854
6:1:3,0,-1,100147,99853
3:6:2,1,1,100146,99854
5:1:4,0,-1,100147,99853
2:6:1,1,1,100146,99854
1:4:5,0,-1,100147,99853
2:1:1,1,1,100146,99854
4:3:4,0,-1,100147,99853
6:5:6,0,-1,100148,99852
6:2:5,1,1,100147,99853
3:2:2,2,2,100145,99855
6:1:2,1,1,100144,99856
2:5:5,1,1,100143,99857
1:4:2,1,1,100142,99858
2:1:3,1,1,100141,99859
4:2:4,1,1,100140,99860
6:5:6,0,-1,100141,99859
3:2:3,1,1,100140,99860
5:6:2,1,1,100139,99861
1:1:6,0,-1,100140,99860
1:2:6,1,1,100139,99861
6:6:2,1,1,100138,99862
6:4:5,0,-1,100139,99861
6:2:1,1,1,100138,99862
4:3:2,1,1,100137,99863
6:2:1,1,1,100136,99864
1:6:5,0,-1,100137,99863
4:4:6,0,-1,100138,99862
2:4:4,1,1,100137,99863
5:1:1,0,-1,100138,99862
4:4:6,0,-1,100139,99861
1:1:1,0,-1,100140,99860
3:2:2,2,2,100138,99862
3:2:3,1,1,100137,99863
5:4:5,0,-1,100138,99862
6:3:1,0,-1,100139,99861
2:5:4,1,1,100138,99862
4:3:6,0,-1,100139,99861
2:2:1,2,2,100137,99863
4:5:4,0,-1,100138,99862
3:1:3,0,-1,100139,99861
4:2:2,2,2,100137,99863
3:2:1,1,1,100136,99864
4:1:2,1,1,100135,99865
5:5:4,0,-1,100136,99864
3:3:5,0,-1,100137,99863
6:4:6,0,-1,100138,99862
2:4:4,1,1,100137,99863
2:6:4,1,1,100136,99864
4:5:2,1,1,100135,99865
4:5:3,0,-1,100136,99864
3:5:3,0,-1,100137,99863
4:4:2,1,1,100136,99864
4:1:1,0,-1,100137,99863
2:6:3,1,1,100136,99864
1:1:5,0,-1,100137,99863
3:1:1,0,-1,100138,99862
4:5:5,0,-1,100139,99861
3:6:4,0,-1,100140,99860
6:3:5,0,-1,100141,99859
6:3:3,0,-1,100142,99858
4:2:6,1,1,100141,99859
3:6:2,1,1,100140,99860
5:5:6,0,-1,100141,99859
6:6:3,0,-1,100142,99858
2:2:3,2,2,100140,99860
5:4:1,0,-1,100141,99859
2:6:5,1,1,100140,99860
4:5:2,1,1,100139,99861
1:4:6,0,-1,100140,99860
5:6:6,0,-1,100141,99859
4:2:1,1,1,100140,99860
2:5:4,1,1,100139,99861
5:4:6,0,-1,100140,99860
4:4:2,1,1,100139,99861
1:3:5,0,-1,100140,99860
2:6:4,1,1,100139,99861
5:6:1,0,-1,100140,99860
4:3:4,0,-1,100141,99859
5:5:4,0,-1,100142,99858
6:3:5,0,-1,100143,99857
4:3:4,0,-1,100144,99856
6:2:5,1,1,100143,99857
2:3:3,1,1,100142,99858
3:4:5,0,-1,100143,99857
1:2:3,1,1,100142,99858
2:3:3,1,1,100141,99859
1:1:6,0,-1,100142,99858
2:2:1,2,2,100140,99860
4:1:3,0,-1,100141,99859
6:1:6,0,-1,100142,99858
2:1:5,1,1,100141,99859
6:5:6,0,-1,100142,99858
4:3:3,0,-1,100143,99857
4:1:1,0,-1,100144,99856
2:6:1,1,1,100143,99857
3:3:3,0,-1,100144,99856
1:2:5,1,1,100143,99857
2:5:3,1,1,100142,99858
3:1:6,0,-1,100143,99857
3:2:5,1,1,100142,99858
4:1:5,0,-1,100143,99857
3:3:1,0,-1,100144,99856
2:5:3,1,1,100143,99857
3:2:2,2,2,100141,99859
5:1:4,0,-1,100142,99858
1:6:4,0,-1,100143,99857
1:1:3,0,-1,100144,99856
6:1:3,0,-1,100145,99855
6:3:6,0,-1,100146,99854
1:2:6,1,1,100145,99855
6:6:2,1,1,100144,99856
4:3:6,0,-1,100145,99855
4:2:1,1,1,100144,99856
3:5:3,0,-1,100145,99855
4:5:5,0,-1,100146,99854
6:4:3,0,-1,100147,99853
6:5:1,0,-1,100148,99852
5:5:4,0,-1,100149,99851
2:1:1,1,1,100148,99852
6:2:5,1,1,100147,99853
5:1:2,1,1,100146,99854
3:4:3,0,-1,100147,99853
6:6:6,0,-1,100148,99852
3:3:2,1,1,100147,99853
1:3:3,0,-1,100148,99852
4:6:5,0,-1,100149,99851
1:2:6,1,1,100148,99852
6:3:2,1,1,100147,99853
4:3:6,0,-1,100148,99852
4:1:5,0,-1,100149,99851
2:3:6,1,1,100148,99852
5:2:5,1,1,100147,99853
2:5:4,1,1,100146,99854
5:6:4,0,-1,100147,99853
4:1:2,1,1,100146,99854
3:4:6,0,-1,100147,99853
4:6:4,0,-1,100148,99852
3:2:6,1,1,100147,99853
4:5:1,0,-1,100148,99852
5:3:3,0,-1,100149,99851
6:3:3,0,-1,100150,99850
3:5:2,1,1,100149,99851
4:1:5,0,-1,100150,99850
1:3:6,0,-1,100151,99849
2:2:6,2,2,100149,99851
5:1:4,0,-1,100150,99850
2:1:1,1,1,100149,99851
4:1:6,0,-1,100150,99850
4:4:5,0,-1,100151,99849
1:4:1,0,-1,100152,99848
2:5:3,1,1,100151,99849
5:6:3,0,-1,100152,99848
3:2:2,2,2,100150,99850
6:4:3,0,-1,100151,99849
5:4:6,0,-1,100152,99848
2:1:4,1,1,100151,99849
5:3:5,0,-1,100152,99848
4:4:6,0,-1,100153,99847
3:2:5,1,1,100152,99848
2:3:5,1,1,100151,99849
6:2:2,2,2,100149,99851
5:6:6,0,-1,100150,99850
6:1:6,0,-1,100151,99849
4:6:1,0,-1,100152,99848
3:4:4,0,-1,100153,99847
5:5:3,0,-1,100154,99846
1:5:4,0,-1,100155,99845
5:1:3,0,-1,100156,99844
4:4:6,0,-1,100157,99843
6:5:5,0,-1,100158,99842
5:5:2,1,1,100157,99843
1:2:5,1,1,100156,99844
2:3:5,1,1,100155,99845
1:1:3,0,-1,100156,99844
5:6:4,0,-1,100157,99843
1:4:2,1,1,100156,99844
6:1:1,0,-1,100157,99843
1:1:1,0,-1,100158,99842
6:4:3,0,-1,100159,99841
6:1:4,0,-1,100160,99840
6:6:3,0,-1,100161,99839
2:6:5,1,1,100160,99840
4:5:4,0,-1,100161,99839
3:1:2,1,1,100160,99840
1:2:6,1,1,100159,99841
5:4:4,0,-1,100160,99840
1:5:1,0,-1,100161,99839
6:3:3,0,-1,100162,99838
5:6:6,0,-1,100163,99837
1:1:6,0,-1,100164,99836
5:2:4,1,1,100163,99837
6:4:5,0,-1,100164,99836
5:2:3,1,1,100163,99837
1:6:6,0,-1,100164,99836
2:4:6,1,1,100163,99837
5:6:5,0,-1,100164,99836
1:2:5,1,1,100163,99837
3:4:2,1,1,100162,99838
2:5:2,2,2,100160,99840
6:5:6,0,-1,100161,99839
1:6:3,0,-1,100162,99838
5:5:1,0,-1,100163,99837
6:3:3,0,-1,100164,99836
4:3:4,0,-1,100165,99835
3:5:4,0,-1,100166,99834
3:3:2,1,1,100165,99835
1:6:4,0,-1,100166,99834
1:1:5,0,-1,100167,99833
2:6:6,1,1,100166,99834
6:2:2,2,2,100164,99836
1:6:2,1,1,100163,99837
5:6:3,0,-1,100164,99836
4:1:2,1,1,100163,99837
3:6:6,0,-1,100164,99836
4:3:2,1,1,100163,99837
3:5:4,0,-1,100164,99836
2:4:1,1,1,100163,99837
4:2:2,2,2,100161,99839
2:3:2,2,2,100159,99841
5:5:1,0,-1,100160,99840
5:6:1,0,-1,100161,99839
5:6:2,1,1,100160,99840
6:4:3,0,-1,100161,99839
1:6:2,1,1,100160,99840
1:6:5,0,-1,100161,99839
1:4:1,0,-1,100162,99838
3:5:4,0,-1,100163,99837
5:4:4,0,-1,100164,99836
1:4:3,0,-1,100165,99835
2:5:2,2,2,100163,99837
1:6:6,0,-1,100164,99836
3:3:2,1,1,100163,99837
6:5:2,1,1,100162,99838
2:4:1,1,1,100161,99839
5:2:3,1,1,100160,99840
5:3:4,0,-1,100161,99839
3:5:3,0,-1,100162,99838
4:6:2,1,1,100161,99839
4:5:5,0,-1,100162,99838
5:6:3,0,-1,100163,99837
3:1:4,0,-1,100164,99836
3:2:5,1,1,100163,99837
3:1:5,0,-1,100164,99836
6:5:1,0,-1,100165,99835
2:1:5,1,1,100164,99836
5:1:4,0,-1,100165,99835
2:4:1,1,1,100164,99836
3:2:1,1,1,100163,99837
5:5:2,1,1,100162,99838
2:4:6,1,1,100161,99839
3:5:2,1,1,100160,99840
1:6:1,0,-1,100161,99839
5:5:3,0,-1,100162,99838
2:4:1,1,1,100161,99839
2:1:1,1,1,100160,99840
5:4:3,0,-1,100161,99839
4:4:4,0,-1,100162,99838
1:3:5,0,-1,100163,99837
6:6:4,0,-1,100164,99836
5:6:6,0,-1,100165,99835
1:5:5,0,-1,100166,99834
2:1:4,1,1,100165,99835
6:4:3,0,-1,100166,99834
5:5:4,0,-1,100167,99833
4:5:4,0,-1,100168,99832
4:3:3,0,-1,100169,99831
1:4:2,1,1,100168,99832
5:5:6,0,-1,100169,99831
4:4:4,0,-1,100170,99830
2:4:1,1,1,100169,99831
5:2:6,1,1,100168,99832
3:5:3,0,-1,100169,99831
5:1:6,0,-1,100170,99830
4:1:1,0,-1,100171,99829
2:3:1,1,1,100170,99830
1:1:1,0,-1,100171,99829
5:3:2,1,1,100170,99830
1:6:4,0,-1,100171,99829
5:2:5,1,1,100170,99830
1:5:3,0,-1,100171,99829
3:4:3,0,-1,100172,99828
2:1:6,1,1,100171,99829
2:4:1,1,1,100170,99830
6:2:6,1,1,100169,99831
6:2:2,2,2,100167,99833
1:1:4,0,-1,100168,99832
6:3:4,0,-1,100169,99831
2:6:5,1,1,100168,99832
2:1:1,1,1,100167,99833
1:3:6,0,-1,100168,99832
6:4:2,1,1,100167,99833
4:6:4,0,-1,100168,99832
3:1:1,0,-1,100169,99831
3:5:1,0,-1,100170,99830
1:6:5,0,-1,100171,99829
2:1:3,1,1,100170,99830
3:5:2,1,1,100169,99831
3:1:5,0,-1,100170,99830
5:1:5,0,-1,100171,99829
5:2:5,1,1,100170,99830
2:1:4,1,1,100169,99831
2:1:2,2,2,100167,99833
5:3:5,0,-1,100168,99832
4:5:6,0,-1,100169,99831
3:6:1,0,-1,100170,99830
1:5:5,0,-1,100171,99829
4:4:6,0,-1,100172,99828
4:3:1,0,-1,100173,99827
5:6:1,0,-1,100174,99826
3:1:3,0,-1,100175,99825
3:4:6,0,-1,100176,99824
1:5:4,0,-1,100177,99823
2:6:3,1,1,100176,99824
1:5:2,1,1,100175,99825
1:3:6,0,-1,100176,99824
2:3:4,1,1,100175,99825
6:1:5,0,-1,100176,99824
1:5:6,0,-1,100177,99823
3:4:5,0,-1,100178,99822
3:3:5,0,-1,100179,99821
4:4:2,1,1,100178,99822
4:3:4,0,-1,100179,99821
6:6:2,1,1,100178,99822
1:4:4,0,-1,100179,99821
5:3:1,0,-1,100180,99820
4:5:5,0,-1,100181,99819
4:1:2,1,1,100180,99820
1:6:1,0,-1,100181,99819
5:5:3,0,-1,100182,99818
2:1:3,1,1,100181,99819
6:3:4,0,-1,100182,99818
6:1:1,0,-1,100183,99817
2:2:3,2,2,100181,99819
5:2:4,1,1,100180,99820
3:4:2,1,1,100179,99821
6:2:2,2,2,100177,99823
4:1:6,0,-1,100178,99822
3:3:3,0,-1,100179,99821
3:4:2,1,1,100178,99822
5:5:6,0,-1,100179,99821
6:2:6,1,1,100178,99822
4:5:4,0,-1,100179,99821
4:4:5,0,-1,100180,99820
4:3:1,0,-1,100181,99819
1:3:3,0,-1,100182,99818
2:4:2,2,2,100180,99820
5:5:4,0,-1,100181,99819
2:6:3,1,1,100180,99820
5:3:1,0,-1,100181,99819
4:5:1,0,-1,100182,99818
1:4:1,0,-1,100183,99817
6:1:4,0,-1,100184,99816
5:3:5,0,-1,100185,99815
5:2:5,1,1,100184,99816
5:2:4,1,1,100183,99817
4:2:1,1,1,100182,99818
5:5:5,0,-1,100183,99817
4:2:6,1,1,100182,99818
2:5:3,1,1,100181,99819
5:1:2,1,1,100180,99820
6:4:4,0,-1,100181,99819
5:5:4,0,-1,100182,99818
6:6:2,1,1,100181,99819
4:2:5,1,1,100180,99820
1:3:1,0,-1,100181,99819
5:1:6,0,-1,100182,99818
5:3:5,0,-1,100183,99817
3:2:2,2,2,100181,99819
2:1:2,2,2,100179,99821
6:1:4,0,-1,100180,99820
2:6:4,1,1,100179,99821
3:2:4,1,1,100178,99822
6:1:6,0,-1,100179,99821
1:5:5,0,-1,100180,99820
3:6:3,0,-1,100181,99819
2:3:2,2,2,100179,99821
3:6:6,0,-1,100180,99820
2:3:2,2,2,100178,99822
6:3:4,0,-1,100179,99821
1:6:6,0,-1,100180,99820
3:4:3,0,-1,100181,99819
4:5:3,0,-1,100182,99818
3:4:1,0,-1,100183,99817
1:4:2,1,1,100182,99818
2:4:6,1,1,100181,99819
3:1:3,0,-1,100182,99818
5:3:5,0,-1,100183,99817
1:6:4,0,-1,100184,99816
5:4:2,1,1,100183,99817
6:1:1,0,-1,100184,99816
5:5:4,0,-1,100185,99815
6:6:5,0,-1,100186,99814
4:2:2,2,2,100184,99816
2:2:1,2,2,100182,99818
4:1:3,0,-1,100183,99817
6:1:2,1,1,100182,99818
4:2:2,2,2,100180,99820
3:5:6,0,-1,100181,99819
5:6:2,1,1,100180,99820
6:5:5,0,-1,100181,99819
3:5:2,1,1,100180,99820
5:6:6,0,-1,100181,99819
3:2:2,2,2,100179,99821
1:2:6,1,1,100178,99822
6:2:6,1,1,100177,99823
6:4:1,0,-1,100178,99822
1:3:5,0,-1,100179,99821
1:1:6,0,-1,100180,99820
2:3:6,1,1,100179,99821
2:3:5,1,1,100178,99822
2:6:3,1,1,100177,99823
6:3:5,0,-1,100178,99822
3:6:1,0,-1,100179,99821
2:2:6,2,2,100177,99823
3:3:6,0,-1,100178,99822
6:6:5,0,-1,100179,99821
4:1:1,0,-1,100180,99820
4:1:6,0,-1,100181,99819
2:6:6,1,1,100180,99820
6:1:1,0,-1,100181,99819
1:2:2,2,2,100179,99821
5:3:4,0,-1,100180,99820
2:4:3,1,1,100179,99821
5:2:5,1,1,100178,99822
3:2:2,2,2,100176,99824
4:1:5,0,-1,100177,99823
6:4:2,1,1,100176,99824
4:6:2,1,1,100175,99825
3:4:3,0,-1,100176,99824
1:4:5,0,-1,100177,99823
5:4:3,0,-1,100178,99822
6:3:6,0,-1,100179,99821
4:1:1,0,-1,100180,99820
2:4:5,1,1,100179,99821
5:2:6,1,1,100178,99822
3:3:2,1,1,100177,99823
6:2:2,2,2,100175,99825
6:4:3,0,-1,100176,99824
6:1:3,0,-1,100177,99823
6:3:4,0,-1,100178,99822
2:2:4,2,2,100176,99824
1:3:1,0,-1,100177,99823
6:4:3,0,-1,100178,99822
6:2:6,1,1,100177,99823
4:4:6,0,-1,100178,99822
5:4:5,0,-1,100179,99821
2:2:1,2,2,100177,99823
5:5:6,0,-1,100178,99822
5:4:2,1,1,100177,99823
6:6:3,0,-1,100178,99822
5:3:1,0,-1,100179,99821
3:3:4,0,-1,100180,99820
6:6:3,0,-1,100181,99819
1:1:3,0,-1,100182,99818
2:4:6,1,1,100181,99819
3:1:4,0,-1,100182,99818
4:4:3,0,-1,100183,99817
4:2:5,1,1,100182,99818
2:2:1,2,2,100180,99820
1:6:1,0,-1,100181,99819
1:5:4,0,-1,100182,99818
2:2:3,2,2,100180,99820
2:4:2,2,2,100178,99822
4:5:5,0,-1,100179,99821
5:1:6,0,-1,100180,99820
2:6:5,1,1,100179,99821
1:6:5,0,-1,100180,99820
6:4:2,1,1,100179,99821
1:1:1,0,-1,100180,99820
4:6:3,0,-1,100181,99819
1:4:1,0,-1,100182,99818
2:4:6,1,1,100181,99819
2:6:6,1,1,100180,99820
2:1:2,2,2,100178,99822
6:2:3,1,1,100177,99823
3:4:6,0,-1,100178,99822
1:2:5,1,1,100177,99823
4:5:4,0,-1,100178,99822
6:2:3,1,1,100177,99823
6:2:1,1,1,100176,99824
4:5:5,0,-1,100177,99823
4:4:6,0,-1,100178,99822
2:6:6,1,1,100177,99823
4:5:3,0,-1,100178,99822
3:4:2,1,1,100177,99823
4:6:5,0,-1,100178,99822
1:5:4,0,-1,100179,99821
3:5:4,0,-1,100180,99820
4:1:3,0,-1,100181,99819
4:3:4,0,-1,100182,99818
2:2:5,2,2,100180,99820
5:1:3,0,-1,100181,99819
2:6:5,1,1,100180,99820
2:4:3,1,1,100179,99821
2:4:1,1,1,100178,99822
5:1:6,0,-1,100179,99821
5:3:2,1,1,100178,99822
5:2:3,1,1,100177,99823
1:3:1,0,-1,100178,99822
3:1:4,0,-1,100179,99821
2:4:5,1,1,100178,99822
4:6:3,0,-1,100179,99821
6:3:4,0,-1,100180,99820
4:5:2,1,1,100179,99821
3:1:6,0,-1,100180,99820
4:5:6,0,-1,100181,99819
4:1:5,0,-1,100182,99818
5:3:3,0,-1,100183,99817
1:4:2,1,1,100182,99818
4:6:6,0,-1,100183,99817
2:3:3,1,1,100182,99818
3:1:4,0,-1,100183,99817
4:5:5,0,-1,100184,99816
4:3:5,0,-1,100185,99815
4:3:5,0,-1,100186,99814
6:3:1,0,-1,100187,99813
4:4:3,0,-1,100188,99812
2:6:2,2,2,100186,99814
3:5:2,1,1,100185,99815
5:2:5,1,1,100184,99816
2:3:1,1,1,100183,99817
1:5:1,0,-1,100184,99816
1:2:5,1,1,100183,99817
6:5:2,1,1,100182,99818
3:4:1,0,-1,100183,99817
3:4:5,0,-1,100184,99816
2:2:1,2,2,100182,99818
4:2:5,1,1,100181,99819
6:2:6,1,1,100180,99820
2:6:5,1,1,100179,99821
4:1:2,1,1,100178,99822
3:3:3,0,-1,100179,99821
6:3:2,1,1,100178,99822
2:2:4,2,2,100176,99824
3:4:5,0,-1,100177,99823
6:6:4,0,-1,100178,99822
6:2:6,1,1,100177,99823
6:1:5,0,-1,100178,99822
5:5:6,0,-1,100179,99821
6:5:5,0,-1,100180,99820
1:6:2,1,1,100179,99821
2:6:3,1,1,100178,99822
5:6:5,0,-1,100179,99821
3:6:3,0,-1,100180,99820
1:6:1,0,-1,100181,99819
5:6:5,0,-1,100182,99818
5:2:6,1,1,100181,99819
1:1:6,0,-1,100182,99818
4:1:2,1,1,100181,99819
5:5:4,0,-1,100182,99818
4:5:2,1,1,100181,99819
5:4:1,0,-1,100182,99818
6:4:4,0,-1,100183,99817
2:5:5,1,1,100182,99818
2:3:1,1,1,100181,99819
4:6:4,0,-1,100182,99818
5:4:4,0,-1,100183,99817
1:2:1,1,1,100182,99818
6:5:4,0,-1,100183,99817
3:6:1,0,-1,100184,99816
3:6:6,0,-1,100185,99815
4:4:1,0,-1,100186,99814
1:4:5,0,-1,100187,99813
4:6:2,1,1,100186,99814
2:2:4,2,2,100184,99816
6:2:2,2,2,100182,99818
2:6:5,1,1,100181,99819
4:6:3,0,-1,100182,99818
3:5:6,0,-1,100183,99817
5:4:1,0,-1,100184,99816
5:1:5,0,-1,100185,99815
5:5:1,0,-1,100186,99814
2:6:3,1,1,100185,99815
1:4:2,1,1,100184,99816
1:5:1,0,-1,100185,99815
1:2:4,1,1,100184,99816
6:2:3,1,1,100183,99817
1:1:4,0,-1,100184,99816
6:6:6,0,-1,100185,99815
4:5:1,0,-1,100186,99814
3:2:2,2,2,100184,99816
1:3:3,0,-1,100185,99815
4:5:3,0,-1,100186,99814
5:1:1,0,-1,100187,99813
1:1:1,0,-1,100188,99812
2:2:6,2,2,100186,99814
1:1:1,0,-1,100187,99813
2:1:3,1,1,100186,99814
6:3:4,0,-1,100187,99813
5:6:2,1,1,100186,99814
6:1:3,0,-1,100187,99813
6:2:3,1,1,100186,99814
4:6:4,0,-1,100187,99813
4:1:6,0,-1,100188,99812
6:3:1,0,-1,100189,99811
2:2:4,2,2,100187,99813
6:4:2,1,1,100186,99814
2:5:5,1,1,100185,99815
1:1:3,0,-1,100186,99814
1:5:3,0,-1,100187,99813
4:2:4,1,1,100186,99814
4:2:5,1,1,100185,99815
6:3:1,0,-1,100186,99814
4:1:2,1,1,100185,99815
2:6:5,1,1,100184,99816
1:4:1,0,-1,100185,99815
4:5:6,0,-1,100186,99814
6:2:6,1,1,100185,99815
5:6:2,1,1,100184,99816
5:6:1,0,-1,100185,99815
1:3:3,0,-1,100186,99814
2:3:5,1,1,100185,99815
5:2:3,1,1,100184,99816
6:2:3,1,1,100183,99817
6:3:6,0,-1,100184,99816
4:5:3,0,-1,100185,99815
4:1:4,0,-1,100186,99814
3:3:5,0,-1,100187,99813
4:5:1,0,-1,100188,99812
5:5:4,0,-1,100189,99811
3:3:6,0,-1,100190,99810
3:3:6,0,-1,100191,99809
2:1:5,1,1,100190,99810
3:6:5,0,-1,100191,99809
5:6:2,1,1,100190,99810
6:6:6,0,-1,100191,99809
4:4:3,0,-1,100192,99808
4:2:5,1,1,100191,99809
6:6:2,1,1,100190,99810
5:2:1,1,1,100189,99811
5:4:5,0,-1,100190,99810
3:4:2,1,1,100189,99811
5:3:6,0,-1,100190,99810
1:4:6,0,-1,100191,99809
2:3:3,1,1,100190,99810
2:5:4,1,1,100189,99811
1:5:5,0,-1,100190,99810
6:6:4,0,-1,100191,99809
4:4:2,1,1,100190,99810
2:3:2,2,2,100188,99812
1:3:4,0,-1,100189,99811
2:6:4,1,1,100188,99812
2:1:1,1,1,100187,99813
2:2:1,2,2,100185,99815
1:2:3,1,1,100184,99816
3:2:6,1,1,100183,99817
2:4:5,1,1,100182,99818
4:3:1,0,-1,100183,99817
1:1:2,1,1,100182,99818
5:6:4,0,-1,100183,99817
5:4:2,1,1,100182,99818
1:6:6,0,-1,100183,99817
5:1:3,0,-1,100184,99816
1:3:1,0,-1,100185,99815
5:4:2,1,1,100184,99816
1:2:2,2,2,100182,99818
4:5:2,1,1,100181,99819
5:4:1,0,-1,100182,99818
6:6:3,0,-1,100183,99817
2:1:3,1,1,100182,99818
6:5:2,1,1,100181,99819
4:2:5,1,1,100180,99820
6:6:3,0,-1,100181,99819
4:4:6,0,-1,100182,99818
1:1:2,1,1,100181,99819
3:4:3,0,-1,100182,99818
2:2:2,3,3,100179,99821
6:3:1,0,-1,100180,99820
2:3:4,1,1,100179,99821
4:6:3,0,-1,100180,99820
4:6:6,0,-1,100181,99819
2:1:3,1,1,100180,99820
2:4:4,1,1,100179,99821
6:3:2,1,1,100178,99822
5:2:5,1,1,100177,99823
6:2:3,1,1,100176,99824
3:2:5,1,1,100175,99825
5:2:1,1,1,100174,99826
1:5:1,0,-1,100175,99825
3:2:3,1,1,100174,99826
6:1:1,0,-1,100175,99825
4:3:2,1,1,100174,99826
6:6:6,0,-1,100175,99825
3:4:6,0,-1,100176,99824
2:3:1,1,1,100175,99825
3:2:3,1,1,100174,99826
4:4:2,1,1,100173,99827
6:3:6,0,-1,100174,99826
2:4:1,1,1,100173,99827
5:2:1,1,1,100172,99828
5:6:4,0,-1,100173,99827
2:4:1,1,1,100172,99828
2:5:6,1,1,100171,99829
5:3:6,0,-1,100172,99828
3:2:5,1,1,100171,99829
1:6:5,0,-1,100172,99828
2:4:4,1,1,100171,99829
2:4:2,2,2,100169,99831
1:4:3,0,-1,100170,99830
2:5:3,1,1,100169,99831
4:5:3,0,-1,100170,99830
2:3:5,1,1,100169,99831
3:6:6,0,-1,100170,99830
6:4:6,0,-1,100171,99829
3:1:2,1,1,100170,99830
6:3:3,0,-1,100171,99829
6:6:4,0,-1,100172,99828
2:4:3,1,1,100171,99829
4:5:2,1,1,100170,99830
6:5:6,0,-1,100171,99829
1:1:2,1,1,100170,99830
2:4:4,1,1,100169,99831
2:3:4,1,1,100168,99832
1:2:1,1,1,100167,99833
4:3:1,0,-1,100168,99832
3:6:6,0,-1,100169,99831
3:6:4,0,-1,100170,99830
5:4:5,0,-1,100171,99829
6:4:1,0,-1,100172,99828
6:4:5,0,-1,100173,99827
5:2:1,1,1,100172,99828
3:1:3,0,-1,100173,99827
1:3:5,0,-1,100174,99826
6:2:6,1,1,100173,99827
4:5:2,1,1,100172,99828
5:1:4,0,-1,100173,99827
4:4:4,0,-1,100174,99826
4:5:1,0,-1,100175,99825
2:5:2,2,2,100173,99827
3:2:6,1,1,100172,99828
5:6:1,0,-1,100173,99827
3:3:2,1,1,100172,99828
3:4:2,1,1,100171,99829
3:1:5,0,-1,100172,99828
2:6:1,1,1,100171,99829
2:1:4,1,1,100170,99830
5:3:3,0,-1,100171,99829
6:6:4,0,-1,100172,99828
5:2:2,2,2,100170,99830
4:4:4,0,-1,100171,99829
4:1:6,0,-1,100172,99828
4:5:5,0,-1,100173,99827
5:5:5,0,-1,100174,99826
3:1:3,0,-1,100175,99825
2:5:3,1,1,100174,99826
2:3:2,2,2,100172,99828
3:3:1,0,-1,100173,99827
6:2:3,1,1,100172,99828
1:3:6,0,-1,100173,99827
5:6:3,0,-1,100174,99826
4:3:5,0,-1,100175,99825
4:6:3,0,-1,100176,99824
3:3:6,0,-1,100177,99823
4:3:2,1,1,100176,99824
4:4:1,0,-1,100177,99823
1:2:3,1,1,100176,99824
3:5:1,0,-1,100177,99823
3:3:2,1,1,100176,99824
4:3:2,1,1,100175,99825
6:4:1,0,-1,100176,99824
5:6:6,0,-1,100177,99823
3:4:1,0,-1,100178,99822
6:5:5,0,-1,100179,99821
6:2:6,1,1,100178,99822
6:5:3,0,-1,100179,99821
5:4:2,1,1,100178,99822
6:5:1,0,-1,100179,99821
1:4:1,0,-1,100180,99820
2:6:3,1,1,100179,99821
1:1:1,0,-1,100180,99820
2:5:2,2,2,100178,99822
4:2:5,1,1,100177,99823
2:4:6,1,1,100176,99824
1:1:2,1,1,100175,99825
3:4:1,0,-1,100176,99824
4:6:3,0,-1,100177,99823
1:2:1,1,1,100176,99824
5:2:4,1,1,100175,99825
3:3:3,0,-1,100176,99824
2:6:1,1,1,100175,99825
4:3:5,0,-1,100176,99824
1:6:6,0,-1,100177,99823
6:5:4,0,-1,100178,99822
3:3:4,0,-1,100179,99821
1:3:3,0,-1,100180,99820
5:4:3,0,-1,100181,99819
4:2:3,1,1,100180,99820
2:1:3,1,1,100179,99821
2:5:5,1,1,100178,99822
1:4:2,1,1,100177,99823
3:6:3,0,-1,100178,99822
2:5:3,1,1,100177,99823
3:1:1,0,-1,100178,99822
2:2:4,2,2,100176,99824
3:6:5,0,-1,100177,99823
3:3:3,0,-1,100178,99822
3:5:5,0,-1,100179,99821
2:5:5,1,1,100178,99822
2:5:5,1,1,100177,99823
5:2:6,1,1,100176,99824
2:3:4,1,1,100175,99825
3:1:2,1,1,100174,99826
4:2:4,1,1,100173,99827
1:5:5,0,-1,100174,99826
6:5:1,0,-1,100175,99825
6:1:5,0,-1,100176,99824
3:1:2,1,1,100175,99825
3:6:1,0,-1,100176,99824
6:6:6,0,-1,100177,99823
3:2:6,1,1,100176,99824
4:5:2,1,1,100175,99825
1:4:5,0,-1,100176,99824
3:5:2,1,1,100175,99825
1:1:4,0,-1,100176,99824
6:3:1,0,-1,100177,99823
5:5:4,0,-1,100178,99822
2:3:1,1,1,100177,99823
4:3:6,0,-1,100178,99822
2:4:2,2,2,100176,99824
3:3:6,0,-1,100177,99823
4:3:2,1,1,100176,99824
2:4:1,1,1,100175,99825
3:5:2,1,1,100174,99826
3:2:4,1,1,100173,99827
5:3:2,1,1,100172,99828
5:2:2,2,2,100170,99830
5:5:5,0,-1,100171,99829
6:3:2,1,1,100170,99830
5:3:1,0,-1,100171,99829
5:6:3,0,-1,100172,99828
2:2:6,2,2,100170,99830
3:6:1,0,-1,100171,99829
3:5:5,0,-1,100172,99828
1:6:6,0,-1,100173,99827
4:2:1,1,1,100172,99828
3:2:2,2,2,100170,99830
5:3:2,1,1,100169,99831
3:1:3,0,-1,100170,99830
4:2:1,1,1,100169,99831
1:4:6,0,-1,100170,99830
6:2:1,1,1,100169,99831
1:1:3,0,-1,100170,99830
5:6:4,0,-1,100171,99829
4:2:6,1,1,100170,99830
6:6:3,0,-1,100171,99829
4:4:1,0,-1,100172,99828
6:3:1,0,-1,100173,99827
4:6:3,0,-1,100174,99826
2:6:2,2,2,100172,99828
3:2:2,2,2,100170,99830
5:5:2,1,1,100169,99831
6:6:1,0,-1,100170,99830
3:1:3,0,-1,100171,99829
6:1:2,1,1,100170,99830
4:4:6,0,-1,100171,99829
1:1:6,0,-1,100172,99828
5:3:1,0,-1,100173,99827
4:4:4,0,-1,100174,99826
2:6:3,1,1,100173,99827
4:5:6,0,-1,100174,99826
4:4:3,0,-1,100175,99825
6:1:5,0,-1,100176,99824
4:1:6,0,-1,100177,99823
6:4:1,0,-1,100178,99822
5:2:1,1,1,100177,99823
2:1:1,1,1,100176,99824
6:4:1,0,-1,100177,99823
6:5:5,0,-1,100178,99822
2:4:1,1,1,100177,99823
3:5:1,0,-1,100178,99822
2:4:3,1,1,100177,99823
6:3:2,1,1,100176,99824
6:4:5,0,-1,100177,99823
6:6:3,0,-1,100178,99822
2:3:2,2,2,100176,99824
4:2:3,1,1,100175,99825
4:3:4,0,-1,100176,99824
1:5:1,0,-1,100177,99823
1:1:3,0,-1,100178,99822
1:5:6,0,-1,100179,99821
5:6:6,0,-1,100180,99820
5:6:1,0,-1,100181,99819
5:1:6,0,-1,100182,99818
5:3:2,1,1,100181,99819
3:1:5,0,-1,100182,99818
3:5:4,0,-1,100183,99817
1:5:3,0,-1,100184,99816
1:2:3,1,1,100183,99817
5:5:5,0,-1,100184,99816
1:1:5,0,-1,100185,99815
1:2:6,1,1,100184,99816
2:3:3,1,1,100183,99817
6:1:1,0,-1,100184,99816
5:2:1,1,1,100183,99817
5:5:1,0,-1,100184,99816
6:6:5,0,-1,100185,99815
6:4:4,0,-1,100186,99814
4:1:3,0,-1,100187,99813
3:4:2,1,1,100186,99814
6:1:6,0,-1,100187,99813
3:5:1,0,-1,100188,99812
4:1:2,1,1,100187,99813
4:1:4,0,-1,100188,99812
2:5:2,2,2,100186,99814
4:6:5,0,-1,100187,99813
5:5:6,0,-1,100188,99812
6:6:4,0,-1,100189,99811
6:1:5,0,-1,100190,99810
6:2:2,2,2,100188,99812
4:5:1,0,-1,100189,99811
1:3:5,0,-1,100190,99810
1:3:1,0,-1,100191,99809
5:4:1,0,-1,100192,99808
6:1:2,1,1,100191,99809
4:1:3,0,-1,100192,99808
3:1:4,0,-1,100193,99807
3:1:4,0,-1,100194,99806
6:5:3,0,-1,100195,99805
2:2:5,2,2,100193,99807
4:2:2,2,2,100191,99809
3:5:6,0,-1,100192,99808
6:1:4,0,-1,100193,99807
3:6:3,0,-1,100194,99806
5:3:6,0,-1,100195,99805
1:1:5,0,-1,100196,99804
2:2:6,2,2,100194,99806
6:4:1,0,-1,100195,99805
2:6:4,1,1,100194,99806
5:5:1,0,-1,100195,99805
5:5:1,0,-1,100196,99804
3:6:6,0,-1,100197,99803
2:5:3,1,1,100196,99804
1:2:2,2,2,100194,99806
3:4:2,1,1,100193,99807
1:1:5,0,-1,100194,99806
6:1:1,0,-1,100195,99805
2:1:3,1,1,100194,99806
5:4:3,0,-1,100195,99805
2:5:6,1,1,100194,99806
6:6:3,0,-1,100195,99805
3:3:5,0,-1,100196,99804
2:6:5,1,1,100195,99805
1:1:6,0,-1,100196,99804
5:1:6,0,-1,100197,99803
1:2:4,1,1,100196,99804
1:2:2,2,2,100194,99806
4:1:2,1,1,100193,99807
1:3:3,0,-1,100194,99806
4:5:2,1,1,100193,99807
1:2:4,1,1,100192,99808
4:2:1,1,1,100191,99809
4:6:2,1,1,100190,99810
5:5:4,0,-1,100191,99809
6:6:4,0,-1,100192,99808
2:2:3,2,2,100190,99810
5:4:3,0,-1,100191,99809
3:3:6,0,-1,100192,99808
4:5:4,0,-1,100193,99807
2:1:3,1,1,100192,99808
1:5:1,0,-1,100193,99807
4:5:1,0,-1,100194,99806
5:1:6,0,-1,100195,99805
5:5:1,0,-1,100196,99804
4:4:2,1,1,100195,99805
3:4:6,0,-1,100196,99804
2:3:4,1,1,100195,99805
4:3:3,0,-1,100196,99804
1:6:2,1,1,100195,99805
2:1:6,1,1,100194,99806
4:5:6,0,-1,100195,99805
3:5:4,0,-1,100196,99804
6:6:1,0,-1,100197,99803
3:3:2,1,1,100196,99804
3:1:1,0,-1,100197,99803
4:5:3,0,-1,100198,99802
2:3:5,1,1,100197,99803
1:2:2,2,2,100195,99805
2:4:1,1,1,100194,99806
5:4:5,0,-1,100195,99805
2:3:4,1,1,100194,99806
1:1:1,0,-1,100195,99805
3:6:4,0,-1,100196,99804
4:3:2,1,1,100195,99805
1:6:4,0,-1,100196,99804
2:1:5,1,1,100195,99805
1:2:3,1,1,100194,99806
3:4:1,0,-1,100195,99805
3:4:6,0,-1,100196,99804
1:6:3,0,-1,100197,99803
4:3:5,0,-1,100198,99802
4:1:3,0,-1,100199,99801
6:5:4,0,-1,100200,99800
3:3:2,1,1,100199,99801
3:2:4,1,1,100198,99802
5:5:4,0,-1,100199,99801
5:1:2,1,1,100198,99802
1:6:5,0,-1,100199,99801
1:3:5,0,-1,100200,99800
2:3:6,1,1,100199,99801
2:6:1,1,1,100198,99802
2:3:5,1,1,100197,99803
3:6:2,1,1,100196,99804
2:3:5,1,1,100195,99805
2:6:2,2,2,100193,99807
3:5:1,0,-1,100194,99806
5:6:4,0,-1,100195,99805
4:4:2,1,1,100194,99806
5:4:6,0,-1,100195,99805
5:1:4,0,-1,100196,99804
5:3:2,1,1,100195,99805
6:5:4,0,-1,100196,99804
2:5:1,1,1,100195,99805
2:4:2,2,2,100193,99807
4:5:4,0,-1,100194,99806
2:2:4,2,2,100192,99808
2:6:1,1,1,100191,99809
2:4:3,1,1,100190,99810
2:3:3,1,1,100189,99811
4:3:1,0,-1,100190,99810
3:3:4,0,-1,100191,99809
2:4:6,1,1,100190,99810
5:3:1,0,-1,100191,99809
1:3:1,0,-1,100192,99808
3:2:2,2,2,100190,99810
5:3:6,0,-1,100191,99809
3:3:2,1,1,100190,99810
4:5:5,0,-1,100191,99809
6:1:2,1,1,100190,99810
5:5:4,0,-1,100191,99809
6:6:3,0,-1,100192,99808
6:3:6,0,-1,100193,99807
2:4:1,1,1,100192,99808
1:4:5,0,-1,100193,99807
4:2:6,1,1,100192,99808
5:4:6,0,-1,100193,99807
3:3:3,0,-1,100194,99806
1:5:2,1,1,100193,99807
4:4:6,0,-1,100194,99806
1:5:4,0,-1,100195,99805
2:3:1,1,1,100194,99806
3:4:5,0,-1,100195,99805
1:2:4,1,1,100194,99806
2:1:1,1,1,100193,99807
2:6:1,1,1,100192,99808
2:3:6,1,1,100191,99809
1:6:4,0,-1,100192,99808
6:6:1,0,-1,100193,99807
1:6:6,0,-1,100194,99806
6:4:2,1,1,100193,99807
2:6:5,1,1,100192,99808
1:3:4,0,-1,100193,99807
3:6:3,0,-1,100194,99806
4:3:1,0,-1,100195,99805
6:5:5,0,-1,100196,99804
3:2:3,1,1,100195,99805
4:1:3,0,-1,100196,99804
2:3:1,1,1,100195,99805
1:4:5,0,-1,100196,99804
6:3:5,0,-1,100197,99803
5:3:3,0,-1,100198,99802
3:1:2,1,1,100197,99803
6:1:2,1,1,100196,99804
6:4:3,0,-1,100197,99803
6:3:3,0,-1,100198,99802
3:5:5,0,-1,100199,99801
5:4:4,0,-1,100200,99800
6:6:2,1,1,100199,99801
5:6:5,0,-1,100200,99800
1:1:3,0,-1,100201,99799
6:4:5,0,-1,100202,99798
6:6:3,0,-1,100203,99797
4:5:6,0,-1,100204,99796
1:1:1,0,-1,100205,99795
4:5:3,0,-1,100206,99794
1:3:1,0,-1,100207,99793
3:2:6,1,1,100206,99794
1:5:1,0,-1,100207,99793
3:1:6,0,-1,100208,99792
6:3:5,0,-1,100209,99791
6:4:4,0,-1,100210,99790
2:2:5,2,2,100208,99792
3:5:6,0,-1,100209,99791
5:4:5,0,-1,100210,99790
3:5:6,0,-1,100211,99789
5:6:5,0,-1,100212,99788
6:3:2,1,1,100211,99789
3:1:5,0,-1,100212,99788
5:1:2,1,1,100211,99789
2:1:1,1,1,100210,99790
3:5:6,0,-1,100211,99789
4:1:4,0,-1,100212,99788
6:3:4,0,-1,100213,99787
3:4:5,0,-1,100214,99786
1:6:2,1,1,100213,99787
2:2:5,2,2,100211,99789
3:5:6,0,-1,100212,99788
2:1:5,1,1,100211,99789
6:3:5,0,-1,100212,99788
5:1:5,0,-1,100213,99787
5:5:3,0,-1,100214,99786
1:5:4,0,-1,100215,99785
5:1:5,0,-1,100216,99784
2:5:4,1,1,100215,99785
5:5:1,0,-1,100216,99784
1:4:2,1,1,100215,99785
4:2:4,1,1,100214,99786
1:1:6,0,-1,100215,99785
2:1:4,1,1,100214,99786
5:1:6,0,-1,100215,99785
4:5:1,0,-1,100216,99784
1:4:3,0,-1,100217,99783
2:1:5,1,1,100216,99784
1:3:3,0,-1,100217,99783
5:6:3,0,-1,100218,99782
1:5:2,1,1,100217,99783
1:1:6,0,-1,100218,99782
3:2:6,1,1,100217,99783
2:3:3,1,1,100216,99784
1:1:1,0,-1,100217,99783
1:5:4,0,-1,100218,99782
6:6:4,0,-1,100219,99781
3:5:6,0,-1,100220,99780
2:1:1,1,1,100219,99781
4:6:6,0,-1,100220,99780
4:5:2,1,1,100219,99781
3:4:3,0,-1,100220,99780
4:1:3,0,-1,100221,99779
5:4:1,0,-1,100222,99778
5:4:2,1,1,100221,99779
5:5:5,0,-1,100222,99778
4:4:6,0,-1,100223,99777
4:2:5,1,1,100222,99778
4:3:5,0,-1,100223,99777
3:4:4,0,-1,100224,99776
3:5:4,0,-1,100225,99775
3:2:5,1,1,100224,99776
6:2:2,2,2,100222,99778
4:2:3,1,1,100221,99779
5:3:3,0,-1,100222,99778
5:5:2,1,1,100221,99779
2:2:5,2,2,100219,99781
2:5:4,1,1,100218,99782
2:6:5,1,1,100217,99783
2:4:4,1,1,100216,99784
5:2:5,1,1,100215,99785
3:6:1,0,-1,100216,99784
6:5:2,1,1,100215,99785
5:1:6,0,-1,100216,99784
5:4:1,0,-1,100217,99783
3:5:3,0,-1,100218,99782
6:4:5,0,-1,100219,99781
3:6:3,0,-1,100220,99780
6:4:6,0,-1,100221,99779
1:4:5,0,-1,100222,99778
3:3:2,1,1,100221,99779
3:2:5,1,1,100220,99780
5:6:4,0,-1,100221,99779
3:3:6,0,-1,100222,99778
3:6:5,0,-1,100223,99777
4:3:1,0,-1,100224,99776
4:1:1,0,-1,100225,99775
4:3:5,0,-1,100226,99774
1:3:3,0,-1,100227,99773
6:3:2,1,1,100226,99774
1:6:4,0,-1,100227,99773
5:4:5,0,-1,100228,99772
5:2:6,1,1,100227,99773
5:2:4,1,1,100226,99774
5:6:2,1,1,100225,99775
5:1:6,0,-1,100226,99774
5:3:3,0,-1,100227,99773
6:4:3,0,-1,100228,99772
3:5:5,0,-1,100229,99771
6:6:1,0,-1,100230,99770
5:3:3,0,-1,100231,99769
4:6:6,0,-1,100232,99768
2:1:1,1,1,100231,99769
1:4:5,0,-1,100232,99768
1:5:2,1,1,100231,99769
1:4:5,0,-1,100232,99768
2:4:1,1,1,100231,99769
6:3:4,0,-1,100232,99768
2:1:6,1,1,100231,99769
1:2:5,1,1,100230,99770
2:4:2,2,2,100228,99772
5:3:4,0,-1,100229,99771
2:6:6,1,1,100228,99772
3:6:1,0,-1,100229,99771
2:6:4,1,1,100228,99772
1:5:3,0,-1,100229,99771
1:3:6,0,-1,100230,99770
2:5:4,1,1,100229,99771
3:6:5,0,-1,100230,99770
4:6:4,0,-1,100231,99769
4:1:3,0,-1,100232,99768
5:2:6,1,1,100231,99769
6:5:6,0,-1,100232,99768
6:3:5,0,-1,100233,99767
2:2:1,2,2,100231,99769
4:5:2,1,1,100230,99770
6:3:1,0,-1,100231,99769
4:5:5,0,-1,100232,99768
5:6:1,0,-1,100233,99767
1:1:1,0,-1,100234,99766
3:4:4,0,-1,100235,99765
4:3:3,0,-1,100236,99764
5:6:5,0,-1,100237,99763
5:4:2,1,1,100236,99764
4:5:3,0,-1,100237,99763
6:6:5,0,-1,100238,99762
2:5:1,1,1,100237,99763
1:6:6,0,-1,100238,99762
1:5:4,0,-1,100239,99761
5:1:6,0,-1,100240,99760
5:1:6,0,-1,100241,99759
4:5:6,0,-1,100242,99758
5:4:6,0,-1,100243,99757
2:1:3,1,1,100242,99758
6:4:2,1,1,100241,99759
6:1:2,1,1,100240,99760
5:3:5,0,-1,100241,99759
1:1:4,0,-1,100242,99758
2:1:6,1,1,100241,99759
4:4:1,0,-1,100242,99758
5:6:3,0,-1,100243,99757
1:5:5,0,-1,100244,99756
2:5:6,1,1,100243,99757
1:2:1,1,1,100242,99758
3:2:5,1,1,100241,99759
3:1:1,0,-1,100242,99758
1:5:2,1,1,100241,99759
6:4:3,0,-1,100242,99758
6:2:4,1,1,100241,99759
5:3:4,0,-1,100242,99758
4:2:2,2,2,100240,99760
1:3:6,0,-1,100241,99759
1:1:1,0,-1,100242,99758
4:5:2,1,1,100241,99759
1:6:4,0,-1,100242,99758
3:6:3,0,-1,100243,99757
3:6:4,0,-1,100244,99756
2:6:5,1,1,100243,99757
2:5:1,1,1,100242,99758
6:2:3,1,1,100241,99759
4:5:6,0,-1,100242,99758
3:2:2,2,2,100240,99760
4:3:6,0,-1,100241,99759
3:6:5,0,-1,100242,99758
3:1:6,0,-1,100243,99757
6:4:2,1,1,100242,99758
6:4:2,1,1,100241,99759
3:5:5,0,-1,100242,99758
1:3:4,0,-1,100243,99757
2:1:2,2,2,100241,99759
1:6:5,0,-1,100242,99758
1:3:4,0,-1,100243,99757
2:4:1,1,1,100242,99758
3:6:1,0,-1,100243,99757
3:3:2,1,1,100242,99758
1:3:2,1,1,100241,99759
1:3:5,0,-1,100242,99758
1:3:4,0,-1,100243,99757
5:6:5,0,-1,100244,99756
3:4:6,0,-1,100245,99755
5:2:1,1,1,100244,99756
6:3:5,0,-1,100245,99755
3:1:6,0,-1,100246,99754
2:6:2,2,2,100244,99756
2:3:6,1,1,100243,99757
2:3:1,1,1,100242,99758
6:4:4,0,-1,100243,99757
5:1:5,0,-1,100244,99756
5:6:1,0,-1,100245,99755
4:4:2,1,1,100244,99756
4:4:3,0,-1,100245,99755
5:6:4,0,-1,100246,99754
1:5:2,1,1,100245,99755
5:3:2,1,1,100244,99756
4:5:5,0,-1,100245,99755
4:4:3,0,-1,100246,99754
1:1:3,0,-1,100247,99753
5:2:4,1,1,100246,99754
1:4:4,0,-1,100247,99753
1:1:6,0,-1,100248,99752
1:6:3,0,-1,100249,99751
5:5:2,1,1,100248,99752
6:5:2,1,1,100247,99753
3:1:4,0,-1,100248,99752
5:6:5,0,-1,100249,99751
6:3:1,0,-1,100250,99750
4:4:2,1,1,100249,99751
4:2:6,1,1,100248,99752
4:2:5,1,1,100247,99753
5:3:6,0,-1,100248,99752
6:3:2,1,1,100247,99753
2:5:4,1,1,100246,99754
2:4:1,1,1,100245,99755
1:1:5,0,-1,100246,99754
1:4:3,0,-1,100247,99753
2:2:4,2,2,100245,99755
4:3:4,0,-1,100246,99754
5:6:3,0,-1,100247,99753
2:1:6,1,1,100246,99754
4:4:4,0,-1,100247,99753
6:1:2,1,1,100246,99754
5:3:2,1,1,100245,99755
6:4:5,0,-1,100246,99754
4:2:3,1,1,100245,99755
4:6:3,0,-1,100246,99754
5:2:4,1,1,100245,99755
5:3:3,0,-1,100246,99754
2:4:4,1,1,100245,99755
1:2:1,1,1,100244,99756
3:5:5,0,-1,100245,99755
2:3:6,1,1,100244,99756
5:6:1,0,-1,100245,99755
4:4:6,0,-1,100246,99754
3:4:6,0,-1,100247,99753
2:5:4,1,1,100246,99754
3:4:2,1,1,100245,99755
4:5:3,0,-1,100246,99754
4:1:6,0,-1,100247,99753
5:5:5,0,-1,100248,99752
3:3:1,0,-1,100249,99751
6:5:1,0,-1,100250,99750
1:1:3,0,-1,100251,99749
3:3:2,1,1,100250,99750
2:6:6,1,1,100249,99751
4:3:6,0,-1,100250,99750
5:3:2,1,1,100249,99751
3:1:6,0,-1,100250,99750
4:6:4,0,-1,100251,99749
2:5:4,1,1,100250,99750
1:4:5,0,-1,100251,99749
1:5:5,0,-1,100252,99748
6:2:1,1,1,100251,99749
1:5:1,0,-1,100252,99748
1:5:3,0,-1,100253,99747
6:5:4,0,-1,100254,99746
3:2:1,1,1,100253,99747
3:4:3,0,-1,100254,99746
3:5:4,0,-1,100255,99745
4:5:4,0,-1,100256,99744
1:5:1,0,-1,100257,99743
4:5:4,0,-1,100258,99742
1:5:4,0,-1,100259,99741
2:1:1,1,1,100258,99742
6:4:2,1,1,100257,99743
6:1:3,0,-1,100258,99742
5:5:4,0,-1,100259,99741
1:1:3,0,-1,100260,99740
1:3:1,0,-1,100261,99739
2:3:3,1,1,100260,99740
4:3:3,0,-1,100261,99739
4:4:4,0,-1,100262,99738
6:4:4,0,-1,100263,99737
1:1:2,1,1,100262,99738
6:3:4,0,-1,100263,99737
5:3:5,0,-1,100264,99736
5:4:4,0,-1,100265,99735
2:2:5,2,2,100263,99737
3:4:2,1,1,100262,99738
5:2:3,1,1,100261,99739
3:6:5,0,-1,100262,99738
5:6:2,1,1,100261,99739
1:5:2,1,1,100260,99740
1:1:2,1,1,100259,99741
2:4:2,2,2,100257,99743
4:4:4,0,-1,100258,99742
4:1:3,0,-1,100259,99741
3:1:1,0,-1,100260,99740
5:4:6,0,-1,100261,99739
6:3:6,0,-1,100262,99738
1:2:1,1,1,100261,99739
3:2:2,2,2,100259,99741
1:5:6,0,-1,100260,99740
5:2:4,1,1,100259,99741
5:1:3,0,-1,100260,99740
5:4:5,0,-1,100261,99739
2:5:1,1,1,100260,99740
6:2:3,1,1,100259,99741
5:6:4,0,-1,100260,99740
6:2:4,1,1,100259,99741
5:6:2,1,1,100258,99742
3:2:1,1,1,100257,99743
2:1:2,2,2,100255,99745
6:1:2,1,1,100254,99746
1:2:2,2,2,100252,99748
3:2:5,1,1,100251,99749
5:6:6,0,-1,100252,99748
2:2:6,2,2,100250,99750
4:6:3,0,-1,100251,99749
6:5:4,0,-1,100252,99748
2:3:3,1,1,100251,99749
4:6:5,0,-1,100252,99748
3:6:4,0,-1,100253,99747
4:5:4,0,-1,100254,99746
4:4:2,1,1,100253,99747
3:4:2,1,1,100252,99748
3:1:5,0,-1,100253,99747
4:1:4,0,-1,100254,99746
1:6:3,0,-1,100255,99745
4:5:4,0,-1,100256,99744
3:3:3,0,-1,100257,99743
2:6:6,1,1,100256,99744
3:6:2,1,1,100255,99745
1:1:5,0,-1,100256,99744
6:4:2,1,1,100255,99745
2:6:4,1,1,100254,99746
4:3:4,0,-1,100255,99745
2:5:5,1,1,100254,99746
2:3:1,1,1,100253,99747
3:5:5,0,-1,100254,99746
6:6:5,0,-1,100255,99745
6:2:1,1,1,100254,99746
2:4:1,1,1,100253,99747
4:3:5,0,-1,100254,99746
1:1:4,0,-1,100255,99745
3:4:5,0,-1,100256,99744
3:6:3,0,-1,100257,99743
5:2:4,1,1,100256,99744
2:5:3,1,1,100255,99745
2:1:6,1,1,100254,99746
4:3:5,0,-1,100255,99745
4:6:4,0,-1,100256,99744
4:6:6,0,-1,100257,99743
1:2:6,1,1,100256,99744
2:3:1,1,1,100255,99745
5:2:6,1,1,100254,99746
3:1:4,0,-1,100255,99745
2:5:2,2,2,100253,99747
4:6:6,0,-1,100254,99746
1:1:3,0,-1,100255,99745
6:5:1,0,-1,100256,99744
3:1:2,1,1,100255,99745
6:1:3,0,-1,100256,99744
5:1:5,0,-1,100257,99743
4:6:4,0,-1,100258,99742
6:4:2,1,1,100257,99743
5:6:4,0,-1,100258,99742
4:1:2,1,1,100257,99743
6:2:4,1,1,100256,99744
5:4:5,0,-1,100257,99743
4:2:3,1,1,100256,99744
1:4:3,0,-1,100257,99743
5:6:5,0,-1,100258,99742
3:1:1,0,-1,100259,99741
4:2:6,1,1,100258,99742
5:2:4,1,1,100257,99743
4:6:4,0,-1,100258,99742
3:2:5,1,1,100257,99743
4:4:4,0,-1,100258,99742
1:1:2,1,1,100257,99743
4:4:4,0,-1,100258,99742
3:5:3,0,-1,100259,99741
2:1:6,1,1,100258,99742
3:6:1,0,-1,100259,99741
2:6:6,1,1,100258,99742
2:6:3,1,1,100257,99743
3:3:5,0,-1,100258,99742
4:2:4,1,1,100257,99743
3:6:1,0,-1,100258,99742
1:4:5,0,-1,100259,99741
5:1:2,1,1,100258,99742
5:5:2,1,1,100257,99743
6:2:4,1,1,100256,99744
6:3:1,0,-1,100257,99743
3:2:4,1,1,100256,99744
6:6:6,0,-1,100257,99743
3:6:2,1,1,100256,99744
4:5:3,0,-1,100257,99743
1:3:2,1,1,100256,99744
1:5:5,0,-1,100257,99743
2:1:2,2,2,100255,99745
1:3:5,0,-1,100256,99744
5:1:4,0,-1,100257,99743
1:3:6,0,-1,100258,99742
6:2:4,1,1,100257,99743
3:2:4,1,1,100256,99744
1:1:3,0,-1,100257,99743
1:2:4,1,1,100256,99744
2:3:1,1,1,100255,99745
5:3:5,0,-1,100256,99744
1:5:5,0,-1,100257,99743
2:5:3,1,1,100256,99744
5:1:1,0,-1,100257,99743
1:4:6,0,-1,100258,99742
6:5:1,0,-1,100259,99741
6:3:2,1,1,100258,99742
4:3:5,0,-1,100259,99741
2:3:5,1,1,100258,99742
3:6:3,0,-1,100259,99741
5:4:1,0,-1,100260,99740
6:1:1,0,-1,100261,99739
6:1:2,1,1,100260,99740
3:5:5,0,-1,100261,99739
1:6:3,0,-1,100262,99738
4:6:3,0,-1,100263,99737
1:3:3,0,-1,100264,99736
5:2:3,1,1,100263,99737
3:2:3,1,1,100262,99738
1:3:1,0,-1,100263,99737
1:3:2,1,1,100262,99738
6:1:6,0,-1,100263,99737
5:6:4,0,-1,100264,99736
3:5:1,0,-1,100265,99735
2:4:5,1,1,100264,99736
5:3:2,1,1,100263,99737
6:3:2,1,1,100262,99738
5:1:1,0,-1,100263,99737
3:6:1,0,-1,100264,99736
5:4:6,0,-1,100265,99735
3:5:3,0,-1,100266,99734
2:1:2,2,2,100264,99736
1:1:4,0,-1,100265,99735
2:2:5,2,2,100263,99737
3:4:3,0,-1,100264,99736
6:4:1,0,-1,100265,99735
2:5:6,1,1,100264,99736
6:2:4,1,1,100263,99737
6:2:3,1,1,100262,99738
2:3:1,1,1,100261,99739
4:4:3,0,-1,100262,99738
5:3:6,0,-1,100263,99737
3:2:6,1,1,100262,99738
2:4:6,1,1,100261,99739
4:6:1,0,-1,100262,99738
5:3:1,0,-1,100263,99737
5:4:3,0,-1,100264,99736
1:6:6,0,-1,100265,99735
1:3:5,0,-1,100266,99734
5:5:5,0,-1,100267,99733
1:3:2,1,1,100266,99734
4:4:4,0,-1,100267,99733
5:4:3,0,-1,100268,99732
1:2:3,1,1,100267,99733
1:4:6,0,-1,100268,99732
4:4:4,0,-1,100269,99731
1:4:1,0,-1,100270,99730
5:4:5,0,-1,100271,99729
4:3:3,0,-1,100272,99728
3:1:3,0,-1,100273,99727
2:4:1,1,1,100272,99728
2:1:2,2,2,100270,99730
2:5:4,1,1,100269,99731
4:6:1,0,-1,100270,99730
4:3:4,0,-1,100271,99729
6:1:1,0,-1,100272,99728
2:6:6,1,1,100271,99729
1:3:5,0,-1,100272,99728
6:4:3,0,-1,100273,99727
3:1:3,0,-1,100274,99726
1:2:1,1,1,100273,99727
3:5:6,0,-1,100274,99726
3:3:2,1,1,100273,99727
6:1:4,0,-1,100274,99726
5:1:4,0,-1,100275,99725
3:2:3,1,1,100274,99726
6:5:5,0,-1,100275,99725
2:6:5,1,1,100274,99726
1:6:3,0,-1,100275,99725
6:2:6,1,1,100274,99726
2:1:6,1,1,100273,99727
4:3:1,0,-1,100274,99726
4:3:3,0,-1,100275,99725
4:3:3,0,-1,100276,99724
2:4:3,1,1,100275,99725
5:2:3,1,1,100274,99726
3:4:5,0,-1,100275,99725
4:2:4,1,1,100274,99726
4:6:2,1,1,100273,99727
1:3:1,0,-1,100274,99726
2:6:3,1,1,100273,99727
5:6:5,0,-1,100274,99726
6:1:4,0,-1,100275,99725
4:6:5,0,-1,100276,99724
3:6:6,0,-1,100277,99723
2:3:4,1,1,100276,99724
5:4:4,0,-1,100277,99723
1:6:6,0,-1,100278,99722
3:3:5,0,-1,100279,99721
1:6:4,0,-1,100280,99720
6:6:3,0,-1,100281,99719
6:1:4,0,-1,100282,99718
1:1:3,0,-1,100283,99717
4:6:1,0,-1,100284,99716
4:4:4,0,-1,100285,99715
5:4:4,0,-1,100286,99714
1:1:3,0,-1,100287,99713
4:1:6,0,-1,100288,99712
5:1:1,0,-1,100289,99711
1:5:1,0,-1,100290,99710
5:3:3,0,-1,100291,99709
1:4:4,0,-1,100292,99708
2:6:2,2,2,100290,99710
5:5:5,0,-1,100291,99709
6:4:3,0,-1,100292,99708
6:4:2,1,1,100291,99709
2:1:2,2,2,100289,99711
5:2:4,1,1,100288,99712
3:3:3,0,-1,100289,99711
2:6:4,1,1,100288,99712
5:5:5,0,-1,100289,99711
5:4:3,0,-1,100290,99710
2:4:4,1,1,100289,99711
2:3:1,1,1,100288,99712
5:5:5,0,-1,100289,99711
5:3:5,0,-1,100290,99710
1:1:3,0,-1,100291,99709
6:2:4,1,1,100290,99710
3:1:6,0,-1,100291,99709
4:4:5,0,-1,100292,99708
4:5:3,0,-1,100293,99707
1:3:4,0,-1,100294,99706
6:5:3,0,-1,100295,99705
2:5:5,1,1,100294,99706
5:6:3,0,-1,100295,99705
4:1:2,1,1,100294,99706
5:3:5,0,-1,100295,99705
3:4:2,1,1,100294,99706
4:2:2,2,2,100292,99708
4:1:5,0,-1,100293,99707
1:5:5,0,-1,100294,99706
5:6:2,1,1,100293,99707
2:1:6,1,1,100292,99708
6:5:4,0,-1,100293,99707
4:5:3,0,-1,100294,99706
1:6:4,0,-1,100295,99705
2:4:1,1,1,100294,99706
1:4:6,0,-1,100295,99705
6:1:3,0,-1,100296,99704
4:1:5,0,-1,100297,99703
5:1:2,1,1,100296,99704
2:5:5,1,1,100295,99705
3:5:6,0,-1,100296,99704
6:6:3,0,-1,100297,99703
1:5:6,0,-1,100298,99702
3:3:6,0,-1,100299,99701
4:1:6,0,-1,100300,99700
1:1:5,0,-1,100301,99699
4:4:5,0,-1,100302,99698
4:3:4,0,-1,100303,99697
5:3:3,0,-1,100304,99696
3:5:4,0,-1,100305,99695
1:3:1,0,-1,100306,99694
5:4:4,0,-1,100307,99693
1:3:5,0,-1,100308,99692
4:6:3,0,-1,100309,99691
6:5:3,0,-1,100310,99690
6:1:1,0,-1,100311,99689
2:4:3,1,1,100310,99690
2:6:3,1,1,100309,99691
1:6:3,0,-1,100310,99690
2:3:2,2,2,100308,99692
2:4:4,1,1,100307,99693
6:5:3,0,-1,100308,99692
1:3:2,1,1,100307,99693
5:5:2,1,1,100306,99694
6:6:4,0,-1,100307,99693
1:5:3,0,-1,100308,99692
4:4:4,0,-1,100309,99691
2:2:2,3,3,100306,99694
5:6:6,0,-1,100307,99693
3:3:3,0,-1,100308,99692
5:5:6,0,-1,100309,99691
3:5:4,0,-1,100310,99690
6:3:3,0,-1,100311,99689
4:5:3,0,-1,100312,99688
3:6:4,0,-1,100313,99687
4:1:1,0,-1,100314,99686
2:4:3,1,1,100313,99687
3:4:5,0,-1,100314,99686
3:1:3,0,-1,100315,99685
4:3:6,0,-1,100316,99684
6:5:2,1,1,100315,99685
3:5:2,1,1,100314,99686
5:5:3,0,-1,100315,99685
3:2:4,1,1,100314,99686
2:6:3,1,1,100313,99687
4:2:2,2,2,100311,99689
6:1:3,0,-1,100312,99688
1:1:6,0,-1,100313,99687
1:1:6,0,-1,100314,99686
3:3:1,0,-1,100315,99685
5:6:4,0,-1,100316,99684
4:4:2,1,1,100315,99685
5:2:2,2,2,100313,99687
4:4:3,0,-1,100314,99686
4:1:5,0,-1,100315,99685
4:3:1,0,-1,100316,99684
1:1:2,1,1,100315,99685
2:6:1,1,1,100314,99686
2:1:3,1,1,100313,99687
3:5:3,0,-1,100314,99686
2:4:5,1,1,100313,99687
6:5:5,0,-1,100314,99686
3:1:2,1,1,100313,99687
1:3:4,0,-1,100314,99686
1:2:5,1,1,100313,99687
1:5:5,0,-1,100314,99686
1:1:5,0,-1,100315,99685
4:3:2,1,1,100314,99686
4:2:5,1,1,100313,99687
2:6:4,1,1,100312,99688
3:1:2,1,1,100311,99689
2:3:5,1,1,100310,99690
5:1:1,0,-1,100311,99689
3:6:6,0,-1,100312,99688
4:4:5,0,-1,100313,99687
1:2:2,2,2,100311,99689
6:4:4,0,-1,100312,99688
3:3:4,0,-1,100313,99687
4:6:4,0,-1,100314,99686
4:4:1,0,-1,100315,99685
2:3:1,1,1,100314,99686
4:1:2,1,1,100313,99687
2:4:3,1,1,100312,99688
6:5:5,0,-1,100313,99687
5:2:2,2,2,100311,99689
3:6:1,0,-1,100312,99688
3:4:6,0,-1,100313,99687
2:2:2,3,3,100310,99690
6:1:4,0,-1,100311,99689
6:2:3,1,1,100310,99690
5:2:1,1,1,100309,99691
6:6:2,1,1,100308,99692
1:2:6,1,1,100307,99693
1:6:6,0,-1,100308,99692
5:3:5,0,-1,100309,99691
1:5:6,0,-1,100310,99690
1:5:2,1,1,100309,99691
5:4:6,0,-1,100310,99690
4:6:5,0,-1,100311,99689
5:2:1,1,1,100310,99690
1:5:6,0,-1,100311,99689
3:6:2,1,1,100310,99690
2:6:1,1,1,100309,99691
2:6:3,1,1,100308,99692
3:1:2,1,1,100307,99693
4:2:6,1,1,100306,99694
3:1:1,0,-1,100307,99693
2:3:3,1,1,100306,99694
5:3:5,0,-1,100307,99693
4:3:6,0,-1,100308,99692
2:4:2,2,2,100306,99694
2:6:6,1,1,100305,99695
5:1:3,0,-1,100306,99694
4:4:5,0,-1,100307,99693
4:4:2,1,1,100306,99694
6:1:5,0,-1,100307,99693
6:4:3,0,-1,100308,99692
4:4:6,0,-1,100309,99691
5:5:2,1,1,100308,99692
3:1:5,0,-1,100309,99691
4:3:6,0,-1,100310,99690
3:6:4,0,-1,100311,99689
1:3:4,0,-1,100312,99688
3:5:5,0,-1,100313,99687
4:6:1,0,-1,100314,99686
5:3:3,0,-1,100315,99685
5:1:5,0,-1,100316,99684
5:2:1,1,1,100315,99685
1:1:6,0,-1,100316,99684
5:5:5,0,-1,100317,99683
2:3:4,1,1,100316,99684
4:4:4,0,-1,100317,99683
5:1:1,0,-1,100318,99682
1:4:1,0,-1,100319,99681
4:1:5,0,-1,100320,99680
6:3:2,1,1,100319,99681
6:2:3,1,1,100318,99682
3:5:3,0,-1,100319,99681
5:5:1,0,-1,100320,99680
6:6:2,1,1,100319,99681
1:2:6,1,1,100318,99682
6:5:6,0,-1,100319,99681
3:5:5,0,-1,100320,99680
3:6:6,0,-1,100321,99679
5:5:6,0,-1,100322,99678
1:1:5,0,-1,100323,99677
2:2:3,2,2,100321,99679
3:6:5,0,-1,100322,99678
2:5:4,1,1,100321,99679
3:2:4,1,1,100320,99680
1:3:3,0,-1,100321,99679
1:2:2,2,2,100319,99681
2:6:4,1,1,100318,99682
2:6:2,2,2,100316,99684
5:3:1,0,-1,100317,99683
6:2:4,1,1,100316,99684
5:5:4,0,-1,100317,99683
3:4:4,0,-1,100318,99682
6:5:4,0,-1,100319,99681
2:6:3,1,1,100318,99682
6:4:6,0,-1,100319,99681
6:2:4,1,1,100318,99682
1:1:6,0,-1,100319,99681
2:2:6,2,2,100317,99683
5:2:6,1,1,100316,99684
6:2:2,2,2,100314,99686
4:3:1,0,-1,100315,99685
4:4:1,0,-1,100316,99684
5:3:2,1,1,100315,99685
1:2:4,1,1,100314,99686
4:1:3,0,-1,100315,99685
1:4:3,0,-1,100316,99684
2:2:1,2,2,100314,99686
3:5:2,1,1,100313,99687
1:6:1,0,-1,100314,99686
2:1:2,2,2,100312,99688
5:1:2,1,1,100311,99689
2:5:6,1,1,100310,99690
5:1:3,0,-1,100311,99689
5:6:2,1,1,100310,99690
3:1:4,0,-1,100311,99689
4:4:6,0,-1,100312,99688
4:3:2,1,1,100311,99689
6:3:6,0,-1,100312,99688
6:4:3,0,-1,100313,99687
3:6:2,1,1,100312,99688
2:2:1,2,2,100310,99690
3:3:3,0,-1,100311,99689
4:5:2,1,1,100310,99690
3:1:1,0,-1,100311,99689
2:6:1,1,1,100310,99690
1:5:5,0,-1,100311,99689
3:1:4,0,-1,100312,99688
1:2:2,2,2,100310,99690
1:6:5,0,-1,100311,99689
5:6:5,0,-1,100312,99688
6:2:3,1,1,100311,99689
1:2:6,1,1,100310,99690
3:5:6,0,-1,100311,99689
4:2:1,1,1,100310,99690
2:4:3,1,1,100309,99691
5:6:6,0,-1,100310,99690
5:4:1,0,-1,100311,99689
6:3:3,0,-1,100312,99688
3:6:3,0,-1,100313,99687
5:5:5,0,-1,100314,99686
6:4:3,0,-1,100315,99685
3:6:5,0,-1,100316,99684
4:2:4,1,1,100315,99685
5:5:6,0,-1,100316,99684
5:6:3,0,-1,100317,99683
4:3:6,0,-1,100318,99682
2:4:1,1,1,100317,99683
4:5:3,0,-1,100318,99682
1:2:1,1,1,100317,99683
5:6:2,1,1,100316,99684
1:1:6,0,-1,100317,99683
6:1:1,0,-1,100318,99682
6:2:5,1,1,100317,99683
4:3:5,0,-1,100318,99682
6:1:1,0,-1,100319,99681
5:1:5,0,-1,100320,99680
4:5:4,0,-1,100321,99679
1:3:4,0,-1,100322,99678
4:3:5,0,-1,100323,99677
1:2:1,1,1,100322,99678
1:3:4,0,-1,100323,99677
3:4:6,0,-1,100324,99676
4:2:4,1,1,100323,99677
6:5:5,0,-1,100324,99676
6:4:4,0,-1,100325,99675
1:1:5,0,-1,100326,99674
3:3:6,0,-1,100327,99673
6:3:5,0,-1,100328,99672
3:4:3,0,-1,100329,99671
2:2:2,3,3,100326,99674
2:1:5,1,1,100325,99675
1:5:1,0,-1,100326,99674
6:5:3,0,-1,100327,99673
1:4:6,0,-1,100328,99672
1:3:6,0,-1,100329,99671
5:2:3,1,1,100328,99672
1:5:1,0,-1,100329,99671
3:4:3,0,-1,100330,99670
4:5:5,0,-1,100331,99669
3:3:3,0,-1,100332,99668
2:5:2,2,2,100330,99670
6:5:3,0,-1,100331,99669
2:5:2,2,2,100329,99671
2:3:3,1,1,100328,99672
1:6:6,0,-1,100329,99671
1:5:4,0,-1,100330,99670
1:3:2,1,1,100329,99671
6:3:2,1,1,100328,99672
6:3:3,0,-1,100329,99671
3:3:6,0,-1,100330,99670
6:5:5,0,-1,100331,99669
5:5:4,0,-1,100332,99668
4:3:6,0,-1,100333,99667
2:1:6,1,1,100332,99668
2:1:3,1,1,100331,99669
6:3:4,0,-1,100332,99668
2:1:1,1,1,100331,99669
2:6:4,1,1,100330,99670
4:3:3,0,-1,100331,99669
2:3:2,2,2,100329,99671
3:6:2,1,1,100328,99672
4:4:4,0,-1,100329,99671
5:2:5,1,1,100328,99672
2:2:4,2,2,100326,99674
3:3:1,0,-1,100327,99673
4:6:2,1,1,100326,99674
5:3:6,0,-1,100327,99673
2:3:6,1,1,100326,99674
5:2:4,1,1,100325,99675
4:6:2,1,1,100324,99676
5:4:5,0,-1,100325,99675
6:3:3,0,-1,100326,99674
6:4:2,1,1,100325,99675
2:2:5,2,2,100323,99677
3:5:4,0,-1,100324,99676
1:3:5,0,-1,100325,99675
2:5:2,2,2,100323,99677
1:5:3,0,-1,100324,99676
4:2:6,1,1,100323,99677
2:3:6,1,1,100322,99678
3:5:3,0,-1,100323,99677
6:2:1,1,1,100322,99678
4:2:4,1,1,100321,99679
2:5:6,1,1,100320,99680
1:5:1,0,-1,100321,99679
5:3:5,0,-1,100322,99678
5:5:5,0,-1,100323,99677
6:4:1,0,-1,100324,99676
6:1:6,0,-1,100325,99675
3:2:4,1,1,100324,99676
6:2:3,1,1,100323,99677
5:5:1,0,-1,100324,99676
6:5:5,0,-1,100325,99675
5:2:3,1,1,100324,99676
6:6:5,0,-1,100325,99675
6:3:3,0,-1,100326,99674
1:4:5,0,-1,100327,99673
3:6:5,0,-1,100328,99672
6:1:2,1,1,100327,99673
6:6:5,0,-1,100328,99672
4:5:5,0,-1,100329,99671
4:6:1,0,-1,100330,99670
6:4:2,1,1,100329,99671
2:2:2,3,3,100326,99674
5:4:2,1,1,100325,99675
6:3:2,1,1,100324,99676
6:1:3,0,-1,100325,99675
5:6:3,0,-1,100326,99674
5:2:1,1,1,100325,99675
1:3:4,0,-1,100326,99674
6:2:2,2,2,100324,99676
2:6:2,2,2,100322,99678
3:6:5,0,-1,100323,99677
5:5:6,0,-1,100324,99676
6:2:6,1,1,100323,99677
2:6:2,2,2,100321,99679
2:2:4,2,2,100319,99681
1:4:2,1,1,100318,99682
2:3:2,2,2,100316,99684
3:6:3,0,-1,100317,99683
3:6:6,0,-1,100318,99682
4:6:4,0,-1,100319,99681
6:3:1,0,-1,100320,99680
5:4:3,0,-1,100321,99679
6:5:2,1,1,100320,99680
1:4:4,0,-1,100321,99679
6:4:5,0,-1,100322,99678
4:3:4,0,-1,100323,99677
3:1:6,0,-1,100324,99676
5:4:5,0,-1,100325,99675
4:5:2,1,1,100324,99676
6:3:3,0,-1,100325,99675
6:5:2,1,1,100324,99676
1:2:5,1,1,100323,99677
6:2:3,1,1,100322,99678
3:5:4,0,-1,100323,99677
4:3:2,1,1,100322,99678
6:1:6,0,-1,100323,99677
5:4:5,0,-1,100324,99676
5:2:4,1,1,100323,99677
1:4:4,0,-1,100324,99676
2:3:5,1,1,100323,99677
6:6:6,0,-1,100324,99676
1:4:5,0,-1,100325,99675
5:2:5,1,1,100324,99676
3:2:2,2,2,100322,99678
6:6:6,0,-1,100323,99677
1:1:2,1,1,100322,99678
1:3:1,0,-1,100323,99677
5:6:5,0,-1,100324,99676
3:6:2,1,1,100323,99677
5:4:6,0,-1,100324,99676
2:4:6,1,1,100323,99677
1:3:6,0,-1,100324,99676
6:3:1,0,-1,100325,99675
5:6:3,0,-1,100326,99674
1:5:4,0,-1,100327,99673
5:6:4,0,-1,100328,99672
3:1:2,1,1,100327,99673
5:3:2,1,1,100326,99674
3:4:3,0,-1,100327,99673
1:6:3,0,-1,100328,99672
5:2:6,1,1,100327,99673
3:4:5,0,-1,100328,99672
2:2:3,2,2,100326,99674
6:5:6,0,-1,100327,99673
2:3:1,1,1,100326,99674
3:3:6,0,-1,100327,99673
6:4:6,0,-1,100328,99672
1:6:5,0,-1,100329,99671
1:4:4,0,-1,100330,99670
4:6:4,0,-1,100331,99669
1:4:5,0,-1,100332,99668
5:5:4,0,-1,100333,99667
6:3:4,0,-1,100334,99666
2:6:2,2,2,100332,99668
4:4:5,0,-1,100333,99667
1:6:5,0,-1,100334,99666
1:2:2,2,2,100332,99668
5:6:6,0,-1,100333,99667
1:4:5,0,-1,100334,99666
2:4:2,2,2,100332,99668
2:3:3,1,1,100331,99669
3:5:2,1,1,100330,99670
1:2:6,1,1,100329,99671
5:1:1,0,-1,100330,99670
4:4:1,0,-1,100331,99669
6:1:1,0,-1,100332,99668
4:5:6,0,-1,100333,99667
1:2:3,1,1,100332,99668
6:5:2,1,1,100331,99669
2:3:1,1,1,100330,99670
4:1:5,0,-1,100331,99669
4:1:2,1,1,100330,99670
3:5:3,0,-1,100331,99669
1:4:3,0,-1,100332,99668
1:2:5,1,1,100331,99669
5:1:1,0,-1,100332,99668
6:4:3,0,-1,100333,99667
3:2:4,1,1,100332,99668
2:3:6,1,1,100331,99669
5:4:6,0,-1,100332,99668
2:1:4,1,1,100331,99669
1:5:2,1,1,100330,99670
4:3:2,1,1,100329,99671
5:2:2,2,2,100327,99673
3:3:4,0,-1,100328,99672
1:4:3,0,-1,100329,99671
3:3:4,0,-1,100330,99670
2:2:2,3,3,100327,99673
5:1:1,0,-1,100328,99672
5:4:1,0,-1,100329,99671
5:6:4,0,-1,100330,99670
3:1:4,0,-1,100331,99669
4:4:4,0,-1,100332,99668
6:5:5,0,-1,100333,99667
2:2:2,3,3,100330,99670
2:5:2,2,2,100328,99672
2:1:4,1,1,100327,99673
6:1:3,0,-1,100328,99672
6:3:3,0,-1,100329,99671
1:3:1,0,-1,100330,99670
1:2:4,1,1,100329,99671
5:2:1,1,1,100328,99672
1:2:4,1,1,100327,99673
3:1:6,0,-1,100328,99672
2:1:5,1,1,100327,99673
6:5:3,0,-1,100328,99672
4:2:3,1,1,100327,99673
2:6:2,2,2,100325,99675
6:4:5,0,-1,100326,99674
1:6:4,0,-1,100327,99673
6:5:4,0,-1,100328,99672
3:1:1,0,-1,100329,99671
4:6:5,0,-1,100330,99670
4:2:3,1,1,100329,99671
3:4:2,1,1,100328,99672
1:3:5,0,-1,100329,99671
2:5:5,1,1,100328,99672
6:3:6,0,-1,100329,99671
4:1:3,0,-1,100330,99670
2:5:3,1,1,100329,99671
3:2:6,1,1,100328,99672
3:6:5,0,-1,100329,99671
3:6:4,0,-1,100330,99670
3:1:6,0,-1,100331,99669
1:2:5,1,1,100330,99670
1:2:3,1,1,100329,99671
3:1:3,0,-1,100330,99670
5:5:3,0,-1,100331,99669
3:5:5,0,-1,100332,99668
3:2:1,1,1,100331,99669
2:3:1,1,1,100330,99670
4:5:3,0,-1,100331,99669
1:5:3,0,-1,100332,99668
3:1:4,0,-1,100333,99667
5:6:4,0,-1,100334,99666
6:4:1,0,-1,100335,99665
5:1:4,0,-1,100336,99664
4:3:1,0,-1,100337,99663
3:2:3,1,1,100336,99664
2:3:6,1,1,100335,99665
3:2:2,2,2,100333,99667
5:4:4,0,-1,100334,99666
2:2:6,2,2,100332,99668
2:6:3,1,1,100331,99669
1:3:2,1,1,100330,99670
2:6:4,1,1,100329,99671
1:1:2,1,1,100328,99672
6:6:4,0,-1,100329,99671
6:6:2,1,1,100328,99672
1:6:6,0,-1,100329,99671
6:3:3,0,-1,100330,99670
2:2:2,3,3,100327,99673
3:1:6,0,-1,100328,99672
5:5:1,0,-1,100329,99671
6:1:2,1,1,100328,99672
3:3:3,0,-1,100329,99671
5:4:3,0,-1,100330,99670
1:3:5,0,-1,100331,99669
3:5:4,0,-1,100332,99668
1:6:6,0,-1,100333,99667
5:5:6,0,-1,100334,99666
6:4:1,0,-1,100335,99665
1:4:3,0,-1,100336,99664
5:2:6,1,1,100335,99665
4:3:5,0,-1,100336,99664
5:6:6,0,-1,100337,99663
2:6:4,1,1,100336,99664
1:1:5,0,-1,100337,99663
2:2:5,2,2,100335,99665
4:5:1,0,-1,100336,99664
3:2:2,2,2,100334,99666
3:5:6,0,-1,100335,99665
1:1:1,0,-1,100336,99664
1:1:6,0,-1,100337,99663
6:6:3,0,-1,100338,99662
4:6:6,0,-1,100339,99661
3:2:2,2,2,100337,99663
6:1:2,1,1,100336,99664
2:6:5,1,1,100335,99665
2:3:1,1,1,100334,99666
3:4:2,1,1,100333,99667
1:3:2,1,1,100332,99668
6:4:6,0,-1,100333,99667
6:6:6,0,-1,100334,99666
4:5:5,0,-1,100335,99665
2:1:4,1,1,100334,99666
3:2:2,2,2,100332,99668
3:5:3,0,-1,100333,99667
1:1:5,0,-1,100334,99666
4:5:3,0,-1,100335,99665
1:3:1,0,-1,100336,99664
4:3:5,0,-1,100337,99663
5:2:5,1,1,100336,99664
6:4:3,0,-1,100337,99663
6:3:1,0,-1,100338,99662
2:1:6,1,1,100337,99663
3:3:1,0,-1,100338,99662
3:5:2,1,1,100337,99663
6:3:4,0,-1,100338,99662
4:4:2,1,1,100337,99663
6:6:2,1,1,100336,99664
4:1:1,0,-1,100337,99663
5:1:1,0,-1,100338,99662
3:1:1,0,-1,100339,99661
5:3:1,0,-1,100340,99660
1:6:3,0,-1,100341,99659
2:1:3,1,1,100340,99660
4:4:4,0,-1,100341,99659
1:5:1,0,-1,100342,99658
4:4:6,0,-1,100343,99657
5:1:3,0,-1,100344,99656
6:1:6,0,-1,100345,99655
1:3:4,0,-1,100346,99654
5:4:1,0,-1,100347,99653
1:2:4,1,1,100346,99654
5:4:6,0,-1,100347,99653
6:6:6,0,-1,100348,99652
5:1:3,0,-1,100349,99651
3:5:3,0,-1,100350,99650
6:6:3,0,-1,100351,99649
2:4:2,2,2,100349,99651
5:6:6,0,-1,100350,99650
1:6:4,0,-1,100351,99649
2:2:5,2,2,100349,99651
2:3:6,1,1,100348,99652
3:2:6,1,1,100347,99653
3:6:6,0,-1,100348,99652
1:1:4,0,-1,100349,99651
1:3:2,1,1,100348,99652
3:6:6,0,-1,100349,99651
6:5:3,0,-1,100350,99650
3:5:2,1,1,100349,99651
3:3:4,0,-1,100350,99650
4:5:4,0,-1,100351,99649
3:4:1,0,-1,100352,99648
1:3:2,1,1,100351,99649
3:3:3,0,-1,100352,99648
4:3:5,0,-1,100353,99647
6:4:6,0,-1,100354,99646
2:3:4,1,1,100353,99647
2:5:5,1,1,100352,99648
1:2:2,2,2,100350,99650
2:5:2,2,2,100348,99652
4:5:6,0,-1,100349,99651
6:5:6,0,-1,100350,99650
1:1:1,0,-1,100351,99649
4:3:3,0,-1,100352,99648
4:1:6,0,-1,100353,99647
1:5:6,0,-1,100354,99646
4:2:6,1,1,100353,99647
3:3:6,0,-1,100354,99646
1:6:6,0,-1,100355,99645
5:2:4,1,1,100354,99646
5:2:1,1,1,100353,99647
5:4:5,0,-1,100354,99646
5:4:1,0,-1,100355,99645
6:2:5,1,1,100354,99646
5:3:2,1,1,100353,99647
6:3:3,0,-1,100354,99646
4:1:3,0,-1,100355,99645
3:2:5,1,1,100354,99646
4:2:2,2,2,100352,99648
3:2:6,1,1,100351,99649
1:5:6,0,-1,100352,99648
6:1:6,0,-1,100353,99647
4:5:3,0,-1,100354,99646
2:6:5,1,1,100353,99647
1:5:1,0,-1,100354,99646
6:5:4,0,-1,100355,99645
5:6:4,0,-1,100356,99644
2:1:5,1,1,100355,99645
6:2:3,1,1,100354,99646
3:4:4,0,-1,100355,99645
5:1:5,0,-1,100356,99644
3:4:1,0,-1,100357,99643
5:6:1,0,-1,100358,99642
1:6:4,0,-1,100359,99641
3:4:1,0,-1,100360,99640
5:5:1,0,-1,100361,99639
2:5:1,1,1,100360,99640
4:1:5,0,-1,100361,99639
1:3:6,0,-1,100362,99638
1:1:2,1,1,100361,99639
5:1:2,1,1,100360,99640
4:3:3,0,-1,100361,99639
4:5:1,0,-1,100362,99638
5:3:3,0,-1,100363,99637
3:6:1,0,-1,100364,99636
6:6:1,0,-1,100365,99635
3:6:2,1,1,100364,99636
5:6:1,0,-1,100365,99635
5:6:5,0,-1,100366,99634
4:4:1,0,-1,100367,99633
2:1:2,2,2,100365,99635
3:1:2,1,1,100364,99636
2:5:5,1,1,100363,99637
5:5:6,0,-1,100364,99636
2:6:3,1,1,100363,99637
6:1:4,0,-1,100364,99636
6:4:1,0,-1,100365,99635
3:4:4,0,-1,100366,99634
6:1:2,1,1,100365,99635
4:3:3,0,-1,100366,99634
1:6:3,0,-1,100367,99633
3:4:2,1,1,100366,99634
5:6:4,0,-1,100367,99633
6:1:1,0,-1,100368,99632
3:5:1,0,-1,100369,99631
5:3:5,0,-1,100370,99630
4:4:1,0,-1,100371,99629
2:4:2,2,2,100369,99631
5:2:4,1,1,100368,99632
5:3:2,1,1,100367,99633
6:5:1,0,-1,100368,99632
6:4:1,0,-1,100369,99631
2:4:1,1,1,100368,99632
1:1:2,1,1,100367,99633
5:3:3,0,-1,100368,99632
3:4:3,0,-1,100369,99631
2:6:5,1,1,100368,99632
6:1:2,1,1,100367,99633
3:4:5,0,-1,100368,99632
6:4:2,1,1,100367,99633
6:2:1,1,1,100366,99634
4:5:2,1,1,100365,99635
1:1:3,0,-1,100366,99634
6:3:4,0,-1,100367,99633
3:1:5,0,-1,100368,99632
3:3:6,0,-1,100369,99631
1:2:3,1,1,100368,99632
3:2:4,1,1,100367,99633
6:1:3,0,-1,100368,99632
3:3:3,0,-1,100369,99631
1:2:4,1,1,100368,99632
4:6:4,0,-1,100369,99631
1:1:3,0,-1,100370,99630
1:4:6,0,-1,100371,99629
6:1:3,0,-1,100372,99628
1:5:4,0,-1,100373,99627
4:6:1,0,-1,100374,99626
1:5:2,1,1,100373,99627
5:6:4,0,-1,100374,99626
4:1:6,0,-1,100375,99625
3:1:5,0,-1,100376,99624
2:6:1,1,1,100375,99625
1:3:1,0,-1,100376,99624
6:5:5,0,-1,100377,99623
1:3:5,0,-1,100378,99622
1:4:2,1,1,100377,99623
2:3:4,1,1,100376,99624
6:3:1,0,-1,100377,99623
5:6:6,0,-1,100378,99622
2:4:4,1,1,100377,99623
4:5:3,0,-1,100378,99622
5:4:2,1,1,100377,99623
6:5:5,0,-1,100378,99622
4:2:3,1,1,100377,99623
3:6:1,0,-1,100378,99622
5:5:5,0,-1,100379,99621
4:3:5,0,-1,100380,99620
2:4:1,1,1,100379,99621
2:6:1,1,1,100378,99622
3:3:3,0,-1,100379,99621
2:2:6,2,2,100377,99623
3:1:1,0,-1,100378,99622
5:4:5,0,-1,100379,99621
3:3:3,0,-1,100380,99620
1:4:2,1,1,100379,99621
4:2:3,1,1,100378,99622
2:3:1,1,1,100377,99623
5:5:3,0,-1,100378,99622
3:3:5,0,-1,100379,99621
5:6:4,0,-1,100380,99620
3:6:2,1,1,100379,99621
3:5:4,0,-1,100380,99620
6:2:5,1,1,100379,99621
6:2:2,2,2,100377,99623
2:4:4,1,1,100376,99624
6:6:3,0,-1,100377,99623
2:1:5,1,1,100376,99624
2:5:6,1,1,100375,99625
5:1:6,0,-1,100376,99624
2:3:4,1,1,100375,99625
5:6:6,0,-1,100376,99624
5:4:4,0,-1,100377,99623
3:1:1,0,-1,100378,99622
3:2:6,1,1,100377,99623
1:1:4,0,-1,100378,99622
3:2:3,1,1,100377,99623
5:6:6,0,-1,100378,99622
5:3:5,0,-1,100379,99621
6:5:2,1,1,100378,99622
1:6:3,0,-1,100379,99621
4:6:3,0,-1,100380,99620
1:6:5,0,-1,100381,99619
2:5:1,1,1,100380,99620
3:5:1,0,-1,100381,99619
5:1:2,1,1,100380,99620
5:6:2,1,1,100379,99621
5:1:5,0,-1,100380,99620
3:5:2,1,1,100379,99621
6:1:4,0,-1,100380,99620
6:5:1,0,-1,100381,99619
5:2:5,1,1,100380,99620
1:4:1,0,-1,100381,99619
6:6:3,0,-1,100382,99618
1:2:4,1,1,100381,99619
6:6:4,0,-1,100382,99618
4:2:2,2,2,100380,99620
4:6:5,0,-1,100381,99619
3:1:5,0,-1,100382,99618
2:3:1,1,1,100381,99619
6:3:6,0,-1,100382,99618
6:2:6,1,1,100381,99619
1:3:2,1,1,100380,99620
3:6:3,0,-1,100381,99619
2:1:4,1,1,100380,99620
4:6:3,0,-1,100381,99619
4:3:6,0,-1,100382,99618
1:4:6,0,-1,100383,99617
5:2:4,1,1,100382,99618
1:1:4,0,-1,100383,99617
4:6:3,0,-1,100384,99616
2:5:5,1,1,100383,99617
4:6:6,0,-1,100384,99616
4:6:1,0,-1,100385,99615
5:2:5,1,1,100384,99616
5:4:5,0,-1,100385,99615
2:1:6,1,1,100384,99616
3:4:5,0,-1,100385,99615
3:3:5,0,-1,100386,99614
1:3:3,0,-1,100387,99613
3:2:6,1,1,100386,99614
5:3:6,0,-1,100387,99613
6:4:6,0,-1,100388,99612
3:2:5,1,1,100387,99613
1:4:6,0,-1,100388,99612
5:4:3,0,-1,100389,99611
4:6:1,0,-1,100390,99610
4:2:6,1,1,100389,99611
1:5:5,0,-1,100390,99610
4:2:4,1,1,100389,99611
4:2:1,1,1,100388,99612
5:4:1,0,-1,100389,99611
5:3:1,0,-1,100390,99610
3:2:3,1,1,100389,99611
2:4:5,1,1,100388,99612
2:1:1,1,1,100387,99613
4:5:2,1,1,100386,99614
4:4:3,0,-1,100387,99613
2:6:5,1,1,100386,99614
6:1:3,0,-1,100387,99613
1:1:1,0,-1,100388,99612
3:2:6,1,1,100387,99613
3:2:1,1,1,100386,99614
1:3:2,1,1,100385,99615
3:4:2,1,1,100384,99616
3:6:4,0,-1,100385,99615
2:1:5,1,1,100384,99616
5:6:5,0,-1,100385,99615
3:4:2,1,1,100384,99616
3:5:2,1,1,100383,99617
2:6:3,1,1,100382,99618
3:6:5,0,-1,100383,99617
3:4:5,0,-1,100384,99616
3:1:1,0,-1,100385,99615
2:3:3,1,1,100384,99616
2:4:4,1,1,100383,99617
5:1:6,0,-1,100384,99616
6:6:1,0,-1,100385,99615
3:5:3,0,-1,100386,99614
4:5:3,0,-1,100387,99613
4:3:6,0,-1,100388,99612
3:2:1,1,1,100387,99613
1:4:6,0,-1,100388,99612
4:6:3,0,-1,100389,99611
2:2:2,3,3,100386,99614
4:2:4,1,1,100385,99615
6:4:3,0,-1,100386,99614
4:4:1,0,-1,100387,99613
6:5:6,0,-1,100388,99612
3:1:1,0,-1,100389,99611
6:4:1,0,-1,100390,99610
6:1:2,1,1,100389,99611
6:3:3,0,-1,100390,99610
5:6:1,0,-1,100391,99609
5:4:2,1,1,100390,99610
4:2:2,2,2,100388,99612
6:6:3,0,-1,100389,99611
3:4:6,0,-1,100390,99610
4:4:1,0,-1,100391,99609
1:1:6,0,-1,100392,99608
2:4:3,1,1,100391,99609
5:6:3,0,-1,100392,99608
6:3:6,0,-1,100393,99607
2:6:3,1,1,100392,99608
6:5:1,0,-1,100393,99607
6:1:5,0,-1,100394,99606
5:1:2,1,1,100393,99607
3:4:3,0,-1,100394,99606
6:5:1,0,-1,100395,99605
5:5:5,0,-1,100396,99604
4:2:2,2,2,100394,99606
4:1:3,0,-1,100395,99605
2:3:6,1,1,100394,99606
2:2:6,2,2,100392,99608
4:2:4,1,1,100391,99609
1:5:2,1,1,100390,99610
4:5:4,0,-1,100391,99609
4:6:2,1,1,100390,99610
3:6:4,0,-1,100391,99609
6:3:3,0,-1,100392,99608
1:2:3,1,1,100391,99609
6:1:2,1,1,100390,99610
5:3:1,0,-1,100391,99609
4:2:5,1,1,100390,99610
6:6:2,1,1,100389,99611
3:4:6,0,-1,100390,99610
6:4:3,0,-1,100391,99609
6:6:1,0,-1,100392,99608
5:4:6,0,-1,100393,99607
1:6:3,0,-1,100394,99606
2:3:6,1,1,100393,99607
1:3:2,1,1,100392,99608
1:6:5,0,-1,100393,99607
2:1:4,1,1,100392,99608
1:6:5,0,-1,100393,99607
1:1:4,0,-1,100394,99606
3:4:2,1,1,100393,99607
2:4:4,1,1,100392,99608
6:3:5,0,-1,100393,99607
2:3:4,1,1,100392,99608
2:4:1,1,1,100391,99609
6:2:4,1,1,100390,99610
6:1:1,0,-1,100391,99609
5:2:1,1,1,100390,99610
5:3:1,0,-1,100391,99609
1:4:2,1,1,100390,99610
1:5:2,1,1,100389,99611
5:2:2,2,2,100387,99613
4:3:5,0,-1,100388,99612
6:4:3,0,-1,100389,99611
3:1:1,0,-1,100390,99610
3:5:6,0,-1,100391,99609
4:2:5,1,1,100390,99610
5:1:6,0,-1,100391,99609
1:3:1,0,-1,100392,99608
5:5:3,0,-1,100393,99607
2:1:6,1,1,100392,99608
5:4:4,0,-1,100393,99607
1:2:5,1,1,100392,99608
1:6:4,0,-1,100393,99607
4:4:1,0,-1,100394,99606
1:6:4,0,-1,100395,99605
3:4:2,1,1,100394,99606
2:3:5,1,1,100393,99607
3:6:4,0,-1,100394,99606
4:4:1,0,-1,100395,99605
2:3:1,1,1,100394,99606
1:2:2,2,2,100392,99608
3:1:2,1,1,100391,99609
3:5:5,0,-1,100392,99608
3:5:5,0,-1,100393,99607
5:6:4,0,-1,100394,99606
5:6:4,0,-1,100395,99605
2:1:4,1,1,100394,99606
1:5:6,0,-1,100395,99605
5:5:4,0,-1,100396,99604
6:3:4,0,-1,100397,99603
5:4:5,0,-1,100398,99602
5:2:6,1,1,100397,99603
6:4:6,0,-1,100398,99602
1:1:4,0,-1,100399,99601
6:6:5,0,-1,100400,99600
4:6:4,0,-1,100401,99599
1:5:1,0,-1,100402,99598
2:5:5,1,1,100401,99599
6:2:4,1,1,100400,99600
5:3:5,0,-1,100401,99599
2:3:1,1,1,100400,99600
1:2:2,2,2,100398,99602
2:4:5,1,1,100397,99603
1:2:2,2,2,100395,99605
3:1:3,0,-1,100396,99604
3:3:1,0,-1,100397,99603
4:1:5,0,-1,100398,99602
2:6:4,1,1,100397,99603
2:1:6,1,1,100396,99604
3:1:3,0,-1,100397,99603
2:3:5,1,1,100396,99604
2:5:1,1,1,100395,99605
2:3:3,1,1,100394,99606
4:6:2,1,1,100393,99607
5:5:3,0,-1,100394,99606
6:4:5,0,-1,100395,99605
4:3:2,1,1,100394,99606
3:5:3,0,-1,100395,99605
1:6:2,1,1,100394,99606
2:6:6,1,1,100393,99607
1:4:5,0,-1,100394,99606
1:5:3,0,-1,100395,99605
3:5:5,0,-1,100396,99604
3:3:3,0,-1,100397,99603
6:1:6,0,-1,100398,99602
4:5:6,0,-1,100399,99601
4:1:5,0,-1,100400,99600
4:4:3,0,-1,100401,99599
3:1:1,0,-1,100402,99598
2:1:3,1,1,100401,99599
1:3:1,0,-1,100402,99598
4:3:3,0,-1,100403,99597
1:4:6,0,-1,100404,99596
3:6:3,0,-1,100405,99595
1:2:6,1,1,100404,99596
4:2:3,1,1,100403,99597
5:2:6,1,1,100402,99598
5:6:3,0,-1,100403,99597
4:1:5,0,-1,100404,99596
6:6:4,0,-1,100405,99595
3:3:6,0,-1,100406,99594
4:1:5,0,-1,100407,99593
4:2:3,1,1,100406,99594
1:2:5,1,1,100405,99595
6:5:5,0,-1,100406,99594
5:3:4,0,-1,100407,99593
5:6:4,0,-1,100408,99592
5:5:3,0,-1,100409,99591
3:1:4,0,-1,100410,99590
3:4:3,0,-1,100411,99589
1:3:5,0,-1,100412,99588
4:4:2,1,1,100411,99589
2:1:1,1,1,100410,99590
2:1:4,1,1,100409,99591
5:3:2,1,1,100408,99592
3:1:5,0,-1,100409,99591
4:6:5,0,-1,100410,99590
5:1:3,0,-1,100411,99589
4:3:6,0,-1,100412,99588
6:4:5,0,-1,100413,99587
4:2:6,1,1,100412,99588
6:2:1,1,1,100411,99589
1:6:3,0,-1,100412,99588
6:4:6,0,-1,100413,99587
2:2:6,2,2,100411,99589
1:5:2,1,1,100410,99590
5:2:4,1,1,100409,99591
2:5:4,1,1,100408,99592
5:3:3,0,-1,100409,99591
1:6:5,0,-1,100410,99590
5:1:2,1,1,100409,99591
2:5:1,1,1,100408,99592
3:6:3,0,-1,100409,99591
1:3:5,0,-1,100410,99590
6:3:2,1,1,100409,99591
2:2:6,2,2,100407,99593
5:5:6,0,-1,100408,99592
6:6:1,0,-1,100409,99591
4:4:3,0,-1,100410,99590
5:5:4,0,-1,100411,99589
5:6:4,0,-1,100412,99588
6:4:6,0,-1,100413,99587
1:6:3,0,-1,100414,99586
1:3:5,0,-1,100415,99585
6:1:1,0,-1,100416,99584
2:3:6,1,1,100415,99585
3:5:5,0,-1,100416,99584
3:4:3,0,-1,100417,99583
5:1:4,0,-1,100418,99582
3:1:3,0,-1,100419,99581
2:1:3,1,1,100418,99582
2:5:4,1,1,100417,99583
2:6:6,1,1,100416,99584
3:6:5,0,-1,100417,99583
3:4:1,0,-1,100418,99582
3:4:3,0,-1,100419,99581
5:2:6,1,1,100418,99582
1:6:6,0,-1,100419,99581
4:3:5,0,-1,100420,99580
1:6:5,0,-1,100421,99579
3:2:5,1,1,100420,99580
1:2:2,2,2,100418,99582
2:2:6,2,2,100416,99584
6:4:3,0,-1,100417,99583
6:5:6,0,-1,100418,99582
5:1:6,0,-1,100419,99581
5:2:3,1,1,100418,99582
2:4:2,2,2,100416,99584
6:1:2,1,1,100415,99585
2:1:1,1,1,100414,99586
4:3:1,0,-1,100415,99585
3:3:5,0,-1,100416,99584
2:2:5,2,2,100414,99586
4:5:1,0,-1,100415,99585
6:2:3,1,1,100414,99586
5:3:2,1,1,100413,99587
1:5:3,0,-1,100414,99586
3:1:5,0,-1,100415,99585
4:1:4,0,-1,100416,99584
2:3:6,1,1,100415,99585
6:6:2,1,1,100414,99586
1:6:1,0,-1,100415,99585
3:3:2,1,1,100414,99586
3:2:4,1,1,100413,99587
5:3:2,1,1,100412,99588
2:1:5,1,1,100411,99589
6:4:5,0,-1,100412,99588
1:4:1,0,-1,100413,99587
5:2:6,1,1,100412,99588
2:2:1,2,2,100410,99590
5:1:4,0,-1,100411,99589
6:3:4,0,-1,100412,99588
4:4:1,0,-1,100413,99587
2:3:4,1,1,100412,99588
6:6:1,0,-1,100413,99587
5:2:6,1,1,100412,99588
4:5:4,0,-1,100413,99587
6:5:6,0,-1,100414,99586
2:1:6,1,1,100413,99587
6:1:1,0,-1,100414,99586
4:6:6,0,-1,100415,99585
2:4:5,1,1,100414,99586
5:4:6,0,-1,100415,99585
5:1:3,0,-1,100416,99584
2:5:4,1,1,100415,99585
3:5:1,0,-1,100416,99584
3:4:2,1,1,100415,99585
6:6:5,0,-1,100416,99584
2:1:3,1,1,100415,99585
1:5:1,0,-1,100416,99584
6:2:6,1,1,100415,99585
2:1:5,1,1,100414,99586
2:1:2,2,2,100412,99588
3:3:5,0,-1,100413,99587
2:2:6,2,2,100411,99589
4:1:4,0,-1,100412,99588
1:5:5,0,-1,100413,99587
3:2:2,2,2,100411,99589
3:4:2,1,1,100410,99590
1:6:4,0,-1,100411,99589
1:4:6,0,-1,100412,99588
1:1:6,0,-1,100413,99587
3:6:1,0,-1,100414,99586
5:5:2,1,1,100413,99587
6:4:1,0,-1,100414,99586
4:3:6,0,-1,100415,99585
5:1:1,0,-1,100416,99584
2:1:5,1,1,100415,99585
3:4:5,0,-1,100416,99584
6:5:6,0,-1,100417,99583
2:2:6,2,2,100415,99585
5:5:5,0,-1,100416,99584
6:1:6,0,-1,100417,99583
1:1:3,0,-1,100418,99582
6:1:3,0,-1,100419,99581
4:6:1,0,-1,100420,99580
2:5:1,1,1,100419,99581
2:6:2,2,2,100417,99583
3:5:4,0,-1,100418,99582
3:2:6,1,1,100417,99583
4:1:2,1,1,100416,99584
2:6:5,1,1,100415,99585
6:3:2,1,1,100414,99586
2:1:6,1,1,100413,99587
5:1:4,0,-1,100414,99586
1:4:3,0,-1,100415,99585
4:4:3,0,-1,100416,99584
3:2:2,2,2,100414,99586
5:1:1,0,-1,100415,99585
2:6:2,2,2,100413,99587
5:4:3,0,-1,100414,99586
3:6:2,1,1,100413,99587
5:6:5,0,-1,100414,99586
1:4:4,0,-1,100415,99585
4:6:2,1,1,100414,99586
5:2:1,1,1,100413,99587
5:6:2,1,1,100412,99588
5:4:5,0,-1,100413,99587
4:4:1,0,-1,100414,99586
2:5:5,1,1,100413,99587
5:1:4,0,-1,100414,99586
4:4:2,1,1,100413,99587
2:2:6,2,2,100411,99589
5:3:6,0,-1,100412,99588
6:6:1,0,-1,100413,99587
1:5:2,1,1,100412,99588
5:5:4,0,-1,100413,99587
5:6:2,1,1,100412,99588
5:2:1,1,1,100411,99589
1:3:3,0,-1,100412,99588
6:4:6,0,-1,100413,99587
1:1:5,0,-1,100414,99586
6:1:2,1,1,100413,99587
1:2:1,1,1,100412,99588
4:6:6,0,-1,100413,99587
4:5:1,0,-1,100414,99586
5:1:5,0,-1,100415,99585
3:3:1,0,-1,100416,99584
3:2:3,1,1,100415,99585
6:1:5,0,-1,100416,99584
3:5:2,1,1,100415,99585
1:6:1,0,-1,100416,99584
4:4:1,0,-1,100417,99583
5:4:2,1,1,100416,99584
3:2:1,1,1,100415,99585
1:4:3,0,-1,100416,99584
3:2:1,1,1,100415,99585
5:1:1,0,-1,100416,99584
6:6:2,1,1,100415,99585
3:2:6,1,1,100414,99586
1:5:1,0,-1,100415,99585
6:6:1,0,-1,100416,99584
3:6:1,0,-1,100417,99583
3:5:5,0,-1,100418,99582
5:6:5,0,-1,100419,99581
2:2:4,2,2,100417,99583
3:1:6,0,-1,100418,99582
4:3:2,1,1,100417,99583
1:5:5,0,-1,100418,99582
2:4:2,2,2,100416,99584
5:2:2,2,2,100414,99586
3:1:2,1,1,100413,99587
6:6:2,1,1,100412,99588
4:3:3,0,-1,100413,99587
2:3:2,2,2,100411,99589
5:4:6,0,-1,100412,99588
5:1:2,1,1,100411,99589
6:3:6,0,-1,100412,99588
2:2:2,3,3,100409,99591
3:2:6,1,1,100408,99592
3:3:5,0,-1,100409,99591
2:6:3,1,1,100408,99592
3:1:3,0,-1,100409,99591
6:6:4,0,-1,100410,99590
6:5:3,0,-1,100411,99589
3:2:5,1,1,100410,99590
3:4:2,1,1,100409,99591
2:2:2,3,3,100406,99594
4:5:4,0,-1,100407,99593
3:5:6,0,-1,100408,99592
5:6:3,0,-1,100409,99591
4:2:3,1,1,100408,99592
6:5:1,0,-1,100409,99591
1:4:4,0,-1,100410,99590
6:2:5,1,1,100409,99591
4:4:5,0,-1,100410,99590
3:1:1,0,-1,100411,99589
4:6:6,0,-1,100412,99588
1:3:1,0,-1,100413,99587
3:1:6,0,-1,100414,99586
1:1:4,0,-1,100415,99585
4:5:3,0,-1,100416,99584
6:5:1,0,-1,100417,99583
2:4:5,1,1,100416,99584
5:4:5,0,-1,100417,99583
4:2:2,2,2,100415,99585
3:6:1,0,-1,100416,99584
2:6:1,1,1,100415,99585
5:5:1,0,-1,100416,99584
2:3:6,1,1,100415,99585
4:6:3,0,-1,100416,99584
1:1:6,0,-1,100417,99583
1:4:6,0,-1,100418,99582
6:2:6,1,1,100417,99583
6:3:3,0,-1,100418,99582
1:3:6,0,-1,100419,99581
5:2:4,1,1,100418,99582
5:2:4,1,1,100417,99583
5:2:6,1,1,100416,99584
5:6:4,0,-1,100417,99583
4:4:6,0,-1,100418,99582
1:2:2,2,2,100416,99584
4:1:1,0,-1,100417,99583
6:2:4,1,1,100416,99584
2:4:1,1,1,100415,99585
6:2:2,2,2,100413,99587
5:1:4,0,-1,100414,99586
5:1:2,1,1,100413,99587
5:3:2,1,1,100412,99588
4:2:5,1,1,100411,99589
3:3:5,0,-1,100412,99588
2:6:6,1,1,100411,99589
5:2:4,1,1,100410,99590
3:1:4,0,-1,100411,99589
6:5:5,0,-1,100412,99588
5:5:2,1,1,100411,99589
5:5:6,0,-1,100412,99588
2:5:4,1,1,100411,99589
6:3:6,0,-1,100412,99588
2:2:4,2,2,100410,99590
5:5:3,0,-1,100411,99589
5:1:6,0,-1,100412,99588
6:1:5,0,-1,100413,99587
1:4:5,0,-1,100414,99586
1:6:5,0,-1,100415,99585
2:3:5,1,1,100414,99586
6:6:3,0,-1,100415,99585
5:5:6,0,-1,100416,99584
1:1:2,1,1,100415,99585
4:4:2,1,1,100414,99586
3:3:1,0,-1,100415,99585
5:3:1,0,-1,100416,99584
4:6:3,0,-1,100417,99583
3:2:2,2,2,100415,99585
4:2:4,1,1,100414,99586
4:3:4,0,-1,100415,99585
6:1:6,0,-1,100416,99584
1:3:1,0,-1,100417,99583
6:5:6,0,-1,100418,99582
5:4:2,1,1,100417,99583
1:6:5,0,-1,100418,99582
1:5:6,0,-1,100419,99581
2:3:6,1,1,100418,99582
6:5:5,0,-1,100419,99581
3:4:5,0,-1,100420,99580
2:6:1,1,1,100419,99581
2:1:4,1,1,100418,99582
5:2:5,1,1,100417,99583
6:6:5,0,-1,100418,99582
4:2:3,1,1,100417,99583
3:6:1,0,-1,100418,99582
3:4:5,0,-1,100419,99581
1:4:4,0,-1,100420,99580
5:2:1,1,1,100419,99581
3:6:4,0,-1,100420,99580
3:1:4,0,-1,100421,99579
3:3:3,0,-1,100422,99578
1:5:2,1,1,100421,99579
6:3:4,0,-1,100422,99578
1:2:6,1,1,100421,99579
6:6:4,0,-1,100422,99578
2:5:6,1,1,100421,99579
4:4:3,0,-1,100422,99578
6:5:3,0,-1,100423,99577
3:6:6,0,-1,100424,99576
3:6:3,0,-1,100425,99575
1:6:3,0,-1,100426,99574
5:4:4,0,-1,100427,99573
3:6:4,0,-1,100428,99572
6:2:2,2,2,100426,99574
2:5:5,1,1,100425,99575
5:2:3,1,1,100424,99576
6:2:4,1,1,100423,99577
3:5:3,0,-1,100424,99576
6:1:2,1,1,100423,99577
2:1:3,1,1,100422,99578
5:6:2,1,1,100421,99579
6:4:4,0,-1,100422,99578
6:2:1,1,1,100421,99579
5:5:2,1,1,100420,99580
2:1:2,2,2,100418,99582
6:3:5,0,-1,100419,99581
2:5:3,1,1,100418,99582
1:5:6,0,-1,100419,99581
4:3:3,0,-1,100420,99580
5:4:6,0,-1,100421,99579
6:1:3,0,-1,100422,99578
4:5:6,0,-1,100423,99577
5:2:4,1,1,100422,99578
4:5:3,0,-1,100423,99577
1:3:5,0,-1,100424,99576
6:5:5,0,-1,100425,99575
6:5:6,0,-1,100426,99574
5:4:5,0,-1,100427,99573
4:6:1,0,-1,100428,99572
4:1:4,0,-1,100429,99571
6:4:1,0,-1,100430,99570
1:6:4,0,-1,100431,99569
5:5:5,0,-1,100432,99568
5:4:5,0,-1,100433,99567
6:3:1,0,-1,100434,99566
3:6:5,0,-1,100435,99565
5:5:4,0,-1,100436,99564
5:4:3,0,-1,100437,99563
4:6:2,1,1,100436,99564
6:4:4,0,-1,100437,99563
2:3:2,2,2,100435,99565
3:6:5,0,-1,100436,99564
3:6:2,1,1,100435,99565
6:5:5,0,-1,100436,99564
1:5:4,0,-1,100437,99563
6:3:5,0,-1,100438,99562
6:4:2,1,1,100437,99563
1:6:6,0,-1,100438,99562
1:4:2,1,1,100437,99563
5:1:6,0,-1,100438,99562
2:1:1,1,1,100437,99563
2:1:4,1,1,100436,99564
2:4:5,1,1,100435,99565
6:5:2,1,1,100434,99566
5:2:4,1,1,100433,99567
1:6:1,0,-1,100434,99566
1:5:4,0,-1,100435,99565
6:3:3,0,-1,100436,99564
3:6:2,1,1,100435,99565
5:1:4,0,-1,100436,99564
2:3:5,1,1,100435,99565
4:3:2,1,1,100434,99566
6:5:4,0,-1,100435,99565
3:3:5,0,-1,100436,99564
5:1:2,1,1,100435,99565
3:4:3,0,-1,100436,99564
1:5:5,0,-1,100437,99563
2:5:4,1,1,100436,99564
3:3:3,0,-1,100437,99563
4:3:6,0,-1,100438,99562
4:5:5,0,-1,100439,99561
2:1:5,1,1,100438,99562
2:6:4,1,1,100437,99563
5:1:4,0,-1,100438,99562
1:4:6,0,-1,100439,99561
1:5:3,0,-1,100440,99560
1:3:2,1,1,100439,99561
4:4:1,0,-1,100440,99560
4:5:2,1,1,100439,99561
5:4:2,1,1,100438,99562
1:5:3,0,-1,100439,99561
2:3:3,1,1,100438,99562
4:5:4,0,-1,100439,99561
2:1:3,1,1,100438,99562
5:5:2,1,1,100437,99563
2:6:2,2,2,100435,99565
6:4:4,0,-1,100436,99564
2:6:2,2,2,100434,99566
3:5:3,0,-1,100435,99565
4:3:3,0,-1,100436,99564
1:4:3,0,-1,100437,99563
5:3:2,1,1,100436,99564
6:1:4,0,-1,100437,99563
5:1:1,0,-1,100438,99562
5:1:3,0,-1,100439,99561
6:3:3,0,-1,100440,99560
3:6:1,0,-1,100441,99559
6:3:5,0,-1,100442,99558
6:2:2,2,2,100440,99560
6:5:2,1,1,100439,99561
3:1:1,0,-1,100440,99560
2:4:2,2,2,100438,99562
4:1:6,0,-1,100439,99561
5:5:6,0,-1,100440,99560
6:3:1,0,-1,100441,99559
3:1:4,0,-1,100442,99558
5:6:5,0,-1,100443,99557
6:4:6,0,-1,100444,99556
4:3:1,0,-1,100445,99555
6:4:2,1,1,100444,99556
1:1:3,0,-1,100445,99555
3:2:2,2,2,100443,99557
3:1:2,1,1,100442,99558
6:2:6,1,1,100441,99559
3:2:6,1,1,100440,99560
5:3:2,1,1,100439,99561
2:6:3,1,1,100438,99562
1:6:5,0,-1,100439,99561
5:3:2,1,1,100438,99562
4:4:3,0,-1,100439,99561
3:2:3,1,1,100438,99562
3:3:4,0,-1,100439,99561
2:2:2,3,3,100436,99564
3:2:3,1,1,100435,99565
5:2:2,2,2,100433,99567
4:6:6,0,-1,100434,99566
1:4:5,0,-1,100435,99565
1:3:6,0,-1,100436,99564
3:6:1,0,-1,100437,99563
3:4:4,0,-1,100438,99562
6:4:2,1,1,100437,99563
6:3:2,1,1,100436,99564
2:5:1,1,1,100435,99565
3:6:4,0,-1,100436,99564
3:2:1,1,1,100435,99565
2:5:3,1,1,100434,99566
6:6:3,0,-1,100435,99565
6:4:5,0,-1,100436,99564
3:1:1,0,-1,100437,99563
3:1:4,0,-1,100438,99562
5:6:3,0,-1,100439,99561
4:1:5,0,-1,100440,99560
5:4:3,0,-1,100441,99559
4:3:3,0,-1,100442,99558
2:1:4,1,1,100441,99559
4:4:5,0,-1,100442,99558
3:4:2,1,1,100441,99559
5:2:1,1,1,100440,99560
5:2:5,1,1,100439,99561
3:5:3,0,-1,100440,99560
5:2:5,1,1,100439,99561
6:4:1,0,-1,100440,99560
3:1:4,0,-1,100441,99559
3:4:4,0,-1,100442,99558
3:3:4,0,-1,100443,99557
3:4:2,1,1,100442,99558
6:6:2,1,1,100441,99559
1:1:1,0,-1,100442,99558
1:3:1,0,-1,100443,99557
3:1:2,1,1,100442,99558
6:5:4,0,-1,100443,99557
4:2:4,1,1,100442,99558
1:2:4,1,1,100441,99559
3:2:2,2,2,100439,99561
6:3:6,0,-1,100440,99560
3:5:4,0,-1,100441,99559
1:2:5,1,1,100440,99560
2:4:1,1,1,100439,99561
1:4:1,0,-1,100440,99560
6:2:5,1,1,100439,99561
5:4:3,0,-1,100440,99560
3:1:2,1,1,100439,99561
6:1:1,0,-1,100440,99560
2:5:1,1,1,100439,99561
5:3:2,1,1,100438,99562
1:4:6,0,-1,100439,99561
2:5:4,1,1,100438,99562
5:2:2,2,2,100436,99564
4:3:3,0,-1,100437,99563
6:4:3,0,-1,100438,99562
1:4:4,0,-1,100439,99561
6:2:5,1,1,100438,99562
4:4:4,0,-1,100439,99561
1:4:1,0,-1,100440,99560
2:5:1,1,1,100439,99561
1:6:6,0,-1,100440,99560
5:6:1,0,-1,100441,99559
3:4:3,0,-1,100442,99558
6:2:6,1,1,100441,99559
3:5:4,0,-1,100442,99558
2:3:6,1,1,100441,99559
4:2:4,1,1,100440,99560
2:2:5,2,2,100438,99562
4:3:2,1,1,100437,99563
6:5:3,0,-1,100438,99562
4:6:5,0,-1,100439,99561
1:6:6,0,-1,100440,99560
2:1:3,1,1,100439,99561
2:6:3,1,1,100438,99562
3:3:3,0,-1,100439,99561
6:3:4,0,-1,100440,99560
1:6:4,0,-1,100441,99559
5:6:1,0,-1,100442,99558
5:3:4,0,-1,100443,99557
6:2:4,1,1,100442,99558
1:6:3,0,-1,100443,99557
5:4:1,0,-1,100444,99556
6:5:4,0,-1,100445,99555
4:1:4,0,-1,100446,99554
1:5:4,0,-1,100447,99553
3:1:1,0,-1,100448,99552
5:2:1,1,1,100447,99553
3:2:6,1,1,100446,99554
4:5:5,0,-1,100447,99553
2:5:2,2,2,100445,99555
5:4:3,0,-1,100446,99554
5:3:5,0,-1,100447,99553
3:2:4,1,1,100446,99554
1:6:6,0,-1,100447,99553
5:2:4,1,1,100446,99554
6:5:2,1,1,100445,99555
1:1:6,0,-1,100446,99554
5:3:5,0,-1,100447,99553
3:5:3,0,-1,100448,99552
1:1:3,0,-1,100449,99551
5:4:1,0,-1,100450,99550
2:4:2,2,2,100448,99552
2:4:2,2,2,100446,99554
5:3:2,1,1,100445,99555
5:5:3,0,-1,100446,99554
1:2:2,2,2,100444,99556
2:4:3,1,1,100443,99557
2:4:5,1,1,100442,99558
4:2:6,1,1,100441,99559
3:4:3,0,-1,100442,99558
5:3:5,0,-1,100443,99557
3:1:3,0,-1,100444,99556
3:2:3,1,1,100443,99557
3:1:3,0,-1,100444,99556
3:2:5,1,1,100443,99557
3:4:4,0,-1,100444,99556
5:6:2,1,1,100443,99557
4:2:5,1,1,100442,99558
2:2:1,2,2,100440,99560
2:3:3,1,1,100439,99561
1:3:6,0,-1,100440,99560
4:1:5,0,-1,100441,99559
4:6:4,0,-1,100442,99558
1:2:2,2,2,100440,99560
4:6:4,0,-1,100441,99559
3:6:5,0,-1,100442,99558
1:6:4,0,-1,100443,99557
5:6:2,1,1,100442,99558
5:2:2,2,2,100440,99560
1:5:6,0,-1,100441,99559
1:6:4,0,-1,100442,99558
3:3:3,0,-1,100443,99557
3:5:4,0,-1,100444,99556
1:3:2,1,1,100443,99557
4:4:5,0,-1,100444,99556
5:4:2,1,1,100443,99557
3:2:4,1,1,100442,99558
2:6:6,1,1,100441,99559
6:3:2,1,1,100440,99560
5:5:1,0,-1,100441,99559
4:4:3,0,-1,100442,99558
1:2:3,1,1,100441,99559
2:1:3,1,1,100440,99560
1:6:2,1,1,100439,99561
1:4:6,0,-1,100440,99560
2:2:5,2,2,100438,99562
2:5:1,1,1,100437,99563
3:2:5,1,1,100436,99564
3:4:5,0,-1,100437,99563
4:5:6,0,-1,100438,99562
6:1:3,0,-1,100439,99561
2:2:4,2,2,100437,99563
3:6:6,0,-1,100438,99562
1:4:1,0,-1,100439,99561
2:6:3,1,1,100438,99562
3:5:5,0,-1,100439,99561
6:5:6,0,-1,100440,99560
3:3:3,0,-1,100441,99559
1:4:4,0,-1,100442,99558
1:6:5,0,-1,100443,99557
6:6:6,0,-1,100444,99556
6:2:6,1,1,100443,99557
2:2:2,3,3,100440,99560
3:3:1,0,-1,100441,99559
1:4:3,0,-1,100442,99558
2:6:4,1,1,100441,99559
6:5:6,0,-1,100442,99558
3:6:5,0,-1,100443,99557
2:2:2,3,3,100440,99560
2:4:2,2,2,100438,99562
3:2:2,2,2,100436,99564
1:1:1,0,-1,100437,99563
3:3:2,1,1,100436,99564
5:2:4,1,1,100435,99565
5:2:3,1,1,100434,99566
2:4:2,2,2,100432,99568
5:5:2,1,1,100431,99569
6:3:6,0,-1,100432,99568
2:2:5,2,2,100430,99570
5:5:4,0,-1,100431,99569
2:6:1,1,1,100430,99570
3:5:5,0,-1,100431,99569
3:2:1,1,1,100430,99570
4:4:1,0,-1,100431,99569
5:1:2,1,1,100430,99570
5:5:2,1,1,100429,99571
6:3:6,0,-1,100430,99570
1:4:5,0,-1,100431,99569
1:1:6,0,-1,100432,99568
6:2:5,1,1,100431,99569
4:4:1,0,-1,100432,99568
2:6:4,1,1,100431,99569
2:2:1,2,2,100429,99571
1:6:4,0,-1,100430,99570
6:2:5,1,1,100429,99571
3:4:2,1,1,100428,99572
2:4:1,1,1,100427,99573
4:1:4,0,-1,100428,99572
5:2:4,1,1,100427,99573
2:1:3,1,1,100426,99574
3:3:4,0,-1,100427,99573
1:3:6,0,-1,100428,99572
4:1:6,0,-1,100429,99571
2:5:2,2,2,100427,99573
5:6:6,0,-1,100428,99572
5:5:3,0,-1,100429,99571
2:5:3,1,1,100428,99572
1:2:5,1,1,100427,99573
6:5:6,0,-1,100428,99572
5:2:2,2,2,100426,99574
1:5:5,0,-1,100427,99573
3:3:1,0,-1,100428,99572
1:5:4,0,-1,100429,99571
5:5:2,1,1,100428,99572
5:3:6,0,-1,100429,99571
6:6:1,0,-1,100430,99570
4:4:3,0,-1,100431,99569
5:1:4,0,-1,100432,99568
6:4:4,0,-1,100433,99567
5:2:1,1,1,100432,99568
5:4:4,0,-1,100433,99567
4:6:1,0,-1,100434,99566
5:3:2,1,1,100433,99567
3:3:5,0,-1,100434,99566
1:6:5,0,-1,100435,99565
3:3:5,0,-1,100436,99564
3:3:3,0,-1,100437,99563
4:3:3,0,-1,100438,99562
1:3:2,1,1,100437,99563
3:6:3,0,-1,100438,99562
2:4:1,1,1,100437,99563
2:4:3,1,1,100436,99564
4:1:6,0,-1,100437,99563
4:2:2,2,2,100435,99565
6:5:2,1,1,100434,99566
4:6:1,0,-1,100435,99565
4:3:4,0,-1,100436,99564
4:1:2,1,1,100435,99565
3:1:1,0,-1,100436,99564
2:4:4,1,1,100435,99565
4:6:3,0,-1,100436,99564
4:1:5,0,-1,100437,99563
1:1:6,0,-1,100438,99562
5:4:2,1,1,100437,99563
5:4:6,0,-1,100438,99562
5:4:3,0,-1,100439,99561
6:3:2,1,1,100438,99562
6:1:3,0,-1,100439,99561
2:1:3,1,1,100438,99562
4:5:2,1,1,100437,99563
4:2:1,1,1,100436,99564
3:6:1,0,-1,100437,99563
2:6:1,1,1,100436,99564
2:2:5,2,2,100434,99566
4:2:2,2,2,100432,99568
6:3:3,0,-1,100433,99567
6:5:3,0,-1,100434,99566
2:1:5,1,1,100433,99567
1:5:2,1,1,100432,99568
2:3:3,1,1,100431,99569
3:1:4,0,-1,100432,99568
4:4:5,0,-1,100433,99567
3:1:4,0,-1,100434,99566
6:2:1,1,1,100433,99567
1:3:1,0,-1,100434,99566
5:2:5,1,1,100433,99567
1:2:4,1,1,100432,99568
1:1:5,0,-1,100433,99567
4:6:5,0,-1,100434,99566
3:5:3,0,-1,100435,99565
1:5:1,0,-1,100436,99564
2:1:4,1,1,100435,99565
3:6:1,0,-1,100436,99564
1:5:1,0,-1,100437,99563
1:5:4,0,-1,100438,99562
4:6:3,0,-1,100439,99561
2:5:2,2,2,100437,99563
3:2:2,2,2,100435,99565
5:2:2,2,2,100433,99567
1:6:2,1,1,100432,99568
3:4:3,0,-1,100433,99567
1:6:2,1,1,100432,99568
6:2:5,1,1,100431,99569
4:4:1,0,-1,100432,99568
4:1:1,0,-1,100433,99567
4:4:5,0,-1,100434,99566
3:2:6,1,1,100433,99567
1:5:3,0,-1,100434,99566
1:1:1,0,-1,100435,99565
4:5:3,0,-1,100436,99564
6:5:3,0,-1,100437,99563
3:2:6,1,1,100436,99564
6:2:1,1,1,100435,99565
4:4:5,0,-1,100436,99564
2:3:1,1,1,100435,99565
6:3:6,0,-1,100436,99564
2:5:4,1,1,100435,99565
4:2:4,1,1,100434,99566
1:4:4,0,-1,100435,99565
6:6:6,0,-1,100436,99564
4:6:6,0,-1,100437,99563
3:4:2,1,1,100436,99564
6:6:4,0,-1,100437,99563
4:1:3,0,-1,100438,99562
6:4:1,0,-1,100439,99561
6:3:3,0,-1,100440,99560
6:5:4,0,-1,100441,99559
2:4:3,1,1,100440,99560
3:5:2,1,1,100439,99561
3:3:2,1,1,100438,99562
4:6:4,0,-1,100439,99561
4:2:1,1,1,100438,99562
1:1:6,0,-1,100439,99561
5:6:2,1,1,100438,99562
1:5:5,0,-1,100439,99561
1:1:3,0,-1,100440,99560
2:2:1,2,2,100438,99562
1:5:2,1,1,100437,99563
3:4:4,0,-1,100438,99562
1:1:4,0,-1,100439,99561
3:1:4,0,-1,100440,99560
3:6:5,0,-1,100441,99559
6:4:2,1,1,100440,99560
1:2:2,2,2,100438,99562
6:6:1,0,-1,100439,99561
1:5:2,1,1,100438,99562
3:2:2,2,2,100436,99564
4:4:4,0,-1,100437,99563
2:5:6,1,1,100436,99564
3:5:6,0,-1,100437,99563
5:2:2,2,2,100435,99565
3:6:3,0,-1,100436,99564
6:1:5,0,-1,100437,99563
3:6:3,0,-1,100438,99562
4:3:5,0,-1,100439,99561
3:1:1,0,-1,100440,99560
3:4:1,0,-1,100441,99559
5:5:4,0,-1,100442,99558
1:2:3,1,1,100441,99559
6:6:2,1,1,100440,99560
1:3:3,0,-1,100441,99559
5:4:1,0,-1,100442,99558
2:1:6,1,1,100441,99559
4:6:6,0,-1,100442,99558
4:3:2,1,1,100441,99559
4:3:3,0,-1,100442,99558
2:1:1,1,1,100441,99559
1:5:6,0,-1,100442,99558
6:5:6,0,-1,100443,99557
2:1:3,1,1,100442,99558
5:1:1,0,-1,100443,99557
4:5:4,0,-1,100444,99556
6:5:5,0,-1,100445,99555
1:1:4,0,-1,100446,99554
2:4:1,1,1,100445,99555
4:6:2,1,1,100444,99556
1:4:2,1,1,100443,99557
3:1:5,0,-1,100444,99556
1:4:2,1,1,100443,99557
1:6:4,0,-1,100444,99556
3:1:2,1,1,100443,99557
5:3:3,0,-1,100444,99556
3:2:2,2,2,100442,99558
5:3:6,0,-1,100443,99557
1:2:4,1,1,100442,99558
2:5:1,1,1,100441,99559
1:2:2,2,2,100439,99561
4:6:4,0,-1,100440,99560
3:4:1,0,-1,100441,99559
1:3:4,0,-1,100442,99558
2:6:5,1,1,100441,99559
4:1:1,0,-1,100442,99558
4:2:3,1,1,100441,99559
6:4:4,0,-1,100442,99558
6:5:4,0,-1,100443,99557
6:1:5,0,-1,100444,99556
4:4:4,0,-1,100445,99555
6:3:2,1,1,100444,99556
4:2:5,1,1,100443,99557
4:5:6,0,-1,100444,99556
1:3:2,1,1,100443,99557
5:2:2,2,2,100441,99559
4:1:2,1,1,100440,99560
6:4:2,1,1,100439,99561
2:2:4,2,2,100437,99563
4:4:1,0,-1,100438,99562
5:3:4,0,-1,100439,99561
3:5:4,0,-1,100440,99560
4:4:5,0,-1,100441,99559
4:4:6,0,-1,100442,99558
2:3:4,1,1,100441,99559
2:2:4,2,2,100439,99561
4:4:3,0,-1,100440,99560
5:5:3,0,-1,100441,99559
5:6:1,0,-1,100442,99558
5:6:6,0,-1,100443,99557
5:2:3,1,1,100442,99558
6:1:6,0,-1,100443,99557
4:1:3,0,-1,100444,99556
2:4:5,1,1,100443,99557
3:3:4,0,-1,100444,99556
2:2:2,3,3,100441,99559
6:2:4,1,1,100440,99560
6:2:2,2,2,100438,99562
4:6:2,1,1,100437,99563
6:6:6,0,-1,100438,99562
2:3:6,1,1,100437,99563
1:6:4,0,-1,100438,99562
4:5:5,0,-1,100439,99561
4:2:5,1,1,100438,99562
5:2:6,1,1,100437,99563
1:3:4,0,-1,100438,99562
3:2:3,1,1,100437,99563
1:3:5,0,-1,100438,99562
6:2:1,1,1,100437,99563
6:5:4,0,-1,100438,99562
4:2:1,1,1,100437,99563
5:3:5,0,-1,100438,99562
1:1:3,0,-1,100439,99561
1:1:1,0,-1,100440,99560
3:2:2,2,2,100438,99562
1:1:6,0,-1,100439,99561
3:5:1,0,-1,100440,99560
4:5:1,0,-1,100441,99559
1:3:4,0,-1,100442,99558
5:4:3,0,-1,100443,99557
1:2:4,1,1,100442,99558
3:3:3,0,-1,100443,99557
4:5:1,0,-1,100444,99556
4:4:2,1,1,100443,99557
5:6:2,1,1,100442,99558
5:1:5,0,-1,100443,99557
6:3:5,0,-1,100444,99556
4:2:1,1,1,100443,99557
4:4:3,0,-1,100444,99556
4:6:3,0,-1,100445,99555
5:5:2,1,1,100444,99556
5:2:4,1,1,100443,99557
6:2:3,1,1,100442,99558
2:6:6,1,1,100441,99559
4:3:6,0,-1,100442,99558
1:1:2,1,1,100441,99559
6:4:5,0,-1,100442,99558
6:1:5,0,-1,100443,99557
2:1:3,1,1,100442,99558
1:6:4,0,-1,100443,99557
2:3:2,2,2,100441,99559
1:6:6,0,-1,100442,99558
4:2:4,1,1,100441,99559
5:4:5,0,-1,100442,99558
5:5:6,0,-1,100443,99557
4:1:2,1,1,100442,99558
5:5:5,0,-1,100443,99557
3:1:5,0,-1,100444,99556
5:5:4,0,-1,100445,99555
4:1:4,0,-1,100446,99554
1:6:1,0,-1,100447,99553
2:2:5,2,2,100445,99555
3:2:6,1,1,100444,99556
2:6:6,1,1,100443,99557
6:2:6,1,1,100442,99558
1:3:3,0,-1,100443,99557
6:3:2,1,1,100442,99558
3:4:5,0,-1,100443,99557
3:1:4,0,-1,100444,99556
3:3:2,1,1,100443,99557
1:1:2,1,1,100442,99558
4:2:4,1,1,100441,99559
5:1:3,0,-1,100442,99558
3:2:4,1,1,100441,99559
5:4:2,1,1,100440,99560
2:5:3,1,1,100439,99561
3:3:6,0,-1,100440,99560
4:6:3,0,-1,100441,99559
6:4:1,0,-1,100442,99558
3:2:5,1,1,100441,99559
1:4:6,0,-1,100442,99558
6:4:6,0,-1,100443,99557
2:2:6,2,2,100441,99559
1:3:4,0,-1,100442,99558
6:3:5,0,-1,100443,99557
3:4:6,0,-1,100444,99556
5:1:4,0,-1,100445,99555
3:2:2,2,2,100443,99557
6:2:1,1,1,100442,99558
2:3:3,1,1,100441,99559
3:1:4,0,-1,100442,99558
1:3:6,0,-1,100443,99557
1:6:5,0,-1,100444,99556
2:2:5,2,2,100442,99558
4:6:2,1,1,100441,99559
3:4:4,0,-1,100442,99558
6:5:5,0,-1,100443,99557
2:3:6,1,1,100442,99558
4:1:6,0,-1,100443,99557
5:4:5,0,-1,100444,99556
3:1:5,0,-1,100445,99555
1:1:4,0,-1,100446,99554
2:6:4,1,1,100445,99555
3:5:2,1,1,100444,99556
2:5:4,1,1,100443,99557
2:1:6,1,1,100442,99558
4:5:4,0,-1,100443,99557
6:3:1,0,-1,100444,99556
1:4:3,0,-1,100445,99555
1:6:1,0,-1,100446,99554
2:5:3,1,1,100445,99555
4:1:2,1,1,100444,99556
2:5:2,2,2,100442,99558
6:5:2,1,1,100441,99559
1:2:4,1,1,100440,99560
5:5:6,0,-1,100441,99559
5:4:1,0,-1,100442,99558
4:2:6,1,1,100441,99559
2:2:4,2,2,100439,99561
3:3:6,0,-1,100440,99560
2:3:2,2,2,100438,99562
5:2:4,1,1,100437,99563
4:5:2,1,1,100436,99564
3:1:2,1,1,100435,99565
4:4:4,0,-1,100436,99564
1:2:1,1,1,100435,99565
1:5:6,0,-1,100436,99564
4:1:4,0,-1,100437,99563
4:1:6,0,-1,100438,99562
6:5:3,0,-1,100439,99561
6:1:4,0,-1,100440,99560
3:6:5,0,-1,100441,99559
5:2:4,1,1,100440,99560
6:4:2,1,1,100439,99561
2:1:5,1,1,100438,99562
2:3:1,1,1,100437,99563
4:5:5,0,-1,100438,99562
2:3:1,1,1,100437,99563
3:5:5,0,-1,100438,99562
5:6:6,0,-1,100439,99561
6:3:5,0,-1,100440,99560
2:3:6,1,1,100439,99561
4:1:1,0,-1,100440,99560
1:6:5,0,-1,100441,99559
5:5:5,0,-1,100442,99558
1:4:3,0,-1,100443,99557
2:4:4,1,1,100442,99558
6:2:3,1,1,100441,99559
5:2:5,1,1,100440,99560
3:5:2,1,1,100439,99561
2:3:1,1,1,100438,99562
4:5:4,0,-1,100439,99561
6:1:4,0,-1,100440,99560
2:4:2,2,2,100438,99562
3:1:2,1,1,100437,99563
6:1:1,0,-1,100438,99562
5:4:4,0,-1,100439,99561
4:1:4,0,-1,100440,99560
6:2:6,1,1,100439,99561
4:4:1,0,-1,100440,99560
4:4:5,0,-1,100441,99559
6:3:1,0,-1,100442,99558
4:6:6,0,-1,100443,99557
2:2:1,2,2,100441,99559
1:1:3,0,-1,100442,99558
5:3:1,0,-1,100443,99557
3:6:1,0,-1,100444,99556
5:1:5,0,-1,100445,99555
4:1:4,0,-1,100446,99554
6:4:6,0,-1,100447,99553
1:5:6,0,-1,100448,99552
4:4:5,0,-1,100449,99551
5:5:5,0,-1,100450,99550
4:4:5,0,-1,100451,99549
3:2:2,2,2,100449,99551
4:3:6,0,-1,100450,99550
2:5:6,1,1,100449,99551
4:5:5,0,-1,100450,99550
2:4:2,2,2,100448,99552
1:2:6,1,1,100447,99553
1:6:5,0,-1,100448,99552
1:1:6,0,-1,100449,99551
6:5:1,0,-1,100450,99550
4:5:1,0,-1,100451,99549
4:5:3,0,-1,100452,99548
2:5:3,1,1,100451,99549
1:5:1,0,-1,100452,99548
3:2:5,1,1,100451,99549
6:4:1,0,-1,100452,99548
2:5:1,1,1,100451,99549
1:4:1,0,-1,100452,99548
4:3:6,0,-1,100453,99547
4:5:5,0,-1,100454,99546
1:1:5,0,-1,100455,99545
5:6:1,0,-1,100456,99544
4:5:2,1,1,100455,99545
3:5:3,0,-1,100456,99544
5:3:3,0,-1,100457,99543
2:4:1,1,1,100456,99544
4:1:2,1,1,100455,99545
6:2:6,1,1,100454,99546
3:6:4,0,-1,100455,99545
2:5:2,2,2,100453,99547
2:5:6,1,1,100452,99548
5:1:6,0,-1,100453,99547
2:4:3,1,1,100452,99548
4:1:3,0,-1,100453,99547
2:4:5,1,1,100452,99548
5:4:3,0,-1,100453,99547
3:1:4,0,-1,100454,99546
5:5:4,0,-1,100455,99545
6:1:2,1,1,100454,99546
6:2:5,1,1,100453,99547
1:5:2,1,1,100452,99548
6:6:2,1,1,100451,99549
6:5:3,0,-1,100452,99548
6:1:4,0,-1,100453,99547
4:4:1,0,-1,100454,99546
3:4:5,0,-1,100455,99545
5:1:6,0,-1,100456,99544
4:2:2,2,2,100454,99546
3:4:5,0,-1,100455,99545
2:3:1,1,1,100454,99546
5:4:5,0,-1,100455,99545
4:1:3,0,-1,100456,99544
1:6:6,0,-1,100457,99543
5:4:3,0,-1,100458,99542
5:4:3,0,-1,100459,99541
2:6:2,2,2,100457,99543
3:3:5,0,-1,100458,99542
1:1:6,0,-1,100459,99541
1:2:4,1,1,100458,99542
1:2:5,1,1,100457,99543
1:4:1,0,-1,100458,99542
5:5:1,0,-1,100459,99541
4:4:5,0,-1,100460,99540
5:2:4,1,1,100459,99541
1:1:2,1,1,100458,99542
3:3:4,0,-1,100459,99541
1:4:4,0,-1,100460,99540
5:3:5,0,-1,100461,99539
5:2:4,1,1,100460,99540
4:1:5,0,-1,100461,99539
1:3:5,0,-1,100462,99538
6:3:1,0,-1,100463,99537
2:4:2,2,2,100461,99539
5:4:2,1,1,100460,99540
5:4:6,0,-1,100461,99539
1:2:3,1,1,100460,99540
2:4:3,1,1,100459,99541
4:6:4,0,-1,100460,99540
4:6:1,0,-1,100461,99539
5:6:3,0,-1,100462,99538
5:1:5,0,-1,100463,99537
3:1:4,0,-1,100464,99536
3:6:5,0,-1,100465,99535
5:6:2,1,1,100464,99536
3:5:4,0,-1,100465,99535
3:2:4,1,1,100464,99536
2:4:6,1,1,100463,99537
1:6:3,0,-1,100464,99536
4:5:5,0,-1,100465,99535
4:1:2,1,1,100464,99536
1:3:5,0,-1,100465,99535
1:4:1,0,-1,100466,99534
3:5:4,0,-1,100467,99533
6:2:5,1,1,100466,99534
5:5:2,1,1,100465,99535
3:4:6,0,-1,100466,99534
6:2:5,1,1,100465,99535
3:5:5,0,-1,100466,99534
3:2:4,1,1,100465,99535
4:1:3,0,-1,100466,99534
5:4:3,0,-1,100467,99533
2:1:1,1,1,100466,99534
3:3:3,0,-1,100467,99533
3:6:6,0,-1,100468,99532
1:1:2,1,1,100467,99533
5:4:3,0,-1,100468,99532
2:1:5,1,1,100467,99533
6:3:3,0,-1,100468,99532
6:3:5,0,-1,100469,99531
3:3:1,0,-1,100470,99530
6:5:6,0,-1,100471,99529
3:1:5,0,-1,100472,99528
3:5:4,0,-1,100473,99527
6:6:4,0,-1,100474,99526
2:6:6,1,1,100473,99527
4:4:1,0,-1,100474,99526
1:2:5,1,1,100473,99527
1:2:6,1,1,100472,99528
3:5:4,0,-1,100473,99527
3:2:2,2,2,100471,99529
5:6:6,0,-1,100472,99528
4:2:3,1,1,100471,99529
2:3:4,1,1,100470,99530
6:2:1,1,1,100469,99531
1:1:6,0,-1,100470,99530
2:4:1,1,1,100469,99531
3:6:6,0,-1,100470,99530
5:5:3,0,-1,100471,99529
3:4:3,0,-1,100472,99528
1:5:3,0,-1,100473,99527
4:2:3,1,1,100472,99528
3:3:3,0,-1,100473,99527
4:1:4,0,-1,100474,99526
2:2:4,2,2,100472,99528
1:2:1,1,1,100471,99529
2:6:2,2,2,100469,99531
1:1:1,0,-1,100470,99530
4:5:5,0,-1,100471,99529
1:3:6,0,-1,100472,99528
1:3:6,0,-1,100473,99527
4:5:6,0,-1,100474,99526
4:6:3,0,-1,100475,99525
1:3:6,0,-1,100476,99524
2:1:4,1,1,100475,99525
6:6:4,0,-1,100476,99524
2:6:2,2,2,100474,99526
3:3:4,0,-1,100475,99525
4:4:6,0,-1,100476,99524
6:6:1,0,-1,100477,99523
6:4:5,0,-1,100478,99522
1:4:1,0,-1,100479,99521
4:6:2,1,1,100478,99522
3:1:5,0,-1,100479,99521
2:3:1,1,1,100478,99522
2:2:3,2,2,100476,99524
2:6:3,1,1,100475,99525
4:3:6,0,-1,100476,99524
5:6:6,0,-1,100477,99523
2:4:3,1,1,100476,99524
2:5:2,2,2,100474,99526
4:1:5,0,-1,100475,99525
6:5:5,0,-1,100476,99524
2:2:2,3,3,100473,99527
2:5:1,1,1,100472,99528
3:4:2,1,1,100471,99529
3:2:4,1,1,100470,99530
3:6:6,0,-1,100471,99529
4:5:1,0,-1,100472,99528
1:2:2,2,2,100470,99530
4:2:4,1,1,100469,99531
5:1:1,0,-1,100470,99530
2:4:1,1,1,100469,99531
3:5:1,0,-1,100470,99530
3:4:6,0,-1,100471,99529
2:2:5,2,2,100469,99531
1:6:3,0,-1,100470,99530
5:3:5,0,-1,100471,99529
5:6:2,1,1,100470,99530
6:1:3,0,-1,100471,99529
4:5:2,1,1,100470,99530
1:1:4,0,-1,100471,99529
1:5:4,0,-1,100472,99528
3:2:1,1,1,100471,99529
2:2:4,2,2,100469,99531
4:4:5,0,-1,100470,99530
2:5:2,2,2,100468,99532
2:4:5,1,1,100467,99533
3:3:6,0,-1,100468,99532
5:1:1,0,-1,100469,99531
2:2:1,2,2,100467,99533
3:1:1,0,-1,100468,99532
5:3:5,0,-1,100469,99531
3:5:4,0,-1,100470,99530
3:6:2,1,1,100469,99531
2:3:1,1,1,100468,99532
6:6:6,0,-1,100469,99531
2:5:3,1,1,100468,99532
3:6:1,0,-1,100469,99531
1:6:3,0,-1,100470,99530
6:2:2,2,2,100468,99532
6:1:1,0,-1,100469,99531
6:1:1,0,-1,100470,99530
6:5:2,1,1,100469,99531
2:3:6,1,1,100468,99532
5:1:4,0,-1,100469,99531
1:2:5,1,1,100468,99532
2:2:4,2,2,100466,99534
4:4:1,0,-1,100467,99533
6:1:3,0,-1,100468,99532
2:3:2,2,2,100466,99534
5:2:3,1,1,100465,99535
5:1:6,0,-1,100466,99534
3:2:6,1,1,100465,99535
6:6:4,0,-1,100466,99534
5:6:2,1,1,100465,99535
1:6:3,0,-1,100466,99534
1:1:6,0,-1,100467,99533
2:2:1,2,2,100465,99535
2:5:3,1,1,100464,99536
1:5:1,0,-1,100465,99535
2:4:1,1,1,100464,99536
1:2:6,1,1,100463,99537
6:2:2,2,2,100461,99539
6:5:6,0,-1,100462,99538
2:1:3,1,1,100461,99539
5:5:6,0,-1,100462,99538
1:6:5,0,-1,100463,99537
2:1:6,1,1,100462,99538
6:6:3,0,-1,100463,99537
5:1:6,0,-1,100464,99536
2:2:4,2,2,100462,99538
3:4:2,1,1,100461,99539
1:6:2,1,1,100460,99540
3:6:5,0,-1,100461,99539
4:6:1,0,-1,100462,99538
1:3:4,0,-1,100463,99537
6:5:2,1,1,100462,99538
5:1:4,0,-1,100463,99537
5:1:5,0,-1,100464,99536
1:2:3,1,1,100463,99537
4:3:1,0,-1,100464,99536
2:1:3,1,1,100463,99537
6:3:4,0,-1,100464,99536
3:1:5,0,-1,100465,99535
4:1:4,0,-1,100466,99534
3:4:6,0,-1,100467,99533
6:1:4,0,-1,100468,99532
6:2:1,1,1,100467,99533
3:1:3,0,-1,100468,99532
6:6:4,0,-1,100469,99531
3:6:4,0,-1,100470,99530
3:2:5,1,1,100469,99531
1:6:1,0,-1,100470,99530
2:6:3,1,1,100469,99531
3:2:5,1,1,100468,99532
5:2:4,1,1,100467,99533
6:3:2,1,1,100466,99534
2:4:4,1,1,100465,99535
6:2:1,1,1,100464,99536
2:5:2,2,2,100462,99538
1:5:4,0,-1,100463,99537
3:4:2,1,1,100462,99538
6:1:3,0,-1,100463,99537
6:1:2,1,1,100462,99538
5:4:1,0,-1,100463,99537
6:2:5,1,1,100462,99538
5:5:5,0,-1,100463,99537
2:6:3,1,1,100462,99538
6:1:1,0,-1,100463,99537
3:4:1,0,-1,100464,99536
5:6:3,0,-1,100465,99535
4:2:1,1,1,100464,99536
4:3:5,0,-1,100465,99535
3:6:3,0,-1,100466,99534
5:4:1,0,-1,100467,99533
4:2:4,1,1,100466,99534
5:6:4,0,-1,100467,99533
4:3:1,0,-1,100468,99532
4:2:1,1,1,100467,99533
5:5:2,1,1,100466,99534
4:6:5,0,-1,100467,99533
3:3:3,0,-1,100468,99532
6:5:1,0,-1,100469,99531
3:1:5,0,-1,100470,99530
4:4:4,0,-1,100471,99529
5:3:3,0,-1,100472,99528
3:4:4,0,-1,100473,99527
1:3:4,0,-1,100474,99526
6:5:4,0,-1,100475,99525
6:6:4,0,-1,100476,99524
5:2:1,1,1,100475,99525
5:5:2,1,1,100474,99526
4:2:3,1,1,100473,99527
2:1:1,1,1,100472,99528
4:3:4,0,-1,100473,99527
1:3:3,0,-1,100474,99526
5:5:4,0,-1,100475,99525
1:5:5,0,-1,100476,99524
1:6:1,0,-1,100477,99523
1:5:5,0,-1,100478,99522
4:4:2,1,1,100477,99523
3:4:3,0,-1,100478,99522
5:4:2,1,1,100477,99523
5:2:1,1,1,100476,99524
2:2:2,3,3,100473,99527
2:3:1,1,1,100472,99528
3:4:1,0,-1,100473,99527
3:4:2,1,1,100472,99528
6:6:5,0,-1,100473,99527
3:2:2,2,2,100471,99529
1:1:3,0,-1,100472,99528
6:5:1,0,-1,100473,99527
3:6:3,0,-1,100474,99526
1:1:5,0,-1,100475,99525
1:6:4,0,-1,100476,99524
2:1:3,1,1,100475,99525
3:3:4,0,-1,100476,99524
4:2:1,1,1,100475,99525
6:1:4,0,-1,100476,99524
6:3:4,0,-1,100477,99523
4:6:1,0,-1,100478,99522
3:4:2,1,1,100477,99523
6:4:4,0,-1,100478,99522
2:1:5,1,1,100477,99523
1:6:4,0,-1,100478,99522
1:6:5,0,-1,100479,99521
4:2:3,1,1,100478,99522
2:1:2,2,2,100476,99524
6:2:4,1,1,100475,99525
5:3:2,1,1,100474,99526
5:2:2,2,2,100472,99528
6:3:6,0,-1,100473,99527
3:2:5,1,1,100472,99528
4:5:2,1,1,100471,99529
3:3:4,0,-1,100472,99528
5:1:1,0,-1,100473,99527
5:4:2,1,1,100472,99528
5:5:5,0,-1,100473,99527
2:2:1,2,2,100471,99529
3:4:4,0,-1,100472,99528
4:3:2,1,1,100471,99529
1:2:6,1,1,100470,99530
4:1:3,0,-1,100471,99529
2:3:1,1,1,100470,99530
2:4:1,1,1,100469,99531
2:5:3,1,1,100468,99532
5:3:5,0,-1,100469,99531
2:1:5,1,1,100468,99532
4:5:1,0,-1,100469,99531
2:1:2,2,2,100467,99533
6:6:5,0,-1,100468,99532
2:2:5,2,2,100466,99534
1:4:5,0,-1,100467,99533
1:1:1,0,-1,100468,99532
5:1:5,0,-1,100469,99531
1:6:5,0,-1,100470,99530
5:4:3,0,-1,100471,99529
5:6:5,0,-1,100472,99528
3:5:4,0,-1,100473,99527
3:3:6,0,-1,100474,99526
3:1:1,0,-1,100475,99525
5:1:1,0,-1,100476,99524
2:1:5,1,1,100475,99525
6:4:4,0,-1,100476,99524
3:2:5,1,1,100475,99525
1:6:2,1,1,100474,99526
4:5:6,0,-1,100475,99525
1:3:4,0,-1,100476,99524
2:2:6,2,2,100474,99526
1:5:5,0,-1,100475,99525
4:3:4,0,-1,100476,99524
2:3:3,1,1,100475,99525
1:4:6,0,-1,100476,99524
4:2:2,2,2,100474,99526
5:3:3,0,-1,100475,99525
6:4:2,1,1,100474,99526
3:5:1,0,-1,100475,99525
4:4:3,0,-1,100476,99524
1:6:3,0,-1,100477,99523
5:3:1,0,-1,100478,99522
6:3:1,0,-1,100479,99521
1:2:1,1,1,100478,99522
5:4:3,0,-1,100479,99521
3:5:3,0,-1,100480,99520
3:3:5,0,-1,100481,99519
4:1:2,1,1,100480,99520
6:2:1,1,1,100479,99521
6:3:6,0,-1,100480,99520
6:4:5,0,-1,100481,99519
6:2:6,1,1,100480,99520
4:4:3,0,-1,100481,99519
1:4:3,0,-1,100482,99518
2:6:2,2,2,100480,99520
3:5:4,0,-1,100481,99519
1:3:4,0,-1,100482,99518
1:5:6,0,-1,100483,99517
2:2:3,2,2,100481,99519
4:3:1,0,-1,100482,99518
3:3:6,0,-1,100483,99517
5:4:6,0,-1,100484,99516
6:1:3,0,-1,100485,99515
6:5:6,0,-1,100486,99514
1:5:5,0,-1,100487,99513
2:2:5,2,2,100485,99515
5:2:5,1,1,100484,99516
1:3:4,0,-1,100485,99515
3:5:4,0,-1,100486,99514
1:1:3,0,-1,100487,99513
5:4:5,0,-1,100488,99512
3:3:1,0,-1,100489,99511
4:6:2,1,1,100488,99512
5:6:4,0,-1,100489,99511
5:3:4,0,-1,100490,99510
1:3:1,0,-1,100491,99509
5:2:4,1,1,100490,99510
6:6:4,0,-1,100491,99509
3:3:1,0,-1,100492,99508
3:2:2,2,2,100490,99510
1:3:5,0,-1,100491,99509
5:3:6,0,-1,100492,99508
5:3:5,0,-1,100493,99507
2:1:3,1,1,100492,99508
4:4:3,0,-1,100493,99507
3:3:2,1,1,100492,99508
5:5:2,1,1,100491,99509
2:1:2,2,2,100489,99511
3:1:4,0,-1,100490,99510
2:2:1,2,2,100488,99512
2:5:6,1,1,100487,99513
3:3:5,0,-1,100488,99512
6:4:1,0,-1,100489,99511
6:6:3,0,-1,100490,99510
1:6:3,0,-1,100491,99509
3:2:2,2,2,100489,99511
2:5:2,2,2,100487,99513
6:1:6,0,-1,100488,99512
5:2:4,1,1,100487,99513
2:6:2,2,2,100485,99515
4:3:3,0,-1,100486,99514
2:6:5,1,1,100485,99515
3:3:3,0,-1,100486,99514
2:5:4,1,1,100485,99515
4:2:5,1,1,100484,99516
1:1:2,1,1,100483,99517
3:4:5,0,-1,100484,99516
1:4:3,0,-1,100485,99515
3:6:4,0,-1,100486,99514
5:3:1,0,-1,100487,99513
5:6:1,0,-1,100488,99512
2:4:4,1,1,100487,99513
3:6:3,0,-1,100488,99512
5:1:4,0,-1,100489,99511
4:1:1,0,-1,100490,99510
5:1:6,0,-1,100491,99509
5:4:2,1,1,100490,99510
6:4:1,0,-1,100491,99509
3:4:2,1,1,100490,99510
4:4:1,0,-1,100491,99509
1:1:1,0,-1,100492,99508
4:3:6,0,-1,100493,99507
6:6:4,0,-1,100494,99506
3:6:1,0,-1,100495,99505
5:6:3,0,-1,100496,99504
2:2:6,2,2,100494,99506
4:4:6,0,-1,100495,99505
5:1:3,0,-1,100496,99504
5:5:3,0,-1,100497,99503
1:1:4,0,-1,100498,99502
2:3:5,1,1,100497,99503
6:2:6,1,1,100496,99504
2:2:1,2,2,100494,99506
6:4:2,1,1,100493,99507
2:2:1,2,2,100491,99509
5:2:2,2,2,100489,99511
4:2:3,1,1,100488,99512
4:6:5,0,-1,100489,99511
4:3:2,1,1,100488,99512
2:1:4,1,1,100487,99513
3:3:5,0,-1,100488,99512
1:5:4,0,-1,100489,99511
2:4:4,1,1,100488,99512
1:6:5,0,-1,100489,99511
5:5:5,0,-1,100490,99510
4:5:6,0,-1,100491,99509
1:4:6,0,-1,100492,99508
1:5:3,0,-1,100493,99507
3:5:1,0,-1,100494,99506
2:5:3,1,1,100493,99507
3:2:6,1,1,100492,99508
5:1:4,0,-1,100493,99507
6:2:4,1,1,100492,99508
4:4:5,0,-1,100493,99507
2:1:2,2,2,100491,99509
4:3:6,0,-1,100492,99508
5:2:2,2,2,100490,99510
6:4:2,1,1,100489,99511
4:6:5,0,-1,100490,99510
6:3:6,0,-1,100491,99509
2:6:1,1,1,100490,99510
2:1:1,1,1,100489,99511
1:1:5,0,-1,100490,99510
3:6:4,0,-1,100491,99509
1:3:4,0,-1,100492,99508
4:5:1,0,-1,100493,99507
5:5:4,0,-1,100494,99506
6:2:4,1,1,100493,99507
4:5:2,1,1,100492,99508
4:2:5,1,1,100491,99509
5:4:5,0,-1,100492,99508
2:4:1,1,1,100491,99509
2:6:3,1,1,100490,99510
2:3:6,1,1,100489,99511
1:6:5,0,-1,100490,99510
3:5:3,0,-1,100491,99509
2:2:3,2,2,100489,99511
3:3:4,0,-1,100490,99510
5:4:6,0,-1,100491,99509
4:4:6,0,-1,100492,99508
5:4:2,1,1,100491,99509
6:2:1,1,1,100490,99510
3:5:1,0,-1,100491,99509
5:1:1,0,-1,100492,99508
6:5:5,0,-1,100493,99507
5:3:4,0,-1,100494,99506
5:2:5,1,1,100493,99507
1:3:3,0,-1,100494,99506
3:4:1,0,-1,100495,99505
5:1:3,0,-1,100496,99504
4:5:1,0,-1,100497,99503
6:3:3,0,-1,100498,99502
4:1:6,0,-1,100499,99501
2:4:4,1,1,100498,99502
6:4:5,0,-1,100499,99501
1:5:1,0,-1,100500,99500
5:4:4,0,-1,100501,99499
6:5:4,0,-1,100502,99498
2:3:3,1,1,100501,99499
3:6:4,0,-1,100502,99498
1:2:1,1,1,100501,99499
2:1:5,1,1,100500,99500
2:1:4,1,1,100499,99501
3:6:2,1,1,100498,99502
2:3:3,1,1,100497,99503
3:4:6,0,-1,100498,99502
3:1:6,0,-1,100499,99501
3:6:3,0,-1,100500,99500
2:5:3,1,1,100499,99501
2:3:2,2,2,100497,99503
1:5:4,0,-1,100498,99502
6:1:2,1,1,100497,99503
1:3:6,0,-1,100498,99502
3:5:4,0,-1,100499,99501
1:5:5,0,-1,100500,99500
3:2:5,1,1,100499,99501
2:1:6,1,1,100498,99502
5:6:3,0,-1,100499,99501
2:4:2,2,2,100497,99503
4:1:3,0,-1,100498,99502
1:4:6,0,-1,100499,99501
4:5:3,0,-1,100500,99500
2:2:3,2,2,100498,99502
4:2:4,1,1,100497,99503
3:3:1,0,-1,100498,99502
1:2:6,1,1,100497,99503
5:2:4,1,1,100496,99504
4:5:2,1,1,100495,99505
4:3:4,0,-1,100496,99504
1:4:5,0,-1,100497,99503
2:1:1,1,1,100496,99504
2:3:1,1,1,100495,99505
1:4:2,1,1,100494,99506
5:4:4,0,-1,100495,99505
5:6:5,0,-1,100496,99504
4:3:1,0,-1,100497,99503
4:1:5,0,-1,100498,99502
2:2:4,2,2,100496,99504
3:4:5,0,-1,100497,99503
5:5:5,0,-1,100498,99502
5:3:6,0,-1,100499,99501
5:5:3,0,-1,100500,99500
2:5:3,1,1,100499,99501
4:2:1,1,1,100498,99502
2:5:2,2,2,100496,99504
5:5:4,0,-1,100497,99503
5:1:4,0,-1,100498,99502
3:4:3,0,-1,100499,99501
2:3:6,1,1,100498,99502
5:1:2,1,1,100497,99503
1:4:2,1,1,100496,99504
4:6:3,0,-1,100497,99503
3:6:2,1,1,100496,99504
1:5:2,1,1,100495,99505
6:2:3,1,1,100494,99506
5:2:6,1,1,100493,99507
3:5:5,0,-1,100494,99506
1:4:5,0,-1,100495,99505
6:2:6,1,1,100494,99506
3:1:5,0,-1,100495,99505
2:5:2,2,2,100493,99507
1:1:1,0,-1,100494,99506
1:6:2,1,1,100493,99507
4:6:2,1,1,100492,99508
5:4:1,0,-1,100493,99507
6:5:2,1,1,100492,99508
5:1:6,0,-1,100493,99507
5:5:2,1,1,100492,99508
2:3:3,1,1,100491,99509
6:1:4,0,-1,100492,99508
3:2:3,1,1,100491,99509
3:3:1,0,-1,100492,99508
6:2:4,1,1,100491,99509
3:4:5,0,-1,100492,99508
3:4:1,0,-1,100493,99507
1:1:1,0,-1,100494,99506
4:4:2,1,1,100493,99507
4:6:2,1,1,100492,99508
6:2:3,1,1,100491,99509
1:3:1,0,-1,100492,99508
2:1:3,1,1,100491,99509
2:3:3,1,1,100490,99510
2:1:2,2,2,100488,99512
6:3:2,1,1,100487,99513
5:1:1,0,-1,100488,99512
4:1:2,1,1,100487,99513
4:5:6,0,-1,100488,99512
2:6:5,1,1,100487,99513
1:3:4,0,-1,100488,99512
2:3:6,1,1,100487,99513
1:3:5,0,-1,100488,99512
4:4:3,0,-1,100489,99511
3:3:5,0,-1,100490,99510
4:5:5,0,-1,100491,99509
4:2:2,2,2,100489,99511
1:5:2,1,1,100488,99512
6:4:5,0,-1,100489,99511
1:5:1,0,-1,100490,99510
4:2:1,1,1,100489,99511
2:6:5,1,1,100488,99512
3:3:3,0,-1,100489,99511
5:1:5,0,-1,100490,99510
3:2:2,2,2,100488,99512
6:3:2,1,1,100487,99513
2:6:6,1,1,100486,99514
3:5:5,0,-1,100487,99513
3:3:2,1,1,100486,99514
1:2:6,1,1,100485,99515
5:3:5,0,-1,100486,99514
3:2:5,1,1,100485,99515
2:1:1,1,1,100484,99516
5:4:4,0,-1,100485,99515
3:5:5,0,-1,100486,99514
1:6:2,1,1,100485,99515
6:1:6,0,-1,100486,99514
6:6:2,1,1,100485,99515
3:6:2,1,1,100484,99516
1:6:5,0,-1,100485,99515
6:3:2,1,1,100484,99516
2:3:3,1,1,100483,99517
2:1:3,1,1,100482,99518
5:3:3,0,-1,100483,99517
4:1:2,1,1,100482,99518
6:4:2,1,1,100481,99519
4:1:2,1,1,100480,99520
3:4:3,0,-1,100481,99519
4:4:1,0,-1,100482,99518
2:1:5,1,1,100481,99519
6:2:1,1,1,100480,99520
1:6:4,0,-1,100481,99519
4:1:1,0,-1,100482,99518
5:6:6,0,-1,100483,99517
3:5:5,0,-1,100484,99516
4:5:4,0,-1,100485,99515
3:4:5,0,-1,100486,99514
2:6:4,1,1,100485,99515
1:4:5,0,-1,100486,99514
1:6:5,0,-1,100487,99513
4:6:4,0,-1,100488,99512
3:5:5,0,-1,100489,99511
2:4:3,1,1,100488,99512
2:6:5,1,1,100487,99513
5:5:6,0,-1,100488,99512
2:2:3,2,2,100486,99514
6:5:6,0,-1,100487,99513
5:4:4,0,-1,100488,99512
5:2:4,1,1,100487,99513
5:4:4,0,-1,100488,99512
6:3:3,0,-1,100489,99511
2:1:6,1,1,100488,99512
3:1:5,0,-1,100489,99511
3:3:6,0,-1,100490,99510
5:4:6,0,-1,100491,99509
3:1:2,1,1,100490,99510
1:1:1,0,-1,100491,99509
3:6:5,0,-1,100492,99508
3:5:6,0,-1,100493,99507
4:2:5,1,1,100492,99508
1:4:2,1,1,100491,99509
3:4:4,0,-1,100492,99508
6:3:1,0,-1,100493,99507
5:6:5,0,-1,100494,99506
4:1:4,0,-1,100495,99505
2:5:1,1,1,100494,99506
6:2:3,1,1,100493,99507
2:4:6,1,1,100492,99508
5:5:3,0,-1,100493,99507
2:5:5,1,1,100492,99508
2:3:1,1,1,100491,99509
3:1:3,0,-1,100492,99508
6:3:3,0,-1,100493,99507
4:4:5,0,-1,100494,99506
3:2:5,1,1,100493,99507
4:5:6,0,-1,100494,99506
3:1:2,1,1,100493,99507
5:5:6,0,-1,100494,99506
2:3:6,1,1,100493,99507
1:6:1,0,-1,100494,99506
4:3:1,0,-1,100495,99505
6:6:3,0,-1,100496,99504
6:3:3,0,-1,100497,99503
5:6:3,0,-1,100498,99502
6:4:4,0,-1,100499,99501
2:1:3,1,1,100498,99502
4:6:2,1,1,100497,99503
2:3:1,1,1,100496,99504
6:2:2,2,2,100494,99506
6:4:3,0,-1,100495,99505
6:6:6,0,-1,100496,99504
6:4:6,0,-1,100497,99503
1:6:5,0,-1,100498,99502
2:2:3,2,2,100496,99504
3:6:5,0,-1,100497,99503
6:2:5,1,1,100496,99504
3:4:3,0,-1,100497,99503
3:6:4,0,-1,100498,99502
5:6:3,0,-1,100499,99501
5:3:6,0,-1,100500,99500
3:3:1,0,-1,100501,99499
6:3:6,0,-1,100502,99498
6:1:4,0,-1,100503,99497
4:4:5,0,-1,100504,99496
2:6:2,2,2,100502,99498
3:6:4,0,-1,100503,99497
3:1:6,0,-1,100504,99496
5:1:3,0,-1,100505,99495
5:2:1,1,1,100504,99496
2:6:6,1,1,100503,99497
2:6:4,1,1,100502,99498
4:6:3,0,-1,100503,99497
2:3:3,1,1,100502,99498
2:5:2,2,2,100500,99500
4:4:3,0,-1,100501,99499
6:3:3,0,-1,100502,99498
4:5:2,1,1,100501,99499
6:5:1,0,-1,100502,99498
4:1:5,0,-1,100503,99497
1:3:3,0,-1,100504,99496
4:3:4,0,-1,100505,99495
6:6:6,0,-1,100506,99494
1:4:6,0,-1,100507,99493
5:2:2,2,2,100505,99495
2:6:2,2,2,100503,99497
2:3:2,2,2,100501,99499
6:6:6,0,-1,100502,99498
2:4:2,2,2,100500,99500
6:2:2,2,2,100498,99502
3:4:5,0,-1,100499,99501
5:4:4,0,-1,100500,99500
5:3:3,0,-1,100501,99499
2:4:3,1,1,100500,99500
6:5:6,0,-1,100501,99499
3:4:6,0,-1,100502,99498
2:2:3,2,2,100500,99500
6:4:1,0,-1,100501,99499
6:1:1,0,-1,100502,99498
1:2:6,1,1,100501,99499
1:3:6,0,-1,100502,99498
5:3:4,0,-1,100503,99497
1:4:2,1,1,100502,99498
3:3:2,1,1,100501,99499
3:3:3,0,-1,100502,99498
2:2:6,2,2,100500,99500
3:3:2,1,1,100499,99501
4:4:6,0,-1,100500,99500
6:3:6,0,-1,100501,99499
3:6:3,0,-1,100502,99498
6:3:2,1,1,100501,99499
1:1:1,0,-1,100502,99498
1:1:4,0,-1,100503,99497
1:3:2,1,1,100502,99498
2:5:4,1,1,100501,99499
4:5:1,0,-1,100502,99498
5:4:3,0,-1,100503,99497
3:1:5,0,-1,100504,99496
1:4:5,0,-1,100505,99495
2:1:1,1,1,100504,99496
4:4:5,0,-1,100505,99495
6:4:6,0,-1,100506,99494
1:4:2,1,1,100505,99495
3:6:6,0,-1,100506,99494
1:2:1,1,1,100505,99495
1:5:4,0,-1,100506,99494
6:3:5,0,-1,100507,99493
2:2:5,2,2,100505,99495
1:5:5,0,-1,100506,99494
3:4:3,0,-1,100507,99493
1:4:4,0,-1,100508,99492
4:1:4,0,-1,100509,99491
4:6:1,0,-1,100510,99490
5:2:4,1,1,100509,99491
6:2:4,1,1,100508,99492
5:4:4,0,-1,100509,99491
2:4:4,1,1,100508,99492
2:4:5,1,1,100507,99493
5:2:3,1,1,100506,99494
3:3:1,0,-1,100507,99493
5:4:4,0,-1,100508,99492
6:3:2,1,1,100507,99493
3:1:3,0,-1,100508,99492
6:5:1,0,-1,100509,99491
5:4:3,0,-1,100510,99490
6:5:6,0,-1,100511,99489
4:1:1,0,-1,100512,99488
2:1:3,1,1,100511,99489
6:1:1,0,-1,100512,99488
4:3:4,0,-1,100513,99487
6:2:3,1,1,100512,99488
1:4:5,0,-1,100513,99487
5:2:2,2,2,100511,99489
5:1:2,1,1,100510,99490
4:1:3,0,-1,100511,99489
1:5:1,0,-1,100512,99488
1:6:1,0,-1,100513,99487
3:5:6,0,-1,100514,99486
4:4:4,0,-1,100515,99485
1:4:1,0,-1,100516,99484
3:3:6,0,-1,100517,99483
4:1:6,0,-1,100518,99482
4:2:3,1,1,100517,99483
1:4:4,0,-1,100518,99482
2:4:3,1,1,100517,99483
4:5:1,0,-1,100518,99482
3:5:3,0,-1,100519,99481
6:4:6,0,-1,100520,99480
1:4:1,0,-1,100521,99479
6:1:3,0,-1,100522,99478
2:4:5,1,1,100521,99479
4:2:6,1,1,100520,99480
1:2:1,1,1,100519,99481
1:1:3,0,-1,100520,99480
2:5:2,2,2,100518,99482
5:5:6,0,-1,100519,99481
5:2:6,1,1,100518,99482
1:5:1,0,-1,100519,99481
3:4:2,1,1,100518,99482
5:1:5,0,-1,100519,99481
2:3:1,1,1,100518,99482
3:1:2,1,1,100517,99483
4:2:4,1,1,100516,99484
1:5:3,0,-1,100517,99483
6:4:2,1,1,100516,99484
3:6:6,0,-1,100517,99483
4:6:1,0,-1,100518,99482
4:1:4,0,-1,100519,99481
4:1:2,1,1,100518,99482
5:2:3,1,1,100517,99483
4:3:3,0,-1,100518,99482
2:4:2,2,2,100516,99484
3:5:4,0,-1,100517,99483
4:2:5,1,1,100516,99484
6:3:5,0,-1,100517,99483
5:6:1,0,-1,100518,99482
4:2:1,1,1,100517,99483
4:1:4,0,-1,100518,99482
1:2:1,1,1,100517,99483
3:6:2,1,1,100516,99484
6:1:5,0,-1,100517,99483
1:3:6,0,-1,100518,99482
6:5:4,0,-1,100519,99481
4:1:2,1,1,100518,99482
3:2:4,1,1,100517,99483
1:4:5,0,-1,100518,99482
1:5:2,1,1,100517,99483
5:5:1,0,-1,100518,99482
3:1:6,0,-1,100519,99481
4:4:3,0,-1,100520,99480
3:6:5,0,-1,100521,99479
4:2:2,2,2,100519,99481
3:4:4,0,-1,100520,99480
2:3:6,1,1,100519,99481
3:1:3,0,-1,100520,99480
5:1:3,0,-1,100521,99479
4:2:2,2,2,100519,99481
3:6:4,0,-1,100520,99480
6:6:1,0,-1,100521,99479
1:3:4,0,-1,100522,99478
2:1:6,1,1,100521,99479
3:5:5,0,-1,100522,99478
3:5:6,0,-1,100523,99477
5:3:2,1,1,100522,99478
1:5:5,0,-1,100523,99477
4:1:5,0,-1,100524,99476
1:3:3,0,-1,100525,99475
4:4:3,0,-1,100526,99474
4:4:2,1,1,100525,99475
3:5:1,0,-1,100526,99474
3:4:1,0,-1,100527,99473
2:4:6,1,1,100526,99474
4:1:5,0,-1,100527,99473
6:4:4,0,-1,100528,99472
2:5:4,1,1,100527,99473
5:5:2,1,1,100526,99474
6:5:6,0,-1,100527,99473
6:4:3,0,-1,100528,99472
6:6:2,1,1,100527,99473
2:2:1,2,2,100525,99475
2:2:5,2,2,100523,99477
4:4:5,0,-1,100524,99476
3:2:5,1,1,100523,99477
4:6:3,0,-1,100524,99476
1:2:1,1,1,100523,99477
3:2:5,1,1,100522,99478
4:1:6,0,-1,100523,99477
1:5:5,0,-1,100524,99476
5:2:2,2,2,100522,99478
3:3:3,0,-1,100523,99477
2:3:6,1,1,100522,99478
6:4:2,1,1,100521,99479
5:6:3,0,-1,100522,99478
3:4:2,1,1,100521,99479
6:4:5,0,-1,100522,99478
5:3:6,0,-1,100523,99477
2:2:5,2,2,100521,99479
5:2:5,1,1,100520,99480
3:2:1,1,1,100519,99481
5:3:5,0,-1,100520,99480
2:1:1,1,1,100519,99481
3:1:4,0,-1,100520,99480
5:6:6,0,-1,100521,99479
6:6:1,0,-1,100522,99478
1:5:1,0,-1,100523,99477
1:1:4,0,-1,100524,99476
4:5:3,0,-1,100525,99475
5:1:1,0,-1,100526,99474
1:5:2,1,1,100525,99475
2:5:3,1,1,100524,99476
2:3:5,1,1,100523,99477
1:5:3,0,-1,100524,99476
4:4:1,0,-1,100525,99475
6:4:4,0,-1,100526,99474
1:5:3,0,-1,100527,99473
4:1:5,0,-1,100528,99472
3:4:6,0,-1,100529,99471
3:6:6,0,-1,100530,99470
6:5:2,1,1,100529,99471
3:2:2,2,2,100527,99473
3:1:1,0,-1,100528,99472
5:4:3,0,-1,100529,99471
1:3:4,0,-1,100530,99470
5:1:4,0,-1,100531,99469
1:4:3,0,-1,100532,99468
4:1:5,0,-1,100533,99467
3:2:3,1,1,100532,99468
1:3:4,0,-1,100533,99467
3:5:1,0,-1,100534,99466
6:6:4,0,-1,100535,99465
5:5:2,1,1,100534,99466
5:1:5,0,-1,100535,99465
3:5:5,0,-1,100536,99464
4:5:1,0,-1,100537,99463
6:3:6,0,-1,100538,99462
5:2:1,1,1,100537,99463
1:3:1,0,-1,100538,99462
1:6:6,0,-1,100539,99461
5:6:5,0,-1,100540,99460
4:2:6,1,1,100539,99461
2:5:5,1,1,100538,99462
1:4:5,0,-1,100539,99461
6:5:1,0,-1,100540,99460
3:5:5,0,-1,100541,99459
2:6:1,1,1,100540,99460
4:2:4,1,1,100539,99461
5:4:5,0,-1,100540,99460
2:6:5,1,1,100539,99461
1:4:1,0,-1,100540,99460
1:1:6,0,-1,100541,99459
2:2:5,2,2,100539,99461
1:1:2,1,1,100538,99462
2:5:5,1,1,100537,99463
4:6:4,0,-1,100538,99462
5:5:4,0,-1,100539,99461
2:5:6,1,1,100538,99462
4:1:1,0,-1,100539,99461
4:5:4,0,-1,100540,99460
1:3:4,0,-1,100541,99459
3:4:1,0,-1,100542,99458
6:1:3,0,-1,100543,99457
2:2:3,2,2,100541,99459
2:4:4,1,1,100540,99460
4:5:4,0,-1,100541,99459
3:3:6,0,-1,100542,99458
4:6:6,0,-1,100543,99457
3:5:6,0,-1,100544,99456
5:1:1,0,-1,100545,99455
1:1:5,0,-1,100546,99454
6:3:5,0,-1,100547,99453
2:5:3,1,1,100546,99454
3:4:6,0,-1,100547,99453
5:2:1,1,1,100546,99454
3:3:6,0,-1,100547,99453
5:2:2,2,2,100545,99455
6:5:2,1,1,100544,99456
1:2:6,1,1,100543,99457
4:4:5,0,-1,100544,99456
2:5:6,1,1,100543,99457
5:3:1,0,-1,100544,99456
4:5:4,0,-1,100545,99455
2:5:5,1,1,100544,99456
6:4:6,0,-1,100545,99455
1:5:3,0,-1,100546,99454
2:5:5,1,1,100545,99455
1:1:1,0,-1,100546,99454
1:3:3,0,-1,100547,99453
3:2:5,1,1,100546,99454
4:4:4,0,-1,100547,99453
2:1:1,1,1,100546,99454
5:3:3,0,-1,100547,99453
1:4:4,0,-1,100548,99452
6:3:6,0,-1,100549,99451
1:1:5,0,-1,100550,99450
1:5:1,0,-1,100551,99449
4:3:4,0,-1,100552,99448
1:4:2,1,1,100551,99449
1:2:6,1,1,100550,99450
5:2:4,1,1,100549,99451
2:4:1,1,1,100548,99452
6:6:6,0,-1,100549,99451
5:1:5,0,-1,100550,99450
4:3:3,0,-1,100551,99449
5:1:5,0,-1,100552,99448
3:2:6,1,1,100551,99449
3:2:1,1,1,100550,99450
2:4:6,1,1,100549,99451
5:5:3,0,-1,100550,99450
2:6:5,1,1,100549,99451
4:2:4,1,1,100548,99452
3:4:3,0,-1,100549,99451
2:2:5,2,2,100547,99453
5:4:6,0,-1,100548,99452
3:1:1,0,-1,100549,99451
5:4:4,0,-1,100550,99450
1:6:4,0,-1,100551,99449
6:5:1,0,-1,100552,99448
6:1:1,0,-1,100553,99447
5:3:2,1,1,100552,99448
3:3:2,1,1,100551,99449
2:5:5,1,1,100550,99450
3:3:6,0,-1,100551,99449
2:1:5,1,1,100550,99450
5:5:1,0,-1,100551,99449
4:3:3,0,-1,100552,99448
4:5:5,0,-1,100553,99447
5:5:2,1,1,100552,99448
4:6:6,0,-1,100553,99447
5:3:1,0,-1,100554,99446
2:5:6,1,1,100553,99447
4:1:4,0,-1,100554,99446
4:4:6,0,-1,100555,99445
5:3:6,0,-1,100556,99444
2:2:6,2,2,100554,99446
5:2:4,1,1,100553,99447
3:5:5,0,-1,100554,99446
3:2:1,1,1,100553,99447
3:1:2,1,1,100552,99448
6:6:6,0,-1,100553,99447
1:3:5,0,-1,100554,99446
6:3:4,0,-1,100555,99445
3:3:5,0,-1,100556,99444
6:4:4,0,-1,100557,99443
3:3:1,0,-1,100558,99442
2:2:6,2,2,100556,99444
5:1:2,1,1,100555,99445
4:3:1,0,-1,100556,99444
3:6:5,0,-1,100557,99443
6:6:4,0,-1,100558,99442
2:4:2,2,2,100556,99444
6:6:4,0,-1,100557,99443
1:2:5,1,1,100556,99444
3:6:1,0,-1,100557,99443
3:1:6,0,-1,100558,99442
4:4:2,1,1,100557,99443
6:5:2,1,1,100556,99444
1:2:2,2,2,100554,99446
3:6:3,0,-1,100555,99445
4:5:3,0,-1,100556,99444
4:5:1,0,-1,100557,99443
2:4:6,1,1,100556,99444
3:3:5,0,-1,100557,99443
2:6:5,1,1,100556,99444
1:6:4,0,-1,100557,99443
6:6:2,1,1,100556,99444
1:6:3,0,-1,100557,99443
1:2:4,1,1,100556,99444
5:3:6,0,-1,100557,99443
1:3:6,0,-1,100558,99442
5:4:3,0,-1,100559,99441
5:6:6,0,-1,100560,99440
2:6:3,1,1,100559,99441
3:4:4,0,-1,100560,99440
4:4:6,0,-1,100561,99439
1:3:6,0,-1,100562,99438
5:4:6,0,-1,100563,99437
4:1:1,0,-1,100564,99436
1:6:1,0,-1,100565,99435
2:3:2,2,2,100563,99437
4:6:4,0,-1,100564,99436
5:6:1,0,-1,100565,99435
4:3:5,0,-1,100566,99434
2:1:6,1,1,100565,99435
3:4:1,0,-1,100566,99434
4:6:6,0,-1,100567,99433
1:3:4,0,-1,100568,99432
4:6:4,0,-1,100569,99431
2:4:6,1,1,100568,99432
3:4:4,0,-1,100569,99431
3:2:5,1,1,100568,99432
4:1:2,1,1,100567,99433
1:3:2,1,1,100566,99434
5:5:6,0,-1,100567,99433
6:1:5,0,-1,100568,99432
4:5:1,0,-1,100569,99431
4:6:3,0,-1,100570,99430
2:2:5,2,2,100568,99432
5:5:6,0,-1,100569,99431
3:4:2,1,1,100568,99432
4:2:2,2,2,100566,99434
6:3:5,0,-1,100567,99433
6:4:5,0,-1,100568,99432
3:3:3,0,-1,100569,99431
6:4:5,0,-1,100570,99430
4:3:1,0,-1,100571,99429
4:3:3,0,-1,100572,99428
6:4:4,0,-1,100573,99427
3:3:1,0,-1,100574,99426
5:6:4,0,-1,100575,99425
6:4:6,0,-1,100576,99424
4:5:2,1,1,100575,99425
1:3:3,0,-1,100576,99424
4:5:2,1,1,100575,99425
6:4:1,0,-1,100576,99424
2:4:4,1,1,100575,99425
2:2:1,2,2,100573,99427
5:5:6,0,-1,100574,99426
3:2:3,1,1,100573,99427
3:4:6,0,-1,100574,99426
2:6:3,1,1,100573,99427
6:5:3,0,-1,100574,99426
2:5:1,1,1,100573,99427
3:4:6,0,-1,100574,99426
6:1:5,0,-1,100575,99425
1:2:1,1,1,100574,99426
2:2:5,2,2,100572,99428
6:3:2,1,1,100571,99429
3:3:1,0,-1,100572,99428
1:4:5,0,-1,100573,99427
5:2:6,1,1,100572,99428
4:1:2,1,1,100571,99429
1:6:5,0,-1,100572,99428
5:1:1,0,-1,100573,99427
5:2:6,1,1,100572,99428
2:6:6,1,1,100571,99429
4:5:1,0,-1,100572,99428
3:2:5,1,1,100571,99429
5:3:1,0,-1,100572,99428
5:3:4,0,-1,100573,99427
6:4:2,1,1,100572,99428
5:5:5,0,-1,100573,99427
2:2:3,2,2,100571,99429
3:2:4,1,1,100570,99430
2:3:6,1,1,100569,99431
1:2:6,1,1,100568,99432
4:2:1,1,1,100567,99433
6:2:3,1,1,100566,99434
1:1:6,0,-1,100567,99433
1:3:1,0,-1,100568,99432
6:6:6,0,-1,100569,99431
5:5:1,0,-1,100570,99430
3:3:3,0,-1,100571,99429
4:1:1,0,-1,100572,99428
3:5:1,0,-1,100573,99427
1:6:4,0,-1,100574,99426
6:4:6,0,-1,100575,99425
3:3:2,1,1,100574,99426
3:6:5,0,-1,100575,99425
6:3:2,1,1,100574,99426
4:3:2,1,1,100573,99427
5:4:3,0,-1,100574,99426
6:3:6,0,-1,100575,99425
2:2:4,2,2,100573,99427
1:4:2,1,1,100572,99428
6:1:4,0,-1,100573,99427
1:1:1,0,-1,100574,99426
3:2:1,1,1,100573,99427
4:2:3,1,1,100572,99428
3:6:6,0,-1,100573,99427
4:4:3,0,-1,100574,99426
4:6:4,0,-1,100575,99425
1:3:4,0,-1,100576,99424
4:1:2,1,1,100575,99425
6:1:1,0,-1,100576,99424
6:2:2,2,2,100574,99426
6:6:2,1,1,100573,99427
3:5:4,0,-1,100574,99426
5:1:3,0,-1,100575,99425
1:3:5,0,-1,100576,99424
6:1:3,0,-1,100577,99423
4:1:6,0,-1,100578,99422
6:1:5,0,-1,100579,99421
3:2:1,1,1,100578,99422
4:5:1,0,-1,100579,99421
6:1:1,0,-1,100580,99420
2:5:2,2,2,100578,99422
4:5:2,1,1,100577,99423
6:6:2,1,1,100576,99424
4:4:6,0,-1,100577,99423
2:6:5,1,1,100576,99424
2:3:4,1,1,100575,99425
5:4:2,1,1,100574,99426
2:2:2,3,3,100571,99429
3:3:1,0,-1,100572,99428
1:2:5,1,1,100571,99429
5:6:1,0,-1,100572,99428
6:5:6,0,-1,100573,99427
6:3:3,0,-1,100574,99426
6:2:4,1,1,100573,99427
2:5:2,2,2,100571,99429
5:4:5,0,-1,100572,99428
3:5:2,1,1,100571,99429
6:1:6,0,-1,100572,99428
5:1:5,0,-1,100573,99427
2:4:6,1,1,100572,99428
6:4:4,0,-1,100573,99427
2:5:1,1,1,100572,99428
6:6:2,1,1,100571,99429
4:5:2,1,1,100570,99430
6:2:5,1,1,100569,99431
1:1:1,0,-1,100570,99430
4:2:6,1,1,100569,99431
3:3:1,0,-1,100570,99430
1:1:5,0,-1,100571,99429
6:5:5,0,-1,100572,99428
5:2:3,1,1,100571,99429
5:4:5,0,-1,100572,99428
3:3:3,0,-1,100573,99427
6:2:5,1,1,100572,99428
5:3:6,0,-1,100573,99427
6:2:1,1,1,100572,99428
2:2:4,2,2,100570,99430
2:2:2,3,3,100567,99433
1:3:4,0,-1,100568,99432
4:2:2,2,2,100566,99434
6:3:4,0,-1,100567,99433
3:3:3,0,-1,100568,99432
2:6:2,2,2,100566,99434
1:5:3,0,-1,100567,99433
3:1:2,1,1,100566,99434
5:4:2,1,1,100565,99435
1:4:5,0,-1,100566,99434
1:6:1,0,-1,100567,99433
3:5:5,0,-1,100568,99432
3:2:4,1,1,100567,99433
6:6:5,0,-1,100568,99432
5:1:4,0,-1,100569,99431
5:4:3,0,-1,100570,99430
1:4:3,0,-1,100571,99429
4:4:6,0,-1,100572,99428
2:1:1,1,1,100571,99429
6:3:3,0,-1,100572,99428
6:3:6,0,-1,100573,99427
5:5:2,1,1,100572,99428
5:1:3,0,-1,100573,99427
6:5:1,0,-1,100574,99426
4:1:5,0,-1,100575,99425
6:2:6,1,1,100574,99426
4:6:4,0,-1,100575,99425
2:4:4,1,1,100574,99426
1:3:4,0,-1,100575,99425
3:1:1,0,-1,100576,99424
3:3:4,0,-1,100577,99423
4:1:5,0,-1,100578,99422
1:6:3,0,-1,100579,99421
2:3:2,2,2,100577,99423
3:6:3,0,-1,100578,99422
3:3:4,0,-1,100579,99421
6:4:6,0,-1,100580,99420
2:3:6,1,1,100579,99421
6:4:3,0,-1,100580,99420
3:4:5,0,-1,100581,99419
4:2:6,1,1,100580,99420
2:4:4,1,1,100579,99421
4:3:5,0,-1,100580,99420
6:4:4,0,-1,100581,99419
6:2:6,1,1,100580,99420
1:5:2,1,1,100579,99421
6:4:5,0,-1,100580,99420
3:4:5,0,-1,100581,99419
5:1:6,0,-1,100582,99418
1:3:6,0,-1,100583,99417
3:2:1,1,1,100582,99418
4:5:2,1,1,100581,99419
1:6:5,0,-1,100582,99418
1:3:2,1,1,100581,99419
5:3:1,0,-1,100582,99418
6:6:6,0,-1,100583,99417
2:3:6,1,1,100582,99418
2:6:5,1,1,100581,99419
5:4:5,0,-1,100582,99418
5:6:1,0,-1,100583,99417
5:1:5,0,-1,100584,99416
5:6:3,0,-1,100585,99415
4:2:6,1,1,100584,99416
4:5:4,0,-1,100585,99415
1:3:2,1,1,100584,99416
4:1:1,0,-1,100585,99415
2:1:5,1,1,100584,99416
3:1:1,0,-1,100585,99415
1:4:2,1,1,100584,99416
3:2:5,1,1,100583,99417
1:6:6,0,-1,100584,99416
5:3:1,0,-1,100585,99415
1:3:3,0,-1,100586,99414
6:5:4,0,-1,100587,99413
3:6:1,0,-1,100588,99412
4:5:4,0,-1,100589,99411
5:5:3,0,-1,100590,99410
4:2:6,1,1,100589,99411
3:1:4,0,-1,100590,99410
5:1:2,1,1,100589,99411
6:1:4,0,-1,100590,99410
3:1:3,0,-1,100591,99409
4:3:6,0,-1,100592,99408
4:3:6,0,-1,100593,99407
6:4:2,1,1,100592,99408
3:3:5,0,-1,100593,99407
4:1:3,0,-1,100594,99406
1:3:4,0,-1,100595,99405
5:2:1,1,1,100594,99406
3:4:5,0,-1,100595,99405
3:2:6,1,1,100594,99406
6:2:6,1,1,100593,99407
6:1:6,0,-1,100594,99406
3:2:5,1,1,100593,99407
2:3:4,1,1,100592,99408
3:4:1,0,-1,100593,99407
2:2:5,2,2,100591,99409
2:5:2,2,2,100589,99411
3:4:4,0,-1,100590,99410
3:2:5,1,1,100589,99411
5:3:4,0,-1,100590,99410
6:4:3,0,-1,100591,99409
5:1:6,0,-1,100592,99408
2:4:6,1,1,100591,99409
5:1:4,0,-1,100592,99408
4:4:5,0,-1,100593,99407
2:2:2,3,3,100590,99410
5:1:3,0,-1,100591,99409
5:4:2,1,1,100590,99410
3:2:4,1,1,100589,99411
4:4:3,0,-1,100590,99410
6:4:4,0,-1,100591,99409
6:2:5,1,1,100590,99410
2:4:4,1,1,100589,99411
1:3:2,1,1,100588,99412
1:3:4,0,-1,100589,99411
5:3:2,1,1,100588,99412
6:3:3,0,-1,100589,99411
6:6:5,0,-1,100590,99410
2:3:2,2,2,100588,99412
4:6:5,0,-1,100589,99411
4:3:2,1,1,100588,99412
3:1:2,1,1,100587,99413
6:2:1,1,1,100586,99414
3:2:6,1,1,100585,99415
2:5:3,1,1,100584,99416
3:1:3,0,-1,100585,99415
4:4:4,0,-1,100586,99414
5:4:1,0,-1,100587,99413
2:6:5,1,1,100586,99414
5:5:3,0,-1,100587,99413
1:1:3,0,-1,100588,99412
5:2:1,1,1,100587,99413
3:5:6,0,-1,100588,99412
6:6:5,0,-1,100589,99411
6:6:4,0,-1,100590,99410
4:1:5,0,-1,100591,99409
6:2:2,2,2,100589,99411
2:1:5,1,1,100588,99412
6:4:6,0,-1,100589,99411
5:4:6,0,-1,100590,99410
6:6:5,0,-1,100591,99409
2:4:2,2,2,100589,99411
5:1:3,0,-1,100590,99410
6:3:3,0,-1,100591,99409
4:4:1,0,-1,100592,99408
3:3:6,0,-1,100593,99407
6:6:2,1,1,100592,99408
3:5:5,0,-1,100593,99407
5:1:4,0,-1,100594,99406
1:3:2,1,1,100593,99407
4:3:1,0,-1,100594,99406
3:3:5,0,-1,100595,99405
6:5:3,0,-1,100596,99404
1:3:3,0,-1,100597,99403
6:6:6,0,-1,100598,99402
1:4:3,0,-1,100599,99401
3:2:6,1,1,100598,99402
2:5:3,1,1,100597,99403
4:1:4,0,-1,100598,99402
3:4:3,0,-1,100599,99401
5:4:6,0,-1,100600,99400
1:6:4,0,-1,100601,99399
4:2:2,2,2,100599,99401
5:4:1,0,-1,100600,99400
6:3:3,0,-1,100601,99399
3:3:1,0,-1,100602,99398
3:4:5,0,-1,100603,99397
1:2:4,1,1,100602,99398
4:6:4,0,-1,100603,99397
4:1:5,0,-1,100604,99396
1:4:6,0,-1,100605,99395
2:4:1,1,1,100604,99396
4:2:6,1,1,100603,99397
4:5:6,0,-1,100604,99396
5:6:5,0,-1,100605,99395
2:6:4,1,1,100604,99396
5:6:2,1,1,100603,99397
2:3:1,1,1,100602,99398
3:3:3,0,-1,100603,99397
4:3:6,0,-1,100604,99396
1:5:5,0,-1,100605,99395
2:4:2,2,2,100603,99397
4:2:3,1,1,100602,99398
6:4:2,1,1,100601,99399
3:3:2,1,1,100600,99400
4:5:3,0,-1,100601,99399
1:3:5,0,-1,100602,99398
2:4:2,2,2,100600,99400
1:3:1,0,-1,100601,99399
3:1:6,0,-1,100602,99398
2:1:6,1,1,100601,99399
1:3:1,0,-1,100602,99398
2:4:4,1,1,100601,99399
5:2:3,1,1,100600,99400
6:4:2,1,1,100599,99401
3:5:1,0,-1,100600,99400
4:5:3,0,-1,100601,99399
4:3:2,1,1,100600,99400
6:6:3,0,-1,100601,99399
3:2:3,1,1,100600,99400
5:2:2,2,2,100598,99402
2:6:4,1,1,100597,99403
6:6:2,1,1,100596,99404
4:3:6,0,-1,100597,99403
1:4:2,1,1,100596,99404
6:4:5,0,-1,100597,99403
2:5:2,2,2,100595,99405
2:6:6,1,1,100594,99406
6:4:5,0,-1,100595,99405
2:6:4,1,1,100594,99406
6:2:2,2,2,100592,99408
1:1:6,0,-1,100593,99407
3:6:3,0,-1,100594,99406
1:6:1,0,-1,100595,99405
5:1:4,0,-1,100596,99404
5:1:4,0,-1,100597,99403
6:4:6,0,-1,100598,99402
4:3:6,0,-1,100599,99401
6:4:2,1,1,100598,99402
1:6:4,0,-1,100599,99401
3:5:6,0,-1,100600,99400
3:1:1,0,-1,100601,99399
5:4:2,1,1,100600,99400
2:5:5,1,1,100599,99401
4:3:5,0,-1,100600,99400
4:5:5,0,-1,100601,99399
1:2:2,2,2,100599,99401
1:6:5,0,-1,100600,99400
5:1:6,0,-1,100601,99399
4:4:5,0,-1,100602,99398
1:6:2,1,1,100601,99399
3:5:4,0,-1,100602,99398
2:6:5,1,1,100601,99399
4:4:6,0,-1,100602,99398
5:3:5,0,-1,100603,99397
1:2:4,1,1,100602,99398
3:5:4,0,-1,100603,99397
1:6:5,0,-1,100604,99396
2:4:2,2,2,100602,99398
2:3:3,1,1,100601,99399
3:6:3,0,-1,100602,99398
1:3:6,0,-1,100603,99397
4:3:4,0,-1,100604,99396
4:2:4,1,1,100603,99397
5:2:1,1,1,100602,99398
1:6:4,0,-1,100603,99397
3:5:1,0,-1,100604,99396
3:4:1,0,-1,100605,99395
2:3:5,1,1,100604,99396
2:1:4,1,1,100603,99397
5:1:2,1,1,100602,99398
3:5:4,0,-1,100603,99397
1:1:3,0,-1,100604,99396
6:4:2,1,1,100603,99397
1:3:1,0,-1,100604,99396
4:6:2,1,1,100603,99397
5:1:1,0,-1,100604,99396
6:3:2,1,1,100603,99397
6:1:2,1,1,100602,99398
4:4:6,0,-1,100603,99397
1:1:2,1,1,100602,99398
3:6:3,0,-1,100603,99397
6:6:4,0,-1,100604,99396
5:6:4,0,-1,100605,99395
4:6:5,0,-1,100606,99394
4:4:4,0,-1,100607,99393
1:6:3,0,-1,100608,99392
2:5:5,1,1,100607,99393
4:3:2,1,1,100606,99394
1:6:5,0,-1,100607,99393
5:3:3,0,-1,100608,99392
2:1:6,1,1,100607,99393
1:2:5,1,1,100606,99394
1:6:3,0,-1,100607,99393
6:3:1,0,-1,100608,99392
6:4:6,0,-1,100609,99391
1:2:5,1,1,100608,99392
5:5:5,0,-1,100609,99391
6:6:4,0,-1,100610,99390
5:4:6,0,-1,100611,99389
1:2:6,1,1,100610,99390
4:6:1,0,-1,100611,99389
5:3:4,0,-1,100612,99388
4:4:6,0,-1,100613,99387
4:3:5,0,-1,100614,99386
2:2:4,2,2,100612,99388
4:5:5,0,-1,100613,99387
2:6:3,1,1,100612,99388
5:2:4,1,1,100611,99389
4:3:5,0,-1,100612,99388
5:3:2,1,1,100611,99389
4:5:4,0,-1,100612,99388
6:1:6,0,-1,100613,99387
1:1:5,0,-1,100614,99386
3:6:4,0,-1,100615,99385
3:3:1,0,-1,100616,99384
6:2:6,1,1,100615,99385
5:4:1,0,-1,100616,99384
5:6:4,0,-1,100617,99383
3:2:4,1,1,100616,99384
4:3:1,0,-1,100617,99383
2:2:1,2,2,100615,99385
6:1:5,0,-1,100616,99384
6:2:1,1,1,100615,99385
5:3:4,0,-1,100616,99384
5:6:6,0,-1,100617,99383
5:2:4,1,1,100616,99384
1:4:5,0,-1,100617,99383
6:4:6,0,-1,100618,99382
4:6:2,1,1,100617,99383
6:1:5,0,-1,100618,99382
2:2:5,2,2,100616,99384
5:2:4,1,1,100615,99385
5:2:2,2,2,100613,99387
6:5:5,0,-1,100614,99386
3:4:3,0,-1,100615,99385
2:5:1,1,1,100614,99386
5:2:5,1,1,100613,99387
3:3:4,0,-1,100614,99386
2:1:3,1,1,100613,99387
2:1:5,1,1,100612,99388
5:5:5,0,-1,100613,99387
2:6:4,1,1,100612,99388
1:6:1,0,-1,100613,99387
2:5:1,1,1,100612,99388
1:5:1,0,-1,100613,99387
2:6:2,2,2,100611,99389
4:3:4,0,-1,100612,99388
6:4:3,0,-1,100613,99387
6:3:5,0,-1,100614,99386
5:4:2,1,1,100613,99387
6:6:2,1,1,100612,99388
5:2:2,2,2,100610,99390
2:5:1,1,1,100609,99391
3:1:1,0,-1,100610,99390
5:3:6,0,-1,100611,99389
6:6:2,1,1,100610,99390
3:5:1,0,-1,100611,99389
1:2:2,2,2,100609,99391
1:4:4,0,-1,100610,99390
1:5:3,0,-1,100611,99389
4:3:5,0,-1,100612,99388
3:6:4,0,-1,100613,99387
4:3:3,0,-1,100614,99386
5:4:2,1,1,100613,99387
4:4:4,0,-1,100614,99386
6:1:1,0,-1,100615,99385
6:6:2,1,1,100614,99386
1:6:3,0,-1,100615,99385
3:2:2,2,2,100613,99387
2:6:5,1,1,100612,99388
3:3:6,0,-1,100613,99387
4:2:2,2,2,100611,99389
2:4:1,1,1,100610,99390
2:2:4,2,2,100608,99392
2:3:3,1,1,100607,99393
4:3:1,0,-1,100608,99392
6:3:6,0,-1,100609,99391
5:2:3,1,1,100608,99392
2:6:2,2,2,100606,99394
3:2:2,2,2,100604,99396
2:1:5,1,1,100603,99397
1:1:1,0,-1,100604,99396
1:6:6,0,-1,100605,99395
5:4:1,0,-1,100606,99394
3:4:3,0,-1,100607,99393
4:2:5,1,1,100606,99394
1:1:4,0,-1,100607,99393
1:4:2,1,1,100606,99394
1:4:2,1,1,100605,99395
6:5:5,0,-1,100606,99394
5:1:1,0,-1,100607,99393
3:2:4,1,1,100606,99394
3:1:4,0,-1,100607,99393
4:1:1,0,-1,100608,99392
5:1:6,0,-1,100609,99391
5:1:6,0,-1,100610,99390
2:2:2,3,3,100607,99393
4:6:5,0,-1,100608,99392
2:4:3,1,1,100607,99393
3:2:3,1,1,100606,99394
3:6:5,0,-1,100607,99393
5:2:4,1,1,100606,99394
1:4:1,0,-1,100607,99393
5:6:5,0,-1,100608,99392
5:6:3,0,-1,100609,99391
4:2:4,1,1,100608,99392
6:6:6,0,-1,100609,99391
4:2:2,2,2,100607,99393
4:4:4,0,-1,100608,99392
1:6:6,0,-1,100609,99391
6:1:3,0,-1,100610,99390
6:4:6,0,-1,100611,99389
1:6:5,0,-1,100612,99388
4:2:5,1,1,100611,99389
2:4:6,1,1,100610,99390
3:3:5,0,-1,100611,99389
1:5:5,0,-1,100612,99388
4:6:2,1,1,100611,99389
1:4:5,0,-1,100612,99388
3:4:4,0,-1,100613,99387
6:1:6,0,-1,100614,99386
4:3:1,0,-1,100615,99385
2:2:6,2,2,100613,99387
6:4:2,1,1,100612,99388
6:6:4,0,-1,100613,99387
3:3:3,0,-1,100614,99386
6:4:3,0,-1,100615,99385
3:3:2,1,1,100614,99386
1:6:3,0,-1,100615,99385
3:6:3,0,-1,100616,99384
3:6:1,0,-1,100617,99383
1:6:5,0,-1,100618,99382
1:4:2,1,1,100617,99383
4:3:1,0,-1,100618,99382
1:2:4,1,1,100617,99383
2:4:3,1,1,100616,99384
5:2:6,1,1,100615,99385
2:2:6,2,2,100613,99387
6:4:3,0,-1,100614,99386
2:1:6,1,1,100613,99387
5:4:3,0,-1,100614,99386
5:4:4,0,-1,100615,99385
3:2:3,1,1,100614,99386
5:4:4,0,-1,100615,99385
6:1:1,0,-1,100616,99384
4:6:1,0,-1,100617,99383
3:4:4,0,-1,100618,99382
3:1:6,0,-1,100619,99381
6:6:2,1,1,100618,99382
5:2:2,2,2,100616,99384
1:3:3,0,-1,100617,99383
5:1:2,1,1,100616,99384
3:4:4,0,-1,100617,99383
5:2:6,1,1,100616,99384
1:4:6,0,-1,100617,99383
2:4:5,1,1,100616,99384
1:3:5,0,-1,100617,99383
5:3:4,0,-1,100618,99382
5:1:6,0,-1,100619,99381
5:1:2,1,1,100618,99382
6:1:3,0,-1,100619,99381
2:3:6,1,1,100618,99382
3:5:6,0,-1,100619,99381
4:2:3,1,1,100618,99382
6:2:2,2,2,100616,99384
2:4:6,1,1,100615,99385
4:5:2,1,1,100614,99386
2:5:5,1,1,100613,99387
1:4:1,0,-1,100614,99386
5:6:5,0,-1,100615,99385
2:2:2,3,3,100612,99388
4:1:6,0,-1,100613,99387
1:1:4,0,-1,100614,99386
6:4:1,0,-1,100615,99385
3:2:6,1,1,100614,99386
3:4:5,0,-1,100615,99385
6:4:4,0,-1,100616,99384
6:6:6,0,-1,100617,99383
3:3:2,1,1,100616,99384
5:5:6,0,-1,100617,99383
3:2:3,1,1,100616,99384
2:2:6,2,2,100614,99386
5:2:3,1,1,100613,99387
4:2:2,2,2,100611,99389
6:2:3,1,1,100610,99390
1:1:3,0,-1,100611,99389
3:1:3,0,-1,100612,99388
5:2:2,2,2,100610,99390
1:4:4,0,-1,100611,99389
2:4:1,1,1,100610,99390
1:5:6,0,-1,100611,99389
3:2:3,1,1,100610,99390
2:3:1,1,1,100609,99391
2:5:5,1,1,100608,99392
6:4:2,1,1,100607,99393
2:2:5,2,2,100605,99395
6:1:4,0,-1,100606,99394
2:5:2,2,2,100604,99396
1:5:4,0,-1,100605,99395
1:2:2,2,2,100603,99397
1:1:6,0,-1,100604,99396
5:5:2,1,1,100603,99397
1:4:1,0,-1,100604,99396
2:3:6,1,1,100603,99397
6:6:2,1,1,100602,99398
3:1:3,0,-1,100603,99397
4:4:3,0,-1,100604,99396
2:1:2,2,2,100602,99398
3:4:5,0,-1,100603,99397
1:4:6,0,-1,100604,99396
5:6:1,0,-1,100605,99395
2:6:2,2,2,100603,99397
3:5:1,0,-1,100604,99396
6:6:4,0,-1,100605,99395
4:6:5,0,-1,100606,99394
1:5:1,0,-1,100607,99393
1:1:5,0,-1,100608,99392
1:2:3,1,1,100607,99393
5:2:1,1,1,100606,99394
6:6:3,0,-1,100607,99393
3:6:3,0,-1,100608,99392
5:4:3,0,-1,100609,99391
3:2:5,1,1,100608,99392
1:4:4,0,-1,100609,99391
5:5:3,0,-1,100610,99390
1:1:1,0,-1,100611,99389
4:4:2,1,1,100610,99390
5:6:5,0,-1,100611,99389
4:6:6,0,-1,100612,99388
5:5:6,0,-1,100613,99387
2:4:3,1,1,100612,99388
4:6:3,0,-1,100613,99387
3:4:2,1,1,100612,99388
4:4:6,0,-1,100613,99387
3:2:3,1,1,100612,99388
1:5:2,1,1,100611,99389
6:4:6,0,-1,100612,99388
3:3:1,0,-1,100613,99387
2:2:2,3,3,100610,99390
5:5:5,0,-1,100611,99389
5:1:4,0,-1,100612,99388
5:2:3,1,1,100611,99389
5:3:2,1,1,100610,99390
3:3:3,0,-1,100611,99389
6:1:2,1,1,100610,99390
3:6:1,0,-1,100611,99389
1:3:1,0,-1,100612,99388
4:3:1,0,-1,100613,99387
2:2:4,2,2,100611,99389
3:6:5,0,-1,100612,99388
5:4:1,0,-1,100613,99387
5:4:2,1,1,100612,99388
6:6:6,0,-1,100613,99387
5:1:4,0,-1,100614,99386
2:2:4,2,2,100612,99388
1:5:4,0,-1,100613,99387
5:1:5,0,-1,100614,99386
2:5:4,1,1,100613,99387
6:3:1,0,-1,100614,99386
6:1:1,0,-1,100615,99385
2:2:6,2,2,100613,99387
4:3:4,0,-1,100614,99386
5:3:5,0,-1,100615,99385
2:6:2,2,2,100613,99387
1:1:4,0,-1,100614,99386
3:5:3,0,-1,100615,99385
5:4:1,0,-1,100616,99384
5:4:6,0,-1,100617,99383
4:1:5,0,-1,100618,99382
3:3:2,1,1,100617,99383
4:6:3,0,-1,100618,99382
2:4:2,2,2,100616,99384
1:3:1,0,-1,100617,99383
5:3:4,0,-1,100618,99382
1:5:1,0,-1,100619,99381
4:6:6,0,-1,100620,99380
5:5:4,0,-1,100621,99379
2:1:3,1,1,100620,99380
2:1:4,1,1,100619,99381
5:3:3,0,-1,100620,99380
3:2:6,1,1,100619,99381
3:5:6,0,-1,100620,99380
3:5:3,0,-1,100621,99379
1:1:4,0,-1,100622,99378
3:4:1,0,-1,100623,99377
4:2:3,1,1,100622,99378
2:2:5,2,2,100620,99380
5:1:5,0,-1,100621,99379
5:5:1,0,-1,100622,99378
3:4:2,1,1,100621,99379
1:5:6,0,-1,100622,99378
6:6:3,0,-1,100623,99377
6:4:1,0,-1,100624,99376
6:4:3,0,-1,100625,99375
5:1:2,1,1,100624,99376
6:3:6,0,-1,100625,99375
3:4:5,0,-1,100626,99374
6:6:3,0,-1,100627,99373
2:6:6,1,1,100626,99374
4:2:1,1,1,100625,99375
1:4:2,1,1,100624,99376
5:6:6,0,-1,100625,99375
6:5:2,1,1,100624,99376
2:4:2,2,2,100622,99378
4:5:3,0,-1,100623,99377
4:4:2,1,1,100622,99378
4:5:2,1,1,100621,99379
1:3:2,1,1,100620,99380
1:1:5,0,-1,100621,99379
5:5:4,0,-1,100622,99378
3:1:4,0,-1,100623,99377
5:4:1,0,-1,100624,99376
6:1:1,0,-1,100625,99375
3:6:3,0,-1,100626,99374
1:2:5,1,1,100625,99375
5:6:4,0,-1,100626,99374
6:1:5,0,-1,100627,99373
3:5:3,0,-1,100628,99372
2:1:6,1,1,100627,99373
6:3:5,0,-1,100628,99372
2:6:5,1,1,100627,99373
2:6:6,1,1,100626,99374
3:2:5,1,1,100625,99375
2:5:3,1,1,100624,99376
2:5:4,1,1,100623,99377
4:3:2,1,1,100622,99378
5:2:5,1,1,100621,99379
6:5:1,0,-1,100622,99378
6:4:6,0,-1,100623,99377
6:6:3,0,-1,100624,99376
5:6:5,0,-1,100625,99375
3:4:2,1,1,100624,99376
4:1:1,0,-1,100625,99375
6:1:3,0,-1,100626,99374
1:2:5,1,1,100625,99375
3:4:6,0,-1,100626,99374
2:6:5,1,1,100625,99375
5:1:3,0,-1,100626,99374
3:2:6,1,1,100625,99375
6:2:4,1,1,100624,99376
5:2:5,1,1,100623,99377
2:6:4,1,1,100622,99378
4:6:3,0,-1,100623,99377
5:6:1,0,-1,100624,99376
3:1:6,0,-1,100625,99375
6:2:5,1,1,100624,99376
4:6:1,0,-1,100625,99375
4:4:3,0,-1,100626,99374
2:5:5,1,1,100625,99375
4:6:6,0,-1,100626,99374
2:1:5,1,1,100625,99375
6:4:1,0,-1,100626,99374
5:5:1,0,-1,100627,99373
2:5:3,1,1,100626,99374
1:2:3,1,1,100625,99375
5:1:5,0,-1,100626,99374
3:1:1,0,-1,100627,99373
1:4:4,0,-1,100628,99372
2:5:2,2,2,100626,99374
3:4:1,0,-1,100627,99373
3:1:6,0,-1,100628,99372
4:3:6,0,-1,100629,99371
2:5:6,1,1,100628,99372
3:4:2,1,1,100627,99373
1:1:4,0,-1,100628,99372
5:4:2,1,1,100627,99373
1:1:4,0,-1,100628,99372
2:3:6,1,1,100627,99373
5:1:2,1,1,100626,99374
2:3:3,1,1,100625,99375
6:3:2,1,1,100624,99376
6:3:2,1,1,100623,99377
1:2:5,1,1,100622,99378
3:4:2,1,1,100621,99379
2:1:3,1,1,100620,99380
5:2:6,1,1,100619,99381
2:3:2,2,2,100617,99383
3:4:4,0,-1,100618,99382
4:5:2,1,1,100617,99383
5:3:1,0,-1,100618,99382
1:5:3,0,-1,100619,99381
3:3:2,1,1,100618,99382
1:6:1,0,-1,100619,99381
4:6:1,0,-1,100620,99380
2:6:2,2,2,100618,99382
3:2:4,1,1,100617,99383
3:2:6,1,1,100616,99384
6:1:6,0,-1,100617,99383
1:5:6,0,-1,100618,99382
6:5:1,0,-1,100619,99381
2:5:4,1,1,100618,99382
5:5:1,0,-1,100619,99381
3:6:6,0,-1,100620,99380
4:1:6,0,-1,100621,99379
4:4:6,0,-1,100622,99378
5:1:4,0,-1,100623,99377
3:5:5,0,-1,100624,99376
2:6:4,1,1,100623,99377
1:1:5,0,-1,100624,99376
3:3:2,1,1,100623,99377
5:3:6,0,-1,100624,99376
3:5:6,0,-1,100625,99375
3:1:5,0,-1,100626,99374
6:4:6,0,-1,100627,99373
2:3:6,1,1,100626,99374
2:1:2,2,2,100624,99376
4:1:5,0,-1,100625,99375
3:4:5,0,-1,100626,99374
5:2:2,2,2,100624,99376
5:6:5,0,-1,100625,99375
6:2:1,1,1,100624,99376
4:1:6,0,-1,100625,99375
4:1:3,0,-1,100626,99374
3:6:2,1,1,100625,99375
1:1:6,0,-1,100626,99374
6:2:5,1,1,100625,99375
6:1:3,0,-1,100626,99374
1:4:4,0,-1,100627,99373
3:1:6,0,-1,100628,99372
4:4:5,0,-1,100629,99371
4:5:4,0,-1,100630,99370
6:3:6,0,-1,100631,99369
3:3:1,0,-1,100632,99368
2:2:2,3,3,100629,99371
5:3:4,0,-1,100630,99370
4:1:4,0,-1,100631,99369
1:4:6,0,-1,100632,99368
3:6:3,0,-1,100633,99367
1:4:4,0,-1,100634,99366
6:4:3,0,-1,100635,99365
1:6:4,0,-1,100636,99364
5:6:6,0,-1,100637,99363
3:6:5,0,-1,100638,99362
4:1:5,0,-1,100639,99361
5:1:1,0,-1,100640,99360
6:5:2,1,1,100639,99361
2:5:3,1,1,100638,99362
2:2:6,2,2,100636,99364
2:6:5,1,1,100635,99365
4:4:6,0,-1,100636,99364
3:3:2,1,1,100635,99365
2:5:1,1,1,100634,99366
2:5:4,1,1,100633,99367
1:1:3,0,-1,100634,99366
6:1:1,0,-1,100635,99365
5:6:6,0,-1,100636,99364
4:5:3,0,-1,100637,99363
6:5:4,0,-1,100638,99362
3:2:2,2,2,100636,99364
3:3:5,0,-1,100637,99363
5:1:6,0,-1,100638,99362
5:1:1,0,-1,100639,99361
4:3:6,0,-1,100640,99360
4:5:6,0,-1,100641,99359
2:6:6,1,1,100640,99360
5:2:2,2,2,100638,99362
5:3:6,0,-1,100639,99361
2:4:5,1,1,100638,99362
3:1:3,0,-1,100639,99361
2:2:5,2,2,100637,99363
4:5:6,0,-1,100638,99362
6:1:4,0,-1,100639,99361
6:6:6,0,-1,100640,99360
6:6:4,0,-1,100641,99359
4:2:1,1,1,100640,99360
2:1:5,1,1,100639,99361
4:3:2,1,1,100638,99362
2:3:3,1,1,100637,99363
2:6:5,1,1,100636,99364
1:6:6,0,-1,100637,99363
2:1:3,1,1,100636,99364
5:5:5,0,-1,100637,99363
3:5:3,0,-1,100638,99362
3:5:3,0,-1,100639,99361
4:3:5,0,-1,100640,99360
1:4:3,0,-1,100641,99359
2:1:2,2,2,100639,99361
6:3:1,0,-1,100640,99360
3:2:5,1,1,100639,99361
2:1:1,1,1,100638,99362
5:2:3,1,1,100637,99363
1:2:2,2,2,100635,99365
1:2:3,1,1,100634,99366
3:6:5,0,-1,100635,99365
4:4:4,0,-1,100636,99364
6:4:3,0,-1,100637,99363
5:5:4,0,-1,100638,99362
5:5:6,0,-1,100639,99361
5:1:5,0,-1,100640,99360
6:5:4,0,-1,100641,99359
1:2:2,2,2,100639,99361
4:4:5,0,-1,100640,99360
4:6:5,0,-1,100641,99359
6:5:1,0,-1,100642,99358
4:4:5,0,-1,100643,99357
1:6:5,0,-1,100644,99356
5:1:5,0,-1,100645,99355
4:2:2,2,2,100643,99357
5:6:6,0,-1,100644,99356
3:3:4,0,-1,100645,99355
5:4:6,0,-1,100646,99354
4:1:4,0,-1,100647,99353
4:5:1,0,-1,100648,99352
4:3:5,0,-1,100649,99351
4:3:3,0,-1,100650,99350
2:1:3,1,1,100649,99351
2:5:6,1,1,100648,99352
3:3:2,1,1,100647,99353
5:2:3,1,1,100646,99354
4:1:6,0,-1,100647,99353
2:1:4,1,1,100646,99354
2:5:2,2,2,100644,99356
6:1:2,1,1,100643,99357
3:6:6,0,-1,100644,99356
3:3:1,0,-1,100645,99355
5:6:5,0,-1,100646,99354
5:3:2,1,1,100645,99355
6:3:1,0,-1,100646,99354
2:1:4,1,1,100645,99355
5:6:1,0,-1,100646,99354
6:1:3,0,-1,100647,99353
6:3:2,1,1,100646,99354
6:1:6,0,-1,100647,99353
6:5:2,1,1,100646,99354
1:1:6,0,-1,100647,99353
4:5:6,0,-1,100648,99352
2:3:1,1,1,100647,99353
4:2:5,1,1,100646,99354
4:1:6,0,-1,100647,99353
1:1:6,0,-1,100648,99352
6:1:4,0,-1,100649,99351
1:6:6,0,-1,100650,99350
4:3:4,0,-1,100651,99349
5:6:4,0,-1,100652,99348
4:5:4,0,-1,100653,99347
4:5:3,0,-1,100654,99346
6:3:5,0,-1,100655,99345
6:3:6,0,-1,100656,99344
2:3:3,1,1,100655,99345
2:6:2,2,2,100653,99347
1:4:5,0,-1,100654,99346
3:2:5,1,1,100653,99347
5:6:1,0,-1,100654,99346
4:5:1,0,-1,100655,99345
3:6:5,0,-1,100656,99344
5:4:6,0,-1,100657,99343
2:1:1,1,1,100656,99344
6:6:5,0,-1,100657,99343
3:4:2,1,1,100656,99344
4:4:5,0,-1,100657,99343
2:6:5,1,1,100656,99344
5:3:5,0,-1,100657,99343
5:6:5,0,-1,100658,99342
3:5:3,0,-1,100659,99341
5:5:6,0,-1,100660,99340
2:5:2,2,2,100658,99342
2:5:5,1,1,100657,99343
4:3:6,0,-1,100658,99342
4:6:2,1,1,100657,99343
5:2:3,1,1,100656,99344
3:2:6,1,1,100655,99345
2:5:6,1,1,100654,99346
5:6:6,0,-1,100655,99345
3:5:1,0,-1,100656,99344
3:4:2,1,1,100655,99345
2:1:1,1,1,100654,99346
5:2:4,1,1,100653,99347
4:4:4,0,-1,100654,99346
4:1:6,0,-1,100655,99345
1:1:4,0,-1,100656,99344
1:6:2,1,1,100655,99345
3:5:5,0,-1,100656,99344
2:4:1,1,1,100655,99345
3:5:1,0,-1,100656,99344
4:3:6,0,-1,100657,99343
5:3:3,0,-1,100658,99342
4:3:2,1,1,100657,99343
6:3:6,0,-1,100658,99342
5:4:6,0,-1,100659,99341
3:2:1,1,1,100658,99342
3:2:6,1,1,100657,99343
3:1:6,0,-1,100658,99342
2:3:3,1,1,100657,99343
3:2:5,1,1,100656,99344
4:3:6,0,-1,100657,99343
5:3:2,1,1,100656,99344
6:3:6,0,-1,100657,99343
3:4:5,0,-1,100658,99342
1:6:6,0,-1,100659,99341
1:2:3,1,1,100658,99342
5:4:4,0,-1,100659,99341
6:3:6,0,-1,100660,99340
1:6:6,0,-1,100661,99339
3:1:5,0,-1,100662,99338
6:3:2,1,1,100661,99339
4:5:3,0,-1,100662,99338
6:2:2,2,2,100660,99340
5:5:1,0,-1,100661,99339
2:6:2,2,2,100659,99341
4:1:6,0,-1,100660,99340
1:1:1,0,-1,100661,99339
6:1:1,0,-1,100662,99338
1:5:6,0,-1,100663,99337
4:2:6,1,1,100662,99338
5:1:3,0,-1,100663,99337
2:6:2,2,2,100661,99339
1:2:6,1,1,100660,99340
3:6:3,0,-1,100661,99339
1:2:2,2,2,100659,99341
2:4:6,1,1,100658,99342
5:2:4,1,1,100657,99343
6:5:6,0,-1,100658,99342
4:5:1,0,-1,100659,99341
5:3:2,1,1,100658,99342
2:3:5,1,1,100657,99343
4:4:1,0,-1,100658,99342
3:1:1,0,-1,100659,99341
3:3:2,1,1,100658,99342
5:5:2,1,1,100657,99343
6:5:2,1,1,100656,99344
1:1:6,0,-1,100657,99343
5:6:5,0,-1,100658,99342
4:5:1,0,-1,100659,99341
5:6:2,1,1,100658,99342
5:4:1,0,-1,100659,99341
2:2:4,2,2,100657,99343
5:3:4,0,-1,100658,99342
2:5:4,1,1,100657,99343
6:6:1,0,-1,100658,99342
6:5:5,0,-1,100659,99341
4:3:5,0,-1,100660,99340
2:6:5,1,1,100659,99341
2:6:1,1,1,100658,99342
6:6:6,0,-1,100659,99341
2:1:5,1,1,100658,99342
2:1:4,1,1,100657,99343
3:5:4,0,-1,100658,99342
3:6:6,0,-1,100659,99341
3:4:1,0,-1,100660,99340
4:4:3,0,-1,100661,99339
1:6:3,0,-1,100662,99338
1:3:2,1,1,100661,99339
6:3:6,0,-1,100662,99338
5:5:1,0,-1,100663,99337
1:5:3,0,-1,100664,99336
2:5:3,1,1,100663,99337
2:5:6,1,1,100662,99338
1:3:2,1,1,100661,99339
5:2:4,1,1,100660,99340
6:4:4,0,-1,100661,99339
4:1:1,0,-1,100662,99338
4:6:5,0,-1,100663,99337
1:6:6,0,-1,100664,99336
3:3:6,0,-1,100665,99335
2:1:5,1,1,100664,99336
2:1:5,1,1,100663,99337
3:4:4,0,-1,100664,99336
3:4:2,1,1,100663,99337
6:6:3,0,-1,100664,99336
4:2:3,1,1,100663,99337
6:2:6,1,1,100662,99338
4:6:2,1,1,100661,99339
2:5:2,2,2,100659,99341
1:4:2,1,1,100658,99342
4:5:5,0,-1,100659,99341
3:1:2,1,1,100658,99342
4:6:5,0,-1,100659,99341
5:6:2,1,1,100658,99342
5:2:1,1,1,100657,99343
4:1:6,0,-1,100658,99342
1:6:5,0,-1,100659,99341
4:3:4,0,-1,100660,99340
3:3:4,0,-1,100661,99339
2:1:2,2,2,100659,99341
5:3:6,0,-1,100660,99340
3:1:3,0,-1,100661,99339
2:1:2,2,2,100659,99341
6:3:6,0,-1,100660,99340
4:2:2,2,2,100658,99342
4:1:2,1,1,100657,99343
4:2:4,1,1,100656,99344
3:2:4,1,1,100655,99345
1:5:5,0,-1,100656,99344
6:4:1,0,-1,100657,99343
5:6:4,0,-1,100658,99342
6:3:2,1,1,100657,99343
3:2:1,1,1,100656,99344
5:6:6,0,-1,100657,99343
6:4:2,1,1,100656,99344
5:6:1,0,-1,100657,99343
2:5:1,1,1,100656,99344
5:5:3,0,-1,100657,99343
5:2:1,1,1,100656,99344
3:5:6,0,-1,100657,99343
5:5:4,0,-1,100658,99342
1:4:3,0,-1,100659,99341
5:5:6,0,-1,100660,99340
2:1:1,1,1,100659,99341
5:2:5,1,1,100658,99342
4:1:3,0,-1,100659,99341
1:3:3,0,-1,100660,99340
1:4:2,1,1,100659,99341
5:4:2,1,1,100658,99342
4:1:1,0,-1,100659,99341
6:5:2,1,1,100658,99342
3:4:1,0,-1,100659,99341
3:6:2,1,1,100658,99342
6:4:3,0,-1,100659,99341
4:4:5,0,-1,100660,99340
2:2:6,2,2,100658,99342
1:2:5,1,1,100657,99343
6:5:2,1,1,100656,99344
2:6:6,1,1,100655,99345
1:2:5,1,1,100654,99346
2:2:2,3,3,100651,99349
2:1:6,1,1,100650,99350
3:3:5,0,-1,100651,99349
6:3:2,1,1,100650,99350
4:2:2,2,2,100648,99352
1:2:4,1,1,100647,99353
1:3:2,1,1,100646,99354
5:4:6,0,-1,100647,99353
2:3:6,1,1,100646,99354
1:1:4,0,-1,100647,99353
1:5:2,1,1,100646,99354
5:2:5,1,1,100645,99355
3:2:5,1,1,100644,99356
6:3:1,0,-1,100645,99355
2:5:6,1,1,100644,99356
5:1:6,0,-1,100645,99355
6:1:6,0,-1,100646,99354
2:2:6,2,2,100644,99356
1:4:5,0,-1,100645,99355
3:6:2,1,1,100644,99356
2:4:4,1,1,100643,99357
5:6:5,0,-1,100644,99356
3:3:4,0,-1,100645,99355
2:3:6,1,1,100644,99356
3:3:1,0,-1,100645,99355
4:5:5,0,-1,100646,99354
1:6:3,0,-1,100647,99353
4:4:6,0,-1,100648,99352
4:5:2,1,1,100647,99353
2:3:3,1,1,100646,99354
5:3:3,0,-1,100647,99353
5:4:6,0,-1,100648,99352
1:2:4,1,1,100647,99353
2:3:5,1,1,100646,99354
2:5:4,1,1,100645,99355
3:5:6,0,-1,100646,99354
2:5:4,1,1,100645,99355
4:4:3,0,-1,100646,99354
2:4:5,1,1,100645,99355
4:4:1,0,-1,100646,99354
5:2:4,1,1,100645,99355
4:2:3,1,1,100644,99356
3:2:2,2,2,100642,99358
6:4:2,1,1,100641,99359
6:3:3,0,-1,100642,99358
5:5:6,0,-1,100643,99357
6:2:6,1,1,100642,99358
5:3:1,0,-1,100643,99357
4:2:1,1,1,100642,99358
1:3:6,0,-1,100643,99357
2:4:2,2,2,100641,99359
6:2:4,1,1,100640,99360
2:3:6,1,1,100639,99361
6:2:3,1,1,100638,99362
6:4:5,0,-1,100639,99361
3:4:6,0,-1,100640,99360
3:4:1,0,-1,100641,99359
3:1:4,0,-1,100642,99358
6:4:2,1,1,100641,99359
4:4:1,0,-1,100642,99358
1:4:3,0,-1,100643,99357
1:4:6,0,-1,100644,99356
1:4:1,0,-1,100645,99355
4:3:2,1,1,100644,99356
1:4:6,0,-1,100645,99355
4:6:6,0,-1,100646,99354
6:1:2,1,1,100645,99355
3:6:3,0,-1,100646,99354
6:6:5,0,-1,100647,99353
4:3:3,0,-1,100648,99352
4:1:4,0,-1,100649,99351
6:2:1,1,1,100648,99352
2:4:4,1,1,100647,99353
4:4:4,0,-1,100648,99352
4:2:3,1,1,100647,99353
5:6:3,0,-1,100648,99352
4:6:5,0,-1,100649,99351
3:1:5,0,-1,100650,99350
2:2:1,2,2,100648,99352
6:3:3,0,-1,100649,99351
5:4:4,0,-1,100650,99350
2:2:6,2,2,100648,99352
6:1:1,0,-1,100649,99351
2:6:6,1,1,100648,99352
4:3:4,0,-1,100649,99351
2:2:1,2,2,100647,99353
6:4:4,0,-1,100648,99352
2:4:6,1,1,100647,99353
6:3:4,0,-1,100648,99352
4:4:6,0,-1,100649,99351
6:5:1,0,-1,100650,99350
3:2:3,1,1,100649,99351
6:1:3,0,-1,100650,99350
3:2:4,1,1,100649,99351
4:4:4,0,-1,100650,99350
4:2:4,1,1,100649,99351
2:5:6,1,1,100648,99352
6:1:1,0,-1,100649,99351
1:4:3,0,-1,100650,99350
2:6:2,2,2,100648,99352
5:4:5,0,-1,100649,99351
4:6:2,1,1,100648,99352
1:3:2,1,1,100647,99353
1:3:1,0,-1,100648,99352
4:4:2,1,1,100647,99353
6:2:6,1,1,100646,99354
3:3:1,0,-1,100647,99353
2:6:3,1,1,100646,99354
5:3:6,0,-1,100647,99353
1:6:4,0,-1,100648,99352
5:4:5,0,-1,100649,99351
6:5:5,0,-1,100650,99350
1:2:2,2,2,100648,99352
5:1:4,0,-1,100649,99351
4:5:5,0,-1,100650,99350
5:1:1,0,-1,100651,99349
2:2:1,2,2,100649,99351
1:6:4,0,-1,100650,99350
5:4:3,0,-1,100651,99349
6:1:3,0,-1,100652,99348
3:1:3,0,-1,100653,99347
3:4:3,0,-1,100654,99346
4:4:4,0,-1,100655,99345
3:6:5,0,-1,100656,99344
2:2:6,2,2,100654,99346
1:2:1,1,1,100653,99347
4:5:4,0,-1,100654,99346
5:6:1,0,-1,100655,99345
6:2:4,1,1,100654,99346
4:6:4,0,-1,100655,99345
2:6:1,1,1,100654,99346
6:2:6,1,1,100653,99347
5:2:6,1,1,100652,99348
5:3:5,0,-1,100653,99347
1:6:6,0,-1,100654,99346
4:4:1,0,-1,100655,99345
6:6:3,0,-1,100656,99344
5:5:2,1,1,100655,99345
3:1:6,0,-1,100656,99344
3:3:2,1,1,100655,99345
5:5:1,0,-1,100656,99344
5:4:5,0,-1,100657,99343
1:5:2,1,1,100656,99344
2:5:4,1,1,100655,99345
2:3:5,1,1,100654,99346
5:4:4,0,-1,100655,99345
6:6:4,0,-1,100656,99344
2:3:2,2,2,100654,99346
1:4:1,0,-1,100655,99345
5:5:2,1,1,100654,99346
6:2:3,1,1,100653,99347
4:4:1,0,-1,100654,99346
4:6:5,0,-1,100655,99345
3:4:3,0,-1,100656,99344
3:3:5,0,-1,100657,99343
3:6:6,0,-1,100658,99342
1:1:1,0,-1,100659,99341
6:6:4,0,-1,100660,99340
6:5:5,0,-1,100661,99339
2:4:1,1,1,100660,99340
4:2:1,1,1,100659,99341
4:4:4,0,-1,100660,99340
2:2:2,3,3,100657,99343
4:5:2,1,1,100656,99344
1:5:2,1,1,100655,99345
4:1:4,0,-1,100656,99344
5:6:5,0,-1,100657,99343
5:2:1,1,1,100656,99344
3:3:2,1,1,100655,99345
3:3:4,0,-1,100656,99344
1:6:5,0,-1,100657,99343
1:6:2,1,1,100656,99344
3:4:2,1,1,100655,99345
5:4:2,1,1,100654,99346
1:3:5,0,-1,100655,99345
2:4:6,1,1,100654,99346
6:1:4,0,-1,100655,99345
6:4:2,1,1,100654,99346
3:4:5,0,-1,100655,99345
1:3:1,0,-1,100656,99344
4:3:2,1,1,100655,99345
6:5:3,0,-1,100656,99344
5:6:2,1,1,100655,99345
5:1:1,0,-1,100656,99344
6:6:1,0,-1,100657,99343
2:1:5,1,1,100656,99344
6:4:5,0,-1,100657,99343
2:3:6,1,1,100656,99344
3:5:4,0,-1,100657,99343
4:6:2,1,1,100656,99344
2:2:2,3,3,100653,99347
3:4:6,0,-1,100654,99346
3:1:3,0,-1,100655,99345
5:3:1,0,-1,100656,99344
5:5:5,0,-1,100657,99343
1:5:2,1,1,100656,99344
6:3:5,0,-1,100657,99343
1:4:5,0,-1,100658,99342
5:4:1,0,-1,100659,99341
4:1:3,0,-1,100660,99340
2:6:5,1,1,100659,99341
5:1:1,0,-1,100660,99340
2:3:5,1,1,100659,99341
6:6:1,0,-1,100660,99340
1:6:3,0,-1,100661,99339
6:3:2,1,1,100660,99340
1:2:3,1,1,100659,99341
2:1:6,1,1,100658,99342
2:2:5,2,2,100656,99344
4:4:6,0,-1,100657,99343
3:6:2,1,1,100656,99344
1:5:2,1,1,100655,99345
5:3:4,0,-1,100656,99344
3:5:5,0,-1,100657,99343
2:5:3,1,1,100656,99344
6:3:4,0,-1,100657,99343
4:3:1,0,-1,100658,99342
6:1:2,1,1,100657,99343
5:5:1,0,-1,100658,99342
6:5:1,0,-1,100659,99341
5:1:1,0,-1,100660,99340
1:2:6,1,1,100659,99341
6:1:4,0,-1,100660,99340
4:1:2,1,1,100659,99341
6:4:5,0,-1,100660,99340
1:6:3,0,-1,100661,99339
3:2:3,1,1,100660,99340
4:6:1,0,-1,100661,99339
6:1:1,0,-1,100662,99338
3:5:2,1,1,100661,99339
1:5:2,1,1,100660,99340
3:3:3,0,-1,100661,99339
3:1:1,0,-1,100662,99338
2:6:6,1,1,100661,99339
2:2:2,3,3,100658,99342
4:1:3,0,-1,100659,99341
2:3:4,1,1,100658,99342
1:6:5,0,-1,100659,99341
5:6:2,1,1,100658,99342
2:5:1,1,1,100657,99343
2:4:4,1,1,100656,99344
4:4:6,0,-1,100657,99343
6:2:3,1,1,100656,99344
2:3:3,1,1,100655,99345
2:4:1,1,1,100654,99346
5:2:4,1,1,100653,99347
1:6:4,0,-1,100654,99346
4:1:2,1,1,100653,99347
1:6:4,0,-1,100654,99346
5:2:3,1,1,100653,99347
5:3:2,1,1,100652,99348
5:5:4,0,-1,100653,99347
4:5:5,0,-1,100654,99346
5:2:3,1,1,100653,99347
4:6:3,0,-1,100654,99346
1:2:1,1,1,100653,99347
2:3:2,2,2,100651,99349
1:4:1,0,-1,100652,99348
3:4:3,0,-1,100653,99347
3:5:1,0,-1,100654,99346
6:3:1,0,-1,100655,99345
4:3:1,0,-1,100656,99344
4:3:6,0,-1,100657,99343
4:3:3,0,-1,100658,99342
1:1:4,0,-1,100659,99341
1:2:2,2,2,100657,99343
4:1:3,0,-1,100658,99342
6:5:3,0,-1,100659,99341
6:2:3,1,1,100658,99342
1:5:4,0,-1,100659,99341
2:2:3,2,2,100657,99343
3:6:3,0,-1,100658,99342
3:6:2,1,1,100657,99343
1:3:5,0,-1,100658,99342
3:2:4,1,1,100657,99343
3:2:6,1,1,100656,99344
5:2:6,1,1,100655,99345
5:5:4,0,-1,100656,99344
1:5:5,0,-1,100657,99343
5:2:4,1,1,100656,99344
3:1:6,0,-1,100657,99343
4:4:1,0,-1,100658,99342
4:3:6,0,-1,100659,99341
2:3:5,1,1,100658,99342
4:1:4,0,-1,100659,99341
5:3:5,0,-1,100660,99340
4:5:3,0,-1,100661,99339
4:1:6,0,-1,100662,99338
1:4:4,0,-1,100663,99337
6:2:3,1,1,100662,99338
4:6:2,1,1,100661,99339
6:4:6,0,-1,100662,99338
2:4:4,1,1,100661,99339
3:6:2,1,1,100660,99340
1:4:1,0,-1,100661,99339
3:6:2,1,1,100660,99340
1:5:2,1,1,100659,99341
3:2:2,2,2,100657,99343
3:1:3,0,-1,100658,99342
2:5:6,1,1,100657,99343
3:6:3,0,-1,100658,99342
6:3:2,1,1,100657,99343
6:1:6,0,-1,100658,99342
6:6:2,1,1,100657,99343
1:5:2,1,1,100656,99344
1:2:5,1,1,100655,99345
5:4:2,1,1,100654,99346
4:6:6,0,-1,100655,99345
2:2:1,2,2,100653,99347
2:2:2,3,3,100650,99350
3:4:4,0,-1,100651,99349
6:3:3,0,-1,100652,99348
2:3:3,1,1,100651,99349
2:6:5,1,1,100650,99350
5:2:5,1,1,100649,99351
6:3:1,0,-1,100650,99350
1:5:1,0,-1,100651,99349
5:4:1,0,-1,100652,99348
4:2:3,1,1,100651,99349
4:2:3,1,1,100650,99350
4:2:6,1,1,100649,99351
2:5:2,2,2,100647,99353
1:1:5,0,-1,100648,99352
6:6:1,0,-1,100649,99351
3:4:3,0,-1,100650,99350
3:3:5,0,-1,100651,99349
2:5:4,1,1,100650,99350
3:4:1,0,-1,100651,99349
5:4:4,0,-1,100652,99348
2:6:2,2,2,100650,99350
1:2:5,1,1,100649,99351
1:5:6,0,-1,100650,99350
1:6:4,0,-1,100651,99349
4:6:4,0,-1,100652,99348
5:1:4,0,-1,100653,99347
5:1:4,0,-1,100654,99346
5:1:6,0,-1,100655,99345
6:4:5,0,-1,100656,99344
4:3:4,0,-1,100657,99343
2:5:6,1,1,100656,99344
6:6:5,0,-1,100657,99343
2:2:3,2,2,100655,99345
6:1:4,0,-1,100656,99344
1:5:3,0,-1,100657,99343
5:5:5,0,-1,100658,99342
4:5:2,1,1,100657,99343
5:6:1,0,-1,100658,99342
6:3:4,0,-1,100659,99341
5:3:3,0,-1,100660,99340
1:6:4,0,-1,100661,99339
5:3:6,0,-1,100662,99338
5:1:5,0,-1,100663,99337
6:5:5,0,-1,100664,99336
5:4:4,0,-1,100665,99335
1:5:1,0,-1,100666,99334
3:3:2,1,1,100665,99335
4:4:1,0,-1,100666,99334
6:2:6,1,1,100665,99335
6:6:1,0,-1,100666,99334
6:3:3,0,-1,100667,99333
5:5:6,0,-1,100668,99332
3:3:2,1,1,100667,99333
5:2:2,2,2,100665,99335
5:2:2,2,2,100663,99337
3:1:6,0,-1,100664,99336
4:1:6,0,-1,100665,99335
6:5:4,0,-1,100666,99334
4:6:2,1,1,100665,99335
6:4:3,0,-1,100666,99334
2:3:3,1,1,100665,99335
6:6:5,0,-1,100666,99334
6:4:3,0,-1,100667,99333
2:3:5,1,1,100666,99334
5:3:5,0,-1,100667,99333
3:1:1,0,-1,100668,99332
2:2:4,2,2,100666,99334
3:6:5,0,-1,100667,99333
6:5:2,1,1,100666,99334
3:5:4,0,-1,100667,99333
1:6:4,0,-1,100668,99332
6:1:1,0,-1,100669,99331
1:4:3,0,-1,100670,99330
6:6:6,0,-1,100671,99329
3:2:6,1,1,100670,99330
6:6:5,0,-1,100671,99329
2:5:3,1,1,100670,99330
3:4:4,0,-1,100671,99329
4:3:3,0,-1,100672,99328
4:4:4,0,-1,100673,99327
6:2:3,1,1,100672,99328
3:6:2,1,1,100671,99329
5:4:5,0,-1,100672,99328
1:5:2,1,1,100671,99329
3:2:3,1,1,100670,99330
4:2:2,2,2,100668,99332
3:4:2,1,1,100667,99333
1:2:6,1,1,100666,99334
6:2:6,1,1,100665,99335
2:2:5,2,2,100663,99337
2:5:3,1,1,100662,99338
4:1:4,0,-1,100663,99337
1:4:4,0,-1,100664,99336
1:1:1,0,-1,100665,99335
1:3:2,1,1,100664,99336
5:3:1,0,-1,100665,99335
6:5:5,0,-1,100666,99334
2:2:6,2,2,100664,99336
6:5:6,0,-1,100665,99335
1:5:4,0,-1,100666,99334
4:5:6,0,-1,100667,99333
6:6:3,0,-1,100668,99332
4:3:2,1,1,100667,99333
4:6:3,0,-1,100668,99332
4:2:1,1,1,100667,99333
1:3:6,0,-1,100668,99332
2:4:4,1,1,100667,99333
5:5:2,1,1,100666,99334
4:6:5,0,-1,100667,99333
1:1:6,0,-1,100668,99332
3:3:6,0,-1,100669,99331
1:1:4,0,-1,100670,99330
1:2:2,2,2,100668,99332
1:5:5,0,-1,100669,99331
4:5:1,0,-1,100670,99330
2:3:5,1,1,100669,99331
3:2:5,1,1,100668,99332
6:2:4,1,1,100667,99333
3:6:4,0,-1,100668,99332
5:2:2,2,2,100666,99334
1:3:2,1,1,100665,99335
1:3:3,0,-1,100666,99334
5:4:3,0,-1,100667,99333
6:4:2,1,1,100666,99334
2:1:5,1,1,100665,99335
6:5:4,0,-1,100666,99334
3:2:6,1,1,100665,99335
4:3:4,0,-1,100666,99334
2:3:1,1,1,100665,99335
4:4:2,1,1,100664,99336
2:5:3,1,1,100663,99337
1:2:6,1,1,100662,99338
3:3:5,0,-1,100663,99337
2:6:1,1,1,100662,99338
2:2:3,2,2,100660,99340
6:4:4,0,-1,100661,99339
4:2:2,2,2,100659,99341
5:1:6,0,-1,100660,99340
2:3:3,1,1,100659,99341
4:2:5,1,1,100658,99342
5:6:6,0,-1,100659,99341
1:1:3,0,-1,100660,99340
1:4:2,1,1,100659,99341
4:3:5,0,-1,100660,99340
2:6:1,1,1,100659,99341
5:4:6,0,-1,100660,99340
2:5:1,1,1,100659,99341
1:6:3,0,-1,100660,99340
6:6:3,0,-1,100661,99339
2:5:2,2,2,100659,99341
3:2:5,1,1,100658,99342
2:6:3,1,1,100657,99343
1:4:1,0,-1,100658,99342
5:2:6,1,1,100657,99343
6:2:5,1,1,100656,99344
6:6:6,0,-1,100657,99343
3:1:6,0,-1,100658,99342
5:5:4,0,-1,100659,99341
1:4:3,0,-1,100660,99340
6:5:3,0,-1,100661,99339
1:5:2,1,1,100660,99340
3:5:3,0,-1,100661,99339
1:2:2,2,2,100659,99341
3:6:4,0,-1,100660,99340
5:6:5,0,-1,100661,99339
4:2:4,1,1,100660,99340
5:6:6,0,-1,100661,99339
1:1:6,0,-1,100662,99338
5:6:2,1,1,100661,99339
2:4:6,1,1,100660,99340
2:1:3,1,1,100659,99341
2:4:1,1,1,100658,99342
2:4:6,1,1,100657,99343
5:1:3,0,-1,100658,99342
6:5:6,0,-1,100659,99341
1:3:4,0,-1,100660,99340
6:5:3,0,-1,100661,99339
4:6:6,0,-1,100662,99338
5:5:1,0,-1,100663,99337
5:2:3,1,1,100662,99338
3:3:6,0,-1,100663,99337
6:2:4,1,1,100662,99338
5:4:2,1,1,100661,99339
3:5:1,0,-1,100662,99338
3:5:5,0,-1,100663,99337
6:2:3,1,1,100662,99338
3:4:3,0,-1,100663,99337
2:2:1,2,2,100661,99339
1:3:6,0,-1,100662,99338
5:2:4,1,1,100661,99339
4:2:6,1,1,100660,99340
2:6:3,1,1,100659,99341
3:1:3,0,-1,100660,99340
1:5:1,0,-1,100661,99339
2:6:6,1,1,100660,99340
5:6:3,0,-1,100661,99339
4:4:2,1,1,100660,99340
1:4:1,0,-1,100661,99339
4:1:3,0,-1,100662,99338
4:1:1,0,-1,100663,99337
1:1:6,0,-1,100664,99336
2:4:6,1,1,100663,99337
5:6:5,0,-1,100664,99336
5:2:4,1,1,100663,99337
1:2:5,1,1,100662,99338
2:6:4,1,1,100661,99339
1:3:3,0,-1,100662,99338
4:3:5,0,-1,100663,99337
2:5:6,1,1,100662,99338
5:1:2,1,1,100661,99339
2:3:2,2,2,100659,99341
5:5:6,0,-1,100660,99340
5:2:4,1,1,100659,99341
2:3:1,1,1,100658,99342
1:1:4,0,-1,100659,99341
3:1:4,0,-1,100660,99340
4:6:6,0,-1,100661,99339
3:5:2,1,1,100660,99340
5:6:2,1,1,100659,99341
1:4:5,0,-1,100660,99340
2:3:1,1,1,100659,99341
2:1:6,1,1,100658,99342
1:5:3,0,-1,100659,99341
1:3:1,0,-1,100660,99340
6:2:6,1,1,100659,99341
5:3:2,1,1,100658,99342
4:1:5,0,-1,100659,99341
1:3:3,0,-1,100660,99340
4:4:5,0,-1,100661,99339
4:4:5,0,-1,100662,99338
2:6:4,1,1,100661,99339
3:1:1,0,-1,100662,99338
3:5:2,1,1,100661,99339
2:6:1,1,1,100660,99340
1:3:5,0,-1,100661,99339
5:6:2,1,1,100660,99340
1:6:2,1,1,100659,99341
5:2:4,1,1,100658,99342
4:2:6,1,1,100657,99343
5:4:6,0,-1,100658,99342
1:1:4,0,-1,100659,99341
6:2:1,1,1,100658,99342
1:2:6,1,1,100657,99343
6:3:3,0,-1,100658,99342
2:4:4,1,1,100657,99343
5:5:3,0,-1,100658,99342
3:4:5,0,-1,100659,99341
4:1:6,0,-1,100660,99340
5:4:3,0,-1,100661,99339
5:1:5,0,-1,100662,99338
4:4:1,0,-1,100663,99337
1:6:1,0,-1,100664,99336
4:4:6,0,-1,100665,99335
2:4:1,1,1,100664,99336
4:4:1,0,-1,100665,99335
6:5:1,0,-1,100666,99334
1:2:3,1,1,100665,99335
5:6:4,0,-1,100666,99334
3:5:1,0,-1,100667,99333
6:5:4,0,-1,100668,99332
2:3:1,1,1,100667,99333
1:3:6,0,-1,100668,99332
1:1:4,0,-1,100669,99331
5:4:1,0,-1,100670,99330
6:5:6,0,-1,100671,99329
2:4:1,1,1,100670,99330
2:4:6,1,1,100669,99331
3:3:4,0,-1,100670,99330
6:3:6,0,-1,100671,99329
5:6:2,1,1,100670,99330
1:4:6,0,-1,100671,99329
4:6:6,0,-1,100672,99328
2:3:1,1,1,100671,99329
3:3:5,0,-1,100672,99328
1:3:6,0,-1,100673,99327
5:2:5,1,1,100672,99328
6:5:1,0,-1,100673,99327
4:1:4,0,-1,100674,99326
4:4:1,0,-1,100675,99325
6:1:1,0,-1,100676,99324
5:2:4,1,1,100675,99325
5:1:6,0,-1,100676,99324
2:3:2,2,2,100674,99326
3:3:1,0,-1,100675,99325
1:1:5,0,-1,100676,99324
5:6:6,0,-1,100677,99323
4:4:4,0,-1,100678,99322
6:5:5,0,-1,100679,99321
6:1:2,1,1,100678,99322
1:5:5,0,-1,100679,99321
4:5:4,0,-1,100680,99320
1:1:6,0,-1,100681,99319
5:1:2,1,1,100680,99320
3:3:1,0,-1,100681,99319
2:4:1,1,1,100680,99320
2:5:5,1,1,100679,99321
4:6:1,0,-1,100680,99320
5:2:3,1,1,100679,99321
3:3:5,0,-1,100680,99320
3:3:1,0,-1,100681,99319
5:3:1,0,-1,100682,99318
2:6:3,1,1,100681,99319
4:1:6,0,-1,100682,99318
2:6:3,1,1,100681,99319
2:2:4,2,2,100679,99321
2:4:6,1,1,100678,99322
3:1:3,0,-1,100679,99321
3:6:2,1,1,100678,99322
1:2:4,1,1,100677,99323
5:4:5,0,-1,100678,99322
5:1:1,0,-1,100679,99321
5:6:1,0,-1,100680,99320
3:3:4,0,-1,100681,99319
3:3:3,0,-1,100682,99318
1:5:3,0,-1,100683,99317
4:3:6,0,-1,100684,99316
4:6:1,0,-1,100685,99315
5:3:3,0,-1,100686,99314
3:4:6,0,-1,100687,99313
4:2:1,1,1,100686,99314
3:2:5,1,1,100685,99315
1:2:2,2,2,100683,99317
1:2:1,1,1,100682,99318
3:2:4,1,1,100681,99319
3:1:1,0,-1,100682,99318
3:3:3,0,-1,100683,99317
4:6:1,0,-1,100684,99316
1:2:4,1,1,100683,99317
3:6:4,0,-1,100684,99316
5:5:5,0,-1,100685,99315
6:1:2,1,1,100684,99316
1:3:2,1,1,100683,99317
3:3:2,1,1,100682,99318
1:4:5,0,-1,100683,99317
4:6:2,1,1,100682,99318
1:4:6,0,-1,100683,99317
1:3:5,0,-1,100684,99316
2:2:4,2,2,100682,99318
5:1:2,1,1,100681,99319
5:2:1,1,1,100680,99320
2:5:5,1,1,100679,99321
3:4:3,0,-1,100680,99320
5:1:3,0,-1,100681,99319
2:1:3,1,1,100680,99320
3:1:1,0,-1,100681,99319
6:1:2,1,1,100680,99320
5:4:4,0,-1,100681,99319
1:2:4,1,1,100680,99320
3:4:3,0,-1,100681,99319
4:2:4,1,1,100680,99320
1:1:5,0,-1,100681,99319
5:6:4,0,-1,100682,99318
5:3:6,0,-1,100683,99317
1:3:3,0,-1,100684,99316
1:5:1,0,-1,100685,99315
6:5:2,1,1,100684,99316
1:5:4,0,-1,100685,99315
2:6:1,1,1,100684,99316
1:6:3,0,-1,100685,99315
2:5:6,1,1,100684,99316
4:5:2,1,1,100683,99317
3:3:4,0,-1,100684,99316
5:5:5,0,-1,100685,99315
4:2:4,1,1,100684,99316
6:3:6,0,-1,100685,99315
4:3:5,0,-1,100686,99314
5:6:3,0,-1,100687,99313
2:6:2,2,2,100685,99315
2:5:4,1,1,100684,99316
5:3:6,0,-1,100685,99315
1:5:5,0,-1,100686,99314
1:4:3,0,-1,100687,99313
6:6:2,1,1,100686,99314
4:4:4,0,-1,100687,99313
6:5:3,0,-1,100688,99312
5:1:6,0,-1,100689,99311
1:1:1,0,-1,100690,99310
4:3:2,1,1,100689,99311
2:2:1,2,2,100687,99313
3:6:1,0,-1,100688,99312
3:1:3,0,-1,100689,99311
4:6:4,0,-1,100690,99310
5:1:4,0,-1,100691,99309
4:6:6,0,-1,100692,99308
5:1:6,0,-1,100693,99307
6:5:5,0,-1,100694,99306
4:1:6,0,-1,100695,99305
6:3:1,0,-1,100696,99304
1:3:6,0,-1,100697,99303
2:3:4,1,1,100696,99304
4:3:4,0,-1,100697,99303
1:1:3,0,-1,100698,99302
4:6:3,0,-1,100699,99301
1:2:1,1,1,100698,99302
1:2:3,1,1,100697,99303
5:4:2,1,1,100696,99304
2:6:6,1,1,100695,99305
4:5:2,1,1,100694,99306
4:4:3,0,-1,100695,99305
4:1:2,1,1,100694,99306
5:5:6,0,-1,100695,99305
1:3:6,0,-1,100696,99304
3:5:6,0,-1,100697,99303
5:3:4,0,-1,100698,99302
4:1:4,0,-1,100699,99301
6:2:1,1,1,100698,99302
5:5:1,0,-1,100699,99301
1:4:6,0,-1,100700,99300
1:3:6,0,-1,100701,99299
2:1:3,1,1,100700,99300
4:6:5,0,-1,100701,99299
3:4:3,0,-1,100702,99298
5:3:2,1,1,100701,99299
6:6:6,0,-1,100702,99298
2:4:6,1,1,100701,99299
3:1:4,0,-1,100702,99298
5:1:3,0,-1,100703,99297
1:4:5,0,-1,100704,99296
3:6:5,0,-1,100705,99295
5:6:6,0,-1,100706,99294
5:5:6,0,-1,100707,99293
4:5:4,0,-1,100708,99292
3:5:2,1,1,100707,99293
4:1:6,0,-1,100708,99292
6:4:1,0,-1,100709,99291
3:2:2,2,2,100707,99293
2:3:6,1,1,100706,99294
2:4:3,1,1,100705,99295
4:1:3,0,-1,100706,99294
1:1:1,0,-1,100707,99293
4:2:3,1,1,100706,99294
4:1:4,0,-1,100707,99293
5:4:3,0,-1,100708,99292
2:6:5,1,1,100707,99293
5:2:2,2,2,100705,99295
5:4:6,0,-1,100706,99294
1:3:1,0,-1,100707,99293
5:4:2,1,1,100706,99294
4:6:1,0,-1,100707,99293
4:6:2,1,1,100706,99294
4:2:3,1,1,100705,99295
3:1:4,0,-1,100706,99294
6:6:4,0,-1,100707,99293
3:2:6,1,1,100706,99294
4:4:4,0,-1,100707,99293
1:6:6,0,-1,100708,99292
2:3:4,1,1,100707,99293
6:6:6,0,-1,100708,99292
4:4:3,0,-1,100709,99291
2:2:6,2,2,100707,99293
4:2:4,1,1,100706,99294
5:2:2,2,2,100704,99296
5:3:4,0,-1,100705,99295
4:2:3,1,1,100704,99296
5:1:4,0,-1,100705,99295
2:3:5,1,1,100704,99296
2:2:2,3,3,100701,99299
5:6:1,0,-1,100702,99298
2:1:6,1,1,100701,99299
2:4:2,2,2,100699,99301
3:3:4,0,-1,100700,99300
3:5:2,1,1,100699,99301
6:2:5,1,1,100698,99302
3:6:3,0,-1,100699,99301
1:5:5,0,-1,100700,99300
3:1:5,0,-1,100701,99299
5:5:6,0,-1,100702,99298
3:6:4,0,-1,100703,99297
3:2:4,1,1,100702,99298
2:1:6,1,1,100701,99299
1:3:3,0,-1,100702,99298
3:6:4,0,-1,100703,99297
2:4:1,1,1,100702,99298
2:2:6,2,2,100700,99300
6:2:1,1,1,100699,99301
6:4:6,0,-1,100700,99300
2:3:4,1,1,100699,99301
5:6:5,0,-1,100700,99300
6:4:3,0,-1,100701,99299
2:1:6,1,1,100700,99300
5:1:2,1,1,100699,99301
5:4:4,0,-1,100700,99300
2:6:1,1,1,100699,99301
1:5:1,0,-1,100700,99300
5:4:6,0,-1,100701,99299
2:2:3,2,2,100699,99301
1:5:1,0,-1,100700,99300
4:4:3,0,-1,100701,99299
4:5:4,0,-1,100702,99298
6:5:5,0,-1,100703,99297
2:5:2,2,2,100701,99299
6:1:6,0,-1,100702,99298
2:5:4,1,1,100701,99299
4:2:3,1,1,100700,99300
2:5:1,1,1,100699,99301
5:2:5,1,1,100698,99302
5:3:6,0,-1,100699,99301
1:1:4,0,-1,100700,99300
2:1:1,1,1,100699,99301
5:4:3,0,-1,100700,99300
5:3:2,1,1,100699,99301
4:4:1,0,-1,100700,99300
3:5:2,1,1,100699,99301
1:5:4,0,-1,100700,99300
1:5:5,0,-1,100701,99299
2:6:6,1,1,100700,99300
4:1:1,0,-1,100701,99299
4:1:5,0,-1,100702,99298
5:2:1,1,1,100701,99299
1:2:3,1,1,100700,99300
3:6:4,0,-1,100701,99299
4:2:3,1,1,100700,99300
2:5:4,1,1,100699,99301
6:3:6,0,-1,100700,99300
3:1:4,0,-1,100701,99299
2:4:2,2,2,100699,99301
4:4:6,0,-1,100700,99300
1:5:3,0,-1,100701,99299
4:5:2,1,1,100700,99300
4:3:6,0,-1,100701,99299
4:4:4,0,-1,100702,99298
5:3:1,0,-1,100703,99297
1:3:2,1,1,100702,99298
5:6:3,0,-1,100703,99297
3:1:3,0,-1,100704,99296
3:4:1,0,-1,100705,99295
2:2:2,3,3,100702,99298
4:4:1,0,-1,100703,99297
2:4:2,2,2,100701,99299
6:1:3,0,-1,100702,99298
4:1:1,0,-1,100703,99297
2:4:1,1,1,100702,99298
5:4:1,0,-1,100703,99297
1:2:6,1,1,100702,99298
2:4:3,1,1,100701,99299
4:4:2,1,1,100700,99300
3:1:4,0,-1,100701,99299
5:1:2,1,1,100700,99300
4:3:5,0,-1,100701,99299
4:1:1,0,-1,100702,99298
1:2:3,1,1,100701,99299
6:2:5,1,1,100700,99300
4:3:5,0,-1,100701,99299
3:5:4,0,-1,100702,99298
5:1:6,0,-1,100703,99297
4:1:2,1,1,100702,99298
5:4:5,0,-1,100703,99297
3:3:4,0,-1,100704,99296
5:5:2,1,1,100703,99297
4:6:5,0,-1,100704,99296
5:5:6,0,-1,100705,99295
1:4:6,0,-1,100706,99294
3:1:3,0,-1,100707,99293
4:4:6,0,-1,100708,99292
1:5:6,0,-1,100709,99291
5:5:5,0,-1,100710,99290
2:1:2,2,2,100708,99292
2:4:6,1,1,100707,99293
5:1:2,1,1,100706,99294
2:3:5,1,1,100705,99295
6:5:5,0,-1,100706,99294
3:5:1,0,-1,100707,99293
2:2:6,2,2,100705,99295
4:3:3,0,-1,100706,99294
5:1:5,0,-1,100707,99293
4:5:5,0,-1,100708,99292
5:6:5,0,-1,100709,99291
1:6:3,0,-1,100710,99290
3:5:1,0,-1,100711,99289
6:3:5,0,-1,100712,99288
2:5:4,1,1,100711,99289
4:6:1,0,-1,100712,99288
4:4:4,0,-1,100713,99287
5:4:4,0,-1,100714,99286
2:1:3,1,1,100713,99287
4:5:1,0,-1,100714,99286
4:6:2,1,1,100713,99287
3:3:5,0,-1,100714,99286
3:6:6,0,-1,100715,99285
4:4:2,1,1,100714,99286
3:3:1,0,-1,100715,99285
1:5:3,0,-1,100716,99284
6:4:6,0,-1,100717,99283
4:2:4,1,1,100716,99284
4:3:1,0,-1,100717,99283
3:3:2,1,1,100716,99284
3:4:4,0,-1,100717,99283
6:4:3,0,-1,100718,99282
6:1:6,0,-1,100719,99281
4:2:5,1,1,100718,99282
3:3:1,0,-1,100719,99281
2:6:1,1,1,100718,99282
4:6:2,1,1,100717,99283
3:4:4,0,-1,100718,99282
1:5:3,0,-1,100719,99281
6:4:3,0,-1,100720,99280
4:5:5,0,-1,100721,99279
6:2:4,1,1,100720,99280
3:5:2,1,1,100719,99281
3:6:4,0,-1,100720,99280
4:6:3,0,-1,100721,99279
2:6:2,2,2,100719,99281
4:2:2,2,2,100717,99283
5:3:4,0,-1,100718,99282
4:2:1,1,1,100717,99283
1:3:2,1,1,100716,99284
3:4:3,0,-1,100717,99283
4:2:2,2,2,100715,99285
3:6:5,0,-1,100716,99284
2:3:5,1,1,100715,99285
1:4:2,1,1,100714,99286
2:5:3,1,1,100713,99287
3:5:4,0,-1,100714,99286
4:1:6,0,-1,100715,99285
6:2:5,1,1,100714,99286
1:1:1,0,-1,100715,99285
2:2:5,2,2,100713,99287
4:4:5,0,-1,100714,99286
3:1:3,0,-1,100715,99285
4:1:3,0,-1,100716,99284
2:2:3,2,2,100714,99286
1:5:5,0,-1,100715,99285
2:5:2,2,2,100713,99287
5:1:1,0,-1,100714,99286
3:6:3,0,-1,100715,99285
4:3:5,0,-1,100716,99284
2:6:4,1,1,100715,99285
2:2:3,2,2,100713,99287
1:6:6,0,-1,100714,99286
6:2:4,1,1,100713,99287
6:2:6,1,1,100712,99288
3:2:6,1,1,100711,99289
3:2:1,1,1,100710,99290
4:2:2,2,2,100708,99292
5:3:5,0,-1,100709,99291
3:4:5,0,-1,100710,99290
2:1:1,1,1,100709,99291
2:6:4,1,1,100708,99292
5:2:6,1,1,100707,99293
1:4:6,0,-1,100708,99292
6:3:3,0,-1,100709,99291
1:5:2,1,1,100708,99292
4:3:2,1,1,100707,99293
3:2:5,1,1,100706,99294
4:5:3,0,-1,100707,99293
4:1:6,0,-1,100708,99292
6:4:4,0,-1,100709,99291
1:6:3,0,-1,100710,99290
3:5:1,0,-1,100711,99289
3:6:1,0,-1,100712,99288
6:3:5,0,-1,100713,99287
4:5:6,0,-1,100714,99286
6:5:2,1,1,100713,99287
3:1:5,0,-1,100714,99286
3:2:2,2,2,100712,99288
5:2:3,1,1,100711,99289
4:6:1,0,-1,100712,99288
4:1:4,0,-1,100713,99287
3:6:1,0,-1,100714,99286
6:4:1,0,-1,100715,99285
1:5:1,0,-1,100716,99284
5:6:6,0,-1,100717,99283
6:3:5,0,-1,100718,99282
2:2:5,2,2,100716,99284
6:3:3,0,-1,100717,99283
5:3:5,0,-1,100718,99282
6:6:3,0,-1,100719,99281
6:6:4,0,-1,100720,99280
5:3:1,0,-1,100721,99279
4:2:1,1,1,100720,99280
2:4:2,2,2,100718,99282
3:1:1,0,-1,100719,99281
6:5:3,0,-1,100720,99280
6:5:2,1,1,100719,99281
4:3:2,1,1,100718,99282
3:6:6,0,-1,100719,99281
4:4:1,0,-1,100720,99280
5:3:3,0,-1,100721,99279
2:6:1,1,1,100720,99280
4:2:3,1,1,100719,99281
3:4:6,0,-1,100720,99280
2:1:3,1,1,100719,99281
3:1:5,0,-1,100720,99280
2:4:2,2,2,100718,99282
1:5:3,0,-1,100719,99281
2:6:6,1,1,100718,99282
2:3:4,1,1,100717,99283
2:5:2,2,2,100715,99285
1:4:6,0,-1,100716,99284
5:6:1,0,-1,100717,99283
3:1:3,0,-1,100718,99282
5:6:3,0,-1,100719,99281
2:5:4,1,1,100718,99282
5:2:3,1,1,100717,99283
3:1:4,0,-1,100718,99282
3:1:1,0,-1,100719,99281
4:5:1,0,-1,100720,99280
6:6:4,0,-1,100721,99279
6:6:2,1,1,100720,99280
2:5:4,1,1,100719,99281
4:3:6,0,-1,100720,99280
1:6:4,0,-1,100721,99279
5:1:5,0,-1,100722,99278
4:3:2,1,1,100721,99279
1:5:1,0,-1,100722,99278
4:4:6,0,-1,100723,99277
3:3:5,0,-1,100724,99276
2:1:2,2,2,100722,99278
4:3:3,0,-1,100723,99277
4:5:4,0,-1,100724,99276
6:5:6,0,-1,100725,99275
2:4:6,1,1,100724,99276
6:3:2,1,1,100723,99277
5:5:3,0,-1,100724,99276
4:5:3,0,-1,100725,99275
5:4:2,1,1,100724,99276
1:2:5,1,1,100723,99277
1:4:5,0,-1,100724,99276
4:1:6,0,-1,100725,99275
3:4:1,0,-1,100726,99274
1:6:6,0,-1,100727,99273
5:5:2,1,1,100726,99274
1:5:4,0,-1,100727,99273
5:6:3,0,-1,100728,99272
2:6:6,1,1,100727,99273
6:2:1,1,1,100726,99274
3:6:6,0,-1,100727,99273
6:5:2,1,1,100726,99274
3:5:4,0,-1,100727,99273
5:6:6,0,-1,100728,99272
6:6:3,0,-1,100729,99271
2:3:6,1,1,100728,99272
2:5:4,1,1,100727,99273
2:5:5,1,1,100726,99274
1:1:6,0,-1,100727,99273
4:5:3,0,-1,100728,99272
6:3:1,0,-1,100729,99271
5:2:1,1,1,100728,99272
4:3:3,0,-1,100729,99271
6:1:1,0,-1,100730,99270
1:6:3,0,-1,100731,99269
1:5:4,0,-1,100732,99268
2:3:5,1,1,100731,99269
3:5:2,1,1,100730,99270
2:2:1,2,2,100728,99272
1:6:3,0,-1,100729,99271
5:1:6,0,-1,100730,99270
4:5:5,0,-1,100731,99269
5:5:1,0,-1,100732,99268
5:4:4,0,-1,100733,99267
2:1:2,2,2,100731,99269
6:2:5,1,1,100730,99270
5:5:1,0,-1,100731,99269
1:1:6,0,-1,100732,99268
6:4:1,0,-1,100733,99267
3:4:3,0,-1,100734,99266
2:4:5,1,1,100733,99267
5:4:2,1,1,100732,99268
6:2:2,2,2,100730,99270
5:5:2,1,1,100729,99271
3:4:4,0,-1,100730,99270
5:4:1,0,-1,100731,99269
3:6:3,0,-1,100732,99268
4:6:1,0,-1,100733,99267
4:4:6,0,-1,100734,99266
4:3:1,0,-1,100735,99265
3:4:5,0,-1,100736,99264
3:5:5,0,-1,100737,99263
2:3:4,1,1,100736,99264
5:5:4,0,-1,100737,99263
1:4:5,0,-1,100738,99262
3:6:3,0,-1,100739,99261
2:1:2,2,2,100737,99263
6:2:3,1,1,100736,99264
6:3:3,0,-1,100737,99263
4:2:6,1,1,100736,99264
4:4:3,0,-1,100737,99263
5:1:3,0,-1,100738,99262
2:2:5,2,2,100736,99264
5:6:3,0,-1,100737,99263
4:5:3,0,-1,100738,99262
3:5:2,1,1,100737,99263
1:6:5,0,-1,100738,99262
2:2:6,2,2,100736,99264
1:4:3,0,-1,100737,99263
2:5:5,1,1,100736,99264
2:1:1,1,1,100735,99265
1:6:6,0,-1,100736,99264
5:2:3,1,1,100735,99265
5:1:4,0,-1,100736,99264
3:6:6,0,-1,100737,99263
4:4:3,0,-1,100738,99262
3:6:1,0,-1,100739,99261
4:2:1,1,1,100738,99262
2:5:1,1,1,100737,99263
4:3:6,0,-1,100738,99262
3:4:3,0,-1,100739,99261
4:3:3,0,-1,100740,99260
2:5:5,1,1,100739,99261
6:5:5,0,-1,100740,99260
1:3:6,0,-1,100741,99259
4:4:1,0,-1,100742,99258
5:1:1,0,-1,100743,99257
6:1:4,0,-1,100744,99256
3:4:6,0,-1,100745,99255
4:4:3,0,-1,100746,99254
5:4:6,0,-1,100747,99253
3:5:5,0,-1,100748,99252
6:2:4,1,1,100747,99253
6:2:1,1,1,100746,99254
1:3:2,1,1,100745,99255
4:1:1,0,-1,100746,99254
3:6:3,0,-1,100747,99253
1:5:6,0,-1,100748,99252
6:5:5,0,-1,100749,99251
6:3:4,0,-1,100750,99250
6:4:3,0,-1,100751,99249
5:6:4,0,-1,100752,99248
1:2:6,1,1,100751,99249
1:5:4,0,-1,100752,99248
2:4:3,1,1,100751,99249
5:4:3,0,-1,100752,99248
6:6:5,0,-1,100753,99247
2:2:3,2,2,100751,99249
1:1:6,0,-1,100752,99248
3:4:1,0,-1,100753,99247
5:4:2,1,1,100752,99248
4:6:5,0,-1,100753,99247
3:4:2,1,1,100752,99248
5:3:6,0,-1,100753,99247
5:2:6,1,1,100752,99248
5:5:2,1,1,100751,99249
5:3:5,0,-1,100752,99248
4:5:5,0,-1,100753,99247
4:4:6,0,-1,100754,99246
3:2:6,1,1,100753,99247
2:1:2,2,2,100751,99249
3:2:4,1,1,100750,99250
1:5:5,0,-1,100751,99249
5:5:5,0,-1,100752,99248
1:5:6,0,-1,100753,99247
4:5:6,0,-1,100754,99246
4:5:5,0,-1,100755,99245
1:1:4,0,-1,100756,99244
2:4:1,1,1,100755,99245
3:1:5,0,-1,100756,99244
1:5:5,0,-1,100757,99243
6:3:5,0,-1,100758,99242
3:1:1,0,-1,100759,99241
5:6:6,0,-1,100760,99240
5:3:3,0,-1,100761,99239
3:2:3,1,1,100760,99240
6:5:4,0,-1,100761,99239
1:2:2,2,2,100759,99241
4:5:4,0,-1,100760,99240
6:2:2,2,2,100758,99242
2:4:6,1,1,100757,99243
6:2:1,1,1,100756,99244
4:3:1,0,-1,100757,99243
5:4:3,0,-1,100758,99242
6:1:4,0,-1,100759,99241
4:1:3,0,-1,100760,99240
5:4:6,0,-1,100761,99239
6:2:6,1,1,100760,99240
5:6:1,0,-1,100761,99239
4:4:4,0,-1,100762,99238
4:5:6,0,-1,100763,99237
1:2:6,1,1,100762,99238
1:3:4,0,-1,100763,99237
4:3:6,0,-1,100764,99236
2:5:6,1,1,100763,99237
2:6:6,1,1,100762,99238
5:6:6,0,-1,100763,99237
4:6:1,0,-1,100764,99236
5:2:1,1,1,100763,99237
4:3:6,0,-1,100764,99236
5:1:1,0,-1,100765,99235
4:3:5,0,-1,100766,99234
2:2:3,2,2,100764,99236
2:3:4,1,1,100763,99237
6:2:1,1,1,100762,99238
5:5:4,0,-1,100763,99237
6:2:5,1,1,100762,99238
2:1:5,1,1,100761,99239
5:6:1,0,-1,100762,99238
5:6:3,0,-1,100763,99237
6:6:5,0,-1,100764,99236
3:5:2,1,1,100763,99237
4:5:6,0,-1,100764,99236
5:6:5,0,-1,100765,99235
1:2:6,1,1,100764,99236
1:2:1,1,1,100763,99237
4:2:3,1,1,100762,99238
3:3:5,0,-1,100763,99237
2:3:6,1,1,100762,99238
6:6:6,0,-1,100763,99237
2:1:4,1,1,100762,99238
1:5:4,0,-1,100763,99237
3:4:4,0,-1,100764,99236
4:2:5,1,1,100763,99237
6:4:6,0,-1,100764,99236
2:5:2,2,2,100762,99238
3:6:4,0,-1,100763,99237
3:1:5,0,-1,100764,99236
5:3:5,0,-1,100765,99235
1:5:2,1,1,100764,99236
1:1:5,0,-1,100765,99235
5:1:1,0,-1,100766,99234
2:1:5,1,1,100765,99235
1:6:6,0,-1,100766,99234
5:3:3,0,-1,100767,99233
1:3:6,0,-1,100768,99232
5:1:5,0,-1,100769,99231
6:2:3,1,1,100768,99232
6:5:6,0,-1,100769,99231
4:6:6,0,-1,100770,99230
6:6:5,0,-1,100771,99229
6:4:5,0,-1,100772,99228
3:6:1,0,-1,100773,99227
4:4:5,0,-1,100774,99226
4:4:5,0,-1,100775,99225
3:3:4,0,-1,100776,99224
6:6:6,0,-1,100777,99223
1:2:1,1,1,100776,99224
2:2:6,2,2,100774,99226
6:1:4,0,-1,100775,99225
4:6:6,0,-1,100776,99224
5:6:6,0,-1,100777,99223
4:6:1,0,-1,100778,99222
2:1:3,1,1,100777,99223
2:1:5,1,1,100776,99224
6:1:2,1,1,100775,99225
2:1:4,1,1,100774,99226
5:5:3,0,-1,100775,99225
3:5:4,0,-1,100776,99224
5:3:1,0,-1,100777,99223
5:3:6,0,-1,100778,99222
1:6:3,0,-1,100779,99221
5:6:1,0,-1,100780,99220
3:3:6,0,-1,100781,99219
3:3:5,0,-1,100782,99218
1:1:4,0,-1,100783,99217
5:1:4,0,-1,100784,99216
6:2:1,1,1,100783,99217
3:1:5,0,-1,100784,99216
5:4:1,0,-1,100785,99215
6:5:4,0,-1,100786,99214
2:2:3,2,2,100784,99216
3:4:1,0,-1,100785,99215
1:3:4,0,-1,100786,99214
5:5:1,0,-1,100787,99213
2:3:1,1,1,100786,99214
1:6:5,0,-1,100787,99213
1:4:1,0,-1,100788,99212
6:1:2,1,1,100787,99213
5:2:5,1,1,100786,99214
1:5:2,1,1,100785,99215
2:6:6,1,1,100784,99216
4:6:5,0,-1,100785,99215
5:5:6,0,-1,100786,99214
1:2:6,1,1,100785,99215
2:5:4,1,1,100784,99216
3:5:4,0,-1,100785,99215
1:3:6,0,-1,100786,99214
5:5:3,0,-1,100787,99213
3:1:4,0,-1,100788,99212
4:4:1,0,-1,100789,99211
6:6:4,0,-1,100790,99210
1:2:6,1,1,100789,99211
2:4:6,1,1,100788,99212
4:6:6,0,-1,100789,99211
4:2:1,1,1,100788,99212
1:6:6,0,-1,100789,99211
2:4:6,1,1,100788,99212
5:1:5,0,-1,100789,99211
1:4:1,0,-1,100790,99210
6:6:3,0,-1,100791,99209
2:4:1,1,1,100790,99210
4:2:1,1,1,100789,99211
2:2:5,2,2,100787,99213
1:3:1,0,-1,100788,99212
2:3:6,1,1,100787,99213
5:5:1,0,-1,100788,99212
3:4:6,0,-1,100789,99211
1:3:6,0,-1,100790,99210
5:1:2,1,1,100789,99211
5:3:6,0,-1,100790,99210
1:2:1,1,1,100789,99211
6:2:5,1,1,100788,99212
4:3:3,0,-1,100789,99211
1:1:3,0,-1,100790,99210
3:1:5,0,-1,100791,99209
6:2:1,1,1,100790,99210
2:2:5,2,2,100788,99212
5:6:5,0,-1,100789,99211
4:5:3,0,-1,100790,99210
5:6:4,0,-1,100791,99209
6:4:2,1,1,100790,99210
5:5:6,0,-1,100791,99209
1:6:4,0,-1,100792,99208
2:4:6,1,1,100791,99209
3:5:3,0,-1,100792,99208
5:3:4,0,-1,100793,99207
3:1:2,1,1,100792,99208
6:3:4,0,-1,100793,99207
5:6:2,1,1,100792,99208
6:1:6,0,-1,100793,99207
6:1:4,0,-1,100794,99206
3:6:2,1,1,100793,99207
3:3:3,0,-1,100794,99206
6:5:5,0,-1,100795,99205
6:5:6,0,-1,100796,99204
5:4:6,0,-1,100797,99203
2:2:3,2,2,100795,99205
2:4:3,1,1,100794,99206
5:3:5,0,-1,100795,99205
4:6:1,0,-1,100796,99204
4:1:6,0,-1,100797,99203
2:2:3,2,2,100795,99205
1:6:5,0,-1,100796,99204
4:2:6,1,1,100795,99205
1:2:5,1,1,100794,99206
1:3:3,0,-1,100795,99205
1:4:6,0,-1,100796,99204
1:2:5,1,1,100795,99205
2:2:6,2,2,100793,99207
3:5:5,0,-1,100794,99206
2:2:6,2,2,100792,99208
3:2:3,1,1,100791,99209
4:1:5,0,-1,100792,99208
3:4:5,0,-1,100793,99207
2:4:3,1,1,100792,99208
5:4:2,1,1,100791,99209
4:5:3,0,-1,100792,99208
5:3:6,0,-1,100793,99207
6:1:3,0,-1,100794,99206
3:6:6,0,-1,100795,99205
3:1:1,0,-1,100796,99204
4:4:1,0,-1,100797,99203
1:5:1,0,-1,100798,99202
4:4:6,0,-1,100799,99201
3:2:5,1,1,100798,99202
2:4:4,1,1,100797,99203
3:2:3,1,1,100796,99204
2:2:2,3,3,100793,99207
2:6:2,2,2,100791,99209
5:4:1,0,-1,100792,99208
3:3:6,0,-1,100793,99207
3:1:1,0,-1,100794,99206
2:6:2,2,2,100792,99208
6:1:3,0,-1,100793,99207
1:2:6,1,1,100792,99208
1:3:2,1,1,100791,99209
1:4:2,1,1,100790,99210
5:1:3,0,-1,100791,99209
3:5:1,0,-1,100792,99208
2:4:3,1,1,100791,99209
3:2:1,1,1,100790,99210
6:3:5,0,-1,100791,99209
5:6:5,0,-1,100792,99208
1:6:6,0,-1,100793,99207
4:2:2,2,2,100791,99209
4:4:4,0,-1,100792,99208
4:1:3,0,-1,100793,99207
5:4:4,0,-1,100794,99206
5:6:4,0,-1,100795,99205
3:1:6,0,-1,100796,99204
6:3:6,0,-1,100797,99203
4:1:5,0,-1,100798,99202
6:6:5,0,-1,100799,99201
2:1:6,1,1,100798,99202
5:3:6,0,-1,100799,99201
3:3:1,0,-1,100800,99200
2:2:3,2,2,100798,99202
2:4:4,1,1,100797,99203
6:2:1,1,1,100796,99204
3:2:4,1,1,100795,99205
3:1:5,0,-1,100796,99204
4:2:6,1,1,100795,99205
3:5:2,1,1,100794,99206
4:6:1,0,-1,100795,99205
4:4:5,0,-1,100796,99204
5:2:4,1,1,100795,99205
3:1:2,1,1,100794,99206
6:1:6,0,-1,100795,99205
2:1:4,1,1,100794,99206
1:4:2,1,1,100793,99207
1:5:1,0,-1,100794,99206
6:3:2,1,1,100793,99207
4:6:2,1,1,100792,99208
5:2:3,1,1,100791,99209
4:3:2,1,1,100790,99210
3:3:1,0,-1,100791,99209
4:2:1,1,1,100790,99210
6:5:6,0,-1,100791,99209
3:2:1,1,1,100790,99210
6:6:4,0,-1,100791,99209
5:4:3,0,-1,100792,99208
3:5:5,0,-1,100793,99207
5:2:5,1,1,100792,99208
3:5:3,0,-1,100793,99207
6:6:2,1,1,100792,99208
6:1:5,0,-1,100793,99207
1:3:5,0,-1,100794,99206
3:2:3,1,1,100793,99207
5:4:5,0,-1,100794,99206
5:6:3,0,-1,100795,99205
1:5:1,0,-1,100796,99204
5:6:2,1,1,100795,99205
6:4:3,0,-1,100796,99204
4:3:4,0,-1,100797,99203
2:2:2,3,3,100794,99206
2:6:2,2,2,100792,99208
4:2:4,1,1,100791,99209
4:2:1,1,1,100790,99210
4:5:2,1,1,100789,99211
3:2:1,1,1,100788,99212
4:6:5,0,-1,100789,99211
4:4:1,0,-1,100790,99210
4:3:2,1,1,100789,99211
5:5:2,1,1,100788,99212
5:3:1,0,-1,100789,99211
6:6:1,0,-1,100790,99210
3:4:6,0,-1,100791,99209
4:2:5,1,1,100790,99210
2:2:3,2,2,100788,99212
5:2:4,1,1,100787,99213
4:1:2,1,1,100786,99214
2:3:2,2,2,100784,99216
2:1:3,1,1,100783,99217
1:6:5,0,-1,100784,99216
6:4:2,1,1,100783,99217
5:2:1,1,1,100782,99218
6:3:1,0,-1,100783,99217
6:1:4,0,-1,100784,99216
6:3:5,0,-1,100785,99215
2:4:3,1,1,100784,99216
2:3:4,1,1,100783,99217
3:2:6,1,1,100782,99218
4:4:3,0,-1,100783,99217
1:1:2,1,1,100782,99218
5:6:4,0,-1,100783,99217
4:1:6,0,-1,100784,99216
6:6:6,0,-1,100785,99215
3:2:1,1,1,100784,99216
3:5:6,0,-1,100785,99215
2:6:2,2,2,100783,99217
1:5:2,1,1,100782,99218
6:1:5,0,-1,100783,99217
5:6:6,0,-1,100784,99216
5:5:6,0,-1,100785,99215
3:6:4,0,-1,100786,99214
1:5:5,0,-1,100787,99213
5:3:3,0,-1,100788,99212
2:2:5,2,2,100786,99214
5:5:4,0,-1,100787,99213
1:3:1,0,-1,100788,99212
3:3:2,1,1,100787,99213
4:2:1,1,1,100786,99214
3:4:1,0,-1,100787,99213
2:4:5,1,1,100786,99214
1:1:3,0,-1,100787,99213
5:4:6,0,-1,100788,99212
5:4:4,0,-1,100789,99211
5:6:1,0,-1,100790,99210
5:1:1,0,-1,100791,99209
4:2:3,1,1,100790,99210
4:5:1,0,-1,100791,99209
5:2:2,2,2,100789,99211
2:2:6,2,2,100787,99213
4:6:5,0,-1,100788,99212
6:1:6,0,-1,100789,99211
2:3:5,1,1,100788,99212
1:1:1,0,-1,100789,99211
3:1:3,0,-1,100790,99210
2:2:1,2,2,100788,99212
4:6:3,0,-1,100789,99211
4:4:6,0,-1,100790,99210
3:3:4,0,-1,100791,99209
2:3:5,1,1,100790,99210
6:6:3,0,-1,100791,99209
2:5:1,1,1,100790,99210
1:5:1,0,-1,100791,99209
6:2:4,1,1,100790,99210
6:2:1,1,1,100789,99211
6:4:4,0,-1,100790,99210
3:5:5,0,-1,100791,99209
6:4:2,1,1,100790,99210
6:6:6,0,-1,100791,99209
2:4:5,1,1,100790,99210
1:6:4,0,-1,100791,99209
1:6:1,0,-1,100792,99208
1:6:1,0,-1,100793,99207
1:3:2,1,1,100792,99208
3:1:3,0,-1,100793,99207
2:2:6,2,2,100791,99209
3:4:3,0,-1,100792,99208
4:1:3,0,-1,100793,99207
3:5:1,0,-1,100794,99206
1:5:3,0,-1,100795,99205
3:4:5,0,-1,100796,99204
1:3:5,0,-1,100797,99203
4:6:4,0,-1,100798,99202
1:6:3,0,-1,100799,99201
5:6:1,0,-1,100800,99200
2:5:3,1,1,100799,99201
4:3:3,0,-1,100800,99200
1:1:3,0,-1,100801,99199
3:3:6,0,-1,100802,99198
3:5:2,1,1,100801,99199
1:2:5,1,1,100800,99200
3:4:6,0,-1,100801,99199
1:5:5,0,-1,100802,99198
4:5:3,0,-1,100803,99197
6:3:4,0,-1,100804,99196
4:5:2,1,1,100803,99197
6:6:3,0,-1,100804,99196
1:2:3,1,1,100803,99197
2:3:3,1,1,100802,99198
2:1:3,1,1,100801,99199
6:3:4,0,-1,100802,99198
5:1:2,1,1,100801,99199
2:5:3,1,1,100800,99200
1:6:2,1,1,100799,99201
5:1:5,0,-1,100800,99200
3:5:3,0,-1,100801,99199
5:6:1,0,-1,100802,99198
1:4:2,1,1,100801,99199
2:5:2,2,2,100799,99201
3:6:3,0,-1,100800,99200
6:6:1,0,-1,100801,99199
3:2:6,1,1,100800,99200
5:4:5,0,-1,100801,99199
5:1:4,0,-1,100802,99198
4:5:3,0,-1,100803,99197
1:4:5,0,-1,100804,99196
6:4:5,0,-1,100805,99195
3:5:6,0,-1,100806,99194
4:4:4,0,-1,100807,99193
4:1:5,0,-1,100808,99192
4:4:5,0,-1,100809,99191
2:3:1,1,1,100808,99192
1:4:2,1,1,100807,99193
5:5:6,0,-1,100808,99192
1:5:1,0,-1,100809,99191
5:4:2,1,1,100808,99192
1:3:5,0,-1,100809,99191
1:1:1,0,-1,100810,99190
5:3:2,1,1,100809,99191
5:5:1,0,-1,100810,99190
1:5:3,0,-1,100811,99189
4:4:4,0,-1,100812,99188
4:3:2,1,1,100811,99189
6:4:5,0,-1,100812,99188
2:5:1,1,1,100811,99189
6:6:3,0,-1,100812,99188
1:5:2,1,1,100811,99189
4:3:5,0,-1,100812,99188
5:4:1,0,-1,100813,99187
1:4:2,1,1,100812,99188
3:5:4,0,-1,100813,99187
4:5:5,0,-1,100814,99186
3:6:3,0,-1,100815,99185
5:1:5,0,-1,100816,99184
1:1:1,0,-1,100817,99183
4:1:4,0,-1,100818,99182
5:5:1,0,-1,100819,99181
4:3:3,0,-1,100820,99180
6:4:2,1,1,100819,99181
1:2:2,2,2,100817,99183
6:3:5,0,-1,100818,99182
4:4:1,0,-1,100819,99181
3:4:2,1,1,100818,99182
5:6:6,0,-1,100819,99181
5:2:6,1,1,100818,99182
1:6:2,1,1,100817,99183
6:1:1,0,-1,100818,99182
5:3:4,0,-1,100819,99181
1:1:5,0,-1,100820,99180
6:5:1,0,-1,100821,99179
6:1:4,0,-1,100822,99178
2:1:1,1,1,100821,99179
5:5:3,0,-1,100822,99178
5:1:6,0,-1,100823,99177
3:3:1,0,-1,100824,99176
2:6:3,1,1,100823,99177
1:6:1,0,-1,100824,99176
3:3:2,1,1,100823,99177
2:3:3,1,1,100822,99178
4:1:6,0,-1,100823,99177
1:4:5,0,-1,100824,99176
5:2:3,1,1,100823,99177
4:5:4,0,-1,100824,99176
2:2:2,3,3,100821,99179
6:6:5,0,-1,100822,99178
4:6:6,0,-1,100823,99177
2:6:3,1,1,100822,99178
1:6:4,0,-1,100823,99177
2:6:4,1,1,100822,99178
5:4:6,0,-1,100823,99177
5:5:6,0,-1,100824,99176
6:4:1,0,-1,100825,99175
6:3:1,0,-1,100826,99174
6:1:1,0,-1,100827,99173
6:2:2,2,2,100825,99175
1:2:6,1,1,100824,99176
1:4:6,0,-1,100825,99175
6:6:1,0,-1,100826,99174
2:6:2,2,2,100824,99176
5:4:1,0,-1,100825,99175
3:4:1,0,-1,100826,99174
6:1:3,0,-1,100827,99173
6:3:6,0,-1,100828,99172
4:5:2,1,1,100827,99173
4:2:2,2,2,100825,99175
4:1:6,0,-1,100826,99174
4:4:1,0,-1,100827,99173
4:5:1,0,-1,100828,99172
4:4:3,0,-1,100829,99171
3:4:2,1,1,100828,99172
4:5:6,0,-1,100829,99171
3:3:6,0,-1,100830,99170
5:5:1,0,-1,100831,99169
3:3:5,0,-1,100832,99168
2:4:6,1,1,100831,99169
5:2:3,1,1,100830,99170
6:4:3,0,-1,100831,99169
5:5:5,0,-1,100832,99168
4:3:1,0,-1,100833,99167
6:6:4,0,-1,100834,99166
2:4:2,2,2,100832,99168
3:4:6,0,-1,100833,99167
3:1:3,0,-1,100834,99166
6:5:6,0,-1,100835,99165
3:6:6,0,-1,100836,99164
4:2:2,2,2,100834,99166
1:3:2,1,1,100833,99167
5:4:4,0,-1,100834,99166
1:2:2,2,2,100832,99168
1:1:3,0,-1,100833,99167
3:1:4,0,-1,100834,99166
3:6:5,0,-1,100835,99165
2:1:2,2,2,100833,99167
5:3:4,0,-1,100834,99166
1:1:6,0,-1,100835,99165
4:3:5,0,-1,100836,99164
6:4:2,1,1,100835,99165
6:6:1,0,-1,100836,99164
6:4:5,0,-1,100837,99163
4:1:2,1,1,100836,99164
4:2:3,1,1,100835,99165
4:1:3,0,-1,100836,99164
5:6:5,0,-1,100837,99163
1:6:4,0,-1,100838,99162
6:5:1,0,-1,100839,99161
3:4:4,0,-1,100840,99160
2:3:1,1,1,100839,99161
5:5:6,0,-1,100840,99160
2:2:3,2,2,100838,99162
3:2:6,1,1,100837,99163
3:2:4,1,1,100836,99164
6:5:5,0,-1,100837,99163
3:6:6,0,-1,100838,99162
2:1:3,1,1,100837,99163
2:3:2,2,2,100835,99165
3:3:2,1,1,100834,99166
2:3:6,1,1,100833,99167
5:1:4,0,-1,100834,99166
4:1:6,0,-1,100835,99165
6:5:4,0,-1,100836,99164
1:6:5,0,-1,100837,99163
1:1:5,0,-1,100838,99162
6:3:5,0,-1,100839,99161
2:4:5,1,1,100838,99162
5:1:6,0,-1,100839,99161
5:5:1,0,-1,100840,99160
2:2:1,2,2,100838,99162
3:3:1,0,-1,100839,99161
2:1:3,1,1,100838,99162
6:4:3,0,-1,100839,99161
6:4:2,1,1,100838,99162
3:4:2,1,1,100837,99163
6:5:3,0,-1,100838,99162
6:5:1,0,-1,100839,99161
3:3:6,0,-1,100840,99160
2:1:3,1,1,100839,99161
3:4:2,1,1,100838,99162
5:6:4,0,-1,100839,99161
3:5:6,0,-1,100840,99160
1:4:5,0,-1,100841,99159
3:6:3,0,-1,100842,99158
4:3:2,1,1,100841,99159
1:2:5,1,1,100840,99160
3:4:3,0,-1,100841,99159
3:4:3,0,-1,100842,99158
6:1:1,0,-1,100843,99157
2:1:6,1,1,100842,99158
4:2:3,1,1,100841,99159
2:2:5,2,2,100839,99161
2:4:4,1,1,100838,99162
6:5:3,0,-1,100839,99161
4:4:6,0,-1,100840,99160
3:6:4,0,-1,100841,99159
3:2:4,1,1,100840,99160
4:1:5,0,-1,100841,99159
2:4:5,1,1,100840,99160
3:2:4,1,1,100839,99161
1:5:4,0,-1,100840,99160
4:5:5,0,-1,100841,99159
2:6:2,2,2,100839,99161
4:4:3,0,-1,100840,99160
1:4:1,0,-1,100841,99159
5:2:2,2,2,100839,99161
4:3:6,0,-1,100840,99160
4:6:4,0,-1,100841,99159
6:5:3,0,-1,100842,99158
5:3:2,1,1,100841,99159
2:6:2,2,2,100839,99161
1:6:3,0,-1,100840,99160
2:2:4,2,2,100838,99162
6:6:5,0,-1,100839,99161
1:6:6,0,-1,100840,99160
1:6:2,1,1,100839,99161
4:1:5,0,-1,100840,99160
1:1:3,0,-1,100841,99159
1:2:5,1,1,100840,99160
4:3:1,0,-1,100841,99159
5:1:3,0,-1,100842,99158
1:2:5,1,1,100841,99159
5:1:6,0,-1,100842,99158
3:1:2,1,1,100841,99159
4:6:1,0,-1,100842,99158
5:2:3,1,1,100841,99159
2:1:6,1,1,100840,99160
2:6:4,1,1,100839,99161
2:5:3,1,1,100838,99162
6:3:5,0,-1,100839,99161
1:1:5,0,-1,100840,99160
5:2:4,1,1,100839,99161
4:6:6,0,-1,100840,99160
5:3:2,1,1,100839,99161
4:2:2,2,2,100837,99163
3:3:6,0,-1,100838,99162
1:1:1,0,-1,100839,99161
2:1:4,1,1,100838,99162
2:3:5,1,1,100837,99163
1:6:2,1,1,100836,99164
2:5:4,1,1,100835,99165
6:4:1,0,-1,100836,99164
4:3:2,1,1,100835,99165
6:5:6,0,-1,100836,99164
1:4:5,0,-1,100837,99163
3:1:4,0,-1,100838,99162
3:1:6,0,-1,100839,99161
1:2:5,1,1,100838,99162
3:4:3,0,-1,100839,99161
5:2:1,1,1,100838,99162
3:3:6,0,-1,100839,99161
1:1:3,0,-1,100840,99160
5:1:3,0,-1,100841,99159
5:1:4,0,-1,100842,99158
1:6:2,1,1,100841,99159
2:4:2,2,2,100839,99161
4:6:6,0,-1,100840,99160
5:3:2,1,1,100839,99161
5:6:1,0,-1,100840,99160
3:2:3,1,1,100839,99161
3:4:2,1,1,100838,99162
2:5:1,1,1,100837,99163
6:2:6,1,1,100836,99164
1:6:4,0,-1,100837,99163
2:2:5,2,2,100835,99165
3:6:4,0,-1,100836,99164
1:1:4,0,-1,100837,99163
2:1:1,1,1,100836,99164
6:2:2,2,2,100834,99166
4:1:6,0,-1,100835,99165
1:5:3,0,-1,100836,99164
1:5:6,0,-1,100837,99163
5:5:3,0,-1,100838,99162
5:4:2,1,1,100837,99163
1:6:6,0,-1,100838,99162
2:2:5,2,2,100836,99164
5:2:3,1,1,100835,99165
3:1:2,1,1,100834,99166
3:6:3,0,-1,100835,99165
1:1:2,1,1,100834,99166
2:4:6,1,1,100833,99167
2:3:3,1,1,100832,99168
4:1:6,0,-1,100833,99167
1:1:6,0,-1,100834,99166
1:1:6,0,-1,100835,99165
6:4:3,0,-1,100836,99164
1:3:5,0,-1,100837,99163
3:4:2,1,1,100836,99164
4:4:6,0,-1,100837,99163
4:1:2,1,1,100836,99164
4:3:5,0,-1,100837,99163
1:1:4,0,-1,100838,99162
2:1:4,1,1,100837,99163
3:2:4,1,1,100836,99164
1:5:6,0,-1,100837,99163
2:3:4,1,1,100836,99164
3:1:5,0,-1,100837,99163
4:5:1,0,-1,100838,99162
5:1:3,0,-1,100839,99161
3:5:4,0,-1,100840,99160
2:5:4,1,1,100839,99161
5:3:3,0,-1,100840,99160
5:4:1,0,-1,100841,99159
6:2:6,1,1,100840,99160
2:3:3,1,1,100839,99161
1:2:6,1,1,100838,99162
3:2:6,1,1,100837,99163
6:5:1,0,-1,100838,99162
6:5:4,0,-1,100839,99161
1:5:3,0,-1,100840,99160
4:6:3,0,-1,100841,99159
5:2:1,1,1,100840,99160
3:6:1,0,-1,100841,99159
1:4:6,0,-1,100842,99158
3:4:2,1,1,100841,99159
4:4:1,0,-1,100842,99158
6:5:2,1,1,100841,99159
1:4:5,0,-1,100842,99158
3:5:5,0,-1,100843,99157
2:6:2,2,2,100841,99159
2:2:6,2,2,100839,99161
3:3:1,0,-1,100840,99160
2:5:2,2,2,100838,99162
1:4:2,1,1,100837,99163
1:2:4,1,1,100836,99164
4:5:5,0,-1,100837,99163
5:4:2,1,1,100836,99164
4:3:1,0,-1,100837,99163
1:5:3,0,-1,100838,99162
1:4:2,1,1,100837,99163
3:1:4,0,-1,100838,99162
4:4:1,0,-1,100839,99161
1:6:1,0,-1,100840,99160
3:1:5,0,-1,100841,99159
1:3:3,0,-1,100842,99158
3:5:2,1,1,100841,99159
3:6:5,0,-1,100842,99158
3:5:6,0,-1,100843,99157
5:6:3,0,-1,100844,99156
2:3:6,1,1,100843,99157
1:1:4,0,-1,100844,99156
1:2:1,1,1,100843,99157
5:4:4,0,-1,100844,99156
6:1:1,0,-1,100845,99155
4:4:3,0,-1,100846,99154
4:4:2,1,1,100845,99155
3:4:4,0,-1,100846,99154
3:5:5,0,-1,100847,99153
2:4:6,1,1,100846,99154
3:6:6,0,-1,100847,99153
6:1:1,0,-1,100848,99152
6:5:2,1,1,100847,99153
6:1:5,0,-1,100848,99152
1:4:1,0,-1,100849,99151
2:1:2,2,2,100847,99153
5:4:2,1,1,100846,99154
2:1:4,1,1,100845,99155
4:5:6,0,-1,100846,99154
3:1:4,0,-1,100847,99153
5:6:6,0,-1,100848,99152
5:4:3,0,-1,100849,99151
6:2:2,2,2,100847,99153
2:1:6,1,1,100846,99154
6:1:5,0,-1,100847,99153
2:6:4,1,1,100846,99154
6:2:6,1,1,100845,99155
2:4:2,2,2,100843,99157
5:2:3,1,1,100842,99158
5:6:3,0,-1,100843,99157
3:5:2,1,1,100842,99158
3:5:3,0,-1,100843,99157
6:4:3,0,-1,100844,99156
4:6:1,0,-1,100845,99155
4:2:2,2,2,100843,99157
6:6:2,1,1,100842,99158
4:4:5,0,-1,100843,99157
4:6:3,0,-1,100844,99156
4:2:5,1,1,100843,99157
6:5:4,0,-1,100844,99156
1:3:1,0,-1,100845,99155
6:2:5,1,1,100844,99156
1:1:2,1,1,100843,99157
5:6:3,0,-1,100844,99156
4:2:1,1,1,100843,99157
2:4:2,2,2,100841,99159
3:4:3,0,-1,100842,99158
1:5:4,0,-1,100843,99157
2:3:4,1,1,100842,99158
6:6:4,0,-1,100843,99157
1:6:5,0,-1,100844,99156
6:4:6,0,-1,100845,99155
1:1:6,0,-1,100846,99154
6:4:6,0,-1,100847,99153
2:2:4,2,2,100845,99155
4:5:3,0,-1,100846,99154
4:4:6,0,-1,100847,99153
6:1:6,0,-1,100848,99152
6:1:2,1,1,100847,99153
2:2:4,2,2,100845,99155
2:6:6,1,1,100844,99156
3:6:5,0,-1,100845,99155
1:5:3,0,-1,100846,99154
4:4:2,1,1,100845,99155
6:3:2,1,1,100844,99156
6:6:2,1,1,100843,99157
5:6:5,0,-1,100844,99156
6:2:4,1,1,100843,99157
2:5:3,1,1,100842,99158
2:2:6,2,2,100840,99160
2:1:2,2,2,100838,99162
5:1:3,0,-1,100839,99161
4:5:3,0,-1,100840,99160
1:3:6,0,-1,100841,99159
5:1:4,0,-1,100842,99158
6:6:2,1,1,100841,99159
2:4:5,1,1,100840,99160
2:6:1,1,1,100839,99161
5:1:4,0,-1,100840,99160
6:6:5,0,-1,100841,99159
4:5:2,1,1,100840,99160
3:2:2,2,2,100838,99162
2:3:1,1,1,100837,99163
2:1:6,1,1,100836,99164
4:5:2,1,1,100835,99165
1:3:3,0,-1,100836,99164
1:1:1,0,-1,100837,99163
6:6:6,0,-1,100838,99162
6:3:2,1,1,100837,99163
2:1:5,1,1,100836,99164
4:6:3,0,-1,100837,99163
4:1:2,1,1,100836,99164
3:3:1,0,-1,100837,99163
6:3:6,0,-1,100838,99162
3:1:6,0,-1,100839,99161
1:4:6,0,-1,100840,99160
1:6:1,0,-1,100841,99159
2:5:1,1,1,100840,99160
1:2:4,1,1,100839,99161
3:1:3,0,-1,100840,99160
4:2:3,1,1,100839,99161
4:4:4,0,-1,100840,99160
1:1:2,1,1,100839,99161
2:3:6,1,1,100838,99162
2:3:2,2,2,100836,99164
5:2:4,1,1,100835,99165
6:2:3,1,1,100834,99166
2:3:3,1,1,100833,99167
2:4:4,1,1,100832,99168
1:4:2,1,1,100831,99169
5:1:6,0,-1,100832,99168
5:1:3,0,-1,100833,99167
6:3:6,0,-1,100834,99166
4:5:4,0,-1,100835,99165
3:4:6,0,-1,100836,99164
1:6:2,1,1,100835,99165
3:2:3,1,1,100834,99166
1:6:2,1,1,100833,99167
3:3:3,0,-1,100834,99166
5:2:1,1,1,100833,99167
5:1:2,1,1,100832,99168
2:6:2,2,2,100830,99170
5:6:6,0,-1,100831,99169
3:5:6,0,-1,100832,99168
1:6:2,1,1,100831,99169
1:3:2,1,1,100830,99170
3:6:4,0,-1,100831,99169
1:5:5,0,-1,100832,99168
3:5:2,1,1,100831,99169
5:4:4,0,-1,100832,99168
2:1:2,2,2,100830,99170
6:4:2,1,1,100829,99171
2:5:2,2,2,100827,99173
1:2:5,1,1,100826,99174
2:5:1,1,1,100825,99175
1:5:3,0,-1,100826,99174
1:1:3,0,-1,100827,99173
1:5:6,0,-1,100828,99172
4:5:3,0,-1,100829,99171
1:2:6,1,1,100828,99172
3:2:2,2,2,100826,99174
1:4:5,0,-1,100827,99173
5:3:3,0,-1,100828,99172
3:6:1,0,-1,100829,99171
6:2:5,1,1,100828,99172
2:1:5,1,1,100827,99173
1:1:1,0,-1,100828,99172
2:5:6,1,1,100827,99173
6:1:3,0,-1,100828,99172
4:2:1,1,1,100827,99173
5:2:6,1,1,100826,99174
2:2:5,2,2,100824,99176
3:4:4,0,-1,100825,99175
4:6:2,1,1,100824,99176
1:4:1,0,-1,100825,99175
1:2:1,1,1,100824,99176
6:3:6,0,-1,100825,99175
6:2:6,1,1,100824,99176
5:5:1,0,-1,100825,99175
2:1:6,1,1,100824,99176
6:3:6,0,-1,100825,99175
5:6:4,0,-1,100826,99174
4:4:2,1,1,100825,99175
3:2:6,1,1,100824,99176
1:4:3,0,-1,100825,99175
3:4:4,0,-1,100826,99174
6:4:4,0,-1,100827,99173
2:5:4,1,1,100826,99174
2:1:4,1,1,100825,99175
3:4:1,0,-1,100826,99174
3:5:6,0,-1,100827,99173
6:6:4,0,-1,100828,99172
4:2:5,1,1,100827,99173
1:3:1,0,-1,100828,99172
1:4:5,0,-1,100829,99171
4:5:5,0,-1,100830,99170
1:1:6,0,-1,100831,99169
4:5:1,0,-1,100832,99168
4:5:1,0,-1,100833,99167
6:5:4,0,-1,100834,99166
4:6:2,1,1,100833,99167
5:3:1,0,-1,100834,99166
4:4:1,0,-1,100835,99165
5:5:2,1,1,100834,99166
2:6:3,1,1,100833,99167
6:2:1,1,1,100832,99168
6:6:1,0,-1,100833,99167
3:6:6,0,-1,100834,99166
4:3:1,0,-1,100835,99165
2:3:1,1,1,100834,99166
3:5:2,1,1,100833,99167
1:6:2,1,1,100832,99168
4:5:1,0,-1,100833,99167
4:6:4,0,-1,100834,99166
4:5:3,0,-1,100835,99165
5:3:2,1,1,100834,99166
5:1:6,0,-1,100835,99165
1:2:3,1,1,100834,99166
6:6:2,1,1,100833,99167
5:1:4,0,-1,100834,99166
4:3:6,0,-1,100835,99165
5:6:6,0,-1,100836,99164
1:3:6,0,-1,100837,99163
6:3:6,0,-1,100838,99162
3:6:2,1,1,100837,99163
5:1:2,1,1,100836,99164
2:2:5,2,2,100834,99166
6:1:5,0,-1,100835,99165
6:5:5,0,-1,100836,99164
6:1:5,0,-1,100837,99163
2:1:5,1,1,100836,99164
4:6:4,0,-1,100837,99163
5:6:1,0,-1,100838,99162
5:6:2,1,1,100837,99163
5:3:1,0,-1,100838,99162
6:4:5,0,-1,100839,99161
5:4:2,1,1,100838,99162
2:3:1,1,1,100837,99163
5:3:5,0,-1,100838,99162
4:1:1,0,-1,100839,99161
2:1:4,1,1,100838,99162
2:6:5,1,1,100837,99163
1:6:1,0,-1,100838,99162
2:5:2,2,2,100836,99164
6:4:1,0,-1,100837,99163
1:3:2,1,1,100836,99164
4:5:6,0,-1,100837,99163
3:3:4,0,-1,100838,99162
1:5:4,0,-1,100839,99161
5:1:6,0,-1,100840,99160
6:1:3,0,-1,100841,99159
3:1:5,0,-1,100842,99158
1:6:2,1,1,100841,99159
1:4:4,0,-1,100842,99158
6:2:5,1,1,100841,99159
4:5:4,0,-1,100842,99158
4:6:1,0,-1,100843,99157
2:3:6,1,1,100842,99158
3:1:4,0,-1,100843,99157
4:5:4,0,-1,100844,99156
6:2:4,1,1,100843,99157
6:6:3,0,-1,100844,99156
1:3:2,1,1,100843,99157
5:4:1,0,-1,100844,99156
2:2:6,2,2,100842,99158
1:4:1,0,-1,100843,99157
1:3:2,1,1,100842,99158
1:1:4,0,-1,100843,99157
2:5:6,1,1,100842,99158
1:6:6,0,-1,100843,99157
5:1:1,0,-1,100844,99156
1:6:3,0,-1,100845,99155
5:1:2,1,1,100844,99156
2:2:4,2,2,100842,99158
3:5:6,0,-1,100843,99157
1:3:4,0,-1,100844,99156
4:3:4,0,-1,100845,99155
5:4:1,0,-1,100846,99154
4:3:2,1,1,100845,99155
2:1:2,2,2,100843,99157
3:4:3,0,-1,100844,99156
4:5:4,0,-1,100845,99155
5:6:1,0,-1,100846,99154
6:6:1,0,-1,100847,99153
4:5:1,0,-1,100848,99152
1:2:6,1,1,100847,99153
4:1:3,0,-1,100848,99152
2:2:4,2,2,100846,99154
5:5:6,0,-1,100847,99153
1:4:4,0,-1,100848,99152
6:3:3,0,-1,100849,99151
4:5:2,1,1,100848,99152
4:4:2,1,1,100847,99153
3:3:1,0,-1,100848,99152
2:3:5,1,1,100847,99153
1:6:3,0,-1,100848,99152
5:6:3,0,-1,100849,99151
1:3:1,0,-1,100850,99150
1:3:6,0,-1,100851,99149
6:4:5,0,-1,100852,99148
2:6:1,1,1,100851,99149
3:1:3,0,-1,100852,99148
5:1:5,0,-1,100853,99147
6:6:2,1,1,100852,99148
5:2:6,1,1,100851,99149
2:5:3,1,1,100850,99150
5:6:6,0,-1,100851,99149
2:1:4,1,1,100850,99150
4:5:4,0,-1,100851,99149
6:6:2,1,1,100850,99150
5:2:6,1,1,100849,99151
6:5:1,0,-1,100850,99150
1:2:5,1,1,100849,99151
4:1:3,0,-1,100850,99150
3:3:3,0,-1,100851,99149
5:3:2,1,1,100850,99150
4:5:4,0,-1,100851,99149
3:4:3,0,-1,100852,99148
4:1:5,0,-1,100853,99147
5:4:2,1,1,100852,99148
1:5:4,0,-1,100853,99147
3:5:6,0,-1,100854,99146
4:3:5,0,-1,100855,99145
1:4:2,1,1,100854,99146
5:5:6,0,-1,100855,99145
3:2:3,1,1,100854,99146
2:6:3,1,1,100853,99147
2:4:1,1,1,100852,99148
1:4:3,0,-1,100853,99147
5:3:3,0,-1,100854,99146
4:3:1,0,-1,100855,99145
2:3:3,1,1,100854,99146
6:4:6,0,-1,100855,99145
4:6:1,0,-1,100856,99144
5:2:5,1,1,100855,99145
5:2:5,1,1,100854,99146
6:1:2,1,1,100853,99147
2:2:4,2,2,100851,99149
2:6:3,1,1,100850,99150
4:5:6,0,-1,100851,99149
6:6:2,1,1,100850,99150
6:6:2,1,1,100849,99151
4:5:5,0,-1,100850,99150
6:1:3,0,-1,100851,99149
6:5:1,0,-1,100852,99148
6:4:6,0,-1,100853,99147
3:4:1,0,-1,100854,99146
3:5:4,0,-1,100855,99145
4:2:2,2,2,100853,99147
2:6:5,1,1,100852,99148
1:6:2,1,1,100851,99149
1:6:3,0,-1,100852,99148
2:3:2,2,2,100850,99150
2:4:2,2,2,100848,99152
2:3:5,1,1,100847,99153
2:1:3,1,1,100846,99154
2:4:6,1,1,100845,99155
3:1:3,0,-1,100846,99154
5:5:3,0,-1,100847,99153
6:5:4,0,-1,100848,99152
3:4:3,0,-1,100849,99151
2:4:6,1,1,100848,99152
3:5:1,0,-1,100849,99151
1:6:5,0,-1,100850,99150
2:2:1,2,2,100848,99152
6:3:6,0,-1,100849,99151
4:2:3,1,1,100848,99152
5:1:2,1,1,100847,99153
2:1:1,1,1,100846,99154
4:1:4,0,-1,100847,99153
2:4:4,1,1,100846,99154
3:3:4,0,-1,100847,99153
5:3:1,0,-1,100848,99152
3:6:6,0,-1,100849,99151
1:4:4,0,-1,100850,99150
4:4:4,0,-1,100851,99149
2:2:2,3,3,100848,99152
6:4:4,0,-1,100849,99151
3:1:2,1,1,100848,99152
5:5:5,0,-1,100849,99151
6:6:1,0,-1,100850,99150
5:3:4,0,-1,100851,99149
5:1:5,0,-1,100852,99148
6:2:4,1,1,100851,99149
5:3:2,1,1,100850,99150
1:5:6,0,-1,100851,99149
1:1:4,0,-1,100852,99148
5:4:2,1,1,100851,99149
2:3:6,1,1,100850,99150
2:3:4,1,1,100849,99151
5:1:4,0,-1,100850,99150
5:1:5,0,-1,100851,99149
3:4:1,0,-1,100852,99148
3:3:2,1,1,100851,99149
6:6:4,0,-1,100852,99148
6:2:2,2,2,100850,99150
2:1:4,1,1,100849,99151
4:3:2,1,1,100848,99152
6:6:3,0,-1,100849,99151
5:6:5,0,-1,100850,99150
4:6:1,0,-1,100851,99149
1:6:6,0,-1,100852,99148
3:5:5,0,-1,100853,99147
4:4:3,0,-1,100854,99146
3:5:3,0,-1,100855,99145
2:4:5,1,1,100854,99146
2:4:3,1,1,100853,99147
2:4:2,2,2,100851,99149
6:4:6,0,-1,100852,99148
5:5:6,0,-1,100853,99147
1:6:5,0,-1,100854,99146
5:5:4,0,-1,100855,99145
3:2:3,1,1,100854,99146
1:6:1,0,-1,100855,99145
1:4:4,0,-1,100856,99144
6:6:4,0,-1,100857,99143
6:3:4,0,-1,100858,99142
2:4:1,1,1,100857,99143
2:5:4,1,1,100856,99144
6:1:5,0,-1,100857,99143
1:1:5,0,-1,100858,99142
6:4:6,0,-1,100859,99141
2:2:4,2,2,100857,99143
4:4:4,0,-1,100858,99142
5:3:6,0,-1,100859,99141
4:1:5,0,-1,100860,99140
1:4:2,1,1,100859,99141
5:3:5,0,-1,100860,99140
4:1:3,0,-1,100861,99139
4:3:5,0,-1,100862,99138
4:4:5,0,-1,100863,99137
6:6:6,0,-1,100864,99136
3:6:3,0,-1,100865,99135
6:4:3,0,-1,100866,99134
1:6:2,1,1,100865,99135
6:6:2,1,1,100864,99136
6:2:1,1,1,100863,99137
4:6:3,0,-1,100864,99136
2:3:2,2,2,100862,99138
3:5:6,0,-1,100863,99137
4:1:3,0,-1,100864,99136
5:5:2,1,1,100863,99137
2:4:3,1,1,100862,99138
2:1:1,1,1,100861,99139
1:2:2,2,2,100859,99141
1:5:1,0,-1,100860,99140
3:1:6,0,-1,100861,99139
4:2:5,1,1,100860,99140
2:3:2,2,2,100858,99142
5:2:2,2,2,100856,99144
2:1:6,1,1,100855,99145
6:5:1,0,-1,100856,99144
1:3:1,0,-1,100857,99143
3:6:4,0,-1,100858,99142
6:6:3,0,-1,100859,99141
2:4:1,1,1,100858,99142
2:6:3,1,1,100857,99143
3:1:5,0,-1,100858,99142
2:4:6,1,1,100857,99143
6:2:6,1,1,100856,99144
2:6:4,1,1,100855,99145
3:1:5,0,-1,100856,99144
4:1:3,0,-1,100857,99143
3:3:5,0,-1,100858,99142
1:1:6,0,-1,100859,99141
4:5:1,0,-1,100860,99140
5:3:1,0,-1,100861,99139
3:3:6,0,-1,100862,99138
4:3:5,0,-1,100863,99137
5:2:1,1,1,100862,99138
2:2:3,2,2,100860,99140
1:5:6,0,-1,100861,99139
2:5:5,1,1,100860,99140
4:3:1,0,-1,100861,99139
5:6:2,1,1,100860,99140
4:5:2,1,1,100859,99141
2:5:5,1,1,100858,99142
3:3:4,0,-1,100859,99141
1:5:3,0,-1,100860,99140
3:4:2,1,1,100859,99141
5:5:2,1,1,100858,99142
5:3:3,0,-1,100859,99141
3:4:5,0,-1,100860,99140
6:1:2,1,1,100859,99141
5:2:5,1,1,100858,99142
3:6:6,0,-1,100859,99141
5:1:5,0,-1,100860,99140
5:4:4,0,-1,100861,99139
6:1:3,0,-1,100862,99138
1:1:2,1,1,100861,99139
4:5:5,0,-1,100862,99138
3:4:3,0,-1,100863,99137
4:1:5,0,-1,100864,99136
2:5:1,1,1,100863,99137
4:4:5,0,-1,100864,99136
5:2:3,1,1,100863,99137
5:6:2,1,1,100862,99138
1:5:6,0,-1,100863,99137
6:1:4,0,-1,100864,99136
6:1:4,0,-1,100865,99135
2:5:3,1,1,100864,99136
1:3:4,0,-1,100865,99135
1:4:4,0,-1,100866,99134
4:3:3,0,-1,100867,99133
2:3:1,1,1,100866,99134
3:5:4,0,-1,100867,99133
3:5:4,0,-1,100868,99132
4:1:2,1,1,100867,99133
4:6:4,0,-1,100868,99132
5:3:2,1,1,100867,99133
5:3:4,0,-1,100868,99132
2:2:6,2,2,100866,99134
1:2:3,1,1,100865,99135
5:6:1,0,-1,100866,99134
2:1:1,1,1,100865,99135
1:2:4,1,1,100864,99136
6:4:3,0,-1,100865,99135
4:2:5,1,1,100864,99136
4:4:2,1,1,100863,99137
1:1:6,0,-1,100864,99136
5:4:5,0,-1,100865,99135
4:2:1,1,1,100864,99136
3:1:5,0,-1,100865,99135
5:3:2,1,1,100864,99136
1:4:3,0,-1,100865,99135
5:6:3,0,-1,100866,99134
6:5:3,0,-1,100867,99133
6:3:5,0,-1,100868,99132
5:1:1,0,-1,100869,99131
2:5:6,1,1,100868,99132
3:4:3,0,-1,100869,99131
6:6:6,0,-1,100870,99130
6:2:2,2,2,100868,99132
5:3:6,0,-1,100869,99131
3:6:6,0,-1,100870,99130
4:2:4,1,1,100869,99131
2:5:1,1,1,100868,99132
5:3:3,0,-1,100869,99131
2:2:1,2,2,100867,99133
4:3:5,0,-1,100868,99132
2:4:2,2,2,100866,99134
2:1:4,1,1,100865,99135
1:6:3,0,-1,100866,99134
1:6:3,0,-1,100867,99133
3:2:4,1,1,100866,99134
6:2:2,2,2,100864,99136
3:2:1,1,1,100863,99137
5:4:2,1,1,100862,99138
2:4:5,1,1,100861,99139
4:6:3,0,-1,100862,99138
4:3:1,0,-1,100863,99137
5:2:6,1,1,100862,99138
6:6:5,0,-1,100863,99137
4:4:4,0,-1,100864,99136
3:6:6,0,-1,100865,99135
3:5:5,0,-1,100866,99134
2:4:4,1,1,100865,99135
2:1:1,1,1,100864,99136
2:3:4,1,1,100863,99137
3:2:4,1,1,100862,99138
4:5:5,0,-1,100863,99137
3:2:1,1,1,100862,99138
5:5:2,1,1,100861,99139
3:3:5,0,-1,100862,99138
4:1:3,0,-1,100863,99137
6:2:6,1,1,100862,99138
1:2:2,2,2,100860,99140
5:5:5,0,-1,100861,99139
6:2:1,1,1,100860,99140
1:1:6,0,-1,100861,99139
4:1:3,0,-1,100862,99138
6:5:5,0,-1,100863,99137
2:2:5,2,2,100861,99139
3:4:5,0,-1,100862,99138
1:2:4,1,1,100861,99139
6:2:5,1,1,100860,99140
3:5:4,0,-1,100861,99139
3:2:4,1,1,100860,99140
5:3:5,0,-1,100861,99139
3:3:6,0,-1,100862,99138
6:5:6,0,-1,100863,99137
5:3:4,0,-1,100864,99136
4:4:5,0,-1,100865,99135
1:5:1,0,-1,100866,99134
4:6:3,0,-1,100867,99133
3:3:2,1,1,100866,99134
4:3:5,0,-1,100867,99133
5:3:4,0,-1,100868,99132
1:2:6,1,1,100867,99133
1:6:6,0,-1,100868,99132
6:2:4,1,1,100867,99133
2:6:2,2,2,100865,99135
4:5:1,0,-1,100866,99134
5:4:1,0,-1,100867,99133
1:4:3,0,-1,100868,99132
2:5:6,1,1,100867,99133
6:4:1,0,-1,100868,99132
3:1:5,0,-1,100869,99131
2:3:5,1,1,100868,99132
5:4:4,0,-1,100869,99131
3:5:5,0,-1,100870,99130
6:1:2,1,1,100869,99131
1:1:4,0,-1,100870,99130
5:2:5,1,1,100869,99131
1:4:2,1,1,100868,99132
1:1:3,0,-1,100869,99131
4:6:6,0,-1,100870,99130
4:2:6,1,1,100869,99131
6:1:5,0,-1,100870,99130
4:4:4,0,-1,100871,99129
4:5:5,0,-1,100872,99128
2:4:3,1,1,100871,99129
3:6:3,0,-1,100872,99128
5:6:6,0,-1,100873,99127
4:4:5,0,-1,100874,99126
5:6:6,0,-1,100875,99125
4:2:1,1,1,100874,99126
3:4:3,0,-1,100875,99125
5:6:5,0,-1,100876,99124
1:5:6,0,-1,100877,99123
2:1:4,1,1,100876,99124
4:5:6,0,-1,100877,99123
2:3:5,1,1,100876,99124
2:6:6,1,1,100875,99125
2:5:5,1,1,100874,99126
4:4:5,0,-1,100875,99125
6:2:5,1,1,100874,99126
3:4:3,0,-1,100875,99125
2:3:2,2,2,100873,99127
4:4:1,0,-1,100874,99126
6:5:1,0,-1,100875,99125
3:5:1,0,-1,100876,99124
4:4:3,0,-1,100877,99123
5:1:4,0,-1,100878,99122
5:2:6,1,1,100877,99123
3:3:5,0,-1,100878,99122
4:6:4,0,-1,100879,99121
4:5:4,0,-1,100880,99120
2:6:5,1,1,100879,99121
1:4:6,0,-1,100880,99120
2:4:1,1,1,100879,99121
4:1:3,0,-1,100880,99120
4:5:6,0,-1,100881,99119
3:1:3,0,-1,100882,99118
5:6:2,1,1,100881,99119
6:2:2,2,2,100879,99121
5:5:1,0,-1,100880,99120
3:6:1,0,-1,100881,99119
5:5:5,0,-1,100882,99118
6:3:4,0,-1,100883,99117
3:1:3,0,-1,100884,99116
6:1:2,1,1,100883,99117
2:3:2,2,2,100881,99119
5:4:4,0,-1,100882,99118
6:4:3,0,-1,100883,99117
2:3:2,2,2,100881,99119
4:6:5,0,-1,100882,99118
3:1:2,1,1,100881,99119
4:6:6,0,-1,100882,99118
3:3:5,0,-1,100883,99117
6:2:1,1,1,100882,99118
6:4:5,0,-1,100883,99117
1:4:3,0,-1,100884,99116
4:4:5,0,-1,100885,99115
1:5:2,1,1,100884,99116
4:3:3,0,-1,100885,99115
4:1:6,0,-1,100886,99114
5:3:4,0,-1,100887,99113
5:1:6,0,-1,100888,99112
3:1:5,0,-1,100889,99111
4:4:6,0,-1,100890,99110
1:1:4,0,-1,100891,99109
4:4:3,0,-1,100892,99108
3:1:2,1,1,100891,99109
6:3:1,0,-1,100892,99108
2:1:1,1,1,100891,99109
6:4:1,0,-1,100892,99108
1:4:1,0,-1,100893,99107
3:5:4,0,-1,100894,99106
6:6:4,0,-1,100895,99105
2:4:6,1,1,100894,99106
6:3:5,0,-1,100895,99105
3:3:5,0,-1,100896,99104
6:2:3,1,1,100895,99105
1:4:6,0,-1,100896,99104
4:3:6,0,-1,100897,99103
4:1:6,0,-1,100898,99102
3:1:2,1,1,100897,99103
5:3:6,0,-1,100898,99102
3:4:4,0,-1,100899,99101
5:1:1,0,-1,100900,99100
6:5:3,0,-1,100901,99099
6:6:5,0,-1,100902,99098
4:2:6,1,1,100901,99099
4:4:2,1,1,100900,99100
3:4:3,0,-1,100901,99099
3:1:5,0,-1,100902,99098
5:5:3,0,-1,100903,99097
2:5:4,1,1,100902,99098
3:1:4,0,-1,100903,99097
3:3:1,0,-1,100904,99096
2:4:4,1,1,100903,99097
6:4:5,0,-1,100904,99096
4:3:3,0,-1,100905,99095
1:2:1,1,1,100904,99096
2:3:2,2,2,100902,99098
6:3:5,0,-1,100903,99097
2:2:4,2,2,100901,99099
6:5:4,0,-1,100902,99098
3:5:2,1,1,100901,99099
5:2:6,1,1,100900,99100
6:3:5,0,-1,100901,99099
5:1:4,0,-1,100902,99098
1:6:4,0,-1,100903,99097
3:6:6,0,-1,100904,99096
1:2:5,1,1,100903,99097
5:5:2,1,1,100902,99098
3:2:1,1,1,100901,99099
6:5:2,1,1,100900,99100
4:6:4,0,-1,100901,99099
2:2:1,2,2,100899,99101
6:3:4,0,-1,100900,99100
1:1:3,0,-1,100901,99099
2:2:6,2,2,100899,99101
5:6:1,0,-1,100900,99100
1:4:4,0,-1,100901,99099
2:3:4,1,1,100900,99100
6:2:2,2,2,100898,99102
4:5:1,0,-1,100899,99101
1:3:5,0,-1,100900,99100
3:2:6,1,1,100899,99101
1:4:4,0,-1,100900,99100
6:5:5,0,-1,100901,99099
3:4:5,0,-1,100902,99098
5:1:6,0,-1,100903,99097
6:1:6,0,-1,100904,99096
6:5:2,1,1,100903,99097
3:3:4,0,-1,100904,99096
2:2:6,2,2,100902,99098
4:4:5,0,-1,100903,99097
4:2:5,1,1,100902,99098
1:6:2,1,1,100901,99099
1:2:3,1,1,100900,99100
1:5:5,0,-1,100901,99099
6:6:3,0,-1,100902,99098
2:6:1,1,1,100901,99099
5:1:5,0,-1,100902,99098
5:6:2,1,1,100901,99099
5:3:6,0,-1,100902,99098
4:1:6,0,-1,100903,99097
1:3:6,0,-1,100904,99096
2:6:2,2,2,100902,99098
2:3:3,1,1,100901,99099
4:2:1,1,1,100900,99100
6:2:3,1,1,100899,99101
3:1:2,1,1,100898,99102
3:2:6,1,1,100897,99103
2:3:3,1,1,100896,99104
5:1:6,0,-1,100897,99103
5:5:5,0,-1,100898,99102
1:6:4,0,-1,100899,99101
5:5:2,1,1,100898,99102
2:4:6,1,1,100897,99103
4:5:1,0,-1,100898,99102
6:1:4,0,-1,100899,99101
5:2:5,1,1,100898,99102
6:1:5,0,-1,100899,99101
1:2:6,1,1,100898,99102
3:6:3,0,-1,100899,99101
4:2:3,1,1,100898,99102
4:6:3,0,-1,100899,99101
2:2:5,2,2,100897,99103
2:2:3,2,2,100895,99105
2:4:2,2,2,100893,99107
4:1:2,1,1,100892,99108
3:1:3,0,-1,100893,99107
6:5:1,0,-1,100894,99106
2:6:2,2,2,100892,99108
1:6:5,0,-1,100893,99107
3:5:4,0,-1,100894,99106
1:3:1,0,-1,100895,99105
6:4:4,0,-1,100896,99104
6:1:1,0,-1,100897,99103
3:3:4,0,-1,100898,99102
1:3:1,0,-1,100899,99101
4:3:6,0,-1,100900,99100
1:2:2,2,2,100898,99102
2:3:6,1,1,100897,99103
2:4:6,1,1,100896,99104
6:6:1,0,-1,100897,99103
6:2:6,1,1,100896,99104
4:1:4,0,-1,100897,99103
2:3:3,1,1,100896,99104
2:5:2,2,2,100894,99106
1:4:5,0,-1,100895,99105
3:1:4,0,-1,100896,99104
1:6:1,0,-1,100897,99103
6:2:2,2,2,100895,99105
5:2:1,1,1,100894,99106
6:3:1,0,-1,100895,99105
4:1:6,0,-1,100896,99104
1:5:4,0,-1,100897,99103
4:6:3,0,-1,100898,99102
4:5:2,1,1,100897,99103
6:6:4,0,-1,100898,99102
1:4:4,0,-1,100899,99101
4:6:5,0,-1,100900,99100
3:5:5,0,-1,100901,99099
2:6:3,1,1,100900,99100
2:2:5,2,2,100898,99102
2:2:6,2,2,100896,99104
3:1:1,0,-1,100897,99103
6:4:5,0,-1,100898,99102
4:6:2,1,1,100897,99103
1:3:6,0,-1,100898,99102
2:6:1,1,1,100897,99103
3:5:4,0,-1,100898,99102
3:6:5,0,-1,100899,99101
1:6:5,0,-1,100900,99100
4:3:6,0,-1,100901,99099
4:3:3,0,-1,100902,99098
3:3:6,0,-1,100903,99097
3:1:6,0,-1,100904,99096
5:2:3,1,1,100903,99097
5:6:2,1,1,100902,99098
3:4:1,0,-1,100903,99097
5:5:2,1,1,100902,99098
1:5:5,0,-1,100903,99097
6:4:2,1,1,100902,99098
1:6:5,0,-1,100903,99097
2:5:5,1,1,100902,99098
5:3:2,1,1,100901,99099
1:2:6,1,1,100900,99100
1:5:6,0,-1,100901,99099
3:5:6,0,-1,100902,99098
5:5:3,0,-1,100903,99097
5:2:1,1,1,100902,99098
1:2:6,1,1,100901,99099
6:5:6,0,-1,100902,99098
3:1:3,0,-1,100903,99097
6:1:2,1,1,100902,99098
2:6:1,1,1,100901,99099
4:1:5,0,-1,100902,99098
4:5:4,0,-1,100903,99097
5:2:4,1,1,100902,99098
3:1:6,0,-1,100903,99097
3:6:3,0,-1,100904,99096
4:3:5,0,-1,100905,99095
5:2:2,2,2,100903,99097
3:4:6,0,-1,100904,99096
5:3:5,0,-1,100905,99095
5:6:3,0,-1,100906,99094
6:5:1,0,-1,100907,99093
4:4:3,0,-1,100908,99092
4:2:3,1,1,100907,99093
4:3:4,0,-1,100908,99092
6:5:1,0,-1,100909,99091
3:2:5,1,1,100908,99092
6:6:4,0,-1,100909,99091
2:1:3,1,1,100908,99092
1:6:6,0,-1,100909,99091
5:3:4,0,-1,100910,99090
1:6:6,0,-1,100911,99089
4:2:1,1,1,100910,99090
3:2:2,2,2,100908,99092
3:4:6,0,-1,100909,99091
2:5:4,1,1,100908,99092
2:3:1,1,1,100907,99093
5:6:3,0,-1,100908,99092
2:2:4,2,2,100906,99094
1:6:1,0,-1,100907,99093
6:6:4,0,-1,100908,99092
5:1:4,0,-1,100909,99091
6:2:3,1,1,100908,99092
6:1:1,0,-1,100909,99091
3:3:3,0,-1,100910,99090
4:3:6,0,-1,100911,99089
4:6:2,1,1,100910,99090
1:2:1,1,1,100909,99091
3:3:2,1,1,100908,99092
6:6:4,0,-1,100909,99091
1:3:1,0,-1,100910,99090
1:4:3,0,-1,100911,99089
1:1:4,0,-1,100912,99088
6:6:2,1,1,100911,99089
1:4:1,0,-1,100912,99088
5:4:2,1,1,100911,99089
1:3:3,0,-1,100912,99088
1:5:5,0,-1,100913,99087
4:6:3,0,-1,100914,99086
1:2:5,1,1,100913,99087
5:6:4,0,-1,100914,99086
4:6:4,0,-1,100915,99085
4:5:1,0,-1,100916,99084
6:6:3,0,-1,100917,99083
3:5:4,0,-1,100918,99082
5:1:5,0,-1,100919,99081
1:3:1,0,-1,100920,99080
5:2:2,2,2,100918,99082
2:1:4,1,1,100917,99083
5:3:1,0,-1,100918,99082
3:4:5,0,-1,100919,99081
1:5:4,0,-1,100920,99080
1:2:6,1,1,100919,99081
1:5:1,0,-1,100920,99080
5:6:3,0,-1,100921,99079
3:1:4,0,-1,100922,99078
6:5:2,1,1,100921,99079
5:4:4,0,-1,100922,99078
3:4:5,0,-1,100923,99077
3:1:3,0,-1,100924,99076
1:4:4,0,-1,100925,99075
4:3:4,0,-1,100926,99074
3:6:1,0,-1,100927,99073
6:2:5,1,1,100926,99074
3:6:6,0,-1,100927,99073
4:5:4,0,-1,100928,99072
5:6:3,0,-1,100929,99071
2:3:4,1,1,100928,99072
4:1:5,0,-1,100929,99071
1:2:4,1,1,100928,99072
1:6:2,1,1,100927,99073
5:1:6,0,-1,100928,99072
5:4:2,1,1,100927,99073
4:3:5,0,-1,100928,99072
3:3:4,0,-1,100929,99071
6:6:6,0,-1,100930,99070
4:4:3,0,-1,100931,99069
5:3:2,1,1,100930,99070
5:1:6,0,-1,100931,99069
1:3:1,0,-1,100932,99068
3:3:5,0,-1,100933,99067
1:6:4,0,-1,100934,99066
2:4:3,1,1,100933,99067
4:6:2,1,1,100932,99068
5:2:6,1,1,100931,99069
5:4:4,0,-1,100932,99068
1:6:1,0,-1,100933,99067
3:1:2,1,1,100932,99068
1:2:2,2,2,100930,99070
3:3:1,0,-1,100931,99069
6:2:1,1,1,100930,99070
3:1:1,0,-1,100931,99069
4:5:4,0,-1,100932,99068
1:3:5,0,-1,100933,99067
4:2:5,1,1,100932,99068
4:4:2,1,1,100931,99069
2:6:5,1,1,100930,99070
4:1:6,0,-1,100931,99069
3:2:2,2,2,100929,99071
6:4:1,0,-1,100930,99070
1:5:4,0,-1,100931,99069
1:6:4,0,-1,100932,99068
1:2:1,1,1,100931,99069
4:4:6,0,-1,100932,99068
5:1:3,0,-1,100933,99067
6:3:5,0,-1,100934,99066
4:2:5,1,1,100933,99067
4:3:6,0,-1,100934,99066
2:6:4,1,1,100933,99067
3:6:5,0,-1,100934,99066
3:1:5,0,-1,100935,99065
4:4:5,0,-1,100936,99064
3:3:5,0,-1,100937,99063
5:4:6,0,-1,100938,99062
5:4:4,0,-1,100939,99061
2:4:1,1,1,100938,99062
2:1:6,1,1,100937,99063
3:6:2,1,1,100936,99064
1:4:6,0,-1,100937,99063
3:3:5,0,-1,100938,99062
4:3:1,0,-1,100939,99061
4:4:3,0,-1,100940,99060
4:5:3,0,-1,100941,99059
2:5:4,1,1,100940,99060
5:2:3,1,1,100939,99061
4:1:6,0,-1,100940,99060
3:5:5,0,-1,100941,99059
6:1:3,0,-1,100942,99058
6:1:2,1,1,100941,99059
4:5:2,1,1,100940,99060
1:3:4,0,-1,100941,99059
3:5:2,1,1,100940,99060
3:6:6,0,-1,100941,99059
4:6:3,0,-1,100942,99058
5:1:1,0,-1,100943,99057
1:3:1,0,-1,100944,99056
5:1:5,0,-1,100945,99055
3:1:1,0,-1,100946,99054
6:2:3,1,1,100945,99055
2:2:4,2,2,100943,99057
3:6:2,1,1,100942,99058
5:5:2,1,1,100941,99059
6:1:5,0,-1,100942,99058
2:5:2,2,2,100940,99060
2:2:1,2,2,100938,99062
5:3:3,0,-1,100939,99061
5:5:2,1,1,100938,99062
3:2:6,1,1,100937,99063
1:6:1,0,-1,100938,99062
1:3:2,1,1,100937,99063
4:4:6,0,-1,100938,99062
1:5:4,0,-1,100939,99061
3:1:2,1,1,100938,99062
5:1:4,0,-1,100939,99061
2:3:4,1,1,100938,99062
5:5:6,0,-1,100939,99061
6:5:4,0,-1,100940,99060
5:2:1,1,1,100939,99061
1:1:2,1,1,100938,99062
2:5:6,1,1,100937,99063
3:4:5,0,-1,100938,99062
5:3:6,0,-1,100939,99061
2:1:1,1,1,100938,99062
1:4:6,0,-1,100939,99061
5:3:6,0,-1,100940,99060
2:1:3,1,1,100939,99061
2:5:4,1,1,100938,99062
2:1:5,1,1,100937,99063
2:1:6,1,1,100936,99064
1:4:6,0,-1,100937,99063
2:4:5,1,1,100936,99064
3:1:3,0,-1,100937,99063
6:4:6,0,-1,100938,99062
1:4:5,0,-1,100939,99061
2:2:5,2,2,100937,99063
4:3:6,0,-1,100938,99062
6:3:1,0,-1,100939,99061
4:4:2,1,1,100938,99062
2:5:2,2,2,100936,99064
3:3:6,0,-1,100937,99063
5:5:1,0,-1,100938,99062
6:3:4,0,-1,100939,99061
5:6:4,0,-1,100940,99060
4:1:2,1,1,100939,99061
6:1:2,1,1,100938,99062
2:5:5,1,1,100937,99063
2:3:1,1,1,100936,99064
1:2:3,1,1,100935,99065
1:5:6,0,-1,100936,99064
4:5:1,0,-1,100937,99063
5:4:2,1,1,100936,99064
6:1:2,1,1,100935,99065
3:2:2,2,2,100933,99067
4:5:3,0,-1,100934,99066
3:3:3,0,-1,100935,99065
3:5:2,1,1,100934,99066
2:5:1,1,1,100933,99067
1:4:2,1,1,100932,99068
4:5:1,0,-1,100933,99067
6:5:3,0,-1,100934,99066
1:6:3,0,-1,100935,99065
3:2:6,1,1,100934,99066
2:5:2,2,2,100932,99068
1:2:5,1,1,100931,99069
4:6:3,0,-1,100932,99068
6:2:1,1,1,100931,99069
3:4:1,0,-1,100932,99068
4:4:6,0,-1,100933,99067
2:2:3,2,2,100931,99069
3:1:4,0,-1,100932,99068
2:4:4,1,1,100931,99069
2:1:3,1,1,100930,99070
4:1:2,1,1,100929,99071
1:6:2,1,1,100928,99072
1:6:2,1,1,100927,99073
1:4:5,0,-1,100928,99072
5:5:5,0,-1,100929,99071
2:5:4,1,1,100928,99072
2:1:5,1,1,100927,99073
5:6:1,0,-1,100928,99072
5:1:6,0,-1,100929,99071
6:6:5,0,-1,100930,99070
4:3:1,0,-1,100931,99069
1:5:1,0,-1,100932,99068
4:1:4,0,-1,100933,99067
1:4:6,0,-1,100934,99066
1:2:4,1,1,100933,99067
2:1:3,1,1,100932,99068
4:1:6,0,-1,100933,99067
4:5:1,0,-1,100934,99066
1:3:6,0,-1,100935,99065
5:2:1,1,1,100934,99066
6:5:3,0,-1,100935,99065
4:5:2,1,1,100934,99066
3:4:1,0,-1,100935,99065
6:2:2,2,2,100933,99067
3:4:3,0,-1,100934,99066
5:6:3,0,-1,100935,99065
4:5:5,0,-1,100936,99064
4:4:1,0,-1,100937,99063
1:5:1,0,-1,100938,99062
2:3:1,1,1,100937,99063
3:1:3,0,-1,100938,99062
2:6:3,1,1,100937,99063
1:3:5,0,-1,100938,99062
2:1:3,1,1,100937,99063
1:6:5,0,-1,100938,99062
1:6:5,0,-1,100939,99061
5:5:5,0,-1,100940,99060
5:2:5,1,1,100939,99061
2:4:1,1,1,100938,99062
4:4:2,1,1,100937,99063
1:6:5,0,-1,100938,99062
5:4:1,0,-1,100939,99061
5:6:2,1,1,100938,99062
1:1:2,1,1,100937,99063
2:1:2,2,2,100935,99065
3:5:5,0,-1,100936,99064
5:6:5,0,-1,100937,99063
4:3:1,0,-1,100938,99062
1:3:2,1,1,100937,99063
4:1:4,0,-1,100938,99062
6:5:1,0,-1,100939,99061
5:6:6,0,-1,100940,99060
6:3:5,0,-1,100941,99059
1:1:5,0,-1,100942,99058
5:6:2,1,1,100941,99059
6:5:6,0,-1,100942,99058
2:4:2,2,2,100940,99060
4:5:6,0,-1,100941,99059
1:6:2,1,1,100940,99060
3:5:5,0,-1,100941,99059
5:2:3,1,1,100940,99060
6:1:1,0,-1,100941,99059
6:6:3,0,-1,100942,99058
1:2:2,2,2,100940,99060
1:5:2,1,1,100939,99061
2:4:6,1,1,100938,99062
2:5:4,1,1,100937,99063
3:5:2,1,1,100936,99064
2:1:1,1,1,100935,99065
2:6:2,2,2,100933,99067
1:6:3,0,-1,100934,99066
6:2:2,2,2,100932,99068
1:1:4,0,-1,100933,99067
4:3:4,0,-1,100934,99066
6:5:1,0,-1,100935,99065
5:5:2,1,1,100934,99066
3:3:5,0,-1,100935,99065
6:3:6,0,-1,100936,99064
1:2:1,1,1,100935,99065
5:5:3,0,-1,100936,99064
2:3:2,2,2,100934,99066
5:5:5,0,-1,100935,99065
2:3:5,1,1,100934,99066
5:2:3,1,1,100933,99067
5:4:6,0,-1,100934,99066
3:2:3,1,1,100933,99067
6:6:5,0,-1,100934,99066
1:2:4,1,1,100933,99067
4:2:6,1,1,100932,99068
5:3:1,0,-1,100933,99067
6:5:6,0,-1,100934,99066
4:6:4,0,-1,100935,99065
1:6:4,0,-1,100936,99064
2:3:1,1,1,100935,99065
4:6:6,0,-1,100936,99064
3:6:6,0,-1,100937,99063
5:4:4,0,-1,100938,99062
6:3:3,0,-1,100939,99061
2:6:4,1,1,100938,99062
3:4:4,0,-1,100939,99061
6:3:4,0,-1,100940,99060
1:3:6,0,-1,100941,99059
1:6:6,0,-1,100942,99058
3:5:6,0,-1,100943,99057
5:1:6,0,-1,100944,99056
1:6:6,0,-1,100945,99055
5:5:6,0,-1,100946,99054
1:3:5,0,-1,100947,99053
2:1:5,1,1,100946,99054
6:1:5,0,-1,100947,99053
6:2:4,1,1,100946,99054
4:3:1,0,-1,100947,99053
4:1:2,1,1,100946,99054
6:3:6,0,-1,100947,99053
4:1:3,0,-1,100948,99052
1:4:1,0,-1,100949,99051
6:3:4,0,-1,100950,99050
6:2:6,1,1,100949,99051
6:3:6,0,-1,100950,99050
6:5:2,1,1,100949,99051
4:4:4,0,-1,100950,99050
3:3:4,0,-1,100951,99049
5:1:1,0,-1,100952,99048
3:5:6,0,-1,100953,99047
4:6:6,0,-1,100954,99046
6:6:2,1,1,100953,99047
2:1:3,1,1,100952,99048
5:6:2,1,1,100951,99049
3:6:4,0,-1,100952,99048
6:6:2,1,1,100951,99049
3:3:1,0,-1,100952,99048
6:5:6,0,-1,100953,99047
6:3:4,0,-1,100954,99046
6:5:2,1,1,100953,99047
5:5:1,0,-1,100954,99046
1:4:1,0,-1,100955,99045
1:1:2,1,1,100954,99046
6:4:2,1,1,100953,99047
2:6:6,1,1,100952,99048
2:3:2,2,2,100950,99050
4:3:1,0,-1,100951,99049
1:1:4,0,-1,100952,99048
5:1:6,0,-1,100953,99047
6:4:5,0,-1,100954,99046
4:6:5,0,-1,100955,99045
3:3:5,0,-1,100956,99044
6:3:5,0,-1,100957,99043
2:4:3,1,1,100956,99044
5:5:2,1,1,100955,99045
4:4:5,0,-1,100956,99044
3:3:1,0,-1,100957,99043
5:3:4,0,-1,100958,99042
1:5:5,0,-1,100959,99041
3:4:6,0,-1,100960,99040
4:2:5,1,1,100959,99041
5:2:4,1,1,100958,99042
2:5:2,2,2,100956,99044
4:2:1,1,1,100955,99045
4:1:4,0,-1,100956,99044
6:4:4,0,-1,100957,99043
4:5:6,0,-1,100958,99042
4:6:6,0,-1,100959,99041
4:3:1,0,-1,100960,99040
6:2:2,2,2,100958,99042
6:1:3,0,-1,100959,99041
4:1:6,0,-1,100960,99040
4:3:4,0,-1,100961,99039
3:5:2,1,1,100960,99040
3:4:2,1,1,100959,99041
2:5:6,1,1,100958,99042
2:3:2,2,2,100956,99044
5:5:5,0,-1,100957,99043
1:6:3,0,-1,100958,99042
6:6:3,0,-1,100959,99041
4:2:5,1,1,100958,99042
6:1:6,0,-1,100959,99041
6:6:2,1,1,100958,99042
3:4:6,0,-1,100959,99041
5:1:1,0,-1,100960,99040
5:3:5,0,-1,100961,99039
6:2:6,1,1,100960,99040
1:2:4,1,1,100959,99041
3:1:6,0,-1,100960,99040
6:4:4,0,-1,100961,99039
3:2:3,1,1,100960,99040
4:5:5,0,-1,100961,99039
3:6:4,0,-1,100962,99038
2:5:4,1,1,100961,99039
4:1:2,1,1,100960,99040
6:1:3,0,-1,100961,99039
6:1:1,0,-1,100962,99038
3:5:4,0,-1,100963,99037
5:6:2,1,1,100962,99038
4:3:1,0,-1,100963,99037
3:6:3,0,-1,100964,99036
6:2:1,1,1,100963,99037
5:4:2,1,1,100962,99038
3:2:3,1,1,100961,99039
6:3:1,0,-1,100962,99038
6:6:1,0,-1,100963,99037
1:2:3,1,1,100962,99038
6:2:6,1,1,100961,99039
4:5:4,0,-1,100962,99038
2:6:1,1,1,100961,99039
6:6:4,0,-1,100962,99038
1:2:2,2,2,100960,99040
4:3:4,0,-1,100961,99039
2:5:2,2,2,100959,99041
3:6:6,0,-1,100960,99040
2:2:6,2,2,100958,99042
1:4:2,1,1,100957,99043
1:6:2,1,1,100956,99044
4:1:2,1,1,100955,99045
4:5:4,0,-1,100956,99044
3:3:3,0,-1,100957,99043
5:1:5,0,-1,100958,99042
4:2:6,1,1,100957,99043
6:5:2,1,1,100956,99044
2:5:6,1,1,100955,99045
1:1:6,0,-1,100956,99044
5:1:5,0,-1,100957,99043
1:1:5,0,-1,100958,99042
6:4:3,0,-1,100959,99041
6:5:2,1,1,100958,99042
2:3:4,1,1,100957,99043
6:1:2,1,1,100956,99044
2:5:6,1,1,100955,99045
2:5:1,1,1,100954,99046
4:3:4,0,-1,100955,99045
5:6:6,0,-1,100956,99044
5:5:4,0,-1,100957,99043
4:1:6,0,-1,100958,99042
6:5:2,1,1,100957,99043
4:5:6,0,-1,100958,99042
4:5:5,0,-1,100959,99041
5:1:3,0,-1,100960,99040
6:4:4,0,-1,100961,99039
2:6:1,1,1,100960,99040
6:2:4,1,1,100959,99041
3:6:1,0,-1,100960,99040
5:6:4,0,-1,100961,99039
2:1:1,1,1,100960,99040
5:6:5,0,-1,100961,99039
2:6:1,1,1,100960,99040
5:4:2,1,1,100959,99041
1:3:6,0,-1,100960,99040
3:3:2,1,1,100959,99041
4:5:2,1,1,100958,99042
1:1:3,0,-1,100959,99041
1:3:3,0,-1,100960,99040
1:6:5,0,-1,100961,99039
2:3:2,2,2,100959,99041
6:6:4,0,-1,100960,99040
1:4:3,0,-1,100961,99039
3:3:5,0,-1,100962,99038
3:4:5,0,-1,100963,99037
5:1:1,0,-1,100964,99036
6:5:5,0,-1,100965,99035
4:3:6,0,-1,100966,99034
4:5:3,0,-1,100967,99033
6:2:6,1,1,100966,99034
3:3:6,0,-1,100967,99033
1:5:2,1,1,100966,99034
4:2:1,1,1,100965,99035
2:3:6,1,1,100964,99036
5:2:4,1,1,100963,99037
1:3:3,0,-1,100964,99036
2:4:4,1,1,100963,99037
2:2:6,2,2,100961,99039
1:6:4,0,-1,100962,99038
1:4:4,0,-1,100963,99037
3:4:4,0,-1,100964,99036
6:6:5,0,-1,100965,99035
3:5:2,1,1,100964,99036
3:2:4,1,1,100963,99037
2:4:5,1,1,100962,99038
6:4:1,0,-1,100963,99037
2:4:3,1,1,100962,99038
4:6:2,1,1,100961,99039
2:4:3,1,1,100960,99040
4:4:5,0,-1,100961,99039
3:3:6,0,-1,100962,99038
4:2:3,1,1,100961,99039
6:3:6,0,-1,100962,99038
2:1:3,1,1,100961,99039
6:3:1,0,-1,100962,99038
1:2:6,1,1,100961,99039
4:3:2,1,1,100960,99040
1:4:4,0,-1,100961,99039
1:6:6,0,-1,100962,99038
4:1:6,0,-1,100963,99037
3:1:6,0,-1,100964,99036
4:2:4,1,1,100963,99037
2:3:6,1,1,100962,99038
4:2:6,1,1,100961,99039
1:2:1,1,1,100960,99040
1:3:5,0,-1,100961,99039
2:2:1,2,2,100959,99041
6:6:1,0,-1,100960,99040
6:5:6,0,-1,100961,99039
3:2:6,1,1,100960,99040
2:5:2,2,2,100958,99042
2:4:2,2,2,100956,99044
1:2:3,1,1,100955,99045
5:5:2,1,1,100954,99046
3:5:5,0,-1,100955,99045
2:6:1,1,1,100954,99046
3:4:5,0,-1,100955,99045
1:5:3,0,-1,100956,99044
1:6:1,0,-1,100957,99043
6:3:2,1,1,100956,99044
1:5:1,0,-1,100957,99043
6:4:3,0,-1,100958,99042
6:5:2,1,1,100957,99043
5:3:3,0,-1,100958,99042
2:1:4,1,1,100957,99043
1:5:2,1,1,100956,99044
2:6:2,2,2,100954,99046
6:6:3,0,-1,100955,99045
1:5:6,0,-1,100956,99044
4:3:6,0,-1,100957,99043
5:1:5,0,-1,100958,99042
6:2:5,1,1,100957,99043
3:5:5,0,-1,100958,99042
2:2:3,2,2,100956,99044
2:3:1,1,1,100955,99045
1:6:1,0,-1,100956,99044
5:4:1,0,-1,100957,99043
1:6:4,0,-1,100958,99042
3:6:1,0,-1,100959,99041
6:4:6,0,-1,100960,99040
4:2:3,1,1,100959,99041
2:5:4,1,1,100958,99042
6:1:4,0,-1,100959,99041
3:4:3,0,-1,100960,99040
4:4:5,0,-1,100961,99039
2:3:3,1,1,100960,99040
2:6:2,2,2,100958,99042
6:1:3,0,-1,100959,99041
6:3:1,0,-1,100960,99040
5:1:3,0,-1,100961,99039
4:4:6,0,-1,100962,99038
3:3:2,1,1,100961,99039
2:4:5,1,1,100960,99040
6:5:6,0,-1,100961,99039
2:1:5,1,1,100960,99040
4:5:6,0,-1,100961,99039
4:2:2,2,2,100959,99041
2:5:1,1,1,100958,99042
5:5:3,0,-1,100959,99041
2:2:1,2,2,100957,99043
2:4:4,1,1,100956,99044
3:1:5,0,-1,100957,99043
4:1:2,1,1,100956,99044
3:2:2,2,2,100954,99046
5:5:1,0,-1,100955,99045
2:3:3,1,1,100954,99046
6:5:1,0,-1,100955,99045
2:6:4,1,1,100954,99046
4:2:1,1,1,100953,99047
5:4:1,0,-1,100954,99046
4:3:2,1,1,100953,99047
6:5:3,0,-1,100954,99046
5:3:6,0,-1,100955,99045
6:1:1,0,-1,100956,99044
1:5:1,0,-1,100957,99043
6:4:6,0,-1,100958,99042
6:3:6,0,-1,100959,99041
6:1:1,0,-1,100960,99040
2:1:4,1,1,100959,99041
3:5:6,0,-1,100960,99040
3:6:6,0,-1,100961,99039
2:2:6,2,2,100959,99041
6:3:1,0,-1,100960,99040
1:1:2,1,1,100959,99041
4:2:2,2,2,100957,99043
6:3:6,0,-1,100958,99042
3:5:4,0,-1,100959,99041
5:4:1,0,-1,100960,99040
6:5:3,0,-1,100961,99039
4:2:2,2,2,100959,99041
6:6:4,0,-1,100960,99040
6:2:6,1,1,100959,99041
6:4:2,1,1,100958,99042
4:1:4,0,-1,100959,99041
2:3:2,2,2,100957,99043
2:3:5,1,1,100956,99044
6:5:2,1,1,100955,99045
3:1:2,1,1,100954,99046
3:5:5,0,-1,100955,99045
3:6:4,0,-1,100956,99044
2:4:1,1,1,100955,99045
5:4:6,0,-1,100956,99044
5:1:5,0,-1,100957,99043
4:1:3,0,-1,100958,99042
5:4:1,0,-1,100959,99041
4:1:6,0,-1,100960,99040
6:1:6,0,-1,100961,99039
6:5:4,0,-1,100962,99038
1:5:6,0,-1,100963,99037
2:5:3,1,1,100962,99038
4:1:6,0,-1,100963,99037
3:3:1,0,-1,100964,99036
6:1:1,0,-1,100965,99035
1:2:3,1,1,100964,99036
6:4:5,0,-1,100965,99035
6:4:4,0,-1,100966,99034
2:6:1,1,1,100965,99035
2:6:5,1,1,100964,99036
4:4:5,0,-1,100965,99035
4:2:2,2,2,100963,99037
4:1:5,0,-1,100964,99036
3:3:4,0,-1,100965,99035
4:3:6,0,-1,100966,99034
5:5:2,1,1,100965,99035
5:1:3,0,-1,100966,99034
6:1:2,1,1,100965,99035
4:4:6,0,-1,100966,99034
3:5:4,0,-1,100967,99033
4:1:2,1,1,100966,99034
3:2:2,2,2,100964,99036
5:1:1,0,-1,100965,99035
3:1:3,0,-1,100966,99034
5:5:4,0,-1,100967,99033
3:2:5,1,1,100966,99034
4:6:5,0,-1,100967,99033
6:4:3,0,-1,100968,99032
4:2:3,1,1,100967,99033
6:3:5,0,-1,100968,99032
2:2:3,2,2,100966,99034
1:6:3,0,-1,100967,99033
4:5:2,1,1,100966,99034
6:5:1,0,-1,100967,99033
6:2:2,2,2,100965,99035
2:4:2,2,2,100963,99037
4:6:3,0,-1,100964,99036
1:1:1,0,-1,100965,99035
6:4:4,0,-1,100966,99034
1:2:6,1,1,100965,99035
6:5:3,0,-1,100966,99034
1:5:6,0,-1,100967,99033
4:6:4,0,-1,100968,99032
6:6:2,1,1,100967,99033
5:4:4,0,-1,100968,99032
4:2:3,1,1,100967,99033
3:4:5,0,-1,100968,99032
1:5:6,0,-1,100969,99031
1:3:6,0,-1,100970,99030
2:4:6,1,1,100969,99031
2:1:4,1,1,100968,99032
6:1:2,1,1,100967,99033
5:6:4,0,-1,100968,99032
4:3:5,0,-1,100969,99031
1:2:3,1,1,100968,99032
6:3:6,0,-1,100969,99031
3:5:5,0,-1,100970,99030
2:3:2,2,2,100968,99032
5:2:5,1,1,100967,99033
1:5:1,0,-1,100968,99032
2:4:3,1,1,100967,99033
2:5:5,1,1,100966,99034
4:3:6,0,-1,100967,99033
5:6:2,1,1,100966,99034
6:2:4,1,1,100965,99035
4:5:2,1,1,100964,99036
1:1:1,0,-1,100965,99035
3:3:5,0,-1,100966,99034
5:3:3,0,-1,100967,99033
4:5:1,0,-1,100968,99032
3:4:2,1,1,100967,99033
5:6:2,1,1,100966,99034
1:1:4,0,-1,100967,99033
5:6:1,0,-1,100968,99032
2:5:2,2,2,100966,99034
5:3:3,0,-1,100967,99033
3:5:5,0,-1,100968,99032
1:1:3,0,-1,100969,99031
5:1:5,0,-1,100970,99030
2:5:3,1,1,100969,99031
6:5:3,0,-1,100970,99030
2:1:4,1,1,100969,99031
5:2:4,1,1,100968,99032
2:3:3,1,1,100967,99033
1:3:3,0,-1,100968,99032
5:4:4,0,-1,100969,99031
2:2:1,2,2,100967,99033
3:2:6,1,1,100966,99034
3:1:5,0,-1,100967,99033
4:6:5,0,-1,100968,99032
5:3:3,0,-1,100969,99031
4:1:3,0,-1,100970,99030
6:1:5,0,-1,100971,99029
1:4:6,0,-1,100972,99028
1:5:5,0,-1,100973,99027
1:2:1,1,1,100972,99028
2:3:1,1,1,100971,99029
4:5:5,0,-1,100972,99028
3:4:5,0,-1,100973,99027
1:3:5,0,-1,100974,99026
1:1:4,0,-1,100975,99025
1:4:5,0,-1,100976,99024
4:1:6,0,-1,100977,99023
5:4:1,0,-1,100978,99022
4:3:5,0,-1,100979,99021
5:6:5,0,-1,100980,99020
5:3:3,0,-1,100981,99019
3:3:6,0,-1,100982,99018
1:3:6,0,-1,100983,99017
2:1:2,2,2,100981,99019
1:1:2,1,1,100980,99020
6:5:6,0,-1,100981,99019
3:3:4,0,-1,100982,99018
6:4:6,0,-1,100983,99017
3:3:1,0,-1,100984,99016
2:3:2,2,2,100982,99018
1:5:6,0,-1,100983,99017
3:5:5,0,-1,100984,99016
3:1:2,1,1,100983,99017
2:5:3,1,1,100982,99018
3:4:1,0,-1,100983,99017
5:1:6,0,-1,100984,99016
2:1:6,1,1,100983,99017
6:3:1,0,-1,100984,99016
2:4:4,1,1,100983,99017
4:1:6,0,-1,100984,99016
1:4:4,0,-1,100985,99015
1:3:6,0,-1,100986,99014
1:5:6,0,-1,100987,99013
3:4:1,0,-1,100988,99012
2:1:5,1,1,100987,99013
2:2:2,3,3,100984,99016
5:5:3,0,-1,100985,99015
5:3:3,0,-1,100986,99014
6:3:5,0,-1,100987,99013
2:5:5,1,1,100986,99014
4:6:4,0,-1,100987,99013
2:5:4,1,1,100986,99014
1:2:4,1,1,100985,99015
5:2:4,1,1,100984,99016
5:4:2,1,1,100983,99017
6:1:5,0,-1,100984,99016
2:6:6,1,1,100983,99017
2:3:3,1,1,100982,99018
5:6:3,0,-1,100983,99017
6:3:3,0,-1,100984,99016
3:1:1,0,-1,100985,99015
3:2:5,1,1,100984,99016
6:6:5,0,-1,100985,99015
2:2:3,2,2,100983,99017
3:4:5,0,-1,100984,99016
4:6:5,0,-1,100985,99015
2:6:2,2,2,100983,99017
6:5:1,0,-1,100984,99016
6:6:5,0,-1,100985,99015
6:3:2,1,1,100984,99016
5:5:2,1,1,100983,99017
5:6:3,0,-1,100984,99016
5:6:4,0,-1,100985,99015
1:2:6,1,1,100984,99016
5:3:5,0,-1,100985,99015
5:6:2,1,1,100984,99016
5:1:3,0,-1,100985,99015
6:6:5,0,-1,100986,99014
6:1:2,1,1,100985,99015
6:6:6,0,-1,100986,99014
4:5:2,1,1,100985,99015
2:4:1,1,1,100984,99016
2:6:1,1,1,100983,99017
1:2:4,1,1,100982,99018
3:4:6,0,-1,100983,99017
4:2:5,1,1,100982,99018
6:4:5,0,-1,100983,99017
3:6:6,0,-1,100984,99016
2:3:1,1,1,100983,99017
2:2:3,2,2,100981,99019
1:5:5,0,-1,100982,99018
3:3:1,0,-1,100983,99017
6:5:5,0,-1,100984,99016
1:5:5,0,-1,100985,99015
4:6:5,0,-1,100986,99014
4:4:3,0,-1,100987,99013
4:1:2,1,1,100986,99014
6:4:2,1,1,100985,99015
6:6:5,0,-1,100986,99014
2:2:3,2,2,100984,99016
5:6:1,0,-1,100985,99015
3:3:1,0,-1,100986,99014
2:6:3,1,1,100985,99015
2:2:4,2,2,100983,99017
1:2:2,2,2,100981,99019
5:3:2,1,1,100980,99020
5:6:2,1,1,100979,99021
3:5:4,0,-1,100980,99020
4:4:1,0,-1,100981,99019
3:3:2,1,1,100980,99020
5:3:2,1,1,100979,99021
5:1:5,0,-1,100980,99020
6:4:2,1,1,100979,99021
4:6:5,0,-1,100980,99020
3:3:4,0,-1,100981,99019
4:5:6,0,-1,100982,99018
4:2:6,1,1,100981,99019
2:1:1,1,1,100980,99020
3:5:2,1,1,100979,99021
1:6:2,1,1,100978,99022
5:5:3,0,-1,100979,99021
1:2:2,2,2,100977,99023
6:6:1,0,-1,100978,99022
1:3:1,0,-1,100979,99021
5:2:2,2,2,100977,99023
6:1:3,0,-1,100978,99022
6:6:6,0,-1,100979,99021
6:5:1,0,-1,100980,99020
1:4:6,0,-1,100981,99019
6:6:3,0,-1,100982,99018
1:3:2,1,1,100981,99019
3:5:5,0,-1,100982,99018
2:3:1,1,1,100981,99019
1:5:5,0,-1,100982,99018
5:5:3,0,-1,100983,99017
5:2:5,1,1,100982,99018
5:5:5,0,-1,100983,99017
6:6:4,0,-1,100984,99016
6:1:2,1,1,100983,99017
6:3:2,1,1,100982,99018
5:5:1,0,-1,100983,99017
6:5:4,0,-1,100984,99016
3:6:2,1,1,100983,99017
2:4:4,1,1,100982,99018
4:2:3,1,1,100981,99019
4:3:3,0,-1,100982,99018
2:2:3,2,2,100980,99020
3:1:5,0,-1,100981,99019
4:3:1,0,-1,100982,99018
1:5:3,0,-1,100983,99017
1:3:4,0,-1,100984,99016
1:6:2,1,1,100983,99017
2:3:3,1,1,100982,99018
6:2:6,1,1,100981,99019
1:2:3,1,1,100980,99020
2:4:2,2,2,100978,99022
5:4:4,0,-1,100979,99021
6:3:2,1,1,100978,99022
3:3:6,0,-1,100979,99021
5:1:3,0,-1,100980,99020
5:6:3,0,-1,100981,99019
3:1:2,1,1,100980,99020
2:2:2,3,3,100977,99023
5:1:4,0,-1,100978,99022
1:5:2,1,1,100977,99023
2:2:4,2,2,100975,99025
1:3:5,0,-1,100976,99024
2:5:4,1,1,100975,99025
6:6:5,0,-1,100976,99024
6:6:4,0,-1,100977,99023
5:1:5,0,-1,100978,99022
1:3:6,0,-1,100979,99021
1:3:1,0,-1,100980,99020
6:5:6,0,-1,100981,99019
2:1:5,1,1,100980,99020
3:5:3,0,-1,100981,99019
4:5:1,0,-1,100982,99018
4:2:1,1,1,100981,99019
4:4:3,0,-1,100982,99018
5:3:4,0,-1,100983,99017
1:6:3,0,-1,100984,99016
1:3:5,0,-1,100985,99015
1:5:5,0,-1,100986,99014
4:6:4,0,-1,100987,99013
2:2:3,2,2,100985,99015
2:5:1,1,1,100984,99016
3:4:2,1,1,100983,99017
3:2:1,1,1,100982,99018
3:2:6,1,1,100981,99019
4:1:2,1,1,100980,99020
2:6:3,1,1,100979,99021
1:1:3,0,-1,100980,99020
6:3:3,0,-1,100981,99019
5:3:6,0,-1,100982,99018
6:4:3,0,-1,100983,99017
1:4:2,1,1,100982,99018
6:4:2,1,1,100981,99019
5:4:6,0,-1,100982,99018
4:6:5,0,-1,100983,99017
3:2:1,1,1,100982,99018
1:6:1,0,-1,100983,99017
5:2:3,1,1,100982,99018
1:1:4,0,-1,100983,99017
4:5:5,0,-1,100984,99016
4:1:3,0,-1,100985,99015
2:4:5,1,1,100984,99016
4:1:1,0,-1,100985,99015
5:1:3,0,-1,100986,99014
5:5:4,0,-1,100987,99013
4:6:3,0,-1,100988,99012
6:3:6,0,-1,100989,99011
1:4:6,0,-1,100990,99010
3:4:1,0,-1,100991,99009
2:2:2,3,3,100988,99012
5:3:3,0,-1,100989,99011
5:1:3,0,-1,100990,99010
4:5:2,1,1,100989,99011
1:4:1,0,-1,100990,99010
3:5:2,1,1,100989,99011
1:6:6,0,-1,100990,99010
4:5:3,0,-1,100991,99009
2:3:6,1,1,100990,99010
1:3:6,0,-1,100991,99009
6:3:6,0,-1,100992,99008
1:4:3,0,-1,100993,99007
1:2:2,2,2,100991,99009
1:2:6,1,1,100990,99010
2:2:6,2,2,100988,99012
6:1:3,0,-1,100989,99011
3:6:4,0,-1,100990,99010
2:6:4,1,1,100989,99011
3:6:6,0,-1,100990,99010
4:6:6,0,-1,100991,99009
4:2:4,1,1,100990,99010
4:1:4,0,-1,100991,99009
4:5:1,0,-1,100992,99008
5:2:1,1,1,100991,99009
5:5:5,0,-1,100992,99008
4:1:3,0,-1,100993,99007
2:3:4,1,1,100992,99008
1:2:2,2,2,100990,99010
2:3:4,1,1,100989,99011
1:6:4,0,-1,100990,99010
2:4:5,1,1,100989,99011
2:3:3,1,1,100988,99012
3:2:3,1,1,100987,99013
6:4:5,0,-1,100988,99012
5:3:1,0,-1,100989,99011
6:1:6,0,-1,100990,99010
6:6:6,0,-1,100991,99009
6:5:1,0,-1,100992,99008
5:5:1,0,-1,100993,99007
5:6:2,1,1,100992,99008
5:2:6,1,1,100991,99009
1:6:6,0,-1,100992,99008
2:4:6,1,1,100991,99009
3:5:2,1,1,100990,99010
1:6:2,1,1,100989,99011
5:6:3,0,-1,100990,99010
1:1:5,0,-1,100991,99009
6:5:6,0,-1,100992,99008
1:3:5,0,-1,100993,99007
6:4:4,0,-1,100994,99006
2:6:4,1,1,100993,99007
2:3:1,1,1,100992,99008
2:6:6,1,1,100991,99009
3:6:3,0,-1,100992,99008
1:3:6,0,-1,100993,99007
2:5:1,1,1,100992,99008
3:5:4,0,-1,100993,99007
4:2:1,1,1,100992,99008
1:3:6,0,-1,100993,99007
3:5:3,0,-1,100994,99006
6:2:1,1,1,100993,99007
5:5:4,0,-1,100994,99006
3:3:5,0,-1,100995,99005
1:3:3,0,-1,100996,99004
3:6:4,0,-1,100997,99003
4:5:2,1,1,100996,99004
3:1:6,0,-1,100997,99003
2:4:5,1,1,100996,99004
4:3:2,1,1,100995,99005
5:6:4,0,-1,100996,99004
3:6:6,0,-1,100997,99003
2:1:1,1,1,100996,99004
4:5:4,0,-1,100997,99003
4:6:4,0,-1,100998,99002
2:1:5,1,1,100997,99003
5:3:3,0,-1,100998,99002
6:3:2,1,1,100997,99003
3:6:1,0,-1,100998,99002
6:2:4,1,1,100997,99003
3:3:1,0,-1,100998,99002
4:3:2,1,1,100997,99003
6:4:1,0,-1,100998,99002
5:6:1,0,-1,100999,99001
2:5:6,1,1,100998,99002
6:1:5,0,-1,100999,99001
4:6:5,0,-1,101000,99000
4:2:4,1,1,100999,99001
1:6:4,0,-1,101000,99000
5:5:6,0,-1,101001,98999
4:1:5,0,-1,101002,98998
2:2:6,2,2,101000,99000
1:6:2,1,1,100999,99001
2:3:6,1,1,100998,99002
4:5:2,1,1,100997,99003
4:4:2,1,1,100996,99004
1:1:2,1,1,100995,99005
6:4:3,0,-1,100996,99004
6:3:2,1,1,100995,99005
1:2:1,1,1,100994,99006
6:2:1,1,1,100993,99007
4:1:4,0,-1,100994,99006
1:3:1,0,-1,100995,99005
5:1:3,0,-1,100996,99004
1:1:1,0,-1,100997,99003
4:1:2,1,1,100996,99004
1:6:2,1,1,100995,99005
1:5:4,0,-1,100996,99004
1:5:1,0,-1,100997,99003
4:3:6,0,-1,100998,99002
6:2:4,1,1,100997,99003
6:6:2,1,1,100996,99004
2:5:2,2,2,100994,99006
6:3:2,1,1,100993,99007
2:5:6,1,1,100992,99008
5:4:4,0,-1,100993,99007
4:5:3,0,-1,100994,99006
1:3:6,0,-1,100995,99005
3:2:4,1,1,100994,99006
3:5:4,0,-1,100995,99005
1:2:6,1,1,100994,99006
2:2:4,2,2,100992,99008
4:6:5,0,-1,100993,99007
2:3:6,1,1,100992,99008
4:2:2,2,2,100990,99010
6:3:6,0,-1,100991,99009
4:5:4,0,-1,100992,99008
1:3:6,0,-1,100993,99007
2:1:5,1,1,100992,99008
6:5:6,0,-1,100993,99007
4:6:4,0,-1,100994,99006
6:3:5,0,-1,100995,99005
1:3:1,0,-1,100996,99004
3:5:3,0,-1,100997,99003
3:4:3,0,-1,100998,99002
5:2:4,1,1,100997,99003
6:3:3,0,-1,100998,99002
6:2:3,1,1,100997,99003
3:6:3,0,-1,100998,99002
3:4:2,1,1,100997,99003
6:4:1,0,-1,100998,99002
4:3:4,0,-1,100999,99001
3:6:6,0,-1,101000,99000
1:4:1,0,-1,101001,98999
5:5:2,1,1,101000,99000
5:1:3,0,-1,101001,98999
6:4:5,0,-1,101002,98998
2:3:5,1,1,101001,98999
3:6:2,1,1,101000,99000
4:6:4,0,-1,101001,98999
4:4:3,0,-1,101002,98998
3:1:2,1,1,101001,98999
5:4:2,1,1,101000,99000
1:1:3,0,-1,101001,98999
4:4:6,0,-1,101002,98998
4:3:1,0,-1,101003,98997
4:2:6,1,1,101002,98998
2:1:1,1,1,101001,98999
2:3:4,1,1,101000,99000
2:5:3,1,1,100999,99001
3:1:4,0,-1,101000,99000
1:3:2,1,1,100999,99001
3:3:6,0,-1,101000,99000
2:5:6,1,1,100999,99001
4:1:2,1,1,100998,99002
3:4:1,0,-1,100999,99001
6:2:6,1,1,100998,99002
2:3:1,1,1,100997,99003
6:5:1,0,-1,100998,99002
3:5:3,0,-1,100999,99001
4:1:5,0,-1,101000,99000
1:1:6,0,-1,101001,98999
2:4:3,1,1,101000,99000
6:2:4,1,1,100999,99001
2:6:5,1,1,100998,99002
6:1:2,1,1,100997,99003
1:1:5,0,-1,100998,99002
2:2:5,2,2,100996,99004
5:2:1,1,1,100995,99005
5:5:2,1,1,100994,99006
6:2:3,1,1,100993,99007
5:5:6,0,-1,100994,99006
1:4:4,0,-1,100995,99005
5:5:2,1,1,100994,99006
6:4:5,0,-1,100995,99005
3:6:3,0,-1,100996,99004
6:3:6,0,-1,100997,99003
3:4:4,0,-1,100998,99002
1:5:6,0,-1,100999,99001
1:5:2,1,1,100998,99002
4:6:6,0,-1,100999,99001
3:5:6,0,-1,101000,99000
3:4:2,1,1,100999,99001
1:4:2,1,1,100998,99002
6:3:6,0,-1,100999,99001
4:2:2,2,2,100997,99003
6:4:5,0,-1,100998,99002
5:3:1,0,-1,100999,99001
5:1:6,0,-1,101000,99000
4:6:2,1,1,100999,99001
2:4:2,2,2,100997,99003
5:3:1,0,-1,100998,99002
1:4:6,0,-1,100999,99001
2:2:2,3,3,100996,99004
5:1:6,0,-1,100997,99003
2:6:4,1,1,100996,99004
4:5:1,0,-1,100997,99003
2:2:1,2,2,100995,99005
6:3:3,0,-1,100996,99004
3:3:3,0,-1,100997,99003
4:5:3,0,-1,100998,99002
6:1:3,0,-1,100999,99001
2:1:2,2,2,100997,99003
3:6:1,0,-1,100998,99002
4:6:2,1,1,100997,99003
5:2:6,1,1,100996,99004
5:1:1,0,-1,100997,99003
2:5:4,1,1,100996,99004
1:1:3,0,-1,100997,99003
5:2:3,1,1,100996,99004
4:6:6,0,-1,100997,99003
1:1:3,0,-1,100998,99002
6:6:5,0,-1,100999,99001
6:2:1,1,1,100998,99002
2:3:4,1,1,100997,99003
1:4:1,0,-1,100998,99002
5:3:4,0,-1,100999,99001
1:3:1,0,-1,101000,99000
3:3:1,0,-1,101001,98999
3:5:5,0,-1,101002,98998
3:6:1,0,-1,101003,98997
6:2:3,1,1,101002,98998
2:2:5,2,2,101000,99000
5:5:4,0,-1,101001,98999
5:6:3,0,-1,101002,98998
5:3:5,0,-1,101003,98997
3:4:2,1,1,101002,98998
1:1:2,1,1,101001,98999
1:1:4,0,-1,101002,98998
6:5:1,0,-1,101003,98997
1:3:1,0,-1,101004,98996
6:2:5,1,1,101003,98997
3:4:3,0,-1,101004,98996
6:2:3,1,1,101003,98997
4:6:1,0,-1,101004,98996
2:4:6,1,1,101003,98997
1:4:5,0,-1,101004,98996
3:3:6,0,-1,101005,98995
1:1:1,0,-1,101006,98994
5:4:3,0,-1,101007,98993
6:5:6,0,-1,101008,98992
6:6:5,0,-1,101009,98991
6:3:5,0,-1,101010,98990
5:5:6,0,-1,101011,98989
1:2:1,1,1,101010,98990
6:6:6,0,-1,101011,98989
5:4:5,0,-1,101012,98988
2:5:1,1,1,101011,98989
1:2:2,2,2,101009,98991
2:3:2,2,2,101007,98993
6:2:2,2,2,101005,98995
1:5:5,0,-1,101006,98994
2:5:4,1,1,101005,98995
6:1:5,0,-1,101006,98994
1:2:4,1,1,101005,98995
5:3:3,0,-1,101006,98994
2:3:2,2,2,101004,98996
2:6:6,1,1,101003,98997
4:4:6,0,-1,101004,98996
2:2:4,2,2,101002,98998
6:2:3,1,1,101001,98999
2:6:6,1,1,101000,99000
1:4:4,0,-1,101001,98999
4:2:3,1,1,101000,99000
5:5:4,0,-1,101001,98999
4:3:4,0,-1,101002,98998
6:1:4,0,-1,101003,98997
3:4:3,0,-1,101004,98996
3:5:6,0,-1,101005,98995
4:3:6,0,-1,101006,98994
5:5:3,0,-1,101007,98993
6:6:5,0,-1,101008,98992
6:5:5,0,-1,101009,98991
3:6:2,1,1,101008,98992
4:4:4,0,-1,101009,98991
3:3:6,0,-1,101010,98990
3:1:6,0,-1,101011,98989
2:6:3,1,1,101010,98990
1:3:3,0,-1,101011,98989
3:2:1,1,1,101010,98990
5:5:6,0,-1,101011,98989
3:2:3,1,1,101010,98990
4:3:1,0,-1,101011,98989
4:5:6,0,-1,101012,98988
5:2:2,2,2,101010,98990
6:6:5,0,-1,101011,98989
3:4:3,0,-1,101012,98988
6:1:4,0,-1,101013,98987
6:5:6,0,-1,101014,98986
2:2:4,2,2,101012,98988
2:3:6,1,1,101011,98989
5:2:6,1,1,101010,98990
4:1:6,0,-1,101011,98989
6:5:6,0,-1,101012,98988
6:3:5,0,-1,101013,98987
1:3:5,0,-1,101014,98986
3:6:4,0,-1,101015,98985
1:6:5,0,-1,101016,98984
3:2:6,1,1,101015,98985
1:5:1,0,-1,101016,98984
2:4:2,2,2,101014,98986
5:4:1,0,-1,101015,98985
1:2:2,2,2,101013,98987
5:3:5,0,-1,101014,98986
2:4:4,1,1,101013,98987
4:2:1,1,1,101012,98988
4:6:6,0,-1,101013,98987
3:3:6,0,-1,101014,98986
2:1:2,2,2,101012,98988
2:1:6,1,1,101011,98989
4:4:4,0,-1,101012,98988
4:3:6,0,-1,101013,98987
3:6:1,0,-1,101014,98986
2:1:2,2,2,101012,98988
1:4:5,0,-1,101013,98987
3:4:4,0,-1,101014,98986
5:1:1,0,-1,101015,98985
3:4:4,0,-1,101016,98984
5:3:4,0,-1,101017,98983
1:5:4,0,-1,101018,98982
1:2:4,1,1,101017,98983
2:6:6,1,1,101016,98984
2:1:4,1,1,101015,98985
5:4:3,0,-1,101016,98984
4:3:3,0,-1,101017,98983
5:1:2,1,1,101016,98984
6:2:5,1,1,101015,98985
4:5:2,1,1,101014,98986
4:5:1,0,-1,101015,98985
4:3:1,0,-1,101016,98984
1:6:5,0,-1,101017,98983
3:5:2,1,1,101016,98984
4:6:6,0,-1,101017,98983
5:1:1,0,-1,101018,98982
6:3:4,0,-1,101019,98981
5:1:5,0,-1,101020,98980
3:5:2,1,1,101019,98981
3:6:4,0,-1,101020,98980
1:4:4,0,-1,101021,98979
4:5:2,1,1,101020,98980
3:6:3,0,-1,101021,98979
4:3:1,0,-1,101022,98978
1:4:4,0,-1,101023,98977
2:4:4,1,1,101022,98978
2:1:3,1,1,101021,98979
6:1:3,0,-1,101022,98978
1:4:4,0,-1,101023,98977
4:2:4,1,1,101022,98978
1:3:1,0,-1,101023,98977
3:4:6,0,-1,101024,98976
2:4:3,1,1,101023,98977
4:1:6,0,-1,101024,98976
3:2:4,1,1,101023,98977
6:5:6,0,-1,101024,98976
5:6:1,0,-1,101025,98975
1:3:5,0,-1,101026,98974
4:2:4,1,1,101025,98975
5:1:3,0,-1,101026,98974
1:6:4,0,-1,101027,98973
4:1:6,0,-1,101028,98972
3:6:3,0,-1,101029,98971
1:2:5,1,1,101028,98972
3:1:2,1,1,101027,98973
6:1:3,0,-1,101028,98972
4:4:3,0,-1,101029,98971
2:3:5,1,1,101028,98972
5:5:4,0,-1,101029,98971
6:2:3,1,1,101028,98972
6:6:2,1,1,101027,98973
1:2:5,1,1,101026,98974
5:6:2,1,1,101025,98975
6:3:6,0,-1,101026,98974
6:3:2,1,1,101025,98975
4:3:6,0,-1,101026,98974
5:3:6,0,-1,101027,98973
4:3:6,0,-1,101028,98972
2:1:5,1,1,101027,98973
4:1:4,0,-1,101028,98972
2:2:3,2,2,101026,98974
4:6:2,1,1,101025,98975
5:6:1,0,-1,101026,98974
2:1:1,1,1,101025,98975
3:2:3,1,1,101024,98976
5:5:5,0,-1,101025,98975
3:6:1,0,-1,101026,98974
4:6:2,1,1,101025,98975
3:6:2,1,1,101024,98976
5:1:4,0,-1,101025,98975
5:5:2,1,1,101024,98976
6:3:2,1,1,101023,98977
1:2:3,1,1,101022,98978
1:1:1,0,-1,101023,98977
6:5:2,1,1,101022,98978
2:3:6,1,1,101021,98979
5:5:6,0,-1,101022,98978
1:5:5,0,-1,101023,98977
3:3:2,1,1,101022,98978
5:5:5,0,-1,101023,98977
3:4:6,0,-1,101024,98976
2:3:2,2,2,101022,98978
6:4:5,0,-1,101023,98977
1:1:5,0,-1,101024,98976
2:1:4,1,1,101023,98977
3:1:5,0,-1,101024,98976
1:4:5,0,-1,101025,98975
4:1:3,0,-1,101026,98974
1:2:6,1,1,101025,98975
4:6:5,0,-1,101026,98974
5:6:2,1,1,101025,98975
6:2:1,1,1,101024,98976
2:2:5,2,2,101022,98978
1:4:1,0,-1,101023,98977
3:6:6,0,-1,101024,98976
5:6:3,0,-1,101025,98975
6:1:3,0,-1,101026,98974
1:5:4,0,-1,101027,98973
4:5:5,0,-1,101028,98972
5:2:3,1,1,101027,98973
3:1:4,0,-1,101028,98972
6:1:4,0,-1,101029,98971
1:5:6,0,-1,101030,98970
2:6:5,1,1,101029,98971
5:1:2,1,1,101028,98972
6:4:2,1,1,101027,98973
5:1:6,0,-1,101028,98972
4:6:6,0,-1,101029,98971
2:5:1,1,1,101028,98972
5:4:6,0,-1,101029,98971
4:2:1,1,1,101028,98972
2:6:3,1,1,101027,98973
2:6:2,2,2,101025,98975
5:1:1,0,-1,101026,98974
4:6:3,0,-1,101027,98973
6:4:6,0,-1,101028,98972
6:2:6,1,1,101027,98973
3:5:4,0,-1,101028,98972
6:2:6,1,1,101027,98973
5:2:5,1,1,101026,98974
1:4:1,0,-1,101027,98973
1:2:5,1,1,101026,98974
4:1:3,0,-1,101027,98973
6:2:3,1,1,101026,98974
2:4:3,1,1,101025,98975
3:1:1,0,-1,101026,98974
6:2:6,1,1,101025,98975
3:2:5,1,1,101024,98976
4:3:2,1,1,101023,98977
2:1:4,1,1,101022,98978
5:1:2,1,1,101021,98979
4:5:2,1,1,101020,98980
5:6:4,0,-1,101021,98979
3:2:5,1,1,101020,98980
5:1:3,0,-1,101021,98979
6:4:4,0,-1,101022,98978
5:1:4,0,-1,101023,98977
2:4:2,2,2,101021,98979
5:1:2,1,1,101020,98980
3:1:6,0,-1,101021,98979
6:4:6,0,-1,101022,98978
2:3:2,2,2,101020,98980
5:5:2,1,1,101019,98981
2:1:1,1,1,101018,98982
6:3:2,1,1,101017,98983
6:6:4,0,-1,101018,98982
1:2:5,1,1,101017,98983
6:1:4,0,-1,101018,98982
1:5:6,0,-1,101019,98981
1:3:4,0,-1,101020,98980
4:4:6,0,-1,101021,98979
5:5:3,0,-1,101022,98978
1:5:2,1,1,101021,98979
6:3:1,0,-1,101022,98978
5:5:5,0,-1,101023,98977
2:5:6,1,1,101022,98978
3:4:6,0,-1,101023,98977
1:1:2,1,1,101022,98978
5:5:4,0,-1,101023,98977
4:2:3,1,1,101022,98978
6:5:6,0,-1,101023,98977
5:2:1,1,1,101022,98978
2:1:5,1,1,101021,98979
6:2:4,1,1,101020,98980
4:2:5,1,1,101019,98981
1:4:5,0,-1,101020,98980
3:3:2,1,1,101019,98981
1:1:3,0,-1,101020,98980
6:6:3,0,-1,101021,98979
1:6:4,0,-1,101022,98978
3:2:6,1,1,101021,98979
6:2:3,1,1,101020,98980
3:1:1,0,-1,101021,98979
2:1:3,1,1,101020,98980
3:2:1,1,1,101019,98981
4:3:1,0,-1,101020,98980
5:5:4,0,-1,101021,98979
1:4:2,1,1,101020,98980
2:1:1,1,1,101019,98981
1:3:6,0,-1,101020,98980
5:2:4,1,1,101019,98981
6:2:2,2,2,101017,98983
4:2:6,1,1,101016,98984
1:3:3,0,-1,101017,98983
4:2:6,1,1,101016,98984
2:5:1,1,1,101015,98985
4:1:6,0,-1,101016,98984
2:6:1,1,1,101015,98985
1:3:4,0,-1,101016,98984
4:6:6,0,-1,101017,98983
3:5:2,1,1,101016,98984
2:5:5,1,1,101015,98985
2:1:2,2,2,101013,98987
5:3:3,0,-1,101014,98986
3:3:2,1,1,101013,98987
4:4:1,0,-1,101014,98986
4:3:1,0,-1,101015,98985
4:1:6,0,-1,101016,98984
2:6:3,1,1,101015,98985
3:3:4,0,-1,101016,98984
6:2:5,1,1,101015,98985
2:2:5,2,2,101013,98987
1:2:6,1,1,101012,98988
5:5:3,0,-1,101013,98987
4:4:6,0,-1,101014,98986
6:4:2,1,1,101013,98987
5:6:4,0,-1,101014,98986
2:4:5,1,1,101013,98987
2:2:1,2,2,101011,98989
1:4:3,0,-1,101012,98988
1:4:2,1,1,101011,98989
4:1:6,0,-1,101012,98988
5:3:1,0,-1,101013,98987
6:4:5,0,-1,101014,98986
2:5:3,1,1,101013,98987
3:6:2,1,1,101012,98988
4:3:2,1,1,101011,98989
2:1:5,1,1,101010,98990
1:1:6,0,-1,101011,98989
1:5:1,0,-1,101012,98988
1:3:5,0,-1,101013,98987
5:6:6,0,-1,101014,98986
6:1:3,0,-1,101015,98985
1:3:4,0,-1,101016,98984
1:5:5,0,-1,101017,98983
2:5:2,2,2,101015,98985
6:6:5,0,-1,101016,98984
5:4:1,0,-1,101017,98983
4:3:3,0,-1,101018,98982
1:3:6,0,-1,101019,98981
1:2:6,1,1,101018,98982
6:4:1,0,-1,101019,98981
3:1:3,0,-1,101020,98980
5:1:5,0,-1,101021,98979
6:4:6,0,-1,101022,98978
4:1:5,0,-1,101023,98977
6:5:6,0,-1,101024,98976
3:5:6,0,-1,101025,98975
6:5:5,0,-1,101026,98974
2:6:1,1,1,101025,98975
6:4:4,0,-1,101026,98974
2:1:5,1,1,101025,98975
1:3:1,0,-1,101026,98974
1:4:6,0,-1,101027,98973
1:4:3,0,-1,101028,98972
2:1:1,1,1,101027,98973
5:2:3,1,1,101026,98974
4:2:2,2,2,101024,98976
6:1:4,0,-1,101025,98975
2:6:4,1,1,101024,98976
5:5:2,1,1,101023,98977
6:6:5,0,-1,101024,98976
4:6:4,0,-1,101025,98975
3:1:1,0,-1,101026,98974
3:5:3,0,-1,101027,98973
4:3:6,0,-1,101028,98972
1:4:3,0,-1,101029,98971
1:4:1,0,-1,101030,98970
1:3:3,0,-1,101031,98969
5:1:1,0,-1,101032,98968
1:3:6,0,-1,101033,98967
1:3:5,0,-1,101034,98966
6:3:2,1,1,101033,98967
3:6:2,1,1,101032,98968
3:6:4,0,-1,101033,98967
1:5:4,0,-1,101034,98966
3:4:6,0,-1,101035,98965
3:1:6,0,-1,101036,98964
4:2:1,1,1,101035,98965
2:6:2,2,2,101033,98967
6:5:4,0,-1,101034,98966
5:3:2,1,1,101033,98967
1:1:2,1,1,101032,98968
5:3:5,0,-1,101033,98967
2:6:3,1,1,101032,98968
4:1:5,0,-1,101033,98967
2:6:5,1,1,101032,98968
3:3:1,0,-1,101033,98967
6:2:6,1,1,101032,98968
4:4:2,1,1,101031,98969
5:1:3,0,-1,101032,98968
1:5:2,1,1,101031,98969
5:4:3,0,-1,101032,98968
5:1:5,0,-1,101033,98967
6:5:3,0,-1,101034,98966
6:2:6,1,1,101033,98967
5:5:5,0,-1,101034,98966
6:6:1,0,-1,101035,98965
4:5:5,0,-1,101036,98964
3:1:5,0,-1,101037,98963
4:1:1,0,-1,101038,98962
5:5:5,0,-1,101039,98961
3:3:6,0,-1,101040,98960
2:6:5,1,1,101039,98961
5:6:3,0,-1,101040,98960
2:5:2,2,2,101038,98962
1:2:4,1,1,101037,98963
1:2:1,1,1,101036,98964
1:5:2,1,1,101035,98965
2:4:6,1,1,101034,98966
1:3:5,0,-1,101035,98965
1:4:5,0,-1,101036,98964
2:4:6,1,1,101035,98965
6:4:1,0,-1,101036,98964
4:1:2,1,1,101035,98965
3:2:1,1,1,101034,98966
6:1:1,0,-1,101035,98965
3:4:3,0,-1,101036,98964
3:2:1,1,1,101035,98965
3:4:5,0,-1,101036,98964
1:6:4,0,-1,101037,98963
2:5:6,1,1,101036,98964
4:1:2,1,1,101035,98965
3:1:4,0,-1,101036,98964
6:6:3,0,-1,101037,98963
4:2:3,1,1,101036,98964
1:2:3,1,1,101035,98965
3:1:2,1,1,101034,98966
5:5:1,0,-1,101035,98965
2:5:4,1,1,101034,98966
2:1:2,2,2,101032,98968
3:5:5,0,-1,101033,98967
1:2:5,1,1,101032,98968
3:3:4,0,-1,101033,98967
5:1:2,1,1,101032,98968
6:1:3,0,-1,101033,98967
1:1:1,0,-1,101034,98966
6:1:1,0,-1,101035,98965
4:6:5,0,-1,101036,98964
3:6:4,0,-1,101037,98963
1:3:5,0,-1,101038,98962
3:4:4,0,-1,101039,98961
5:4:3,0,-1,101040,98960
5:4:3,0,-1,101041,98959
6:4:2,1,1,101040,98960
5:4:3,0,-1,101041,98959
6:1:1,0,-1,101042,98958
2:2:2,3,3,101039,98961
6:3:6,0,-1,101040,98960
2:6:3,1,1,101039,98961
4:2:2,2,2,101037,98963
5:6:5,0,-1,101038,98962
1:5:1,0,-1,101039,98961
2:6:2,2,2,101037,98963
6:6:6,0,-1,101038,98962
5:4:1,0,-1,101039,98961
6:6:4,0,-1,101040,98960
1:2:4,1,1,101039,98961
2:2:4,2,2,101037,98963
5:1:1,0,-1,101038,98962
4:4:5,0,-1,101039,98961
1:4:1,0,-1,101040,98960
6:6:2,1,1,101039,98961
4:4:6,0,-1,101040,98960
1:1:6,0,-1,101041,98959
1:5:2,1,1,101040,98960
3:5:5,0,-1,101041,98959
5:1:1,0,-1,101042,98958
2:5:4,1,1,101041,98959
3:6:6,0,-1,101042,98958
3:6:4,0,-1,101043,98957
2:3:2,2,2,101041,98959
1:6:1,0,-1,101042,98958
2:4:6,1,1,101041,98959
1:3:3,0,-1,101042,98958
5:1:6,0,-1,101043,98957
1:5:1,0,-1,101044,98956
1:5:4,0,-1,101045,98955
3:6:6,0,-1,101046,98954
4:5:3,0,-1,101047,98953
6:1:4,0,-1,101048,98952
6:6:6,0,-1,101049,98951
4:4:2,1,1,101048,98952
6:1:4,0,-1,101049,98951
5:3:5,0,-1,101050,98950
4:5:2,1,1,101049,98951
5:2:3,1,1,101048,98952
4:4:2,1,1,101047,98953
2:4:3,1,1,101046,98954
4:5:3,0,-1,101047,98953
3:6:5,0,-1,101048,98952
4:6:4,0,-1,101049,98951
1:4:5,0,-1,101050,98950
3:2:5,1,1,101049,98951
3:6:1,0,-1,101050,98950
6:4:2,1,1,101049,98951
2:6:2,2,2,101047,98953
1:6:5,0,-1,101048,98952
3:1:5,0,-1,101049,98951
5:1:6,0,-1,101050,98950
2:1:6,1,1,101049,98951
1:4:1,0,-1,101050,98950
6:1:3,0,-1,101051,98949
4:4:4,0,-1,101052,98948
5:1:4,0,-1,101053,98947
5:2:2,2,2,101051,98949
6:6:4,0,-1,101052,98948
6:6:3,0,-1,101053,98947
6:3:3,0,-1,101054,98946
6:1:4,0,-1,101055,98945
4:3:6,0,-1,101056,98944
6:4:4,0,-1,101057,98943
2:6:5,1,1,101056,98944
3:2:5,1,1,101055,98945
2:3:4,1,1,101054,98946
6:2:4,1,1,101053,98947
5:6:5,0,-1,101054,98946
3:1:1,0,-1,101055,98945
5:6:3,0,-1,101056,98944
3:5:5,0,-1,101057,98943
3:3:3,0,-1,101058,98942
5:6:1,0,-1,101059,98941
3:3:5,0,-1,101060,98940
5:3:2,1,1,101059,98941
4:6:1,0,-1,101060,98940
6:3:2,1,1,101059,98941
2:1:4,1,1,101058,98942
1:4:1,0,-1,101059,98941
1:1:2,1,1,101058,98942
4:3:4,0,-1,101059,98941
5:3:5,0,-1,101060,98940
6:2:4,1,1,101059,98941
6:2:3,1,1,101058,98942
3:6:6,0,-1,101059,98941
6:4:5,0,-1,101060,98940
2:5:4,1,1,101059,98941
6:3:5,0,-1,101060,98940
4:3:2,1,1,101059,98941
4:1:6,0,-1,101060,98940
2:2:2,3,3,101057,98943
5:2:4,1,1,101056,98944
4:1:3,0,-1,101057,98943
6:5:2,1,1,101056,98944
4:4:6,0,-1,101057,98943
4:1:1,0,-1,101058,98942
4:6:6,0,-1,101059,98941
1:1:5,0,-1,101060,98940
5:3:5,0,-1,101061,98939
5:6:3,0,-1,101062,98938
5:2:6,1,1,101061,98939
2:4:3,1,1,101060,98940
6:1:4,0,-1,101061,98939
1:6:2,1,1,101060,98940
3:4:6,0,-1,101061,98939
5:5:4,0,-1,101062,98938
3:3:1,0,-1,101063,98937
4:2:4,1,1,101062,98938
6:4:4,0,-1,101063,98937
1:3:4,0,-1,101064,98936
1:1:6,0,-1,101065,98935
1:4:1,0,-1,101066,98934
3:4:6,0,-1,101067,98933
2:1:1,1,1,101066,98934
1:6:3,0,-1,101067,98933
2:3:5,1,1,101066,98934
6:1:3,0,-1,101067,98933
5:4:6,0,-1,101068,98932
4:3:6,0,-1,101069,98931
2:1:1,1,1,101068,98932
1:1:1,0,-1,101069,98931
2:5:1,1,1,101068,98932
2:2:4,2,2,101066,98934
6:2:6,1,1,101065,98935
2:6:5,1,1,101064,98936
2:6:2,2,2,101062,98938
5:6:4,0,-1,101063,98937
6:5:1,0,-1,101064,98936
3:1:3,0,-1,101065,98935
3:2:4,1,1,101064,98936
5:2:4,1,1,101063,98937
3:5:4,0,-1,101064,98936
2:6:5,1,1,101063,98937
3:2:3,1,1,101062,98938
2:6:5,1,1,101061,98939
5:5:5,0,-1,101062,98938
4:2:3,1,1,101061,98939
5:3:2,1,1,101060,98940
6:2:3,1,1,101059,98941
3:2:5,1,1,101058,98942
1:5:4,0,-1,101059,98941
4:6:4,0,-1,101060,98940
4:4:1,0,-1,101061,98939
5:1:3,0,-1,101062,98938
1:6:6,0,-1,101063,98937
1:4:2,1,1,101062,98938
1:4:2,1,1,101061,98939
1:6:2,1,1,101060,98940
3:6:3,0,-1,101061,98939
4:6:6,0,-1,101062,98938
6:6:2,1,1,101061,98939
4:6:2,1,1,101060,98940
5:1:2,1,1,101059,98941
5:5:3,0,-1,101060,98940
2:2:6,2,2,101058,98942
2:6:5,1,1,101057,98943
5:3:1,0,-1,101058,98942
1:5:4,0,-1,101059,98941
1:2:6,1,1,101058,98942
3:4:6,0,-1,101059,98941
4:3:2,1,1,101058,98942
5:4:4,0,-1,101059,98941
4:5:3,0,-1,101060,98940
2:4:3,1,1,101059,98941
2:5:1,1,1,101058,98942
4:2:4,1,1,101057,98943
4:5:4,0,-1,101058,98942
4:5:2,1,1,101057,98943
2:4:3,1,1,101056,98944
2:3:3,1,1,101055,98945
6:2:3,1,1,101054,98946
3:3:5,0,-1,101055,98945
4:6:2,1,1,101054,98946
4:3:2,1,1,101053,98947
2:2:4,2,2,101051,98949
5:2:4,1,1,101050,98950
6:5:6,0,-1,101051,98949
4:1:5,0,-1,101052,98948
1:4:4,0,-1,101053,98947
1:1:2,1,1,101052,98948
4:6:1,0,-1,101053,98947
6:5:4,0,-1,101054,98946
3:5:6,0,-1,101055,98945
2:3:3,1,1,101054,98946
4:2:1,1,1,101053,98947
3:2:2,2,2,101051,98949
6:3:5,0,-1,101052,98948
3:4:5,0,-1,101053,98947
6:1:5,0,-1,101054,98946
1:4:4,0,-1,101055,98945
5:5:5,0,-1,101056,98944
5:1:1,0,-1,101057,98943
6:2:2,2,2,101055,98945
6:2:1,1,1,101054,98946
2:3:2,2,2,101052,98948
3:4:4,0,-1,101053,98947
5:3:1,0,-1,101054,98946
2:4:2,2,2,101052,98948
3:1:4,0,-1,101053,98947
3:6:3,0,-1,101054,98946
4:3:4,0,-1,101055,98945
6:6:1,0,-1,101056,98944
6:5:6,0,-1,101057,98943
6:5:4,0,-1,101058,98942
3:4:1,0,-1,101059,98941
1:4:4,0,-1,101060,98940
3:6:2,1,1,101059,98941
5:5:5,0,-1,101060,98940
6:1:6,0,-1,101061,98939
5:3:1,0,-1,101062,98938
5:5:2,1,1,101061,98939
4:2:1,1,1,101060,98940
6:3:1,0,-1,101061,98939
3:3:5,0,-1,101062,98938
2:2:3,2,2,101060,98940
6:4:3,0,-1,101061,98939
5:2:4,1,1,101060,98940
2:3:1,1,1,101059,98941
4:3:5,0,-1,101060,98940
3:2:4,1,1,101059,98941
2:1:1,1,1,101058,98942
2:1:4,1,1,101057,98943
5:3:6,0,-1,101058,98942
1:3:6,0,-1,101059,98941
1:5:1,0,-1,101060,98940
1:1:2,1,1,101059,98941
4:1:2,1,1,101058,98942
5:2:2,2,2,101056,98944
1:4:6,0,-1,101057,98943
6:4:4,0,-1,101058,98942
5:5:1,0,-1,101059,98941
4:4:5,0,-1,101060,98940
2:3:2,2,2,101058,98942
4:1:4,0,-1,101059,98941
5:6:2,1,1,101058,98942
6:5:6,0,-1,101059,98941
3:2:4,1,1,101058,98942
1:4:6,0,-1,101059,98941
2:5:6,1,1,101058,98942
3:1:3,0,-1,101059,98941
6:1:2,1,1,101058,98942
1:2:2,2,2,101056,98944
6:5:3,0,-1,101057,98943
6:2:6,1,1,101056,98944
4:2:2,2,2,101054,98946
1:1:5,0,-1,101055,98945
1:2:2,2,2,101053,98947
6:5:6,0,-1,101054,98946
4:3:5,0,-1,101055,98945
1:2:6,1,1,101054,98946
1:5:3,0,-1,101055,98945
5:3:3,0,-1,101056,98944
4:1:5,0,-1,101057,98943
4:5:3,0,-1,101058,98942
1:3:3,0,-1,101059,98941
3:6:4,0,-1,101060,98940
1:6:3,0,-1,101061,98939
2:1:3,1,1,101060,98940
6:6:4,0,-1,101061,98939
3:1:3,0,-1,101062,98938
4:4:5,0,-1,101063,98937
4:5:1,0,-1,101064,98936
1:5:1,0,-1,101065,98935
3:2:2,2,2,101063,98937
2:3:1,1,1,101062,98938
6:2:3,1,1,101061,98939
3:3:6,0,-1,101062,98938
2:6:1,1,1,101061,98939
2:5:5,1,1,101060,98940
1:5:1,0,-1,101061,98939
1:6:1,0,-1,101062,98938
5:4:1,0,-1,101063,98937
2:2:4,2,2,101061,98939
6:3:1,0,-1,101062,98938
2:5:4,1,1,101061,98939
1:5:1,0,-1,101062,98938
6:3:1,0,-1,101063,98937
6:3:2,1,1,101062,98938
2:5:1,1,1,101061,98939
5:2:5,1,1,101060,98940
3:4:4,0,-1,101061,98939
3:2:3,1,1,101060,98940
4:3:6,0,-1,101061,98939
5:3:2,1,1,101060,98940
6:1:4,0,-1,101061,98939
1:5:2,1,1,101060,98940
3:1:3,0,-1,101061,98939
5:4:4,0,-1,101062,98938
3:1:2,1,1,101061,98939
3:3:1,0,-1,101062,98938
1:6:6,0,-1,101063,98937
2:5:5,1,1,101062,98938
4:1:1,0,-1,101063,98937
1:1:1,0,-1,101064,98936
1:4:4,0,-1,101065,98935
4:5:4,0,-1,101066,98934
3:4:6,0,-1,101067,98933
3:4:1,0,-1,101068,98932
1:1:5,0,-1,101069,98931
5:4:5,0,-1,101070,98930
2:1:2,2,2,101068,98932
1:4:1,0,-1,101069,98931
3:5:6,0,-1,101070,98930
1:5:6,0,-1,101071,98929
2:3:5,1,1,101070,98930
5:5:3,0,-1,101071,98929
6:4:6,0,-1,101072,98928
5:4:5,0,-1,101073,98927
1:6:4,0,-1,101074,98926
4:1:4,0,-1,101075,98925
2:2:3,2,2,101073,98927
1:5:1,0,-1,101074,98926
5:3:2,1,1,101073,98927
1:3:5,0,-1,101074,98926
4:4:2,1,1,101073,98927
6:1:3,0,-1,101074,98926
2:5:3,1,1,101073,98927
5:6:5,0,-1,101074,98926
1:6:5,0,-1,101075,98925
1:4:2,1,1,101074,98926
2:2:2,3,3,101071,98929
2:2:4,2,2,101069,98931
5:1:2,1,1,101068,98932
6:6:3,0,-1,101069,98931
1:1:4,0,-1,101070,98930
1:2:3,1,1,101069,98931
6:6:4,0,-1,101070,98930
2:4:4,1,1,101069,98931
2:4:6,1,1,101068,98932
6:1:1,0,-1,101069,98931
5:1:3,0,-1,101070,98930
3:2:5,1,1,101069,98931
6:5:2,1,1,101068,98932
4:4:1,0,-1,101069,98931
3:4:4,0,-1,101070,98930
3:2:3,1,1,101069,98931
2:2:5,2,2,101067,98933
6:3:3,0,-1,101068,98932
6:6:4,0,-1,101069,98931
2:5:6,1,1,101068,98932
4:2:4,1,1,101067,98933
4:1:4,0,-1,101068,98932
3:6:2,1,1,101067,98933
4:4:2,1,1,101066,98934
5:1:3,0,-1,101067,98933
6:5:2,1,1,101066,98934
1:6:6,0,-1,101067,98933
1:5:3,0,-1,101068,98932
1:6:6,0,-1,101069,98931
2:1:3,1,1,101068,98932
1:4:6,0,-1,101069,98931
5:5:4,0,-1,101070,98930
2:5:2,2,2,101068,98932
1:4:2,1,1,101067,98933
2:2:6,2,2,101065,98935
2:3:2,2,2,101063,98937
1:4:4,0,-1,101064,98936
6:6:6,0,-1,101065,98935
4:3:3,0,-1,101066,98934
6:6:3,0,-1,101067,98933
2:5:4,1,1,101066,98934
6:2:1,1,1,101065,98935
6:5:4,0,-1,101066,98934
6:1:5,0,-1,101067,98933
5:2:6,1,1,101066,98934
6:3:6,0,-1,101067,98933
1:2:2,2,2,101065,98935
2:1:2,2,2,101063,98937
5:1:1,0,-1,101064,98936
6:2:6,1,1,101063,98937
3:4:2,1,1,101062,98938
6:4:1,0,-1,101063,98937
2:5:2,2,2,101061,98939
3:6:4,0,-1,101062,98938
3:4:6,0,-1,101063,98937
3:5:5,0,-1,101064,98936
2:5:3,1,1,101063,98937
2:4:2,2,2,101061,98939
4:1:3,0,-1,101062,98938
1:5:5,0,-1,101063,98937
5:4:6,0,-1,101064,98936
4:2:6,1,1,101063,98937
3:4:1,0,-1,101064,98936
6:3:1,0,-1,101065,98935
5:1:4,0,-1,101066,98934
1:6:2,1,1,101065,98935
6:2:3,1,1,101064,98936
4:3:5,0,-1,101065,98935
1:3:5,0,-1,101066,98934
2:3:1,1,1,101065,98935
5:4:4,0,-1,101066,98934
2:3:5,1,1,101065,98935
5:4:1,0,-1,101066,98934
1:2:5,1,1,101065,98935
4:2:5,1,1,101064,98936
5:5:5,0,-1,101065,98935
1:4:5,0,-1,101066,98934
2:6:6,1,1,101065,98935
2:2:2,3,3,101062,98938
5:3:5,0,-1,101063,98937
4:2:2,2,2,101061,98939
4:3:3,0,-1,101062,98938
2:4:6,1,1,101061,98939
6:4:2,1,1,101060,98940
2:3:4,1,1,101059,98941
4:1:6,0,-1,101060,98940
6:2:2,2,2,101058,98942
4:1:3,0,-1,101059,98941
6:5:2,1,1,101058,98942
3:4:5,0,-1,101059,98941
1:6:3,0,-1,101060,98940
6:3:2,1,1,101059,98941
1:5:5,0,-1,101060,98940
3:3:2,1,1,101059,98941
3:3:4,0,-1,101060,98940
3:6:3,0,-1,101061,98939
1:3:1,0,-1,101062,98938
3:5:3,0,-1,101063,98937
6:3:3,0,-1,101064,98936
4:1:4,0,-1,101065,98935
4:2:2,2,2,101063,98937
3:3:3,0,-1,101064,98936
1:1:3,0,-1,101065,98935
4:1:3,0,-1,101066,98934
6:5:6,0,-1,101067,98933
2:5:4,1,1,101066,98934
2:4:2,2,2,101064,98936
1:1:4,0,-1,101065,98935
4:1:5,0,-1,101066,98934
1:3:2,1,1,101065,98935
2:5:5,1,1,101064,98936
3:3:6,0,-1,101065,98935
5:2:4,1,1,101064,98936
3:2:1,1,1,101063,98937
2:6:2,2,2,101061,98939
1:6:3,0,-1,101062,98938
6:2:3,1,1,101061,98939
1:3:2,1,1,101060,98940
4:5:6,0,-1,101061,98939
5:3:5,0,-1,101062,98938
5:3:3,0,-1,101063,98937
2:6:6,1,1,101062,98938
4:4:4,0,-1,101063,98937
5:5:4,0,-1,101064,98936
2:2:6,2,2,101062,98938
6:1:5,0,-1,101063,98937
6:5:2,1,1,101062,98938
6:3:2,1,1,101061,98939
1:5:6,0,-1,101062,98938
1:3:5,0,-1,101063,98937
6:2:1,1,1,101062,98938
5:3:3,0,-1,101063,98937
1:2:6,1,1,101062,98938
5:5:5,0,-1,101063,98937
1:5:2,1,1,101062,98938
2:3:6,1,1,101061,98939
3:4:6,0,-1,101062,98938
5:6:4,0,-1,101063,98937
3:1:1,0,-1,101064,98936
2:3:2,2,2,101062,98938
3:3:5,0,-1,101063,98937
6:2:3,1,1,101062,98938
3:4:5,0,-1,101063,98937
5:1:6,0,-1,101064,98936
2:6:4,1,1,101063,98937
3:2:6,1,1,101062,98938
6:1:4,0,-1,101063,98937
5:6:6,0,-1,101064,98936
3:2:3,1,1,101063,98937
2:6:5,1,1,101062,98938
5:1:5,0,-1,101063,98937
3:5:2,1,1,101062,98938
5:3:6,0,-1,101063,98937
3:5:5,0,-1,101064,98936
2:1:6,1,1,101063,98937
1:2:6,1,1,101062,98938
3:1:1,0,-1,101063,98937
4:6:4,0,-1,101064,98936
1:2:5,1,1,101063,98937
6:2:1,1,1,101062,98938
4:4:3,0,-1,101063,98937
6:3:1,0,-1,101064,98936
1:2:4,1,1,101063,98937
1:2:3,1,1,101062,98938
4:4:1,0,-1,101063,98937
4:5:6,0,-1,101064,98936
3:6:1,0,-1,101065,98935
4:6:4,0,-1,101066,98934
3:2:3,1,1,101065,98935
3:4:6,0,-1,101066,98934
1:4:2,1,1,101065,98935
6:5:1,0,-1,101066,98934
6:1:6,0,-1,101067,98933
2:6:2,2,2,101065,98935
2:1:2,2,2,101063,98937
1:3:6,0,-1,101064,98936
4:5:2,1,1,101063,98937
2:2:2,3,3,101060,98940
3:5:2,1,1,101059,98941
5:3:3,0,-1,101060,98940
4:1:1,0,-1,101061,98939
2:4:6,1,1,101060,98940
4:5:1,0,-1,101061,98939
5:6:6,0,-1,101062,98938
6:2:1,1,1,101061,98939
6:3:4,0,-1,101062,98938
5:5:4,0,-1,101063,98937
2:6:3,1,1,101062,98938
3:4:4,0,-1,101063,98937
5:4:6,0,-1,101064,98936
5:6:5,0,-1,101065,98935
3:1:5,0,-1,101066,98934
5:3:1,0,-1,101067,98933
6:5:3,0,-1,101068,98932
5:1:6,0,-1,101069,98931
4:1:5,0,-1,101070,98930
2:6:5,1,1,101069,98931
4:6:1,0,-1,101070,98930
3:6:3,0,-1,101071,98929
1:3:3,0,-1,101072,98928
2:4:3,1,1,101071,98929
3:4:5,0,-1,101072,98928
6:1:3,0,-1,101073,98927
6:5:1,0,-1,101074,98926
5:2:2,2,2,101072,98928
5:1:2,1,1,101071,98929
4:4:1,0,-1,101072,98928
1:3:4,0,-1,101073,98927
1:6:3,0,-1,101074,98926
3:1:5,0,-1,101075,98925
1:2:4,1,1,101074,98926
6:1:3,0,-1,101075,98925
1:5:2,1,1,101074,98926
6:5:5,0,-1,101075,98925
1:1:1,0,-1,101076,98924
2:4:2,2,2,101074,98926
2:4:6,1,1,101073,98927
3:5:3,0,-1,101074,98926
5:1:2,1,1,101073,98927
1:1:6,0,-1,101074,98926
1:6:3,0,-1,101075,98925
2:1:4,1,1,101074,98926
4:5:3,0,-1,101075,98925
3:4:5,0,-1,101076,98924
1:1:5,0,-1,101077,98923
1:5:4,0,-1,101078,98922
5:2:5,1,1,101077,98923
6:2:2,2,2,101075,98925
5:1:5,0,-1,101076,98924
2:4:6,1,1,101075,98925
5:4:2,1,1,101074,98926
1:2:2,2,2,101072,98928
2:6:6,1,1,101071,98929
5:4:3,0,-1,101072,98928
6:4:4,0,-1,101073,98927
5:3:5,0,-1,101074,98926
5:2:2,2,2,101072,98928
5:2:5,1,1,101071,98929
1:3:2,1,1,101070,98930
1:6:5,0,-1,101071,98929
1:3:6,0,-1,101072,98928
1:5:6,0,-1,101073,98927
4:5:3,0,-1,101074,98926
6:1:1,0,-1,101075,98925
5:3:1,0,-1,101076,98924
3:5:6,0,-1,101077,98923
1:1:4,0,-1,101078,98922
1:1:5,0,-1,101079,98921
1:6:2,1,1,101078,98922
3:4:2,1,1,101077,98923
4:3:6,0,-1,101078,98922
6:4:4,0,-1,101079,98921
6:1:1,0,-1,101080,98920
2:4:4,1,1,101079,98921
4:6:4,0,-1,101080,98920
6:5:6,0,-1,101081,98919
5:6:3,0,-1,101082,98918
1:6:3,0,-1,101083,98917
5:6:6,0,-1,101084,98916
4:5:3,0,-1,101085,98915
2:4:4,1,1,101084,98916
1:2:3,1,1,101083,98917
6:2:1,1,1,101082,98918
2:6:4,1,1,101081,98919
2:3:5,1,1,101080,98920
5:3:2,1,1,101079,98921
1:2:1,1,1,101078,98922
1:5:6,0,-1,101079,98921
2:6:5,1,1,101078,98922
3:2:3,1,1,101077,98923
3:1:6,0,-1,101078,98922
6:4:6,0,-1,101079,98921
5:5:4,0,-1,101080,98920
3:4:5,0,-1,101081,98919
4:5:2,1,1,101080,98920
3:1:2,1,1,101079,98921
2:4:3,1,1,101078,98922
2:2:3,2,2,101076,98924
2:4:1,1,1,101075,98925
5:6:2,1,1,101074,98926
5:5:6,0,-1,101075,98925
5:6:6,0,-1,101076,98924
6:4:1,0,-1,101077,98923
3:4:5,0,-1,101078,98922
4:3:4,0,-1,101079,98921
2:2:5,2,2,101077,98923
1:1:1,0,-1,101078,98922
1:3:2,1,1,101077,98923
3:2:1,1,1,101076,98924
4:5:2,1,1,101075,98925
5:3:5,0,-1,101076,98924
4:6:2,1,1,101075,98925
6:6:5,0,-1,101076,98924
3:3:5,0,-1,101077,98923
1:2:2,2,2,101075,98925
6:3:4,0,-1,101076,98924
3:6:2,1,1,101075,98925
2:1:6,1,1,101074,98926
1:6:2,1,1,101073,98927
1:4:1,0,-1,101074,98926
6:1:3,0,-1,101075,98925
2:1:4,1,1,101074,98926
1:4:4,0,-1,101075,98925
5:5:2,1,1,101074,98926
5:1:5,0,-1,101075,98925
3:5:5,0,-1,101076,98924
3:2:1,1,1,101075,98925
6:2:4,1,1,101074,98926
6:6:1,0,-1,101075,98925
3:3:1,0,-1,101076,98924
1:6:4,0,-1,101077,98923
2:1:5,1,1,101076,98924
5:2:6,1,1,101075,98925
6:3:1,0,-1,101076,98924
6:2:5,1,1,101075,98925
1:4:6,0,-1,101076,98924
4:3:4,0,-1,101077,98923
4:4:5,0,-1,101078,98922
3:2:5,1,1,101077,98923
5:1:1,0,-1,101078,98922
6:5:5,0,-1,101079,98921
5:5:3,0,-1,101080,98920
5:2:5,1,1,101079,98921
2:2:2,3,3,101076,98924
3:4:6,0,-1,101077,98923
2:6:1,1,1,101076,98924
4:4:1,0,-1,101077,98923
3:3:3,0,-1,101078,98922
2:3:5,1,1,101077,98923
4:2:3,1,1,101076,98924
5:3:4,0,-1,101077,98923
2:2:5,2,2,101075,98925
1:4:6,0,-1,101076,98924
3:5:4,0,-1,101077,98923
5:3:3,0,-1,101078,98922
3:5:2,1,1,101077,98923
3:2:3,1,1,101076,98924
3:3:1,0,-1,101077,98923
3:3:2,1,1,101076,98924
3:2:3,1,1,101075,98925
4:3:2,1,1,101074,98926
1:3:2,1,1,101073,98927
4:6:5,0,-1,101074,98926
1:2:2,2,2,101072,98928
5:5:2,1,1,101071,98929
1:3:1,0,-1,101072,98928
3:3:5,0,-1,101073,98927
1:5:3,0,-1,101074,98926
5:2:6,1,1,101073,98927
6:4:5,0,-1,101074,98926
5:2:4,1,1,101073,98927
3:1:3,0,-1,101074,98926
4:6:6,0,-1,101075,98925
6:3:5,0,-1,101076,98924
6:3:2,1,1,101075,98925
6:1:6,0,-1,101076,98924
5:5:4,0,-1,101077,98923
1:6:1,0,-1,101078,98922
6:4:1,0,-1,101079,98921
5:4:2,1,1,101078,98922
4:6:4,0,-1,101079,98921
3:4:3,0,-1,101080,98920
4:2:3,1,1,101079,98921
2:4:3,1,1,101078,98922
2:5:2,2,2,101076,98924
3:3:4,0,-1,101077,98923
3:1:1,0,-1,101078,98922
4:4:3,0,-1,101079,98921
1:5:6,0,-1,101080,98920
2:3:6,1,1,101079,98921
4:2:2,2,2,101077,98923
2:1:3,1,1,101076,98924
3:1:4,0,-1,101077,98923
3:2:4,1,1,101076,98924
1:6:5,0,-1,101077,98923
3:6:1,0,-1,101078,98922
5:6:3,0,-1,101079,98921
1:6:6,0,-1,101080,98920
2:5:3,1,1,101079,98921
2:6:6,1,1,101078,98922
5:5:1,0,-1,101079,98921
3:4:1,0,-1,101080,98920
4:1:6,0,-1,101081,98919
5:3:3,0,-1,101082,98918
6:1:6,0,-1,101083,98917
3:4:6,0,-1,101084,98916
2:4:2,2,2,101082,98918
2:6:4,1,1,101081,98919
1:6:3,0,-1,101082,98918
4:2:2,2,2,101080,98920
4:1:6,0,-1,101081,98919
3:3:4,0,-1,101082,98918
3:6:5,0,-1,101083,98917
1:6:5,0,-1,101084,98916
1:5:2,1,1,101083,98917
4:5:1,0,-1,101084,98916
2:6:2,2,2,101082,98918
6:4:6,0,-1,101083,98917
1:3:1,0,-1,101084,98916
3:5:2,1,1,101083,98917
3:4:3,0,-1,101084,98916
2:3:1,1,1,101083,98917
3:6:5,0,-1,101084,98916
1:4:2,1,1,101083,98917
4:2:6,1,1,101082,98918
1:2:4,1,1,101081,98919
1:5:5,0,-1,101082,98918
5:1:6,0,-1,101083,98917
1:4:3,0,-1,101084,98916
3:4:1,0,-1,101085,98915
1:5:5,0,-1,101086,98914
6:3:4,0,-1,101087,98913
6:3:2,1,1,101086,98914
4:1:4,0,-1,101087,98913
4:3:4,0,-1,101088,98912
6:1:6,0,-1,101089,98911
4:1:5,0,-1,101090,98910
1:6:1,0,-1,101091,98909
3:5:4,0,-1,101092,98908
5:2:2,2,2,101090,98910
5:1:1,0,-1,101091,98909
6:5:5,0,-1,101092,98908
6:4:1,0,-1,101093,98907
4:6:5,0,-1,101094,98906
1:5:3,0,-1,101095,98905
4:6:3,0,-1,101096,98904
5:3:1,0,-1,101097,98903
5:6:2,1,1,101096,98904
5:2:3,1,1,101095,98905
5:3:2,1,1,101094,98906
1:2:3,1,1,101093,98907
6:2:2,2,2,101091,98909
1:5:2,1,1,101090,98910
4:5:6,0,-1,101091,98909
3:6:6,0,-1,101092,98908
4:4:2,1,1,101091,98909
4:6:5,0,-1,101092,98908
1:5:2,1,1,101091,98909
1:5:1,0,-1,101092,98908
1:2:1,1,1,101091,98909
2:1:1,1,1,101090,98910
1:6:1,0,-1,101091,98909
1:6:5,0,-1,101092,98908
4:5:1,0,-1,101093,98907
2:5:2,2,2,101091,98909
2:3:4,1,1,101090,98910
3:2:6,1,1,101089,98911
5:6:1,0,-1,101090,98910
5:1:2,1,1,101089,98911
3:2:2,2,2,101087,98913
2:1:2,2,2,101085,98915
1:3:4,0,-1,101086,98914
1:3:3,0,-1,101087,98913
1:3:3,0,-1,101088,98912
4:2:1,1,1,101087,98913
2:1:5,1,1,101086,98914
6:4:3,0,-1,101087,98913
4:6:4,0,-1,101088,98912
5:4:4,0,-1,101089,98911
3:2:1,1,1,101088,98912
2:3:6,1,1,101087,98913
6:1:1,0,-1,101088,98912
1:5:5,0,-1,101089,98911
6:5:1,0,-1,101090,98910
3:2:6,1,1,101089,98911
5:6:3,0,-1,101090,98910
2:2:4,2,2,101088,98912
1:4:6,0,-1,101089,98911
2:6:1,1,1,101088,98912
4:1:6,0,-1,101089,98911
5:1:1,0,-1,101090,98910
2:1:2,2,2,101088,98912
3:5:4,0,-1,101089,98911
2:6:2,2,2,101087,98913
3:1:3,0,-1,101088,98912
1:4:6,0,-1,101089,98911
5:4:5,0,-1,101090,98910
2:4:5,1,1,101089,98911
2:2:4,2,2,101087,98913
2:2:5,2,2,101085,98915
2:4:6,1,1,101084,98916
6:4:2,1,1,101083,98917
4:3:6,0,-1,101084,98916
4:4:2,1,1,101083,98917
6:5:6,0,-1,101084,98916
2:1:6,1,1,101083,98917
6:5:4,0,-1,101084,98916
2:1:1,1,1,101083,98917
3:3:1,0,-1,101084,98916
3:3:1,0,-1,101085,98915
2:2:4,2,2,101083,98917
3:1:4,0,-1,101084,98916
1:2:5,1,1,101083,98917
4:5:5,0,-1,101084,98916
3:1:3,0,-1,101085,98915
2:2:1,2,2,101083,98917
6:6:2,1,1,101082,98918
6:6:6,0,-1,101083,98917
3:3:4,0,-1,101084,98916
6:3:5,0,-1,101085,98915
4:3:4,0,-1,101086,98914
3:3:4,0,-1,101087,98913
5:4:5,0,-1,101088,98912
5:3:1,0,-1,101089,98911
1:2:2,2,2,101087,98913
1:3:3,0,-1,101088,98912
3:6:1,0,-1,101089,98911
6:4:3,0,-1,101090,98910
2:5:5,1,1,101089,98911
4:5:2,1,1,101088,98912
2:5:6,1,1,101087,98913
4:6:3,0,-1,101088,98912
6:2:2,2,2,101086,98914
6:4:4,0,-1,101087,98913
6:2:6,1,1,101086,98914
5:5:5,0,-1,101087,98913
6:3:3,0,-1,101088,98912
3:3:2,1,1,101087,98913
3:1:3,0,-1,101088,98912
4:6:2,1,1,101087,98913
5:6:4,0,-1,101088,98912
2:1:2,2,2,101086,98914
6:4:6,0,-1,101087,98913
1:5:5,0,-1,101088,98912
5:1:3,0,-1,101089,98911
4:6:2,1,1,101088,98912
3:1:4,0,-1,101089,98911
2:1:2,2,2,101087,98913
3:2:5,1,1,101086,98914
2:4:2,2,2,101084,98916
1:6:5,0,-1,101085,98915
5:4:4,0,-1,101086,98914
4:1:6,0,-1,101087,98913
6:2:5,1,1,101086,98914
6:5:3,0,-1,101087,98913
5:3:3,0,-1,101088,98912
3:6:2,1,1,101087,98913
4:3:2,1,1,101086,98914
5:6:4,0,-1,101087,98913
6:1:4,0,-1,101088,98912
3:4:5,0,-1,101089,98911
2:2:3,2,2,101087,98913
1:3:3,0,-1,101088,98912
5:5:6,0,-1,101089,98911
1:2:5,1,1,101088,98912
3:6:6,0,-1,101089,98911
6:6:6,0,-1,101090,98910
5:5:1,0,-1,101091,98909
6:6:3,0,-1,101092,98908
5:1:6,0,-1,101093,98907
1:2:6,1,1,101092,98908
6:5:6,0,-1,101093,98907
6:3:6,0,-1,101094,98906
2:1:2,2,2,101092,98908
3:3:2,1,1,101091,98909
3:6:4,0,-1,101092,98908
1:2:6,1,1,101091,98909
2:5:5,1,1,101090,98910
2:1:6,1,1,101089,98911
3:1:1,0,-1,101090,98910
4:5:6,0,-1,101091,98909
5:5:3,0,-1,101092,98908
4:6:5,0,-1,101093,98907
2:5:6,1,1,101092,98908
4:4:6,0,-1,101093,98907
2:5:4,1,1,101092,98908
3:6:1,0,-1,101093,98907
5:1:6,0,-1,101094,98906
2:3:6,1,1,101093,98907
4:2:4,1,1,101092,98908
2:1:4,1,1,101091,98909
5:6:3,0,-1,101092,98908
2:1:6,1,1,101091,98909
4:6:5,0,-1,101092,98908
2:5:1,1,1,101091,98909
2:5:1,1,1,101090,98910
6:5:5,0,-1,101091,98909
4:5:5,0,-1,101092,98908
4:2:6,1,1,101091,98909
4:2:6,1,1,101090,98910
5:1:6,0,-1,101091,98909
1:6:5,0,-1,101092,98908
5:1:6,0,-1,101093,98907
1:4:5,0,-1,101094,98906
5:4:1,0,-1,101095,98905
5:4:5,0,-1,101096,98904
6:3:3,0,-1,101097,98903
2:5:6,1,1,101096,98904
3:6:3,0,-1,101097,98903
4:4:2,1,1,101096,98904
4:3:4,0,-1,101097,98903
4:6:3,0,-1,101098,98902
6:6:2,1,1,101097,98903
2:3:3,1,1,101096,98904
2:6:3,1,1,101095,98905
1:3:6,0,-1,101096,98904
1:6:6,0,-1,101097,98903
2:3:5,1,1,101096,98904
3:4:1,0,-1,101097,98903
3:2:5,1,1,101096,98904
3:2:6,1,1,101095,98905
4:3:6,0,-1,101096,98904
1:1:3,0,-1,101097,98903
3:5:3,0,-1,101098,98902
1:2:6,1,1,101097,98903
5:6:1,0,-1,101098,98902
1:3:1,0,-1,101099,98901
5:5:5,0,-1,101100,98900
2:6:1,1,1,101099,98901
5:2:6,1,1,101098,98902
3:2:6,1,1,101097,98903
3:6:4,0,-1,101098,98902
2:1:1,1,1,101097,98903
3:6:2,1,1,101096,98904
5:5:5,0,-1,101097,98903
1:5:5,0,-1,101098,98902
1:3:5,0,-1,101099,98901
5:5:5,0,-1,101100,98900
6:6:4,0,-1,101101,98899
6:3:2,1,1,101100,98900
6:5:2,1,1,101099,98901
4:6:1,0,-1,101100,98900
2:1:2,2,2,101098,98902
6:2:3,1,1,101097,98903
1:4:4,0,-1,101098,98902
2:2:5,2,2,101096,98904
4:2:1,1,1,101095,98905
2:6:6,1,1,101094,98906
3:6:1,0,-1,101095,98905
5:5:6,0,-1,101096,98904
1:1:2,1,1,101095,98905
2:4:1,1,1,101094,98906
1:4:1,0,-1,101095,98905
4:1:3,0,-1,101096,98904
5:5:4,0,-1,101097,98903
3:5:2,1,1,101096,98904
3:2:2,2,2,101094,98906
2:3:1,1,1,101093,98907
2:1:1,1,1,101092,98908
4:1:4,0,-1,101093,98907
1:5:1,0,-1,101094,98906
1:3:6,0,-1,101095,98905
3:1:2,1,1,101094,98906
1:2:6,1,1,101093,98907
3:2:4,1,1,101092,98908
1:6:2,1,1,101091,98909
2:2:6,2,2,101089,98911
2:5:3,1,1,101088,98912
4:1:4,0,-1,101089,98911
5:3:2,1,1,101088,98912
6:2:1,1,1,101087,98913
3:1:6,0,-1,101088,98912
2:3:4,1,1,101087,98913
6:4:3,0,-1,101088,98912
1:6:1,0,-1,101089,98911
2:1:4,1,1,101088,98912
2:1:6,1,1,101087,98913
6:5:4,0,-1,101088,98912
5:4:4,0,-1,101089,98911
5:5:2,1,1,101088,98912
4:5:5,0,-1,101089,98911
3:3:3,0,-1,101090,98910
4:3:5,0,-1,101091,98909
4:3:2,1,1,101090,98910
6:6:6,0,-1,101091,98909
3:6:4,0,-1,101092,98908
1:2:3,1,1,101091,98909
1:3:3,0,-1,101092,98908
3:2:6,1,1,101091,98909
6:2:2,2,2,101089,98911
4:2:1,1,1,101088,98912
5:3:4,0,-1,101089,98911
6:6:4,0,-1,101090,98910
3:3:3,0,-1,101091,98909
6:5:1,0,-1,101092,98908
2:1:5,1,1,101091,98909
4:4:2,1,1,101090,98910
6:5:6,0,-1,101091,98909
5:3:5,0,-1,101092,98908
1:3:4,0,-1,101093,98907
5:1:5,0,-1,101094,98906
3:2:6,1,1,101093,98907
2:4:6,1,1,101092,98908
2:5:1,1,1,101091,98909
4:5:4,0,-1,101092,98908
5:3:2,1,1,101091,98909
4:4:6,0,-1,101092,98908
1:2:3,1,1,101091,98909
5:2:4,1,1,101090,98910
5:5:3,0,-1,101091,98909
2:1:3,1,1,101090,98910
3:6:4,0,-1,101091,98909
6:4:6,0,-1,101092,98908
2:5:4,1,1,101091,98909
3:1:4,0,-1,101092,98908
3:2:4,1,1,101091,98909
6:6:5,0,-1,101092,98908
4:1:5,0,-1,101093,98907
5:2:4,1,1,101092,98908
5:2:2,2,2,101090,98910
5:4:3,0,-1,101091,98909
3:6:5,0,-1,101092,98908
4:6:5,0,-1,101093,98907
5:1:6,0,-1,101094,98906
3:5:2,1,1,101093,98907
1:2:1,1,1,101092,98908
3:2:2,2,2,101090,98910
5:1:3,0,-1,101091,98909
1:3:5,0,-1,101092,98908
5:5:3,0,-1,101093,98907
3:6:1,0,-1,101094,98906
5:1:6,0,-1,101095,98905
3:5:1,0,-1,101096,98904
4:4:3,0,-1,101097,98903
1:5:3,0,-1,101098,98902
5:3:4,0,-1,101099,98901
3:6:6,0,-1,101100,98900
2:1:4,1,1,101099,98901
5:4:3,0,-1,101100,98900
4:6:5,0,-1,101101,98899
4:3:6,0,-1,101102,98898
4:5:5,0,-1,101103,98897
3:1:4,0,-1,101104,98896
4:4:3,0,-1,101105,98895
6:2:1,1,1,101104,98896
3:6:6,0,-1,101105,98895
6:1:5,0,-1,101106,98894
4:4:4,0,-1,101107,98893
3:2:3,1,1,101106,98894
3:2:5,1,1,101105,98895
4:1:2,1,1,101104,98896
6:2:6,1,1,101103,98897
1:3:1,0,-1,101104,98896
5:5:2,1,1,101103,98897
5:1:1,0,-1,101104,98896
4:3:1,0,-1,101105,98895
2:5:5,1,1,101104,98896
2:4:3,1,1,101103,98897
3:5:4,0,-1,101104,98896
1:1:4,0,-1,101105,98895
1:1:6,0,-1,101106,98894
6:1:5,0,-1,101107,98893
1:6:1,0,-1,101108,98892
2:4:3,1,1,101107,98893
6:5:1,0,-1,101108,98892
6:3:1,0,-1,101109,98891
4:6:1,0,-1,101110,98890
4:4:3,0,-1,101111,98889
1:1:4,0,-1,101112,98888
1:5:3,0,-1,101113,98887
5:4:5,0,-1,101114,98886
3:4:2,1,1,101113,98887
6:5:6,0,-1,101114,98886
3:4:3,0,-1,101115,98885
5:3:1,0,-1,101116,98884
6:4:4,0,-1,101117,98883
1:3:3,0,-1,101118,98882
2:3:2,2,2,101116,98884
4:3:2,1,1,101115,98885
6:6:6,0,-1,101116,98884
6:3:1,0,-1,101117,98883
3:4:1,0,-1,101118,98882
1:6:6,0,-1,101119,98881
3:6:5,0,-1,101120,98880
1:2:3,1,1,101119,98881
6:6:5,0,-1,101120,98880
2:4:5,1,1,101119,98881
2:3:1,1,1,101118,98882
3:2:6,1,1,101117,98883
6:2:6,1,1,101116,98884
4:1:4,0,-1,101117,98883
5:4:2,1,1,101116,98884
4:3:1,0,-1,101117,98883
1:4:2,1,1,101116,98884
3:6:5,0,-1,101117,98883
1:4:1,0,-1,101118,98882
3:1:1,0,-1,101119,98881
5:3:4,0,-1,101120,98880
2:4:3,1,1,101119,98881
6:6:5,0,-1,101120,98880
5:5:6,0,-1,101121,98879
4:3:1,0,-1,101122,98878
3:4:2,1,1,101121,98879
6:1:1,0,-1,101122,98878
2:6:4,1,1,101121,98879
1:1:6,0,-1,101122,98878
2:5:6,1,1,101121,98879
3:4:5,0,-1,101122,98878
4:2:4,1,1,101121,98879
5:2:5,1,1,101120,98880
3:4:4,0,-1,101121,98879
2:2:5,2,2,101119,98881
4:5:4,0,-1,101120,98880
4:2:4,1,1,101119,98881
6:2:5,1,1,101118,98882
6:3:1,0,-1,101119,98881
2:5:5,1,1,101118,98882
4:6:4,0,-1,101119,98881
6:6:6,0,-1,101120,98880
1:1:5,0,-1,101121,98879
2:2:3,2,2,101119,98881
6:1:2,1,1,101118,98882
6:2:3,1,1,101117,98883
3:4:4,0,-1,101118,98882
1:5:6,0,-1,101119,98881
5:4:4,0,-1,101120,98880
2:2:3,2,2,101118,98882
4:4:6,0,-1,101119,98881
2:1:2,2,2,101117,98883
4:2:5,1,1,101116,98884
2:3:4,1,1,101115,98885
1:4:6,0,-1,101116,98884
1:6:3,0,-1,101117,98883
6:4:6,0,-1,101118,98882
3:1:4,0,-1,101119,98881
6:3:3,0,-1,101120,98880
4:4:3,0,-1,101121,98879
1:3:5,0,-1,101122,98878
2:1:5,1,1,101121,98879
3:5:5,0,-1,101122,98878
6:6:2,1,1,101121,98879
2:4:5,1,1,101120,98880
2:1:3,1,1,101119,98881
6:5:6,0,-1,101120,98880
5:1:1,0,-1,101121,98879
1:1:5,0,-1,101122,98878
4:2:4,1,1,101121,98879
4:3:4,0,-1,101122,98878
3:1:4,0,-1,101123,98877
5:3:4,0,-1,101124,98876
5:5:1,0,-1,101125,98875
2:1:3,1,1,101124,98876
1:4:5,0,-1,101125,98875
6:3:3,0,-1,101126,98874
5:3:5,0,-1,101127,98873
3:4:1,0,-1,101128,98872
4:2:5,1,1,101127,98873
1:2:1,1,1,101126,98874
5:2:5,1,1,101125,98875
6:5:6,0,-1,101126,98874
2:5:3,1,1,101125,98875
1:4:5,0,-1,101126,98874
4:5:4,0,-1,101127,98873
6:1:1,0,-1,101128,98872
2:3:2,2,2,101126,98874
1:2:6,1,1,101125,98875
4:4:3,0,-1,101126,98874
4:3:1,0,-1,101127,98873
3:1:1,0,-1,101128,98872
6:5:4,0,-1,101129,98871
1:6:3,0,-1,101130,98870
5:3:1,0,-1,101131,98869
1:4:2,1,1,101130,98870
3:4:6,0,-1,101131,98869
3:4:1,0,-1,101132,98868
3:2:4,1,1,101131,98869
6:1:5,0,-1,101132,98868
2:6:3,1,1,101131,98869
2:2:5,2,2,101129,98871
2:2:6,2,2,101127,98873
2:4:5,1,1,101126,98874
1:2:6,1,1,101125,98875
1:3:6,0,-1,101126,98874
3:6:6,0,-1,101127,98873
2:2:3,2,2,101125,98875
5:2:3,1,1,101124,98876
5:3:4,0,-1,101125,98875
5:5:2,1,1,101124,98876
1:5:6,0,-1,101125,98875
4:5:4,0,-1,101126,98874
1:3:3,0,-1,101127,98873
1:3:3,0,-1,101128,98872
5:5:2,1,1,101127,98873
4:1:4,0,-1,101128,98872
4:4:5,0,-1,101129,98871
1:2:2,2,2,101127,98873
2:1:6,1,1,101126,98874
4:1:2,1,1,101125,98875
5:3:5,0,-1,101126,98874
1:1:6,0,-1,101127,98873
4:2:6,1,1,101126,98874
2:6:6,1,1,101125,98875
4:2:3,1,1,101124,98876
6:2:3,1,1,101123,98877
3:2:4,1,1,101122,98878
2:4:3,1,1,101121,98879
5:4:3,0,-1,101122,98878
6:3:4,0,-1,101123,98877
1:5:2,1,1,101122,98878
4:2:6,1,1,101121,98879
2:2:6,2,2,101119,98881
5:4:5,0,-1,101120,98880
6:1:4,0,-1,101121,98879
2:1:4,1,1,101120,98880
1:6:5,0,-1,101121,98879
5:5:5,0,-1,101122,98878
4:4:2,1,1,101121,98879
5:6:6,0,-1,101122,98878
5:4:3,0,-1,101123,98877
1:3:6,0,-1,101124,98876
2:1:3,1,1,101123,98877
1:6:3,0,-1,101124,98876
6:3:3,0,-1,101125,98875
3:6:4,0,-1,101126,98874
5:1:4,0,-1,101127,98873
5:6:3,0,-1,101128,98872
1:3:6,0,-1,101129,98871
3:2:2,2,2,101127,98873
4:4:4,0,-1,101128,98872
3:3:4,0,-1,101129,98871
2:6:4,1,1,101128,98872
5:2:2,2,2,101126,98874
6:3:3,0,-1,101127,98873
6:4:3,0,-1,101128,98872
2:6:6,1,1,101127,98873
2:4:4,1,1,101126,98874
3:5:5,0,-1,101127,98873
3:2:2,2,2,101125,98875
2:4:3,1,1,101124,98876
6:1:1,0,-1,101125,98875
6:1:3,0,-1,101126,98874
1:6:4,0,-1,101127,98873
1:1:2,1,1,101126,98874
5:2:6,1,1,101125,98875
1:3:3,0,-1,101126,98874
5:6:1,0,-1,101127,98873
1:3:1,0,-1,101128,98872
3:5:2,1,1,101127,98873
3:4:5,0,-1,101128,98872
4:1:6,0,-1,101129,98871
3:3:3,0,-1,101130,98870
4:5:4,0,-1,101131,98869
2:1:6,1,1,101130,98870
5:4:4,0,-1,101131,98869
3:4:3,0,-1,101132,98868
6:1:1,0,-1,101133,98867
1:1:1,0,-1,101134,98866
6:3:4,0,-1,101135,98865
2:4:4,1,1,101134,98866
2:2:2,3,3,101131,98869
6:5:3,0,-1,101132,98868
3:5:6,0,-1,101133,98867
5:5:6,0,-1,101134,98866
4:6:6,0,-1,101135,98865
6:6:1,0,-1,101136,98864
2:3:4,1,1,101135,98865
5:4:5,0,-1,101136,98864
6:6:3,0,-1,101137,98863
1:4:2,1,1,101136,98864
3:3:6,0,-1,101137,98863
5:1:4,0,-1,101138,98862
3:6:1,0,-1,101139,98861
4:4:5,0,-1,101140,98860
5:3:6,0,-1,101141,98859
6:5:5,0,-1,101142,98858
1:4:2,1,1,101141,98859
4:6:3,0,-1,101142,98858
2:3:6,1,1,101141,98859
6:6:6,0,-1,101142,98858
6:2:1,1,1,101141,98859
3:4:1,0,-1,101142,98858
5:2:1,1,1,101141,98859
6:1:4,0,-1,101142,98858
6:6:6,0,-1,101143,98857
4:5:1,0,-1,101144,98856
1:2:3,1,1,101143,98857
2:2:3,2,2,101141,98859
4:1:3,0,-1,101142,98858
5:3:2,1,1,101141,98859
6:1:6,0,-1,101142,98858
5:6:3,0,-1,101143,98857
2:5:4,1,1,101142,98858
6:4:6,0,-1,101143,98857
5:6:2,1,1,101142,98858
3:4:3,0,-1,101143,98857
6:6:2,1,1,101142,98858
3:6:3,0,-1,101143,98857
3:1:1,0,-1,101144,98856
3:6:2,1,1,101143,98857
6:5:2,1,1,101142,98858
2:6:4,1,1,101141,98859
1:4:3,0,-1,101142,98858
6:3:1,0,-1,101143,98857
5:1:6,0,-1,101144,98856
1:3:2,1,1,101143,98857
3:3:1,0,-1,101144,98856
3:1:4,0,-1,101145,98855
5:1:6,0,-1,101146,98854
3:5:6,0,-1,101147,98853
2:4:6,1,1,101146,98854
4:6:1,0,-1,101147,98853
1:6:4,0,-1,101148,98852
4:5:2,1,1,101147,98853
1:5:4,0,-1,101148,98852
2:5:2,2,2,101146,98854
5:3:5,0,-1,101147,98853
2:5:3,1,1,101146,98854
6:6:6,0,-1,101147,98853
2:1:3,1,1,101146,98854
3:1:2,1,1,101145,98855
4:3:4,0,-1,101146,98854
2:4:4,1,1,101145,98855
6:1:3,0,-1,101146,98854
4:3:6,0,-1,101147,98853
2:5:4,1,1,101146,98854
1:5:5,0,-1,101147,98853
5:1:2,1,1,101146,98854
1:5:4,0,-1,101147,98853
4:3:1,0,-1,101148,98852
1:5:1,0,-1,101149,98851
5:4:1,0,-1,101150,98850
6:3:5,0,-1,101151,98849
3:1:4,0,-1,101152,98848
3:2:4,1,1,101151,98849
6:4:4,0,-1,101152,98848
5:1:1,0,-1,101153,98847
1:1:4,0,-1,101154,98846
6:3:6,0,-1,101155,98845
1:2:4,1,1,101154,98846
3:3:6,0,-1,101155,98845
3:3:1,0,-1,101156,98844
1:6:4,0,-1,101157,98843
1:5:2,1,1,101156,98844
6:6:1,0,-1,101157,98843
4:6:6,0,-1,101158,98842
3:1:3,0,-1,101159,98841
5:3:6,0,-1,101160,98840
1:6:1,0,-1,101161,98839
4:4:6,0,-1,101162,98838
6:6:6,0,-1,101163,98837
5:4:5,0,-1,101164,98836
2:4:6,1,1,101163,98837
4:4:6,0,-1,101164,98836
2:4:5,1,1,101163,98837
2:5:1,1,1,101162,98838
4:5:5,0,-1,101163,98837
4:2:2,2,2,101161,98839
4:2:4,1,1,101160,98840
3:5:2,1,1,101159,98841
6:1:6,0,-1,101160,98840
1:3:1,0,-1,101161,98839
1:3:5,0,-1,101162,98838
2:6:2,2,2,101160,98840
4:6:6,0,-1,101161,98839
1:6:1,0,-1,101162,98838
2:5:3,1,1,101161,98839
3:6:1,0,-1,101162,98838
4:6:6,0,-1,101163,98837
5:5:5,0,-1,101164,98836
2:1:1,1,1,101163,98837
3:2:6,1,1,101162,98838
6:5:5,0,-1,101163,98837
5:6:4,0,-1,101164,98836
5:4:2,1,1,101163,98837
5:1:6,0,-1,101164,98836
2:6:3,1,1,101163,98837
4:2:1,1,1,101162,98838
4:1:3,0,-1,101163,98837
3:3:2,1,1,101162,98838
4:5:1,0,-1,101163,98837
4:4:3,0,-1,101164,98836
6:1:3,0,-1,101165,98835
3:1:1,0,-1,101166,98834
1:3:2,1,1,101165,98835
5:4:4,0,-1,101166,98834
5:1:5,0,-1,101167,98833
1:3:4,0,-1,101168,98832
2:2:4,2,2,101166,98834
5:4:1,0,-1,101167,98833
2:6:3,1,1,101166,98834
6:2:4,1,1,101165,98835
4:6:6,0,-1,101166,98834
5:1:3,0,-1,101167,98833
4:2:3,1,1,101166,98834
6:1:5,0,-1,101167,98833
3:6:1,0,-1,101168,98832
1:6:2,1,1,101167,98833
5:4:4,0,-1,101168,98832
2:5:4,1,1,101167,98833
6:5:4,0,-1,101168,98832
5:4:5,0,-1,101169,98831
4:6:6,0,-1,101170,98830
1:1:5,0,-1,101171,98829
3:5:5,0,-1,101172,98828
3:3:4,0,-1,101173,98827
4:1:2,1,1,101172,98828
5:5:2,1,1,101171,98829
6:1:1,0,-1,101172,98828
2:1:2,2,2,101170,98830
4:6:3,0,-1,101171,98829
4:5:5,0,-1,101172,98828
5:3:5,0,-1,101173,98827
4:4:2,1,1,101172,98828
1:1:2,1,1,101171,98829
6:5:2,1,1,101170,98830
1:1:5,0,-1,101171,98829
1:1:2,1,1,101170,98830
1:2:5,1,1,101169,98831
1:2:3,1,1,101168,98832
5:2:6,1,1,101167,98833
3:5:4,0,-1,101168,98832
2:4:1,1,1,101167,98833
5:1:4,0,-1,101168,98832
2:6:6,1,1,101167,98833
3:1:4,0,-1,101168,98832
1:1:3,0,-1,101169,98831
2:2:2,3,3,101166,98834
4:5:4,0,-1,101167,98833
2:5:3,1,1,101166,98834
6:6:3,0,-1,101167,98833
1:2:4,1,1,101166,98834
3:2:3,1,1,101165,98835
3:4:6,0,-1,101166,98834
6:3:4,0,-1,101167,98833
3:5:1,0,-1,101168,98832
4:5:3,0,-1,101169,98831
5:3:4,0,-1,101170,98830
5:4:2,1,1,101169,98831
4:4:2,1,1,101168,98832
2:4:1,1,1,101167,98833
1:3:6,0,-1,101168,98832
3:3:3,0,-1,101169,98831
1:5:1,0,-1,101170,98830
5:5:3,0,-1,101171,98829
3:6:5,0,-1,101172,98828
4:6:6,0,-1,101173,98827
6:3:5,0,-1,101174,98826
2:5:6,1,1,101173,98827
6:4:2,1,1,101172,98828
2:3:2,2,2,101170,98830
3:6:3,0,-1,101171,98829
5:6:3,0,-1,101172,98828
3:3:3,0,-1,101173,98827
5:3:6,0,-1,101174,98826
1:5:3,0,-1,101175,98825
1:5:4,0,-1,101176,98824
4:2:6,1,1,101175,98825
1:3:5,0,-1,101176,98824
5:5:1,0,-1,101177,98823
6:4:4,0,-1,101178,98822
6:4:2,1,1,101177,98823
6:2:6,1,1,101176,98824
3:5:4,0,-1,101177,98823
5:5:4,0,-1,101178,98822
2:5:3,1,1,101177,98823
5:2:4,1,1,101176,98824
3:5:4,0,-1,101177,98823
2:1:1,1,1,101176,98824
5:2:4,1,1,101175,98825
6:1:4,0,-1,101176,98824
1:3:4,0,-1,101177,98823
1:3:3,0,-1,101178,98822
3:5:4,0,-1,101179,98821
2:4:2,2,2,101177,98823
4:1:5,0,-1,101178,98822
2:5:2,2,2,101176,98824
5:6:1,0,-1,101177,98823
4:2:2,2,2,101175,98825
4:3:1,0,-1,101176,98824
4:4:5,0,-1,101177,98823
4:3:1,0,-1,101178,98822
1:6:4,0,-1,101179,98821
5:2:2,2,2,101177,98823
2:5:1,1,1,101176,98824
4:3:4,0,-1,101177,98823
2:4:2,2,2,101175,98825
2:1:2,2,2,101173,98827
5:6:2,1,1,101172,98828
1:1:6,0,-1,101173,98827
3:5:1,0,-1,101174,98826
5:1:4,0,-1,101175,98825
3:2:4,1,1,101174,98826
4:1:6,0,-1,101175,98825
1:3:5,0,-1,101176,98824
5:4:6,0,-1,101177,98823
2:2:1,2,2,101175,98825
2:2:4,2,2,101173,98827
1:1:6,0,-1,101174,98826
4:5:4,0,-1,101175,98825
2:3:2,2,2,101173,98827
4:4:3,0,-1,101174,98826
3:5:3,0,-1,101175,98825
5:2:4,1,1,101174,98826
2:4:6,1,1,101173,98827
3:3:6,0,-1,101174,98826
5:3:5,0,-1,101175,98825
5:4:2,1,1,101174,98826
1:2:3,1,1,101173,98827
4:4:3,0,-1,101174,98826
1:5:4,0,-1,101175,98825
1:6:6,0,-1,101176,98824
3:1:6,0,-1,101177,98823
1:2:5,1,1,101176,98824
5:4:2,1,1,101175,98825
2:1:3,1,1,101174,98826
4:5:5,0,-1,101175,98825
3:3:2,1,1,101174,98826
4:1:3,0,-1,101175,98825
5:1:2,1,1,101174,98826
2:1:3,1,1,101173,98827
5:4:1,0,-1,101174,98826
6:4:1,0,-1,101175,98825
3:6:1,0,-1,101176,98824
1:5:4,0,-1,101177,98823
5:1:2,1,1,101176,98824
3:3:2,1,1,101175,98825
2:6:5,1,1,101174,98826
3:4:3,0,-1,101175,98825
3:4:2,1,1,101174,98826
5:5:6,0,-1,101175,98825
5:4:3,0,-1,101176,98824
1:4:5,0,-1,101177,98823
5:4:1,0,-1,101178,98822
1:5:6,0,-1,101179,98821
2:3:4,1,1,101178,98822
4:4:5,0,-1,101179,98821
5:1:1,0,-1,101180,98820
6:1:1,0,-1,101181,98819
6:5:1,0,-1,101182,98818
6:2:6,1,1,101181,98819
2:2:6,2,2,101179,98821
4:5:1,0,-1,101180,98820
4:2:4,1,1,101179,98821
1:5:3,0,-1,101180,98820
6:1:3,0,-1,101181,98819
5:1:6,0,-1,101182,98818
3:6:1,0,-1,101183,98817
4:1:3,0,-1,101184,98816
4:5:1,0,-1,101185,98815
2:6:2,2,2,101183,98817
3:1:6,0,-1,101184,98816
1:3:4,0,-1,101185,98815
6:3:1,0,-1,101186,98814
2:2:4,2,2,101184,98816
3:6:3,0,-1,101185,98815
4:2:3,1,1,101184,98816
3:4:4,0,-1,101185,98815
1:1:3,0,-1,101186,98814
3:2:3,1,1,101185,98815
4:6:6,0,-1,101186,98814
5:2:3,1,1,101185,98815
5:1:5,0,-1,101186,98814
2:1:5,1,1,101185,98815
4:2:5,1,1,101184,98816
5:1:1,0,-1,101185,98815
2:4:1,1,1,101184,98816
6:5:6,0,-1,101185,98815
6:2:3,1,1,101184,98816
1:2:1,1,1,101183,98817
5:2:5,1,1,101182,98818
6:5:4,0,-1,101183,98817
5:6:2,1,1,101182,98818
3:4:6,0,-1,101183,98817
3:5:3,0,-1,101184,98816
4:1:6,0,-1,101185,98815
4:6:2,1,1,101184,98816
6:5:1,0,-1,101185,98815
4:3:4,0,-1,101186,98814
1:6:5,0,-1,101187,98813
1:1:6,0,-1,101188,98812
6:5:5,0,-1,101189,98811
3:1:3,0,-1,101190,98810
1:4:3,0,-1,101191,98809
6:4:4,0,-1,101192,98808
6:6:2,1,1,101191,98809
1:4:1,0,-1,101192,98808
2:2:3,2,2,101190,98810
1:5:3,0,-1,101191,98809
3:6:1,0,-1,101192,98808
3:4:6,0,-1,101193,98807
3:1:2,1,1,101192,98808
4:5:1,0,-1,101193,98807
5:6:1,0,-1,101194,98806
4:1:1,0,-1,101195,98805
5:6:1,0,-1,101196,98804
6:2:4,1,1,101195,98805
6:3:2,1,1,101194,98806
3:1:4,0,-1,101195,98805
3:1:4,0,-1,101196,98804
2:4:6,1,1,101195,98805
5:2:6,1,1,101194,98806
2:6:6,1,1,101193,98807
1:5:3,0,-1,101194,98806
3:4:3,0,-1,101195,98805
4:6:3,0,-1,101196,98804
2:2:4,2,2,101194,98806
5:4:6,0,-1,101195,98805
3:3:2,1,1,101194,98806
6:4:3,0,-1,101195,98805
1:3:6,0,-1,101196,98804
4:2:5,1,1,101195,98805
2:2:5,2,2,101193,98807
5:3:5,0,-1,101194,98806
5:3:6,0,-1,101195,98805
4:4:3,0,-1,101196,98804
6:6:3,0,-1,101197,98803
1:2:2,2,2,101195,98805
5:3:1,0,-1,101196,98804
1:3:6,0,-1,101197,98803
6:4:2,1,1,101196,98804
4:5:2,1,1,101195,98805
3:1:3,0,-1,101196,98804
6:1:4,0,-1,101197,98803
6:1:3,0,-1,101198,98802
6:5:2,1,1,101197,98803
6:2:1,1,1,101196,98804
2:3:4,1,1,101195,98805
4:6:3,0,-1,101196,98804
3:6:4,0,-1,101197,98803
1:2:2,2,2,101195,98805
5:6:5,0,-1,101196,98804
2:1:4,1,1,101195,98805
4:3:3,0,-1,101196,98804
4:1:1,0,-1,101197,98803
5:4:3,0,-1,101198,98802
3:3:2,1,1,101197,98803
6:1:5,0,-1,101198,98802
4:5:1,0,-1,101199,98801
6:1:3,0,-1,101200,98800
4:6:2,1,1,101199,98801
3:3:4,0,-1,101200,98800
6:1:3,0,-1,101201,98799
5:3:3,0,-1,101202,98798
5:6:5,0,-1,101203,98797
1:6:5,0,-1,101204,98796
3:3:3,0,-1,101205,98795
5:5:1,0,-1,101206,98794
3:5:4,0,-1,101207,98793
3:4:1,0,-1,101208,98792
3:6:3,0,-1,101209,98791
1:2:3,1,1,101208,98792
2:3:6,1,1,101207,98793
6:2:5,1,1,101206,98794
2:6:5,1,1,101205,98795
4:6:5,0,-1,101206,98794
5:2:6,1,1,101205,98795
2:2:1,2,2,101203,98797
2:5:3,1,1,101202,98798
5:4:6,0,-1,101203,98797
2:3:6,1,1,101202,98798
1:4:4,0,-1,101203,98797
2:6:2,2,2,101201,98799
4:1:2,1,1,101200,98800
4:6:6,0,-1,101201,98799
2:6:6,1,1,101200,98800
2:5:6,1,1,101199,98801
5:2:2,2,2,101197,98803
1:6:4,0,-1,101198,98802
4:4:4,0,-1,101199,98801
2:2:5,2,2,101197,98803
2:6:2,2,2,101195,98805
4:5:4,0,-1,101196,98804
6:1:4,0,-1,101197,98803
2:6:5,1,1,101196,98804
2:3:4,1,1,101195,98805
1:5:5,0,-1,101196,98804
6:3:2,1,1,101195,98805
1:5:2,1,1,101194,98806
4:4:4,0,-1,101195,98805
3:6:3,0,-1,101196,98804
1:3:3,0,-1,101197,98803
4:1:3,0,-1,101198,98802
1:3:2,1,1,101197,98803
2:3:4,1,1,101196,98804
4:3:4,0,-1,101197,98803
3:3:2,1,1,101196,98804
5:6:2,1,1,101195,98805
5:2:1,1,1,101194,98806
3:5:6,0,-1,101195,98805
2:2:6,2,2,101193,98807
6:5:1,0,-1,101194,98806
4:4:6,0,-1,101195,98805
4:2:3,1,1,101194,98806
3:2:5,1,1,101193,98807
1:4:5,0,-1,101194,98806
5:3:4,0,-1,101195,98805
1:2:5,1,1,101194,98806
1:6:2,1,1,101193,98807
2:2:4,2,2,101191,98809
4:2:6,1,1,101190,98810
4:3:4,0,-1,101191,98809
4:5:5,0,-1,101192,98808
5:5:6,0,-1,101193,98807
1:6:4,0,-1,101194,98806
2:6:1,1,1,101193,98807
4:5:3,0,-1,101194,98806
6:4:1,0,-1,101195,98805
3:3:4,0,-1,101196,98804
4:2:4,1,1,101195,98805
4:3:6,0,-1,101196,98804
1:6:1,0,-1,101197,98803
2:4:3,1,1,101196,98804
5:3:1,0,-1,101197,98803
5:6:5,0,-1,101198,98802
5:6:2,1,1,101197,98803
5:4:2,1,1,101196,98804
3:4:4,0,-1,101197,98803
4:4:1,0,-1,101198,98802
4:3:1,0,-1,101199,98801
5:3:2,1,1,101198,98802
3:6:6,0,-1,101199,98801
4:5:1,0,-1,101200,98800
1:2:1,1,1,101199,98801
4:6:4,0,-1,101200,98800
1:5:6,0,-1,101201,98799
5:1:6,0,-1,101202,98798
1:2:3,1,1,101201,98799
4:1:5,0,-1,101202,98798
4:3:2,1,1,101201,98799
3:4:4,0,-1,101202,98798
5:6:4,0,-1,101203,98797
4:5:1,0,-1,101204,98796
1:4:6,0,-1,101205,98795
5:1:3,0,-1,101206,98794
5:4:4,0,-1,101207,98793
1:4:5,0,-1,101208,98792
5:6:6,0,-1,101209,98791
5:1:4,0,-1,101210,98790
5:2:1,1,1,101209,98791
6:6:6,0,-1,101210,98790
5:3:5,0,-1,101211,98789
2:5:3,1,1,101210,98790
5:2:4,1,1,101209,98791
1:5:1,0,-1,101210,98790
1:4:6,0,-1,101211,98789
2:5:4,1,1,101210,98790
2:6:4,1,1,101209,98791
1:6:3,0,-1,101210,98790
5:4:5,0,-1,101211,98789
3:4:1,0,-1,101212,98788
3:6:6,0,-1,101213,98787
5:3:6,0,-1,101214,98786
6:6:6,0,-1,101215,98785
5:1:5,0,-1,101216,98784
5:4:1,0,-1,101217,98783
5:2:2,2,2,101215,98785
4:4:6,0,-1,101216,98784
1:6:2,1,1,101215,98785
1:5:1,0,-1,101216,98784
3:1:5,0,-1,101217,98783
4:5:1,0,-1,101218,98782
6:2:2,2,2,101216,98784
3:2:3,1,1,101215,98785
3:1:5,0,-1,101216,98784
6:5:5,0,-1,101217,98783
6:5:4,0,-1,101218,98782
4:4:4,0,-1,101219,98781
1:2:5,1,1,101218,98782
4:6:5,0,-1,101219,98781
2:1:3,1,1,101218,98782
6:3:3,0,-1,101219,98781
5:4:3,0,-1,101220,98780
3:5:1,0,-1,101221,98779
3:4:2,1,1,101220,98780
3:3:5,0,-1,101221,98779
3:4:3,0,-1,101222,98778
6:4:6,0,-1,101223,98777
2:4:3,1,1,101222,98778
3:3:1,0,-1,101223,98777
4:2:4,1,1,101222,98778
4:3:2,1,1,101221,98779
4:3:3,0,-1,101222,98778
5:3:5,0,-1,101223,98777
1:4:1,0,-1,101224,98776
3:6:4,0,-1,101225,98775
6:4:2,1,1,101224,98776
1:1:1,0,-1,101225,98775
6:5:5,0,-1,101226,98774
2:4:6,1,1,101225,98775
2:4:5,1,1,101224,98776
5:5:3,0,-1,101225,98775
1:1:5,0,-1,101226,98774
1:6:5,0,-1,101227,98773
5:1:1,0,-1,101228,98772
1:4:5,0,-1,101229,98771
3:6:6,0,-1,101230,98770
3:2:6,1,1,101229,98771
2:4:4,1,1,101228,98772
5:4:2,1,1,101227,98773
4:6:3,0,-1,101228,98772
2:6:1,1,1,101227,98773
1:1:5,0,-1,101228,98772
4:3:6,0,-1,101229,98771
1:5:2,1,1,101228,98772
2:2:3,2,2,101226,98774
2:1:3,1,1,101225,98775
4:1:4,0,-1,101226,98774
4:5:5,0,-1,101227,98773
4:6:1,0,-1,101228,98772
1:2:6,1,1,101227,98773
6:4:2,1,1,101226,98774
6:4:5,0,-1,101227,98773
1:1:2,1,1,101226,98774
1:1:6,0,-1,101227,98773
5:3:6,0,-1,101228,98772
4:4:3,0,-1,101229,98771
1:6:4,0,-1,101230,98770
6:5:1,0,-1,101231,98769
2:5:1,1,1,101230,98770
5:4:5,0,-1,101231,98769
6:3:6,0,-1,101232,98768
4:2:6,1,1,101231,98769
5:4:1,0,-1,101232,98768
2:5:2,2,2,101230,98770
1:6:1,0,-1,101231,98769
2:5:6,1,1,101230,98770
2:2:3,2,2,101228,98772
1:2:6,1,1,101227,98773
5:5:1,0,-1,101228,98772
6:2:2,2,2,101226,98774
4:6:6,0,-1,101227,98773
6:3:3,0,-1,101228,98772
6:2:2,2,2,101226,98774
6:6:5,0,-1,101227,98773
3:2:4,1,1,101226,98774
1:2:2,2,2,101224,98776
4:3:2,1,1,101223,98777
5:6:5,0,-1,101224,98776
2:1:4,1,1,101223,98777
5:4:4,0,-1,101224,98776
2:3:2,2,2,101222,98778
2:2:5,2,2,101220,98780
1:3:4,0,-1,101221,98779
4:5:4,0,-1,101222,98778
2:2:6,2,2,101220,98780
1:3:3,0,-1,101221,98779
1:6:6,0,-1,101222,98778
6:3:3,0,-1,101223,98777
5:1:1,0,-1,101224,98776
6:4:6,0,-1,101225,98775
6:1:5,0,-1,101226,98774
6:4:5,0,-1,101227,98773
1:1:6,0,-1,101228,98772
2:2:5,2,2,101226,98774
3:5:2,1,1,101225,98775
6:5:6,0,-1,101226,98774
4:6:2,1,1,101225,98775
3:1:1,0,-1,101226,98774
6:4:2,1,1,101225,98775
6:3:3,0,-1,101226,98774
6:5:3,0,-1,101227,98773
6:1:4,0,-1,101228,98772
4:3:2,1,1,101227,98773
1:1:5,0,-1,101228,98772
5:6:3,0,-1,101229,98771
1:1:1,0,-1,101230,98770
3:1:4,0,-1,101231,98769
4:1:5,0,-1,101232,98768
4:2:1,1,1,101231,98769
5:4:1,0,-1,101232,98768
6:3:4,0,-1,101233,98767
3:6:1,0,-1,101234,98766
4:2:5,1,1,101233,98767
3:5:4,0,-1,101234,98766
5:4:1,0,-1,101235,98765
6:2:4,1,1,101234,98766
1:2:1,1,1,101233,98767
3:6:3,0,-1,101234,98766
6:6:4,0,-1,101235,98765
1:3:1,0,-1,101236,98764
3:4:5,0,-1,101237,98763
6:3:3,0,-1,101238,98762
3:2:2,2,2,101236,98764
3:2:3,1,1,101235,98765
3:6:1,0,-1,101236,98764
6:1:2,1,1,101235,98765
1:6:1,0,-1,101236,98764
1:5:6,0,-1,101237,98763
4:5:4,0,-1,101238,98762
3:3:3,0,-1,101239,98761
2:5:3,1,1,101238,98762
5:3:2,1,1,101237,98763
6:4:6,0,-1,101238,98762
3:6:5,0,-1,101239,98761
5:5:4,0,-1,101240,98760
4:1:5,0,-1,101241,98759
5:4:1,0,-1,101242,98758
6:3:3,0,-1,101243,98757
3:5:1,0,-1,101244,98756
5:6:1,0,-1,101245,98755
1:3:4,0,-1,101246,98754
1:3:3,0,-1,101247,98753
2:1:2,2,2,101245,98755
2:5:6,1,1,101244,98756
2:4:4,1,1,101243,98757
6:2:3,1,1,101242,98758
3:2:5,1,1,101241,98759
1:1:5,0,-1,101242,98758
6:2:5,1,1,101241,98759
1:6:2,1,1,101240,98760
1:2:3,1,1,101239,98761
5:3:6,0,-1,101240,98760
4:3:6,0,-1,101241,98759
6:6:1,0,-1,101242,98758
2:3:3,1,1,101241,98759
6:3:1,0,-1,101242,98758
1:4:4,0,-1,101243,98757
6:4:3,0,-1,101244,98756
3:5:3,0,-1,101245,98755
2:2:4,2,2,101243,98757
4:5:4,0,-1,101244,98756
1:6:3,0,-1,101245,98755
2:2:4,2,2,101243,98757
5:2:2,2,2,101241,98759
4:1:6,0,-1,101242,98758
6:4:6,0,-1,101243,98757
2:6:2,2,2,101241,98759
5:4:2,1,1,101240,98760
4:4:1,0,-1,101241,98759
4:6:3,0,-1,101242,98758
3:1:6,0,-1,101243,98757
3:2:1,1,1,101242,98758
6:2:4,1,1,101241,98759
2:2:4,2,2,101239,98761
2:5:5,1,1,101238,98762
5:6:6,0,-1,101239,98761
1:2:2,2,2,101237,98763
1:4:4,0,-1,101238,98762
6:1:4,0,-1,101239,98761
6:3:3,0,-1,101240,98760
3:5:4,0,-1,101241,98759
2:2:4,2,2,101239,98761
1:6:4,0,-1,101240,98760
2:3:6,1,1,101239,98761
3:3:2,1,1,101238,98762
1:4:4,0,-1,101239,98761
6:2:3,1,1,101238,98762
1:1:3,0,-1,101239,98761
2:3:4,1,1,101238,98762
4:5:6,0,-1,101239,98761
5:3:1,0,-1,101240,98760
6:3:6,0,-1,101241,98759
1:2:3,1,1,101240,98760
6:5:5,0,-1,101241,98759
3:6:6,0,-1,101242,98758
3:4:2,1,1,101241,98759
1:6:1,0,-1,101242,98758
3:3:5,0,-1,101243,98757
1:4:5,0,-1,101244,98756
1:6:5,0,-1,101245,98755
5:4:5,0,-1,101246,98754
3:5:6,0,-1,101247,98753
4:1:5,0,-1,101248,98752
3:5:5,0,-1,101249,98751
3:4:1,0,-1,101250,98750
2:4:3,1,1,101249,98751
3:1:6,0,-1,101250,98750
1:1:3,0,-1,101251,98749
1:6:5,0,-1,101252,98748
6:5:5,0,-1,101253,98747
2:2:2,3,3,101250,98750
2:6:1,1,1,101249,98751
1:1:4,0,-1,101250,98750
5:3:6,0,-1,101251,98749
1:5:6,0,-1,101252,98748
6:3:3,0,-1,101253,98747
3:4:3,0,-1,101254,98746
4:3:1,0,-1,101255,98745
5:4:5,0,-1,101256,98744
1:3:6,0,-1,101257,98743
3:1:3,0,-1,101258,98742
2:2:6,2,2,101256,98744
5:1:5,0,-1,101257,98743
2:5:5,1,1,101256,98744
5:1:3,0,-1,101257,98743
3:3:5,0,-1,101258,98742
2:4:1,1,1,101257,98743
5:1:1,0,-1,101258,98742
4:6:3,0,-1,101259,98741
1:4:6,0,-1,101260,98740
5:3:3,0,-1,101261,98739
2:3:3,1,1,101260,98740
1:2:5,1,1,101259,98741
5:4:4,0,-1,101260,98740
5:2:5,1,1,101259,98741
4:4:6,0,-1,101260,98740
5:1:1,0,-1,101261,98739
5:3:4,0,-1,101262,98738
3:1:1,0,-1,101263,98737
6:5:4,0,-1,101264,98736
2:2:6,2,2,101262,98738
5:1:6,0,-1,101263,98737
1:5:5,0,-1,101264,98736
5:5:4,0,-1,101265,98735
1:6:4,0,-1,101266,98734
6:6:5,0,-1,101267,98733
5:3:2,1,1,101266,98734
1:2:6,1,1,101265,98735
3:4:1,0,-1,101266,98734
6:6:6,0,-1,101267,98733
1:1:6,0,-1,101268,98732
2:3:5,1,1,101267,98733
4:1:1,0,-1,101268,98732
1:1:5,0,-1,101269,98731
5:1:5,0,-1,101270,98730
1:6:2,1,1,101269,98731
6:4:3,0,-1,101270,98730
6:5:3,0,-1,101271,98729
1:1:1,0,-1,101272,98728
5:3:6,0,-1,101273,98727
1:2:6,1,1,101272,98728
3:1:5,0,-1,101273,98727
1:1:3,0,-1,101274,98726
1:1:3,0,-1,101275,98725
6:3:3,0,-1,101276,98724
1:2:5,1,1,101275,98725
1:3:6,0,-1,101276,98724
4:2:6,1,1,101275,98725
1:5:1,0,-1,101276,98724
6:4:3,0,-1,101277,98723
4:3:3,0,-1,101278,98722
4:2:6,1,1,101277,98723
6:2:1,1,1,101276,98724
1:4:4,0,-1,101277,98723
1:1:5,0,-1,101278,98722
2:2:6,2,2,101276,98724
2:4:4,1,1,101275,98725
6:1:2,1,1,101274,98726
2:6:5,1,1,101273,98727
3:6:6,0,-1,101274,98726
1:4:2,1,1,101273,98727
3:1:6,0,-1,101274,98726
2:5:3,1,1,101273,98727
4:4:4,0,-1,101274,98726
4:2:1,1,1,101273,98727
3:4:1,0,-1,101274,98726
3:4:1,0,-1,101275,98725
4:4:5,0,-1,101276,98724
2:5:6,1,1,101275,98725
3:6:6,0,-1,101276,98724
5:5:1,0,-1,101277,98723
2:4:2,2,2,101275,98725
2:5:1,1,1,101274,98726
1:1:6,0,-1,101275,98725
3:4:3,0,-1,101276,98724
5:5:4,0,-1,101277,98723
3:6:5,0,-1,101278,98722
5:5:2,1,1,101277,98723
4:5:1,0,-1,101278,98722
6:3:4,0,-1,101279,98721
4:1:1,0,-1,101280,98720
2:2:2,3,3,101277,98723
4:4:4,0,-1,101278,98722
5:1:6,0,-1,101279,98721
5:3:1,0,-1,101280,98720
6:3:3,0,-1,101281,98719
5:3:6,0,-1,101282,98718
4:5:2,1,1,101281,98719
1:2:3,1,1,101280,98720
4:1:6,0,-1,101281,98719
3:1:1,0,-1,101282,98718
6:2:6,1,1,101281,98719
4:5:6,0,-1,101282,98718
6:3:5,0,-1,101283,98717
5:1:4,0,-1,101284,98716
4:3:3,0,-1,101285,98715
6:3:4,0,-1,101286,98714
4:4:3,0,-1,101287,98713
6:6:2,1,1,101286,98714
3:4:3,0,-1,101287,98713
2:6:5,1,1,101286,98714
2:2:5,2,2,101284,98716
6:5:3,0,-1,101285,98715
4:1:1,0,-1,101286,98714
6:2:4,1,1,101285,98715
4:1:5,0,-1,101286,98714
6:2:2,2,2,101284,98716
4:2:4,1,1,101283,98717
3:3:6,0,-1,101284,98716
1:5:3,0,-1,101285,98715
6:6:1,0,-1,101286,98714
6:2:2,2,2,101284,98716
4:2:1,1,1,101283,98717
1:2:6,1,1,101282,98718
1:4:3,0,-1,101283,98717
2:6:5,1,1,101282,98718
3:3:4,0,-1,101283,98717
3:6:3,0,-1,101284,98716
4:6:2,1,1,101283,98717
4:4:2,1,1,101282,98718
4:5:6,0,-1,101283,98717
1:5:5,0,-1,101284,98716
5:2:1,1,1,101283,98717
2:3:6,1,1,101282,98718
2:2:1,2,2,101280,98720
2:6:5,1,1,101279,98721
2:3:1,1,1,101278,98722
1:6:3,0,-1,101279,98721
1:6:1,0,-1,101280,98720
4:6:4,0,-1,101281,98719
6:5:3,0,-1,101282,98718
6:1:1,0,-1,101283,98717
6:6:2,1,1,101282,98718
5:3:5,0,-1,101283,98717
2:3:3,1,1,101282,98718
3:5:1,0,-1,101283,98717
4:2:3,1,1,101282,98718
1:5:4,0,-1,101283,98717
2:5:1,1,1,101282,98718
2:3:6,1,1,101281,98719
4:2:6,1,1,101280,98720
2:4:3,1,1,101279,98721
3:3:2,1,1,101278,98722
5:3:2,1,1,101277,98723
6:2:3,1,1,101276,98724
4:1:6,0,-1,101277,98723
6:4:6,0,-1,101278,98722
2:3:6,1,1,101277,98723
4:2:4,1,1,101276,98724
1:3:2,1,1,101275,98725
2:5:1,1,1,101274,98726
6:5:1,0,-1,101275,98725
3:4:4,0,-1,101276,98724
6:4:1,0,-1,101277,98723
6:5:5,0,-1,101278,98722
6:5:3,0,-1,101279,98721
1:1:2,1,1,101278,98722
6:4:2,1,1,101277,98723
4:1:2,1,1,101276,98724
4:6:3,0,-1,101277,98723
2:3:5,1,1,101276,98724
3:4:4,0,-1,101277,98723
1:2:1,1,1,101276,98724
4:5:5,0,-1,101277,98723
1:6:5,0,-1,101278,98722
3:2:2,2,2,101276,98724
2:1:3,1,1,101275,98725
5:2:2,2,2,101273,98727
1:6:2,1,1,101272,98728
5:5:5,0,-1,101273,98727
3:3:6,0,-1,101274,98726
2:4:1,1,1,101273,98727
6:6:5,0,-1,101274,98726
3:3:1,0,-1,101275,98725
1:4:2,1,1,101274,98726
1:5:4,0,-1,101275,98725
1:5:5,0,-1,101276,98724
4:5:3,0,-1,101277,98723
6:3:3,0,-1,101278,98722
4:2:2,2,2,101276,98724
3:5:1,0,-1,101277,98723
3:6:2,1,1,101276,98724
4:2:1,1,1,101275,98725
4:2:3,1,1,101274,98726
4:1:6,0,-1,101275,98725
6:5:4,0,-1,101276,98724
3:2:2,2,2,101274,98726
2:6:1,1,1,101273,98727
1:2:4,1,1,101272,98728
1:5:4,0,-1,101273,98727
3:3:5,0,-1,101274,98726
2:3:4,1,1,101273,98727
2:4:2,2,2,101271,98729
2:1:5,1,1,101270,98730
5:2:5,1,1,101269,98731
3:2:2,2,2,101267,98733
6:5:4,0,-1,101268,98732
2:6:1,1,1,101267,98733
2:4:1,1,1,101266,98734
1:4:1,0,-1,101267,98733
3:4:6,0,-1,101268,98732
6:4:5,0,-1,101269,98731
6:2:4,1,1,101268,98732
2:4:2,2,2,101266,98734
5:3:2,1,1,101265,98735
4:4:5,0,-1,101266,98734
4:5:4,0,-1,101267,98733
3:6:4,0,-1,101268,98732
4:2:2,2,2,101266,98734
1:4:5,0,-1,101267,98733
4:5:3,0,-1,101268,98732
5:3:3,0,-1,101269,98731
6:3:5,0,-1,101270,98730
2:3:4,1,1,101269,98731
1:2:3,1,1,101268,98732
6:6:2,1,1,101267,98733
4:1:6,0,-1,101268,98732
6:2:1,1,1,101267,98733
1:5:3,0,-1,101268,98732
4:4:3,0,-1,101269,98731
5:5:3,0,-1,101270,98730
1:2:4,1,1,101269,98731
2:1:1,1,1,101268,98732
4:3:1,0,-1,101269,98731
4:3:2,1,1,101268,98732
1:6:4,0,-1,101269,98731
6:3:6,0,-1,101270,98730
1:1:2,1,1,101269,98731
2:6:3,1,1,101268,98732
6:2:2,2,2,101266,98734
5:5:6,0,-1,101267,98733
5:6:5,0,-1,101268,98732
4:3:6,0,-1,101269,98731
5:6:2,1,1,101268,98732
1:5:1,0,-1,101269,98731
5:1:2,1,1,101268,98732
4:6:6,0,-1,101269,98731
5:1:3,0,-1,101270,98730
5:1:6,0,-1,101271,98729
3:3:2,1,1,101270,98730
3:6:1,0,-1,101271,98729
3:4:1,0,-1,101272,98728
2:6:2,2,2,101270,98730
2:3:3,1,1,101269,98731
3:5:3,0,-1,101270,98730
1:2:6,1,1,101269,98731
3:2:2,2,2,101267,98733
2:5:4,1,1,101266,98734
2:4:3,1,1,101265,98735
2:4:6,1,1,101264,98736
1:4:6,0,-1,101265,98735
4:5:6,0,-1,101266,98734
1:5:3,0,-1,101267,98733
6:5:4,0,-1,101268,98732
5:5:4,0,-1,101269,98731
2:3:4,1,1,101268,98732
4:1:5,0,-1,101269,98731
6:4:2,1,1,101268,98732
3:5:6,0,-1,101269,98731
5:5:2,1,1,101268,98732
4:1:5,0,-1,101269,98731
6:5:3,0,-1,101270,98730
5:1:5,0,-1,101271,98729
6:6:4,0,-1,101272,98728
2:2:6,2,2,101270,98730
1:4:2,1,1,101269,98731
4:3:1,0,-1,101270,98730
1:5:3,0,-1,101271,98729
5:4:5,0,-1,101272,98728
4:2:4,1,1,101271,98729
2:4:5,1,1,101270,98730
4:2:4,1,1,101269,98731
6:3:6,0,-1,101270,98730
3:3:6,0,-1,101271,98729
5:3:6,0,-1,101272,98728
4:4:1,0,-1,101273,98727
3:5:2,1,1,101272,98728
2:2:3,2,2,101270,98730
6:3:6,0,-1,101271,98729
2:5:1,1,1,101270,98730
4:5:4,0,-1,101271,98729
3:1:4,0,-1,101272,98728
4:4:4,0,-1,101273,98727
5:5:4,0,-1,101274,98726
5:1:2,1,1,101273,98727
6:1:6,0,-1,101274,98726
5:5:3,0,-1,101275,98725
4:1:3,0,-1,101276,98724
2:3:6,1,1,101275,98725
6:3:2,1,1,101274,98726
4:4:5,0,-1,101275,98725
1:5:1,0,-1,101276,98724
2:1:5,1,1,101275,98725
3:4:6,0,-1,101276,98724
2:2:1,2,2,101274,98726
4:3:2,1,1,101273,98727
5:2:4,1,1,101272,98728
6:5:4,0,-1,101273,98727
2:1:1,1,1,101272,98728
1:1:1,0,-1,101273,98727
1:3:4,0,-1,101274,98726
4:1:2,1,1,101273,98727
4:1:5,0,-1,101274,98726
6:1:1,0,-1,101275,98725
6:6:3,0,-1,101276,98724
3:6:5,0,-1,101277,98723
4:3:1,0,-1,101278,98722
5:4:5,0,-1,101279,98721
6:2:3,1,1,101278,98722
1:1:4,0,-1,101279,98721
1:5:1,0,-1,101280,98720
2:3:4,1,1,101279,98721
2:5:6,1,1,101278,98722
3:6:2,1,1,101277,98723
5:2:6,1,1,101276,98724
4:4:5,0,-1,101277,98723
3:4:1,0,-1,101278,98722
1:2:2,2,2,101276,98724
4:3:5,0,-1,101277,98723
4:2:4,1,1,101276,98724
5:6:4,0,-1,101277,98723
6:2:5,1,1,101276,98724
3:5:1,0,-1,101277,98723
5:3:6,0,-1,101278,98722
3:4:3,0,-1,101279,98721
1:5:4,0,-1,101280,98720
1:6:1,0,-1,101281,98719
5:4:3,0,-1,101282,98718
2:1:1,1,1,101281,98719
1:6:5,0,-1,101282,98718
4:4:4,0,-1,101283,98717
2:4:6,1,1,101282,98718
2:5:2,2,2,101280,98720
5:6:3,0,-1,101281,98719
1:5:5,0,-1,101282,98718
4:1:2,1,1,101281,98719
3:5:1,0,-1,101282,98718
2:2:4,2,2,101280,98720
5:5:6,0,-1,101281,98719
1:3:3,0,-1,101282,98718
4:6:1,0,-1,101283,98717
1:4:4,0,-1,101284,98716
3:3:3,0,-1,101285,98715
5:3:1,0,-1,101286,98714
5:2:2,2,2,101284,98716
5:2:1,1,1,101283,98717
2:3:6,1,1,101282,98718
2:5:5,1,1,101281,98719
5:3:1,0,-1,101282,98718
1:3:2,1,1,101281,98719
3:5:2,1,1,101280,98720
6:4:1,0,-1,101281,98719
2:2:4,2,2,101279,98721
1:6:2,1,1,101278,98722
2:3:1,1,1,101277,98723
2:2:4,2,2,101275,98725
1:4:1,0,-1,101276,98724
6:5:3,0,-1,101277,98723
2:4:3,1,1,101276,98724
4:1:5,0,-1,101277,98723
5:4:3,0,-1,101278,98722
5:1:4,0,-1,101279,98721
5:1:2,1,1,101278,98722
4:2:5,1,1,101277,98723
4:2:5,1,1,101276,98724
5:6:4,0,-1,101277,98723
4:3:2,1,1,101276,98724
4:4:6,0,-1,101277,98723
1:1:1,0,-1,101278,98722
2:1:4,1,1,101277,98723
4:4:2,1,1,101276,98724
5:1:1,0,-1,101277,98723
2:4:3,1,1,101276,98724
5:6:6,0,-1,101277,98723
1:2:3,1,1,101276,98724
3:2:3,1,1,101275,98725
1:6:1,0,-1,101276,98724
1:1:4,0,-1,101277,98723
4:1:3,0,-1,101278,98722
5:5:5,0,-1,101279,98721
1:6:1,0,-1,101280,98720
5:4:1,0,-1,101281,98719
5:4:4,0,-1,101282,98718
3:2:2,2,2,101280,98720
4:4:2,1,1,101279,98721
4:1:6,0,-1,101280,98720
1:5:6,0,-1,101281,98719
4:1:5,0,-1,101282,98718
3:6:5,0,-1,101283,98717
4:4:4,0,-1,101284,98716
5:2:5,1,1,101283,98717
4:5:5,0,-1,101284,98716
5:5:4,0,-1,101285,98715
5:4:1,0,-1,101286,98714
4:2:5,1,1,101285,98715
3:5:1,0,-1,101286,98714
6:6:3,0,-1,101287,98713
6:6:5,0,-1,101288,98712
5:2:2,2,2,101286,98714
4:4:1,0,-1,101287,98713
6:4:1,0,-1,101288,98712
4:3:6,0,-1,101289,98711
3:6:1,0,-1,101290,98710
2:4:6,1,1,101289,98711
2:6:2,2,2,101287,98713
1:2:6,1,1,101286,98714
5:1:2,1,1,101285,98715
4:3:5,0,-1,101286,98714
4:5:6,0,-1,101287,98713
6:2:2,2,2,101285,98715
1:4:3,0,-1,101286,98714
5:3:4,0,-1,101287,98713
6:3:5,0,-1,101288,98712
2:1:5,1,1,101287,98713
6:2:2,2,2,101285,98715
2:4:1,1,1,101284,98716
2:5:2,2,2,101282,98718
1:2:5,1,1,101281,98719
1:5:5,0,-1,101282,98718
5:3:2,1,1,101281,98719
2:5:2,2,2,101279,98721
5:6:3,0,-1,101280,98720
4:5:3,0,-1,101281,98719
5:3:2,1,1,101280,98720
5:2:4,1,1,101279,98721
5:2:6,1,1,101278,98722
4:2:6,1,1,101277,98723
5:3:5,0,-1,101278,98722
1:3:1,0,-1,101279,98721
5:6:4,0,-1,101280,98720
5:1:6,0,-1,101281,98719
4:6:6,0,-1,101282,98718
4:2:4,1,1,101281,98719
5:5:2,1,1,101280,98720
2:4:5,1,1,101279,98721
6:3:4,0,-1,101280,98720
3:3:2,1,1,101279,98721
4:2:6,1,1,101278,98722
2:5:1,1,1,101277,98723
2:4:3,1,1,101276,98724
2:3:5,1,1,101275,98725
1:5:1,0,-1,101276,98724
5:2:5,1,1,101275,98725
4:3:2,1,1,101274,98726
5:2:5,1,1,101273,98727
1:2:3,1,1,101272,98728
5:5:4,0,-1,101273,98727
6:3:2,1,1,101272,98728
2:3:4,1,1,101271,98729
3:6:5,0,-1,101272,98728
5:3:6,0,-1,101273,98727
6:5:4,0,-1,101274,98726
1:3:1,0,-1,101275,98725
2:5:4,1,1,101274,98726
5:6:1,0,-1,101275,98725
4:5:2,1,1,101274,98726
2:2:5,2,2,101272,98728
1:4:5,0,-1,101273,98727
6:4:3,0,-1,101274,98726
1:4:2,1,1,101273,98727
6:3:3,0,-1,101274,98726
1:6:6,0,-1,101275,98725
2:4:5,1,1,101274,98726
1:3:2,1,1,101273,98727
4:4:1,0,-1,101274,98726
1:6:3,0,-1,101275,98725
2:1:1,1,1,101274,98726
3:1:2,1,1,101273,98727
5:1:5,0,-1,101274,98726
1:4:2,1,1,101273,98727
4:6:5,0,-1,101274,98726
3:1:6,0,-1,101275,98725
3:2:6,1,1,101274,98726
5:4:2,1,1,101273,98727
6:3:4,0,-1,101274,98726
3:6:1,0,-1,101275,98725
6:3:6,0,-1,101276,98724
1:3:2,1,1,101275,98725
6:4:6,0,-1,101276,98724
5:4:1,0,-1,101277,98723
6:5:2,1,1,101276,98724
1:3:6,0,-1,101277,98723
6:2:2,2,2,101275,98725
4:5:4,0,-1,101276,98724
5:5:5,0,-1,101277,98723
4:4:2,1,1,101276,98724
4:1:4,0,-1,101277,98723
2:4:4,1,1,101276,98724
2:1:4,1,1,101275,98725
5:4:5,0,-1,101276,98724
6:1:3,0,-1,101277,98723
5:1:2,1,1,101276,98724
5:2:5,1,1,101275,98725
3:5:5,0,-1,101276,98724
6:2:2,2,2,101274,98726
1:4:4,0,-1,101275,98725
2:5:1,1,1,101274,98726
1:6:6,0,-1,101275,98725
3:1:3,0,-1,101276,98724
2:5:4,1,1,101275,98725
6:2:5,1,1,101274,98726
1:3:6,0,-1,101275,98725
3:4:4,0,-1,101276,98724
4:2:6,1,1,101275,98725
2:6:5,1,1,101274,98726
6:1:6,0,-1,101275,98725
5:3:2,1,1,101274,98726
6:2:6,1,1,101273,98727
3:1:6,0,-1,101274,98726
4:4:2,1,1,101273,98727
2:6:1,1,1,101272,98728
6:1:3,0,-1,101273,98727
5:2:3,1,1,101272,98728
1:4:6,0,-1,101273,98727
1:4:4,0,-1,101274,98726
1:2:1,1,1,101273,98727
1:6:2,1,1,101272,98728
2:2:1,2,2,101270,98730
5:2:4,1,1,101269,98731
4:4:6,0,-1,101270,98730
4:1:1,0,-1,101271,98729
3:1:3,0,-1,101272,98728
1:5:2,1,1,101271,98729
5:4:5,0,-1,101272,98728
1:6:4,0,-1,101273,98727
3:4:5,0,-1,101274,98726
3:6:4,0,-1,101275,98725
3:1:4,0,-1,101276,98724
1:4:3,0,-1,101277,98723
5:2:2,2,2,101275,98725
4:6:1,0,-1,101276,98724
2:5:2,2,2,101274,98726
3:5:3,0,-1,101275,98725
5:2:3,1,1,101274,98726
6:5:4,0,-1,101275,98725
1:5:6,0,-1,101276,98724
2:3:5,1,1,101275,98725
1:2:1,1,1,101274,98726
6:6:1,0,-1,101275,98725
2:6:5,1,1,101274,98726
6:4:6,0,-1,101275,98725
6:1:5,0,-1,101276,98724
4:6:6,0,-1,101277,98723
4:1:4,0,-1,101278,98722
5:3:6,0,-1,101279,98721
3:1:1,0,-1,101280,98720
6:1:6,0,-1,101281,98719
3:5:6,0,-1,101282,98718
5:5:5,0,-1,101283,98717
5:2:3,1,1,101282,98718
5:6:3,0,-1,101283,98717
4:6:2,1,1,101282,98718
3:5:2,1,1,101281,98719
4:3:4,0,-1,101282,98718
1:2:6,1,1,101281,98719
5:2:6,1,1,101280,98720
6:6:1,0,-1,101281,98719
3:2:3,1,1,101280,98720
2:1:2,2,2,101278,98722
3:5:6,0,-1,101279,98721
1:5:5,0,-1,101280,98720
4:2:6,1,1,101279,98721
3:4:2,1,1,101278,98722
1:4:2,1,1,101277,98723
5:6:2,1,1,101276,98724
1:2:6,1,1,101275,98725
3:1:2,1,1,101274,98726
3:5:3,0,-1,101275,98725
1:4:3,0,-1,101276,98724
6:1:4,0,-1,101277,98723
2:4:5,1,1,101276,98724
4:3:3,0,-1,101277,98723
2:1:4,1,1,101276,98724
3:3:1,0,-1,101277,98723
6:2:6,1,1,101276,98724
2:5:1,1,1,101275,98725
5:3:6,0,-1,101276,98724
5:2:1,1,1,101275,98725
4:1:3,0,-1,101276,98724
2:1:1,1,1,101275,98725
5:4:2,1,1,101274,98726
2:2:3,2,2,101272,98728
4:5:4,0,-1,101273,98727
1:6:2,1,1,101272,98728
3:3:1,0,-1,101273,98727
6:3:6,0,-1,101274,98726
5:2:4,1,1,101273,98727
4:5:4,0,-1,101274,98726
5:3:3,0,-1,101275,98725
2:1:3,1,1,101274,98726
5:4:6,0,-1,101275,98725
3:2:1,1,1,101274,98726
1:4:2,1,1,101273,98727
2:1:2,2,2,101271,98729
2:6:6,1,1,101270,98730
1:3:3,0,-1,101271,98729
2:4:5,1,1,101270,98730
6:2:5,1,1,101269,98731
1:6:1,0,-1,101270,98730
3:2:1,1,1,101269,98731
5:1:1,0,-1,101270,98730
2:1:2,2,2,101268,98732
6:4:5,0,-1,101269,98731
6:1:3,0,-1,101270,98730
1:2:4,1,1,101269,98731
4:6:1,0,-1,101270,98730
6:5:4,0,-1,101271,98729
2:4:4,1,1,101270,98730
3:2:2,2,2,101268,98732
5:6:3,0,-1,101269,98731
4:1:4,0,-1,101270,98730
3:1:6,0,-1,101271,98729
4:3:1,0,-1,101272,98728
3:4:6,0,-1,101273,98727
6:1:3,0,-1,101274,98726
2:4:5,1,1,101273,98727
3:6:2,1,1,101272,98728
5:2:6,1,1,101271,98729
6:4:1,0,-1,101272,98728
5:3:1,0,-1,101273,98727
4:3:3,0,-1,101274,98726
5:5:6,0,-1,101275,98725
5:5:5,0,-1,101276,98724
5:6:3,0,-1,101277,98723
2:5:4,1,1,101276,98724
5:1:5,0,-1,101277,98723
4:5:2,1,1,101276,98724
5:1:3,0,-1,101277,98723
1:5:5,0,-1,101278,98722
3:3:6,0,-1,101279,98721
3:5:1,0,-1,101280,98720
4:2:6,1,1,101279,98721
2:5:6,1,1,101278,98722
3:6:1,0,-1,101279,98721
3:5:5,0,-1,101280,98720
4:3:3,0,-1,101281,98719
4:5:1,0,-1,101282,98718
5:3:1,0,-1,101283,98717
4:6:5,0,-1,101284,98716
5:4:2,1,1,101283,98717
6:5:6,0,-1,101284,98716
6:4:1,0,-1,101285,98715
2:6:1,1,1,101284,98716
6:3:2,1,1,101283,98717
4:5:1,0,-1,101284,98716
6:6:3,0,-1,101285,98715
4:6:4,0,-1,101286,98714
2:1:1,1,1,101285,98715
3:5:1,0,-1,101286,98714
2:2:5,2,2,101284,98716
2:2:2,3,3,101281,98719
1:1:5,0,-1,101282,98718
6:6:1,0,-1,101283,98717
3:6:4,0,-1,101284,98716
6:4:5,0,-1,101285,98715
5:6:5,0,-1,101286,98714
1:6:3,0,-1,101287,98713
6:4:1,0,-1,101288,98712
3:5:2,1,1,101287,98713
4:3:2,1,1,101286,98714
5:5:1,0,-1,101287,98713
3:3:1,0,-1,101288,98712
1:2:4,1,1,101287,98713
3:1:4,0,-1,101288,98712
6:2:6,1,1,101287,98713
6:5:1,0,-1,101288,98712
1:4:1,0,-1,101289,98711
6:6:2,1,1,101288,98712
3:5:6,0,-1,101289,98711
4:1:4,0,-1,101290,98710
4:4:4,0,-1,101291,98709
6:3:4,0,-1,101292,98708
6:2:4,1,1,101291,98709
3:4:2,1,1,101290,98710
3:3:6,0,-1,101291,98709
2:3:1,1,1,101290,98710
5:2:6,1,1,101289,98711
4:2:5,1,1,101288,98712
5:3:5,0,-1,101289,98711
1:4:5,0,-1,101290,98710
5:4:6,0,-1,101291,98709
2:3:2,2,2,101289,98711
6:5:5,0,-1,101290,98710
6:6:4,0,-1,101291,98709
4:4:4,0,-1,101292,98708
1:3:6,0,-1,101293,98707
1:5:1,0,-1,101294,98706
3:4:6,0,-1,101295,98705
5:6:6,0,-1,101296,98704
5:6:4,0,-1,101297,98703
6:1:2,1,1,101296,98704
3:3:3,0,-1,101297,98703
6:2:3,1,1,101296,98704
6:6:1,0,-1,101297,98703
4:6:2,1,1,101296,98704
6:3:2,1,1,101295,98705
1:6:2,1,1,101294,98706
1:3:6,0,-1,101295,98705
1:1:4,0,-1,101296,98704
3:6:3,0,-1,101297,98703
2:4:5,1,1,101296,98704
2:1:5,1,1,101295,98705
2:3:1,1,1,101294,98706
5:4:5,0,-1,101295,98705
6:4:1,0,-1,101296,98704
1:3:2,1,1,101295,98705
3:4:3,0,-1,101296,98704
3:5:1,0,-1,101297,98703
3:2:4,1,1,101296,98704
5:6:4,0,-1,101297,98703
2:2:6,2,2,101295,98705
3:1:2,1,1,101294,98706
2:5:1,1,1,101293,98707
4:2:3,1,1,101292,98708
5:6:3,0,-1,101293,98707
3:4:6,0,-1,101294,98706
3:2:1,1,1,101293,98707
5:2:5,1,1,101292,98708
4:6:2,1,1,101291,98709
1:4:2,1,1,101290,98710
4:1:1,0,-1,101291,98709
1:3:3,0,-1,101292,98708
2:3:6,1,1,101291,98709
6:1:6,0,-1,101292,98708
1:5:1,0,-1,101293,98707
1:5:1,0,-1,101294,98706
2:5:5,1,1,101293,98707
5:1:1,0,-1,101294,98706
5:3:3,0,-1,101295,98705
3:4:4,0,-1,101296,98704
3:5:5,0,-1,101297,98703
6:1:5,0,-1,101298,98702
2:6:6,1,1,101297,98703
2:2:1,2,2,101295,98705
6:1:2,1,1,101294,98706
4:6:5,0,-1,101295,98705
5:6:4,0,-1,101296,98704
4:6:6,0,-1,101297,98703
4:5:5,0,-1,101298,98702
2:1:5,1,1,101297,98703
6:1:3,0,-1,101298,98702
1:1:1,0,-1,101299,98701
1:5:2,1,1,101298,98702
1:4:1,0,-1,101299,98701
2:1:2,2,2,101297,98703
1:5:2,1,1,101296,98704
3:2:3,1,1,101295,98705
6:5:2,1,1,101294,98706
4:4:3,0,-1,101295,98705
3:2:4,1,1,101294,98706
1:4:1,0,-1,101295,98705
3:5:1,0,-1,101296,98704
6:2:5,1,1,101295,98705
6:4:5,0,-1,101296,98704
1:5:2,1,1,101295,98705
1:1:1,0,-1,101296,98704
1:2:5,1,1,101295,98705
5:6:1,0,-1,101296,98704
6:6:3,0,-1,101297,98703
6:6:2,1,1,101296,98704
4:5:4,0,-1,101297,98703
5:2:3,1,1,101296,98704
1:1:6,0,-1,101297,98703
3:6:6,0,-1,101298,98702
2:2:1,2,2,101296,98704
4:1:5,0,-1,101297,98703
3:5:2,1,1,101296,98704
4:1:1,0,-1,101297,98703
4:5:6,0,-1,101298,98702
2:1:4,1,1,101297,98703
4:4:4,0,-1,101298,98702
3:1:2,1,1,101297,98703
5:2:1,1,1,101296,98704
5:4:4,0,-1,101297,98703
2:2:4,2,2,101295,98705
6:5:6,0,-1,101296,98704
6:3:2,1,1,101295,98705
2:1:6,1,1,101294,98706
5:3:4,0,-1,101295,98705
5:2:1,1,1,101294,98706
1:4:3,0,-1,101295,98705
6:2:3,1,1,101294,98706
2:4:4,1,1,101293,98707
3:1:1,0,-1,101294,98706
3:3:1,0,-1,101295,98705
1:4:5,0,-1,101296,98704
1:1:5,0,-1,101297,98703
1:2:5,1,1,101296,98704
1:6:3,0,-1,101297,98703
6:6:5,0,-1,101298,98702
1:4:2,1,1,101297,98703
1:4:5,0,-1,101298,98702
6:4:6,0,-1,101299,98701
3:1:2,1,1,101298,98702
2:5:1,1,1,101297,98703
4:5:1,0,-1,101298,98702
6:5:2,1,1,101297,98703
2:2:1,2,2,101295,98705
4:6:2,1,1,101294,98706
4:6:3,0,-1,101295,98705
2:6:4,1,1,101294,98706
2:6:1,1,1,101293,98707
6:3:5,0,-1,101294,98706
5:6:3,0,-1,101295,98705
1:1:1,0,-1,101296,98704
1:4:6,0,-1,101297,98703
1:6:3,0,-1,101298,98702
2:6:6,1,1,101297,98703
3:2:3,1,1,101296,98704
4:3:3,0,-1,101297,98703
6:3:3,0,-1,101298,98702
4:3:2,1,1,101297,98703
3:4:1,0,-1,101298,98702
2:4:4,1,1,101297,98703
3:5:6,0,-1,101298,98702
4:2:2,2,2,101296,98704
2:5:1,1,1,101295,98705
2:2:2,3,3,101292,98708
6:5:2,1,1,101291,98709
6:2:6,1,1,101290,98710
3:1:1,0,-1,101291,98709
1:1:6,0,-1,101292,98708
2:3:6,1,1,101291,98709
6:3:3,0,-1,101292,98708
6:6:6,0,-1,101293,98707
5:2:4,1,1,101292,98708
3:4:6,0,-1,101293,98707
6:3:6,0,-1,101294,98706
3:1:6,0,-1,101295,98705
4:3:2,1,1,101294,98706
3:5:6,0,-1,101295,98705
1:6:2,1,1,101294,98706
4:3:3,0,-1,101295,98705
4:2:5,1,1,101294,98706
4:5:2,1,1,101293,98707
4:2:3,1,1,101292,98708
5:6:2,1,1,101291,98709
2:1:1,1,1,101290,98710
3:2:6,1,1,101289,98711
6:6:5,0,-1,101290,98710
5:1:1,0,-1,101291,98709
6:6:5,0,-1,101292,98708
3:5:1,0,-1,101293,98707
1:1:4,0,-1,101294,98706
2:1:3,1,1,101293,98707
6:6:1,0,-1,101294,98706
3:1:1,0,-1,101295,98705
4:5:4,0,-1,101296,98704
4:5:6,0,-1,101297,98703
6:3:3,0,-1,101298,98702
3:6:4,0,-1,101299,98701
4:2:5,1,1,101298,98702
6:1:1,0,-1,101299,98701
1:4:5,0,-1,101300,98700
5:2:1,1,1,101299,98701
5:3:5,0,-1,101300,98700
4:1:4,0,-1,101301,98699
5:2:6,1,1,101300,98700
3:6:5,0,-1,101301,98699
5:5:2,1,1,101300,98700
3:2:6,1,1,101299,98701
3:2:5,1,1,101298,98702
6:4:1,0,-1,101299,98701
1:2:6,1,1,101298,98702
2:6:3,1,1,101297,98703
3:6:1,0,-1,101298,98702
6:1:2,1,1,101297,98703
4:4:5,0,-1,101298,98702
6:1:4,0,-1,101299,98701
4:2:6,1,1,101298,98702
6:2:2,2,2,101296,98704
2:2:1,2,2,101294,98706
3:1:1,0,-1,101295,98705
3:3:2,1,1,101294,98706
4:1:4,0,-1,101295,98705
2:2:6,2,2,101293,98707
1:2:1,1,1,101292,98708
1:3:6,0,-1,101293,98707
1:5:3,0,-1,101294,98706
3:4:5,0,-1,101295,98705
2:6:4,1,1,101294,98706
6:2:2,2,2,101292,98708
5:5:4,0,-1,101293,98707
5:6:1,0,-1,101294,98706
6:3:2,1,1,101293,98707
5:1:1,0,-1,101294,98706
3:1:2,1,1,101293,98707
4:5:2,1,1,101292,98708
1:1:6,0,-1,101293,98707
1:5:5,0,-1,101294,98706
2:4:5,1,1,101293,98707
5:5:6,0,-1,101294,98706
2:1:2,2,2,101292,98708
2:6:5,1,1,101291,98709
2:3:3,1,1,101290,98710
2:2:4,2,2,101288,98712
5:1:4,0,-1,101289,98711
4:6:6,0,-1,101290,98710
4:6:4,0,-1,101291,98709
5:6:1,0,-1,101292,98708
4:3:1,0,-1,101293,98707
1:3:3,0,-1,101294,98706
3:1:4,0,-1,101295,98705
4:4:3,0,-1,101296,98704
2:4:1,1,1,101295,98705
6:2:2,2,2,101293,98707
3:4:5,0,-1,101294,98706
3:6:1,0,-1,101295,98705
1:1:3,0,-1,101296,98704
6:5:4,0,-1,101297,98703
2:3:4,1,1,101296,98704
4:6:5,0,-1,101297,98703
5:4:6,0,-1,101298,98702
2:3:5,1,1,101297,98703
3:1:1,0,-1,101298,98702
3:3:4,0,-1,101299,98701
1:6:3,0,-1,101300,98700
3:2:1,1,1,101299,98701
3:5:2,1,1,101298,98702
4:5:3,0,-1,101299,98701
1:2:1,1,1,101298,98702
4:6:5,0,-1,101299,98701
2:3:2,2,2,101297,98703
5:1:2,1,1,101296,98704
1:6:3,0,-1,101297,98703
1:4:1,0,-1,101298,98702
4:2:6,1,1,101297,98703
6:6:4,0,-1,101298,98702
6:2:4,1,1,101297,98703
2:3:5,1,1,101296,98704
5:1:4,0,-1,101297,98703
3:1:4,0,-1,101298,98702
3:3:2,1,1,101297,98703
6:2:3,1,1,101296,98704
1:5:5,0,-1,101297,98703
2:5:1,1,1,101296,98704
2:2:1,2,2,101294,98706
2:1:4,1,1,101293,98707
3:5:6,0,-1,101294,98706
3:2:2,2,2,101292,98708
5:1:4,0,-1,101293,98707
3:3:4,0,-1,101294,98706
3:5:4,0,-1,101295,98705
5:2:1,1,1,101294,98706
3:5:6,0,-1,101295,98705
6:5:1,0,-1,101296,98704
4:6:5,0,-1,101297,98703
4:4:5,0,-1,101298,98702
5:3:2,1,1,101297,98703
3:6:2,1,1,101296,98704
5:4:5,0,-1,101297,98703
4:6:1,0,-1,101298,98702
6:1:2,1,1,101297,98703
2:6:1,1,1,101296,98704
5:4:6,0,-1,101297,98703
6:1:5,0,-1,101298,98702
2:6:5,1,1,101297,98703
1:3:2,1,1,101296,98704
6:3:3,0,-1,101297,98703
6:5:5,0,-1,101298,98702
3:6:1,0,-1,101299,98701
5:3:5,0,-1,101300,98700
4:6:1,0,-1,101301,98699
2:1:2,2,2,101299,98701
4:4:6,0,-1,101300,98700
4:4:2,1,1,101299,98701
2:6:3,1,1,101298,98702
6:6:2,1,1,101297,98703
4:2:3,1,1,101296,98704
4:3:5,0,-1,101297,98703
5:1:5,0,-1,101298,98702
1:1:5,0,-1,101299,98701
1:4:6,0,-1,101300,98700
1:4:3,0,-1,101301,98699
4:3:6,0,-1,101302,98698
5:6:2,1,1,101301,98699
1:3:5,0,-1,101302,98698
5:4:1,0,-1,101303,98697
5:1:4,0,-1,101304,98696
1:6:4,0,-1,101305,98695
5:2:3,1,1,101304,98696
1:1:2,1,1,101303,98697
4:4:6,0,-1,101304,98696
2:6:5,1,1,101303,98697
5:1:1,0,-1,101304,98696
6:1:1,0,-1,101305,98695
1:6:4,0,-1,101306,98694
5:3:5,0,-1,101307,98693
4:1:3,0,-1,101308,98692
1:6:1,0,-1,101309,98691
1:4:2,1,1,101308,98692
3:2:5,1,1,101307,98693
4:1:6,0,-1,101308,98692
5:3:1,0,-1,101309,98691
5:5:6,0,-1,101310,98690
4:5:6,0,-1,101311,98689
6:5:2,1,1,101310,98690
6:4:5,0,-1,101311,98689
5:6:4,0,-1,101312,98688
2:5:3,1,1,101311,98689
4:1:2,1,1,101310,98690
6:4:1,0,-1,101311,98689
1:2:3,1,1,101310,98690
1:3:5,0,-1,101311,98689
1:1:6,0,-1,101312,98688
5:3:1,0,-1,101313,98687
1:4:5,0,-1,101314,98686
6:6:2,1,1,101313,98687
5:3:5,0,-1,101314,98686
5:3:1,0,-1,101315,98685
1:3:6,0,-1,101316,98684
1:3:5,0,-1,101317,98683
6:6:4,0,-1,101318,98682
5:6:6,0,-1,101319,98681
2:3:4,1,1,101318,98682
2:5:4,1,1,101317,98683
2:2:2,3,3,101314,98686
2:3:1,1,1,101313,98687
1:4:6,0,-1,101314,98686
4:5:6,0,-1,101315,98685
5:5:5,0,-1,101316,98684
6:1:3,0,-1,101317,98683
1:6:5,0,-1,101318,98682
2:4:2,2,2,101316,98684
3:5:5,0,-1,101317,98683
1:2:6,1,1,101316,98684
1:4:5,0,-1,101317,98683
3:2:2,2,2,101315,98685
6:1:3,0,-1,101316,98684
5:2:2,2,2,101314,98686
5:5:4,0,-1,101315,98685
6:6:4,0,-1,101316,98684
5:2:6,1,1,101315,98685
1:6:3,0,-1,101316,98684
5:5:1,0,-1,101317,98683
3:2:5,1,1,101316,98684
4:5:2,1,1,101315,98685
4:5:3,0,-1,101316,98684
6:5:5,0,-1,101317,98683
5:6:4,0,-1,101318,98682
4:4:6,0,-1,101319,98681
5:6:2,1,1,101318,98682
4:5:3,0,-1,101319,98681
1:6:3,0,-1,101320,98680
5:4:6,0,-1,101321,98679
3:5:6,0,-1,101322,98678
3:5:1,0,-1,101323,98677
4:2:3,1,1,101322,98678
2:2:4,2,2,101320,98680
1:3:4,0,-1,101321,98679
2:2:2,3,3,101318,98682
3:4:6,0,-1,101319,98681
1:2:5,1,1,101318,98682
5:5:6,0,-1,101319,98681
3:2:6,1,1,101318,98682
1:3:5,0,-1,101319,98681
2:1:5,1,1,101318,98682
4:4:6,0,-1,101319,98681
5:5:3,0,-1,101320,98680
6:4:5,0,-1,101321,98679
3:5:3,0,-1,101322,98678
3:1:3,0,-1,101323,98677
3:4:2,1,1,101322,98678
6:6:4,0,-1,101323,98677
2:1:1,1,1,101322,98678
2:5:2,2,2,101320,98680
5:2:6,1,1,101319,98681
3:4:3,0,-1,101320,98680
1:6:6,0,-1,101321,98679
3:6:4,0,-1,101322,98678
6:3:1,0,-1,101323,98677
2:5:5,1,1,101322,98678
4:1:1,0,-1,101323,98677
4:6:3,0,-1,101324,98676
3:2:1,1,1,101323,98677
5:5:6,0,-1,101324,98676
3:1:6,0,-1,101325,98675
2:3:6,1,1,101324,98676
5:2:6,1,1,101323,98677
4:1:4,0,-1,101324,98676
6:2:2,2,2,101322,98678
2:3:1,1,1,101321,98679
4:2:6,1,1,101320,98680
3:4:6,0,-1,101321,98679
2:1:4,1,1,101320,98680
6:4:2,1,1,101319,98681
5:4:1,0,-1,101320,98680
2:5:5,1,1,101319,98681
2:3:5,1,1,101318,98682
4:1:6,0,-1,101319,98681
6:4:2,1,1,101318,98682
5:2:4,1,1,101317,98683
6:6:4,0,-1,101318,98682
5:3:4,0,-1,101319,98681
5:1:2,1,1,101318,98682
2:3:6,1,1,101317,98683
5:5:4,0,-1,101318,98682
6:5:5,0,-1,101319,98681
5:3:5,0,-1,101320,98680
1:6:6,0,-1,101321,98679
1:3:1,0,-1,101322,98678
3:5:4,0,-1,101323,98677
2:5:3,1,1,101322,98678
2:6:6,1,1,101321,98679
3:5:5,0,-1,101322,98678
6:3:3,0,-1,101323,98677
5:6:3,0,-1,101324,98676
4:3:1,0,-1,101325,98675
5:1:1,0,-1,101326,98674
4:2:6,1,1,101325,98675
3:4:2,1,1,101324,98676
1:1:5,0,-1,101325,98675
4:6:4,0,-1,101326,98674
2:3:6,1,1,101325,98675
1:6:4,0,-1,101326,98674
3:2:6,1,1,101325,98675
6:2:3,1,1,101324,98676
6:1:6,0,-1,101325,98675
3:1:6,0,-1,101326,98674
3:3:6,0,-1,101327,98673
4:5:1,0,-1,101328,98672
5:1:2,1,1,101327,98673
6:2:1,1,1,101326,98674
3:3:6,0,-1,101327,98673
2:3:5,1,1,101326,98674
5:4:3,0,-1,101327,98673
3:2:4,1,1,101326,98674
5:6:6,0,-1,101327,98673
2:3:6,1,1,101326,98674
6:1:5,0,-1,101327,98673
1:5:2,1,1,101326,98674
6:2:5,1,1,101325,98675
4:6:1,0,-1,101326,98674
5:2:6,1,1,101325,98675
6:6:4,0,-1,101326,98674
4:1:1,0,-1,101327,98673
6:2:5,1,1,101326,98674
4:3:5,0,-1,101327,98673
3:5:1,0,-1,101328,98672
5:3:3,0,-1,101329,98671
4:3:4,0,-1,101330,98670
2:1:3,1,1,101329,98671
1:5:6,0,-1,101330,98670
4:6:5,0,-1,101331,98669
1:6:4,0,-1,101332,98668
1:1:3,0,-1,101333,98667
1:3:6,0,-1,101334,98666
4:2:6,1,1,101333,98667
3:1:6,0,-1,101334,98666
6:5:3,0,-1,101335,98665
3:6:5,0,-1,101336,98664
2:1:4,1,1,101335,98665
2:5:4,1,1,101334,98666
3:4:5,0,-1,101335,98665
1:5:3,0,-1,101336,98664
6:1:1,0,-1,101337,98663
6:6:5,0,-1,101338,98662
5:1:2,1,1,101337,98663
3:5:6,0,-1,101338,98662
5:6:5,0,-1,101339,98661
6:4:2,1,1,101338,98662
1:3:5,0,-1,101339,98661
6:1:5,0,-1,101340,98660
5:5:2,1,1,101339,98661
4:3:1,0,-1,101340,98660
5:5:3,0,-1,101341,98659
2:4:3,1,1,101340,98660
2:4:1,1,1,101339,98661
3:1:1,0,-1,101340,98660
1:2:5,1,1,101339,98661
5:2:2,2,2,101337,98663
5:3:3,0,-1,101338,98662
3:2:5,1,1,101337,98663
5:4:2,1,1,101336,98664
6:5:4,0,-1,101337,98663
4:5:3,0,-1,101338,98662
4:3:3,0,-1,101339,98661
2:5:1,1,1,101338,98662
1:6:3,0,-1,101339,98661
1:1:5,0,-1,101340,98660
1:3:3,0,-1,101341,98659
2:5:5,1,1,101340,98660
2:2:6,2,2,101338,98662
4:2:2,2,2,101336,98664
2:3:3,1,1,101335,98665
6:5:5,0,-1,101336,98664
2:6:4,1,1,101335,98665
2:1:6,1,1,101334,98666
3:4:2,1,1,101333,98667
2:6:6,1,1,101332,98668
2:4:6,1,1,101331,98669
6:3:2,1,1,101330,98670
1:2:1,1,1,101329,98671
1:4:2,1,1,101328,98672
5:2:5,1,1,101327,98673
1:1:1,0,-1,101328,98672
5:3:6,0,-1,101329,98671
2:4:5,1,1,101328,98672
6:4:5,0,-1,101329,98671
1:4:2,1,1,101328,98672
6:5:2,1,1,101327,98673
3:3:5,0,-1,101328,98672
1:4:1,0,-1,101329,98671
1:4:3,0,-1,101330,98670
2:4:6,1,1,101329,98671
5:1:1,0,-1,101330,98670
3:4:4,0,-1,101331,98669
4:3:1,0,-1,101332,98668
2:1:6,1,1,101331,98669
6:5:1,0,-1,101332,98668
6:6:6,0,-1,101333,98667
1:3:3,0,-1,101334,98666
2:2:1,2,2,101332,98668
4:6:6,0,-1,101333,98667
2:6:4,1,1,101332,98668
3:4:4,0,-1,101333,98667
5:2:6,1,1,101332,98668
3:5:4,0,-1,101333,98667
3:5:3,0,-1,101334,98666
2:2:5,2,2,101332,98668
3:1:4,0,-1,101333,98667
6:6:2,1,1,101332,98668
2:4:5,1,1,101331,98669
2:6:3,1,1,101330,98670
5:2:5,1,1,101329,98671
1:3:3,0,-1,101330,98670
6:3:4,0,-1,101331,98669
5:2:4,1,1,101330,98670
5:3:3,0,-1,101331,98669
2:2:6,2,2,101329,98671
5:5:6,0,-1,101330,98670
5:6:4,0,-1,101331,98669
6:2:6,1,1,101330,98670
5:4:5,0,-1,101331,98669
6:3:2,1,1,101330,98670
5:4:4,0,-1,101331,98669
1:1:2,1,1,101330,98670
3:4:2,1,1,101329,98671
5:2:5,1,1,101328,98672
6:6:3,0,-1,101329,98671
6:1:6,0,-1,101330,98670
1:1:4,0,-1,101331,98669
6:6:3,0,-1,101332,98668
6:4:1,0,-1,101333,98667
5:5:4,0,-1,101334,98666
5:3:2,1,1,101333,98667
3:3:3,0,-1,101334,98666
3:3:4,0,-1,101335,98665
3:1:4,0,-1,101336,98664
6:1:6,0,-1,101337,98663
2:4:3,1,1,101336,98664
6:6:5,0,-1,101337,98663
2:5:6,1,1,101336,98664
4:6:3,0,-1,101337,98663
2:3:6,1,1,101336,98664
4:3:4,0,-1,101337,98663
4:6:4,0,-1,101338,98662
4:2:3,1,1,101337,98663
6:2:1,1,1,101336,98664
5:6:4,0,-1,101337,98663
3:3:5,0,-1,101338,98662
3:2:6,1,1,101337,98663
4:3:6,0,-1,101338,98662
1:6:3,0,-1,101339,98661
1:6:6,0,-1,101340,98660
6:4:6,0,-1,101341,98659
3:6:3,0,-1,101342,98658
4:3:1,0,-1,101343,98657
5:3:6,0,-1,101344,98656
6:6:2,1,1,101343,98657
3:4:3,0,-1,101344,98656
4:3:5,0,-1,101345,98655
6:3:2,1,1,101344,98656
4:5:6,0,-1,101345,98655
5:5:3,0,-1,101346,98654
2:2:6,2,2,101344,98656
2:3:5,1,1,101343,98657
3:1:6,0,-1,101344,98656
5:4:5,0,-1,101345,98655
4:6:2,1,1,101344,98656
3:5:5,0,-1,101345,98655
5:4:6,0,-1,101346,98654
1:4:1,0,-1,101347,98653
2:1:2,2,2,101345,98655
3:1:4,0,-1,101346,98654
1:1:3,0,-1,101347,98653
2:3:6,1,1,101346,98654
5:2:3,1,1,101345,98655
4:1:4,0,-1,101346,98654
1:3:4,0,-1,101347,98653
1:3:3,0,-1,101348,98652
5:5:6,0,-1,101349,98651
1:4:1,0,-1,101350,98650
1:5:1,0,-1,101351,98649
3:5:2,1,1,101350,98650
6:2:4,1,1,101349,98651
6:6:6,0,-1,101350,98650
6:1:5,0,-1,101351,98649
1:1:4,0,-1,101352,98648
5:2:6,1,1,101351,98649
4:2:3,1,1,101350,98650
6:2:4,1,1,101349,98651
1:3:6,0,-1,101350,98650
2:2:1,2,2,101348,98652
1:3:4,0,-1,101349,98651
4:1:4,0,-1,101350,98650
5:2:6,1,1,101349,98651
5:4:5,0,-1,101350,98650
3:6:1,0,-1,101351,98649
2:3:3,1,1,101350,98650
1:5:4,0,-1,101351,98649
6:6:2,1,1,101350,98650
3:4:6,0,-1,101351,98649
4:5:3,0,-1,101352,98648
6:4:3,0,-1,101353,98647
4:4:4,0,-1,101354,98646
2:3:4,1,1,101353,98647
3:3:5,0,-1,101354,98646
2:4:5,1,1,101353,98647
1:6:3,0,-1,101354,98646
4:4:6,0,-1,101355,98645
6:5:6,0,-1,101356,98644
4:2:4,1,1,101355,98645
4:4:3,0,-1,101356,98644
5:2:6,1,1,101355,98645
5:4:5,0,-1,101356,98644
4:1:5,0,-1,101357,98643
4:2:4,1,1,101356,98644
6:2:4,1,1,101355,98645
6:4:4,0,-1,101356,98644
1:3:6,0,-1,101357,98643
1:2:4,1,1,101356,98644
1:6:3,0,-1,101357,98643
3:2:5,1,1,101356,98644
2:2:1,2,2,101354,98646
1:5:2,1,1,101353,98647
4:2:1,1,1,101352,98648
5:4:2,1,1,101351,98649
1:6:4,0,-1,101352,98648
6:2:6,1,1,101351,98649
4:3:5,0,-1,101352,98648
2:6:2,2,2,101350,98650
5:4:2,1,1,101349,98651
6:2:6,1,1,101348,98652
2:6:2,2,2,101346,98654
1:4:6,0,-1,101347,98653
3:2:2,2,2,101345,98655
4:5:4,0,-1,101346,98654
5:1:3,0,-1,101347,98653
5:4:1,0,-1,101348,98652
2:5:1,1,1,101347,98653
1:3:4,0,-1,101348,98652
3:1:1,0,-1,101349,98651
5:1:6,0,-1,101350,98650
5:3:5,0,-1,101351,98649
4:2:5,1,1,101350,98650
5:2:5,1,1,101349,98651
6:2:2,2,2,101347,98653
6:6:6,0,-1,101348,98652
4:2:1,1,1,101347,98653
1:2:6,1,1,101346,98654
6:1:2,1,1,101345,98655
1:2:3,1,1,101344,98656
2:4:1,1,1,101343,98657
1:6:6,0,-1,101344,98656
6:6:3,0,-1,101345,98655
1:4:5,0,-1,101346,98654
4:6:5,0,-1,101347,98653
3:5:4,0,-1,101348,98652
4:6:3,0,-1,101349,98651
3:1:2,1,1,101348,98652
6:5:6,0,-1,101349,98651
1:2:2,2,2,101347,98653
1:6:2,1,1,101346,98654
5:2:1,1,1,101345,98655
1:5:4,0,-1,101346,98654
6:5:5,0,-1,101347,98653
1:2:4,1,1,101346,98654
4:4:4,0,-1,101347,98653
2:4:5,1,1,101346,98654
6:4:5,0,-1,101347,98653
5:2:5,1,1,101346,98654
6:3:4,0,-1,101347,98653
5:5:5,0,-1,101348,98652
6:5:1,0,-1,101349,98651
2:4:4,1,1,101348,98652
2:4:6,1,1,101347,98653
6:5:5,0,-1,101348,98652
6:5:3,0,-1,101349,98651
2:1:2,2,2,101347,98653
6:6:3,0,-1,101348,98652
6:6:6,0,-1,101349,98651
1:4:5,0,-1,101350,98650
1:3:6,0,-1,101351,98649
6:6:2,1,1,101350,98650
1:4:6,0,-1,101351,98649
1:6:6,0,-1,101352,98648
2:2:4,2,2,101350,98650
2:4:6,1,1,101349,98651
6:3:5,0,-1,101350,98650
6:3:5,0,-1,101351,98649
6:1:4,0,-1,101352,98648
2:6:5,1,1,101351,98649
5:1:6,0,-1,101352,98648
5:3:6,0,-1,101353,98647
4:6:1,0,-1,101354,98646
4:6:1,0,-1,101355,98645
5:5:2,1,1,101354,98646
2:5:5,1,1,101353,98647
5:3:6,0,-1,101354,98646
1:3:4,0,-1,101355,98645
2:5:6,1,1,101354,98646
3:5:2,1,1,101353,98647
2:6:5,1,1,101352,98648
6:5:1,0,-1,101353,98647
3:3:5,0,-1,101354,98646
4:6:1,0,-1,101355,98645
5:4:6,0,-1,101356,98644
6:2:6,1,1,101355,98645
1:2:5,1,1,101354,98646
1:1:4,0,-1,101355,98645
1:3:6,0,-1,101356,98644
5:2:2,2,2,101354,98646
2:6:3,1,1,101353,98647
4:2:1,1,1,101352,98648
4:3:6,0,-1,101353,98647
4:3:3,0,-1,101354,98646
3:3:6,0,-1,101355,98645
5:6:6,0,-1,101356,98644
3:6:3,0,-1,101357,98643
2:4:4,1,1,101356,98644
6:3:5,0,-1,101357,98643
3:1:2,1,1,101356,98644
2:2:5,2,2,101354,98646
1:5:4,0,-1,101355,98645
6:5:6,0,-1,101356,98644
5:4:4,0,-1,101357,98643
5:5:6,0,-1,101358,98642
1:3:4,0,-1,101359,98641
5:2:1,1,1,101358,98642
6:5:6,0,-1,101359,98641
5:2:6,1,1,101358,98642
6:4:3,0,-1,101359,98641
6:4:1,0,-1,101360,98640
3:5:4,0,-1,101361,98639
2:3:2,2,2,101359,98641
6:5:6,0,-1,101360,98640
6:3:4,0,-1,101361,98639
5:4:5,0,-1,101362,98638
3:2:4,1,1,101361,98639
5:6:6,0,-1,101362,98638
3:5:1,0,-1,101363,98637
5:5:5,0,-1,101364,98636
3:4:1,0,-1,101365,98635
6:6:5,0,-1,101366,98634
6:5:2,1,1,101365,98635
5:3:2,1,1,101364,98636
5:4:6,0,-1,101365,98635
2:6:6,1,1,101364,98636
1:4:5,0,-1,101365,98635
5:6:5,0,-1,101366,98634
5:5:1,0,-1,101367,98633
5:1:4,0,-1,101368,98632
3:4:6,0,-1,101369,98631
4:2:4,1,1,101368,98632
3:3:5,0,-1,101369,98631
1:1:6,0,-1,101370,98630
5:1:2,1,1,101369,98631
5:2:1,1,1,101368,98632
1:5:4,0,-1,101369,98631
5:5:1,0,-1,101370,98630
1:6:1,0,-1,101371,98629
6:6:6,0,-1,101372,98628
6:5:5,0,-1,101373,98627
5:2:5,1,1,101372,98628
3:3:6,0,-1,101373,98627
5:1:2,1,1,101372,98628
2:2:4,2,2,101370,98630
2:4:4,1,1,101369,98631
1:3:6,0,-1,101370,98630
2:4:4,1,1,101369,98631
5:3:2,1,1,101368,98632
6:3:6,0,-1,101369,98631
3:4:1,0,-1,101370,98630
5:4:6,0,-1,101371,98629
6:4:2,1,1,101370,98630
6:6:2,1,1,101369,98631
1:2:3,1,1,101368,98632
6:5:2,1,1,101367,98633
4:2:3,1,1,101366,98634
2:4:3,1,1,101365,98635
4:1:1,0,-1,101366,98634
6:2:2,2,2,101364,98636
6:1:2,1,1,101363,98637
6:1:2,1,1,101362,98638
2:1:5,1,1,101361,98639
3:1:4,0,-1,101362,98638
6:3:6,0,-1,101363,98637
4:6:6,0,-1,101364,98636
6:5:2,1,1,101363,98637
2:6:3,1,1,101362,98638
5:6:6,0,-1,101363,98637
5:5:4,0,-1,101364,98636
4:6:2,1,1,101363,98637
4:5:2,1,1,101362,98638
3:1:6,0,-1,101363,98637
3:3:6,0,-1,101364,98636
3:6:2,1,1,101363,98637
5:6:4,0,-1,101364,98636
4:5:5,0,-1,101365,98635
2:5:1,1,1,101364,98636
1:4:1,0,-1,101365,98635
6:2:4,1,1,101364,98636
2:6:5,1,1,101363,98637
2:5:6,1,1,101362,98638
3:3:2,1,1,101361,98639
3:1:5,0,-1,101362,98638
1:2:1,1,1,101361,98639
3:2:2,2,2,101359,98641
5:5:6,0,-1,101360,98640
5:1:3,0,-1,101361,98639
5:1:6,0,-1,101362,98638
6:6:3,0,-1,101363,98637
2:5:5,1,1,101362,98638
6:6:4,0,-1,101363,98637
5:2:3,1,1,101362,98638
2:6:2,2,2,101360,98640
5:5:2,1,1,101359,98641
2:1:3,1,1,101358,98642
3:4:5,0,-1,101359,98641
4:4:2,1,1,101358,98642
3:6:6,0,-1,101359,98641
4:2:5,1,1,101358,98642
4:6:6,0,-1,101359,98641
3:4:6,0,-1,101360,98640
3:5:4,0,-1,101361,98639
6:1:6,0,-1,101362,98638
3:1:6,0,-1,101363,98637
5:3:2,1,1,101362,98638
1:2:2,2,2,101360,98640
4:6:5,0,-1,101361,98639
5:3:6,0,-1,101362,98638
4:4:3,0,-1,101363,98637
6:6:5,0,-1,101364,98636
2:1:3,1,1,101363,98637
6:6:1,0,-1,101364,98636
4:2:1,1,1,101363,98637
6:3:6,0,-1,101364,98636
5:6:5,0,-1,101365,98635
4:3:1,0,-1,101366,98634
2:3:3,1,1,101365,98635
3:6:6,0,-1,101366,98634
4:2:4,1,1,101365,98635
5:1:5,0,-1,101366,98634
6:3:2,1,1,101365,98635
1:1:4,0,-1,101366,98634
5:2:6,1,1,101365,98635
5:4:3,0,-1,101366,98634
6:6:5,0,-1,101367,98633
1:1:6,0,-1,101368,98632
1:5:3,0,-1,101369,98631
6:6:5,0,-1,101370,98630
1:6:5,0,-1,101371,98629
3:3:2,1,1,101370,98630
3:4:5,0,-1,101371,98629
3:5:4,0,-1,101372,98628
5:5:5,0,-1,101373,98627
2:2:3,2,2,101371,98629
4:3:5,0,-1,101372,98628
3:3:4,0,-1,101373,98627
1:6:5,0,-1,101374,98626
3:2:1,1,1,101373,98627
3:1:6,0,-1,101374,98626
2:4:6,1,1,101373,98627
5:5:1,0,-1,101374,98626
3:3:1,0,-1,101375,98625
6:4:3,0,-1,101376,98624
6:2:6,1,1,101375,98625
1:5:4,0,-1,101376,98624
3:4:6,0,-1,101377,98623
6:3:2,1,1,101376,98624
1:5:3,0,-1,101377,98623
5:4:3,0,-1,101378,98622
3:2:1,1,1,101377,98623
2:1:5,1,1,101376,98624
3:2:4,1,1,101375,98625
6:1:1,0,-1,101376,98624
2:3:3,1,1,101375,98625
6:2:2,2,2,101373,98627
5:6:1,0,-1,101374,98626
2:5:6,1,1,101373,98627
5:3:5,0,-1,101374,98626
1:1:3,0,-1,101375,98625
2:3:3,1,1,101374,98626
4:1:5,0,-1,101375,98625
6:5:2,1,1,101374,98626
1:5:4,0,-1,101375,98625
5:1:5,0,-1,101376,98624
4:3:3,0,-1,101377,98623
4:5:2,1,1,101376,98624
2:2:3,2,2,101374,98626
4:6:1,0,-1,101375,98625
3:1:6,0,-1,101376,98624
3:4:2,1,1,101375,98625
5:3:2,1,1,101374,98626
3:5:4,0,-1,101375,98625
1:2:6,1,1,101374,98626
4:1:2,1,1,101373,98627
1:1:2,1,1,101372,98628
6:1:5,0,-1,101373,98627
1:2:5,1,1,101372,98628
2:5:1,1,1,101371,98629
1:5:5,0,-1,101372,98628
1:2:1,1,1,101371,98629
6:1:5,0,-1,101372,98628
5:2:4,1,1,101371,98629
2:5:6,1,1,101370,98630
6:6:4,0,-1,101371,98629
6:1:2,1,1,101370,98630
3:5:4,0,-1,101371,98629
5:2:1,1,1,101370,98630
2:4:3,1,1,101369,98631
6:6:2,1,1,101368,98632
6:1:6,0,-1,101369,98631
1:1:5,0,-1,101370,98630
4:3:2,1,1,101369,98631
5:5:6,0,-1,101370,98630
6:1:1,0,-1,101371,98629
3:2:6,1,1,101370,98630
1:6:1,0,-1,101371,98629
3:4:2,1,1,101370,98630
6:2:3,1,1,101369,98631
1:2:5,1,1,101368,98632
1:1:6,0,-1,101369,98631
4:3:6,0,-1,101370,98630
3:1:1,0,-1,101371,98629
6:4:4,0,-1,101372,98628
5:2:5,1,1,101371,98629
5:6:3,0,-1,101372,98628
4:3:2,1,1,101371,98629
6:6:3,0,-1,101372,98628
6:6:4,0,-1,101373,98627
1:3:5,0,-1,101374,98626
3:2:3,1,1,101373,98627
6:6:6,0,-1,101374,98626
4:3:4,0,-1,101375,98625
1:3:3,0,-1,101376,98624
5:4:1,0,-1,101377,98623
3:5:4,0,-1,101378,98622
4:5:5,0,-1,101379,98621
1:6:5,0,-1,101380,98620
4:2:3,1,1,101379,98621
6:4:2,1,1,101378,98622
2:5:1,1,1,101377,98623
4:6:5,0,-1,101378,98622
3:5:5,0,-1,101379,98621
6:5:2,1,1,101378,98622
1:6:3,0,-1,101379,98621
2:5:5,1,1,101378,98622
1:1:1,0,-1,101379,98621
4:5:5,0,-1,101380,98620
6:6:3,0,-1,101381,98619
6:4:3,0,-1,101382,98618
4:5:3,0,-1,101383,98617
3:4:1,0,-1,101384,98616
6:1:3,0,-1,101385,98615
6:6:2,1,1,101384,98616
6:5:1,0,-1,101385,98615
1:2:3,1,1,101384,98616
5:1:5,0,-1,101385,98615
1:5:5,0,-1,101386,98614
2:1:5,1,1,101385,98615
6:3:6,0,-1,101386,98614
6:3:1,0,-1,101387,98613
2:5:3,1,1,101386,98614
3:5:1,0,-1,101387,98613
5:3:1,0,-1,101388,98612
2:5:6,1,1,101387,98613
5:1:3,0,-1,101388,98612
2:5:2,2,2,101386,98614
3:6:6,0,-1,101387,98613
6:3:1,0,-1,101388,98612
4:2:5,1,1,101387,98613
5:4:3,0,-1,101388,98612
1:2:5,1,1,101387,98613
4:2:1,1,1,101386,98614
5:6:6,0,-1,101387,98613
5:2:2,2,2,101385,98615
6:5:2,1,1,101384,98616
5:1:2,1,1,101383,98617
4:2:3,1,1,101382,98618
4:2:2,2,2,101380,98620
5:5:2,1,1,101379,98621
3:2:2,2,2,101377,98623
1:1:5,0,-1,101378,98622
1:3:3,0,-1,101379,98621
4:5:3,0,-1,101380,98620
3:1:4,0,-1,101381,98619
5:2:1,1,1,101380,98620
2:1:3,1,1,101379,98621
2:6:3,1,1,101378,98622
2:3:3,1,1,101377,98623
2:3:3,1,1,101376,98624
3:5:6,0,-1,101377,98623
2:5:6,1,1,101376,98624
5:1:4,0,-1,101377,98623
2:1:6,1,1,101376,98624
5:5:3,0,-1,101377,98623
5:4:2,1,1,101376,98624
5:2:6,1,1,101375,98625
3:5:4,0,-1,101376,98624
5:6:3,0,-1,101377,98623
6:3:4,0,-1,101378,98622
1:4:6,0,-1,101379,98621
5:3:6,0,-1,101380,98620
4:4:5,0,-1,101381,98619
2:4:1,1,1,101380,98620
6:5:4,0,-1,101381,98619
1:6:2,1,1,101380,98620
5:5:4,0,-1,101381,98619
5:1:6,0,-1,101382,98618
5:3:3,0,-1,101383,98617
6:1:6,0,-1,101384,98616
1:3:6,0,-1,101385,98615
2:4:2,2,2,101383,98617
5:6:1,0,-1,101384,98616
3:4:5,0,-1,101385,98615
2:6:1,1,1,101384,98616
2:6:5,1,1,101383,98617
1:6:2,1,1,101382,98618
2:6:4,1,1,101381,98619
6:1:2,1,1,101380,98620
3:1:1,0,-1,101381,98619
5:3:5,0,-1,101382,98618
4:2:2,2,2,101380,98620
3:4:6,0,-1,101381,98619
5:5:1,0,-1,101382,98618
1:2:3,1,1,101381,98619
4:5:4,0,-1,101382,98618
1:6:2,1,1,101381,98619
2:1:3,1,1,101380,98620
2:1:1,1,1,101379,98621
2:1:3,1,1,101378,98622
5:4:4,0,-1,101379,98621
3:5:4,0,-1,101380,98620
2:4:5,1,1,101379,98621
5:2:6,1,1,101378,98622
5:3:1,0,-1,101379,98621
5:6:5,0,-1,101380,98620
1:3:1,0,-1,101381,98619
2:5:1,1,1,101380,98620
5:4:6,0,-1,101381,98619
6:2:5,1,1,101380,98620
6:2:1,1,1,101379,98621
4:2:3,1,1,101378,98622
2:3:2,2,2,101376,98624
4:4:4,0,-1,101377,98623
5:2:4,1,1,101376,98624
2:1:5,1,1,101375,98625
2:1:4,1,1,101374,98626
5:6:3,0,-1,101375,98625
4:5:4,0,-1,101376,98624
1:2:1,1,1,101375,98625
5:6:2,1,1,101374,98626
2:3:6,1,1,101373,98627
5:2:4,1,1,101372,98628
3:6:3,0,-1,101373,98627
6:5:4,0,-1,101374,98626
1:4:2,1,1,101373,98627
5:5:5,0,-1,101374,98626
2:1:3,1,1,101373,98627
6:6:2,1,1,101372,98628
4:6:3,0,-1,101373,98627
6:5:6,0,-1,101374,98626
5:2:6,1,1,101373,98627
1:2:2,2,2,101371,98629
6:6:4,0,-1,101372,98628
4:3:6,0,-1,101373,98627
3:6:5,0,-1,101374,98626
3:4:1,0,-1,101375,98625
2:3:1,1,1,101374,98626
5:3:1,0,-1,101375,98625
1:4:5,0,-1,101376,98624
5:4:5,0,-1,101377,98623
4:1:3,0,-1,101378,98622
2:3:4,1,1,101377,98623
1:1:5,0,-1,101378,98622
2:5:2,2,2,101376,98624
5:6:6,0,-1,101377,98623
3:6:5,0,-1,101378,98622
6:4:3,0,-1,101379,98621
4:3:4,0,-1,101380,98620
4:3:2,1,1,101379,98621
1:5:5,0,-1,101380,98620
1:2:6,1,1,101379,98621
5:1:2,1,1,101378,98622
3:6:4,0,-1,101379,98621
4:5:2,1,1,101378,98622
5:6:4,0,-1,101379,98621
4:1:2,1,1,101378,98622
4:2:4,1,1,101377,98623
1:1:3,0,-1,101378,98622
2:6:5,1,1,101377,98623
5:5:2,1,1,101376,98624
1:3:4,0,-1,101377,98623
1:3:5,0,-1,101378,98622
6:3:4,0,-1,101379,98621
3:1:4,0,-1,101380,98620
3:1:6,0,-1,101381,98619
6:3:2,1,1,101380,98620
2:3:1,1,1,101379,98621
1:1:1,0,-1,101380,98620
2:1:2,2,2,101378,98622
4:4:2,1,1,101377,98623
4:3:6,0,-1,101378,98622
1:6:2,1,1,101377,98623
1:4:1,0,-1,101378,98622
4:5:3,0,-1,101379,98621
1:4:3,0,-1,101380,98620
3:5:6,0,-1,101381,98619
6:1:2,1,1,101380,98620
3:2:5,1,1,101379,98621
1:1:6,0,-1,101380,98620
5:2:2,2,2,101378,98622
2:5:5,1,1,101377,98623
4:1:4,0,-1,101378,98622
6:6:3,0,-1,101379,98621
5:6:2,1,1,101378,98622
1:1:2,1,1,101377,98623
3:5:1,0,-1,101378,98622
2:5:2,2,2,101376,98624
2:5:5,1,1,101375,98625
3:6:3,0,-1,101376,98624
6:1:2,1,1,101375,98625
4:2:5,1,1,101374,98626
6:4:4,0,-1,101375,98625
6:3:1,0,-1,101376,98624
5:1:4,0,-1,101377,98623
4:2:4,1,1,101376,98624
4:5:1,0,-1,101377,98623
4:5:5,0,-1,101378,98622
4:4:1,0,-1,101379,98621
1:4:4,0,-1,101380,98620
5:5:2,1,1,101379,98621
5:3:6,0,-1,101380,98620
6:6:2,1,1,101379,98621
6:4:6,0,-1,101380,98620
5:4:1,0,-1,101381,98619
1:4:6,0,-1,101382,98618
3:1:4,0,-1,101383,98617
3:4:3,0,-1,101384,98616
2:1:1,1,1,101383,98617
4:4:5,0,-1,101384,98616
4:2:1,1,1,101383,98617
2:2:1,2,2,101381,98619
5:1:4,0,-1,101382,98618
3:2:3,1,1,101381,98619
4:6:3,0,-1,101382,98618
6:5:3,0,-1,101383,98617
1:2:5,1,1,101382,98618
4:2:3,1,1,101381,98619
2:6:5,1,1,101380,98620
4:6:6,0,-1,101381,98619
3:5:1,0,-1,101382,98618
3:1:3,0,-1,101383,98617
6:6:2,1,1,101382,98618
2:6:4,1,1,101381,98619
3:3:6,0,-1,101382,98618
2:3:5,1,1,101381,98619
2:4:3,1,1,101380,98620
3:1:2,1,1,101379,98621
3:4:5,0,-1,101380,98620
1:1:3,0,-1,101381,98619
3:1:3,0,-1,101382,98618
1:6:1,0,-1,101383,98617
6:5:2,1,1,101382,98618
2:6:5,1,1,101381,98619
4:2:1,1,1,101380,98620
1:4:2,1,1,101379,98621
4:6:2,1,1,101378,98622
4:1:3,0,-1,101379,98621
3:2:4,1,1,101378,98622
4:1:3,0,-1,101379,98621
1:6:4,0,-1,101380,98620
3:6:4,0,-1,101381,98619
3:3:4,0,-1,101382,98618
6:2:6,1,1,101381,98619
5:6:4,0,-1,101382,98618
1:4:4,0,-1,101383,98617
6:6:5,0,-1,101384,98616
4:5:3,0,-1,101385,98615
6:1:5,0,-1,101386,98614
2:2:4,2,2,101384,98616
6:3:6,0,-1,101385,98615
2:6:6,1,1,101384,98616
2:1:4,1,1,101383,98617
2:3:4,1,1,101382,98618
3:4:2,1,1,101381,98619
4:1:6,0,-1,101382,98618
1:6:2,1,1,101381,98619
4:5:4,0,-1,101382,98618
1:4:3,0,-1,101383,98617
2:3:2,2,2,101381,98619
6:4:3,0,-1,101382,98618
6:5:6,0,-1,101383,98617
1:3:2,1,1,101382,98618
1:5:6,0,-1,101383,98617
4:2:5,1,1,101382,98618
4:2:6,1,1,101381,98619
1:3:6,0,-1,101382,98618
2:6:4,1,1,101381,98619
5:5:4,0,-1,101382,98618
5:1:3,0,-1,101383,98617
4:6:6,0,-1,101384,98616
5:6:3,0,-1,101385,98615
4:3:5,0,-1,101386,98614
3:4:2,1,1,101385,98615
5:2:3,1,1,101384,98616
2:6:6,1,1,101383,98617
3:5:1,0,-1,101384,98616
5:2:1,1,1,101383,98617
6:3:2,1,1,101382,98618
5:4:6,0,-1,101383,98617
2:4:5,1,1,101382,98618
2:6:4,1,1,101381,98619
3:2:1,1,1,101380,98620
5:2:5,1,1,101379,98621
2:6:2,2,2,101377,98623
5:2:1,1,1,101376,98624
1:1:5,0,-1,101377,98623
3:2:5,1,1,101376,98624
2:2:3,2,2,101374,98626
5:4:4,0,-1,101375,98625
3:4:3,0,-1,101376,98624
6:1:6,0,-1,101377,98623
3:1:6,0,-1,101378,98622
6:3:2,1,1,101377,98623
4:2:6,1,1,101376,98624
5:5:6,0,-1,101377,98623
6:6:5,0,-1,101378,98622
5:1:5,0,-1,101379,98621
6:1:3,0,-1,101380,98620
4:2:1,1,1,101379,98621
1:1:4,0,-1,101380,98620
2:4:5,1,1,101379,98621
5:1:6,0,-1,101380,98620
2:1:6,1,1,101379,98621
5:3:5,0,-1,101380,98620
6:6:5,0,-1,101381,98619
2:2:1,2,2,101379,98621
2:6:6,1,1,101378,98622
3:6:5,0,-1,101379,98621
4:4:4,0,-1,101380,98620
4:4:1,0,-1,101381,98619
3:3:1,0,-1,101382,98618
4:6:4,0,-1,101383,98617
5:5:3,0,-1,101384,98616
2:4:4,1,1,101383,98617
5:5:5,0,-1,101384,98616
2:5:3,1,1,101383,98617
1:5:6,0,-1,101384,98616
6:1:1,0,-1,101385,98615
3:6:1,0,-1,101386,98614
2:3:5,1,1,101385,98615
5:5:3,0,-1,101386,98614
6:4:1,0,-1,101387,98613
6:3:6,0,-1,101388,98612
2:2:3,2,2,101386,98614
6:1:3,0,-1,101387,98613
2:2:3,2,2,101385,98615
2:3:6,1,1,101384,98616
6:4:3,0,-1,101385,98615
1:4:3,0,-1,101386,98614
5:1:6,0,-1,101387,98613
4:4:6,0,-1,101388,98612
2:2:1,2,2,101386,98614
5:1:5,0,-1,101387,98613
2:3:2,2,2,101385,98615
2:1:2,2,2,101383,98617
6:2:6,1,1,101382,98618
3:1:6,0,-1,101383,98617
2:4:3,1,1,101382,98618
1:4:6,0,-1,101383,98617
4:6:1,0,-1,101384,98616
4:6:5,0,-1,101385,98615
1:6:1,0,-1,101386,98614
4:2:6,1,1,101385,98615
2:6:2,2,2,101383,98617
5:3:6,0,-1,101384,98616
1:5:5,0,-1,101385,98615
5:6:6,0,-1,101386,98614
1:1:5,0,-1,101387,98613
3:1:6,0,-1,101388,98612
6:5:2,1,1,101387,98613
4:6:2,1,1,101386,98614
4:1:3,0,-1,101387,98613
4:1:4,0,-1,101388,98612
3:6:1,0,-1,101389,98611
2:5:3,1,1,101388,98612
6:1:3,0,-1,101389,98611
4:5:6,0,-1,101390,98610
3:6:1,0,-1,101391,98609
1:2:6,1,1,101390,98610
5:6:2,1,1,101389,98611
4:4:3,0,-1,101390,98610
5:1:5,0,-1,101391,98609
4:3:3,0,-1,101392,98608
6:5:2,1,1,101391,98609
2:3:3,1,1,101390,98610
6:2:1,1,1,101389,98611
3:6:5,0,-1,101390,98610
5:6:5,0,-1,101391,98609
4:4:2,1,1,101390,98610
4:2:3,1,1,101389,98611
5:4:5,0,-1,101390,98610
1:4:2,1,1,101389,98611
5:3:1,0,-1,101390,98610
1:2:4,1,1,101389,98611
4:1:6,0,-1,101390,98610
4:5:4,0,-1,101391,98609
6:2:6,1,1,101390,98610
4:6:2,1,1,101389,98611
3:5:5,0,-1,101390,98610
5:3:3,0,-1,101391,98609
5:1:3,0,-1,101392,98608
2:2:4,2,2,101390,98610
1:6:5,0,-1,101391,98609
6:5:6,0,-1,101392,98608
5:1:2,1,1,101391,98609
6:3:2,1,1,101390,98610
6:6:6,0,-1,101391,98609
5:1:3,0,-1,101392,98608
1:4:1,0,-1,101393,98607
6:4:3,0,-1,101394,98606
6:2:3,1,1,101393,98607
4:5:1,0,-1,101394,98606
6:3:3,0,-1,101395,98605
6:3:6,0,-1,101396,98604
1:1:4,0,-1,101397,98603
2:2:1,2,2,101395,98605
2:6:1,1,1,101394,98606
4:6:3,0,-1,101395,98605
5:2:3,1,1,101394,98606
5:2:3,1,1,101393,98607
2:3:5,1,1,101392,98608
4:3:3,0,-1,101393,98607
1:3:6,0,-1,101394,98606
1:3:1,0,-1,101395,98605
1:3:5,0,-1,101396,98604
2:6:6,1,1,101395,98605
5:2:4,1,1,101394,98606
1:5:1,0,-1,101395,98605
4:6:1,0,-1,101396,98604
3:5:1,0,-1,101397,98603
5:1:4,0,-1,101398,98602
1:4:3,0,-1,101399,98601
2:1:3,1,1,101398,98602
6:3:6,0,-1,101399,98601
4:3:1,0,-1,101400,98600
5:1:1,0,-1,101401,98599
2:4:3,1,1,101400,98600
1:2:4,1,1,101399,98601
1:4:2,1,1,101398,98602
2:1:2,2,2,101396,98604
6:3:4,0,-1,101397,98603
4:2:6,1,1,101396,98604
3:1:2,1,1,101395,98605
5:3:6,0,-1,101396,98604
5:2:5,1,1,101395,98605
5:5:3,0,-1,101396,98604
5:3:6,0,-1,101397,98603
3:5:3,0,-1,101398,98602
3:5:1,0,-1,101399,98601
5:2:4,1,1,101398,98602
4:3:6,0,-1,101399,98601
3:6:1,0,-1,101400,98600
5:4:1,0,-1,101401,98599
5:6:2,1,1,101400,98600
4:5:3,0,-1,101401,98599
1:4:5,0,-1,101402,98598
6:6:1,0,-1,101403,98597
3:4:5,0,-1,101404,98596
1:6:2,1,1,101403,98597
6:2:1,1,1,101402,98598
5:1:3,0,-1,101403,98597
5:3:4,0,-1,101404,98596
6:3:6,0,-1,101405,98595
1:5:4,0,-1,101406,98594
4:5:3,0,-1,101407,98593
5:5:6,0,-1,101408,98592
2:3:2,2,2,101406,98594
1:4:1,0,-1,101407,98593
4:6:6,0,-1,101408,98592
4:3:5,0,-1,101409,98591
5:4:5,0,-1,101410,98590
1:2:1,1,1,101409,98591
5:2:2,2,2,101407,98593
1:3:2,1,1,101406,98594
2:3:3,1,1,101405,98595
3:6:5,0,-1,101406,98594
1:5:5,0,-1,101407,98593
1:2:2,2,2,101405,98595
5:2:1,1,1,101404,98596
5:4:6,0,-1,101405,98595
1:5:5,0,-1,101406,98594
3:3:3,0,-1,101407,98593
4:5:3,0,-1,101408,98592
2:1:4,1,1,101407,98593
4:1:2,1,1,101406,98594
6:6:5,0,-1,101407,98593
2:6:1,1,1,101406,98594
6:6:1,0,-1,101407,98593
1:2:5,1,1,101406,98594
4:4:3,0,-1,101407,98593
5:4:4,0,-1,101408,98592
1:2:3,1,1,101407,98593
5:1:4,0,-1,101408,98592
3:4:2,1,1,101407,98593
4:2:2,2,2,101405,98595
6:2:6,1,1,101404,98596
1:4:1,0,-1,101405,98595
6:2:3,1,1,101404,98596
6:4:6,0,-1,101405,98595
4:3:2,1,1,101404,98596
3:2:2,2,2,101402,98598
3:4:1,0,-1,101403,98597
6:5:6,0,-1,101404,98596
1:6:4,0,-1,101405,98595
5:3:6,0,-1,101406,98594
6:4:1,0,-1,101407,98593
5:4:6,0,-1,101408,98592
1:3:1,0,-1,101409,98591
5:5:1,0,-1,101410,98590
3:5:4,0,-1,101411,98589
1:5:3,0,-1,101412,98588
4:4:1,0,-1,101413,98587
3:5:4,0,-1,101414,98586
3:4:3,0,-1,101415,98585
6:2:2,2,2,101413,98587
6:6:5,0,-1,101414,98586
2:4:6,1,1,101413,98587
2:1:3,1,1,101412,98588
5:1:2,1,1,101411,98589
1:2:2,2,2,101409,98591
4:2:6,1,1,101408,98592
4:2:5,1,1,101407,98593
6:5:4,0,-1,101408,98592
4:3:4,0,-1,101409,98591
4:6:4,0,-1,101410,98590
5:6:6,0,-1,101411,98589
5:5:6,0,-1,101412,98588
3:3:3,0,-1,101413,98587
2:3:2,2,2,101411,98589
1:1:5,0,-1,101412,98588
6:5:3,0,-1,101413,98587
6:6:1,0,-1,101414,98586
2:6:6,1,1,101413,98587
1:2:3,1,1,101412,98588
4:5:1,0,-1,101413,98587
5:1:6,0,-1,101414,98586
6:4:4,0,-1,101415,98585
1:3:1,0,-1,101416,98584
4:4:4,0,-1,101417,98583
4:1:6,0,-1,101418,98582
6:5:6,0,-1,101419,98581
1:6:1,0,-1,101420,98580
5:2:6,1,1,101419,98581
4:5:2,1,1,101418,98582
6:1:4,0,-1,101419,98581
4:3:4,0,-1,101420,98580
6:4:4,0,-1,101421,98579
5:6:6,0,-1,101422,98578
4:5:3,0,-1,101423,98577
3:6:3,0,-1,101424,98576
4:4:1,0,-1,101425,98575
3:3:1,0,-1,101426,98574
2:3:2,2,2,101424,98576
3:4:5,0,-1,101425,98575
5:6:1,0,-1,101426,98574
4:4:2,1,1,101425,98575
2:2:6,2,2,101423,98577
6:3:6,0,-1,101424,98576
1:5:5,0,-1,101425,98575
1:1:2,1,1,101424,98576
5:2:1,1,1,101423,98577
2:1:4,1,1,101422,98578
2:1:6,1,1,101421,98579
5:5:1,0,-1,101422,98578
6:2:3,1,1,101421,98579
4:6:4,0,-1,101422,98578
6:2:4,1,1,101421,98579
6:3:4,0,-1,101422,98578
3:2:5,1,1,101421,98579
5:2:4,1,1,101420,98580
4:1:6,0,-1,101421,98579
6:5:3,0,-1,101422,98578
5:6:6,0,-1,101423,98577
3:6:5,0,-1,101424,98576
2:2:1,2,2,101422,98578
4:5:6,0,-1,101423,98577
5:6:4,0,-1,101424,98576
3:5:6,0,-1,101425,98575
6:6:1,0,-1,101426,98574
2:2:2,3,3,101423,98577
3:1:5,0,-1,101424,98576
2:3:2,2,2,101422,98578
3:2:1,1,1,101421,98579
5:4:3,0,-1,101422,98578
6:1:1,0,-1,101423,98577
3:6:2,1,1,101422,98578
2:5:3,1,1,101421,98579
6:1:2,1,1,101420,98580
3:4:3,0,-1,101421,98579
5:3:6,0,-1,101422,98578
2:1:1,1,1,101421,98579
5:6:6,0,-1,101422,98578
2:6:5,1,1,101421,98579
5:3:1,0,-1,101422,98578
1:4:2,1,1,101421,98579
2:6:3,1,1,101420,98580
1:2:6,1,1,101419,98581
5:1:6,0,-1,101420,98580
3:5:4,0,-1,101421,98579
5:6:2,1,1,101420,98580
6:4:3,0,-1,101421,98579
1:5:3,0,-1,101422,98578
4:2:6,1,1,101421,98579
6:1:6,0,-1,101422,98578
6:6:4,0,-1,101423,98577
4:1:5,0,-1,101424,98576
4:3:1,0,-1,101425,98575
5:1:5,0,-1,101426,98574
6:5:3,0,-1,101427,98573
6:2:6,1,1,101426,98574
4:6:3,0,-1,101427,98573
6:1:4,0,-1,101428,98572
3:4:6,0,-1,101429,98571
1:6:3,0,-1,101430,98570
4:4:1,0,-1,101431,98569
6:4:5,0,-1,101432,98568
2:6:5,1,1,101431,98569
5:6:3,0,-1,101432,98568
1:5:6,0,-1,101433,98567
1:2:3,1,1,101432,98568
3:2:2,2,2,101430,98570
3:6:6,0,-1,101431,98569
3:1:1,0,-1,101432,98568
4:3:3,0,-1,101433,98567
5:4:4,0,-1,101434,98566
2:6:3,1,1,101433,98567
6:5:1,0,-1,101434,98566
3:6:2,1,1,101433,98567
4:5:6,0,-1,101434,98566
5:1:5,0,-1,101435,98565
3:6:4,0,-1,101436,98564
3:6:4,0,-1,101437,98563
3:1:2,1,1,101436,98564
3:3:2,1,1,101435,98565
2:3:5,1,1,101434,98566
2:4:6,1,1,101433,98567
3:5:6,0,-1,101434,98566
3:1:2,1,1,101433,98567
1:5:6,0,-1,101434,98566
3:1:3,0,-1,101435,98565
6:1:4,0,-1,101436,98564
6:1:1,0,-1,101437,98563
2:1:3,1,1,101436,98564
2:4:6,1,1,101435,98565
2:4:2,2,2,101433,98567
5:2:5,1,1,101432,98568
2:3:1,1,1,101431,98569
2:3:4,1,1,101430,98570
3:2:2,2,2,101428,98572
4:1:4,0,-1,101429,98571
4:6:2,1,1,101428,98572
6:5:1,0,-1,101429,98571
1:1:1,0,-1,101430,98570
2:3:1,1,1,101429,98571
3:5:3,0,-1,101430,98570
5:3:6,0,-1,101431,98569
1:2:5,1,1,101430,98570
1:6:3,0,-1,101431,98569
4:2:6,1,1,101430,98570
3:1:4,0,-1,101431,98569
5:6:4,0,-1,101432,98568
1:3:1,0,-1,101433,98567
2:1:5,1,1,101432,98568
2:4:4,1,1,101431,98569
3:5:3,0,-1,101432,98568
1:2:6,1,1,101431,98569
2:3:2,2,2,101429,98571
1:5:5,0,-1,101430,98570
3:4:3,0,-1,101431,98569
2:4:2,2,2,101429,98571
5:6:1,0,-1,101430,98570
6:6:6,0,-1,101431,98569
1:3:2,1,1,101430,98570
6:6:3,0,-1,101431,98569
2:1:3,1,1,101430,98570
6:1:1,0,-1,101431,98569
3:1:2,1,1,101430,98570
6:6:3,0,-1,101431,98569
1:4:6,0,-1,101432,98568
2:4:4,1,1,101431,98569
2:5:2,2,2,101429,98571
6:6:6,0,-1,101430,98570
1:2:6,1,1,101429,98571
6:4:6,0,-1,101430,98570
2:1:2,2,2,101428,98572
4:4:1,0,-1,101429,98571
6:2:5,1,1,101428,98572
1:1:5,0,-1,101429,98571
4:4:3,0,-1,101430,98570
3:6:4,0,-1,101431,98569
2:6:5,1,1,101430,98570
4:2:1,1,1,101429,98571
5:3:6,0,-1,101430,98570
2:6:1,1,1,101429,98571
2:4:2,2,2,101427,98573
4:2:2,2,2,101425,98575
3:5:2,1,1,101424,98576
4:1:3,0,-1,101425,98575
5:4:6,0,-1,101426,98574
1:6:2,1,1,101425,98575
6:2:2,2,2,101423,98577
6:5:1,0,-1,101424,98576
4:4:5,0,-1,101425,98575
3:3:3,0,-1,101426,98574
5:4:2,1,1,101425,98575
2:5:4,1,1,101424,98576
4:6:2,1,1,101423,98577
6:4:4,0,-1,101424,98576
2:4:5,1,1,101423,98577
1:1:2,1,1,101422,98578
2:3:5,1,1,101421,98579
1:4:1,0,-1,101422,98578
3:4:2,1,1,101421,98579
3:4:4,0,-1,101422,98578
4:6:4,0,-1,101423,98577
6:1:2,1,1,101422,98578
5:5:6,0,-1,101423,98577
1:2:1,1,1,101422,98578
1:1:4,0,-1,101423,98577
5:4:5,0,-1,101424,98576
5:4:6,0,-1,101425,98575
1:5:5,0,-1,101426,98574
3:6:5,0,-1,101427,98573
2:6:3,1,1,101426,98574
4:1:2,1,1,101425,98575
4:2:1,1,1,101424,98576
1:4:4,0,-1,101425,98575
1:3:6,0,-1,101426,98574
5:1:6,0,-1,101427,98573
5:6:1,0,-1,101428,98572
4:5:3,0,-1,101429,98571
3:1:3,0,-1,101430,98570
3:1:3,0,-1,101431,98569
2:4:1,1,1,101430,98570
6:5:2,1,1,101429,98571
6:3:1,0,-1,101430,98570
2:2:2,3,3,101427,98573
6:6:5,0,-1,101428,98572
2:5:4,1,1,101427,98573
6:4:6,0,-1,101428,98572
4:6:5,0,-1,101429,98571
5:3:4,0,-1,101430,98570
6:5:4,0,-1,101431,98569
4:2:3,1,1,101430,98570
1:2:2,2,2,101428,98572
6:1:4,0,-1,101429,98571
5:6:1,0,-1,101430,98570
2:1:3,1,1,101429,98571
4:6:4,0,-1,101430,98570
6:2:6,1,1,101429,98571
1:6:6,0,-1,101430,98570
1:1:3,0,-1,101431,98569
2:4:4,1,1,101430,98570
2:6:2,2,2,101428,98572
1:2:1,1,1,101427,98573
1:2:5,1,1,101426,98574
1:3:4,0,-1,101427,98573
3:5:5,0,-1,101428,98572
2:4:1,1,1,101427,98573
1:5:6,0,-1,101428,98572
6:2:5,1,1,101427,98573
6:1:3,0,-1,101428,98572
6:3:5,0,-1,101429,98571
2:4:4,1,1,101428,98572
1:1:4,0,-1,101429,98571
1:3:4,0,-1,101430,98570
2:3:5,1,1,101429,98571
1:6:4,0,-1,101430,98570
4:4:2,1,1,101429,98571
3:3:5,0,-1,101430,98570
3:4:1,0,-1,101431,98569
1:1:6,0,-1,101432,98568
2:4:5,1,1,101431,98569
2:4:1,1,1,101430,98570
3:6:5,0,-1,101431,98569
1:3:6,0,-1,101432,98568
3:4:1,0,-1,101433,98567
1:5:1,0,-1,101434,98566
6:1:5,0,-1,101435,98565
4:4:3,0,-1,101436,98564
3:5:4,0,-1,101437,98563
4:2:1,1,1,101436,98564
2:3:4,1,1,101435,98565
3:4:2,1,1,101434,98566
1:5:1,0,-1,101435,98565
4:4:6,0,-1,101436,98564
1:4:6,0,-1,101437,98563
2:1:3,1,1,101436,98564
4:1:1,0,-1,101437,98563
3:6:5,0,-1,101438,98562
3:1:2,1,1,101437,98563
2:1:6,1,1,101436,98564
1:1:2,1,1,101435,98565
1:3:5,0,-1,101436,98564
5:4:6,0,-1,101437,98563
3:6:3,0,-1,101438,98562
2:3:6,1,1,101437,98563
1:4:2,1,1,101436,98564
2:3:2,2,2,101434,98566
4:3:1,0,-1,101435,98565
1:6:2,1,1,101434,98566
4:5:5,0,-1,101435,98565
2:6:1,1,1,101434,98566
3:6:3,0,-1,101435,98565
5:6:5,0,-1,101436,98564
4:6:6,0,-1,101437,98563
6:2:6,1,1,101436,98564
4:1:3,0,-1,101437,98563
3:1:6,0,-1,101438,98562
5:6:5,0,-1,101439,98561
5:2:3,1,1,101438,98562
1:3:6,0,-1,101439,98561
3:3:2,1,1,101438,98562
4:6:4,0,-1,101439,98561
4:3:5,0,-1,101440,98560
1:5:3,0,-1,101441,98559
1:3:3,0,-1,101442,98558
1:3:5,0,-1,101443,98557
5:5:4,0,-1,101444,98556
6:4:6,0,-1,101445,98555
4:5:6,0,-1,101446,98554
5:6:4,0,-1,101447,98553
3:6:2,1,1,101446,98554
4:5:5,0,-1,101447,98553
2:6:4,1,1,101446,98554
1:6:5,0,-1,101447,98553
2:4:5,1,1,101446,98554
1:3:5,0,-1,101447,98553
4:6:4,0,-1,101448,98552
2:3:4,1,1,101447,98553
3:1:2,1,1,101446,98554
3:5:1,0,-1,101447,98553
2:6:1,1,1,101446,98554
5:2:6,1,1,101445,98555
3:4:3,0,-1,101446,98554
4:3:3,0,-1,101447,98553
1:4:2,1,1,101446,98554
4:6:5,0,-1,101447,98553
4:3:3,0,-1,101448,98552
6:6:4,0,-1,101449,98551
6:3:3,0,-1,101450,98550
6:4:1,0,-1,101451,98549
6:4:4,0,-1,101452,98548
6:3:2,1,1,101451,98549
2:3:2,2,2,101449,98551
4:4:3,0,-1,101450,98550
5:6:1,0,-1,101451,98549
5:5:5,0,-1,101452,98548
2:5:2,2,2,101450,98550
3:5:1,0,-1,101451,98549
5:5:1,0,-1,101452,98548
3:1:4,0,-1,101453,98547
6:1:4,0,-1,101454,98546
1:6:5,0,-1,101455,98545
2:4:5,1,1,101454,98546
4:3:4,0,-1,101455,98545
2:4:4,1,1,101454,98546
5:6:2,1,1,101453,98547
5:5:4,0,-1,101454,98546
4:5:2,1,1,101453,98547
1:3:4,0,-1,101454,98546
5:3:6,0,-1,101455,98545
4:6:3,0,-1,101456,98544
3:4:3,0,-1,101457,98543
3:5:5,0,-1,101458,98542
6:5:2,1,1,101457,98543
1:4:1,0,-1,101458,98542
2:5:3,1,1,101457,98543
6:6:1,0,-1,101458,98542
2:5:1,1,1,101457,98543
2:1:4,1,1,101456,98544
3:5:6,0,-1,101457,98543
2:4:6,1,1,101456,98544
6:4:5,0,-1,101457,98543
2:4:5,1,1,101456,98544
6:3:6,0,-1,101457,98543
1:1:2,1,1,101456,98544
3:2:5,1,1,101455,98545
2:6:6,1,1,101454,98546
6:4:4,0,-1,101455,98545
2:2:6,2,2,101453,98547
3:5:2,1,1,101452,98548
6:3:6,0,-1,101453,98547
1:6:5,0,-1,101454,98546
2:4:3,1,1,101453,98547
2:5:4,1,1,101452,98548
5:5:1,0,-1,101453,98547
5:1:2,1,1,101452,98548
3:2:4,1,1,101451,98549
4:2:6,1,1,101450,98550
3:5:5,0,-1,101451,98549
2:6:6,1,1,101450,98550
4:1:3,0,-1,101451,98549
2:5:3,1,1,101450,98550
5:4:6,0,-1,101451,98549
3:6:4,0,-1,101452,98548
6:2:5,1,1,101451,98549
6:6:5,0,-1,101452,98548
2:1:2,2,2,101450,98550
1:2:5,1,1,101449,98551
6:4:6,0,-1,101450,98550
1:2:6,1,1,101449,98551
1:6:6,0,-1,101450,98550
5:5:1,0,-1,101451,98549
6:1:2,1,1,101450,98550
2:1:6,1,1,101449,98551
2:4:6,1,1,101448,98552
6:1:2,1,1,101447,98553
2:4:2,2,2,101445,98555
5:5:4,0,-1,101446,98554
2:1:1,1,1,101445,98555
4:2:1,1,1,101444,98556
3:5:1,0,-1,101445,98555
3:5:3,0,-1,101446,98554
2:4:3,1,1,101445,98555
5:2:2,2,2,101443,98557
4:4:1,0,-1,101444,98556
5:2:6,1,1,101443,98557
3:6:1,0,-1,101444,98556
3:1:2,1,1,101443,98557
6:3:3,0,-1,101444,98556
6:3:4,0,-1,101445,98555
1:4:4,0,-1,101446,98554
3:1:3,0,-1,101447,98553
4:1:2,1,1,101446,98554
6:4:5,0,-1,101447,98553
5:4:5,0,-1,101448,98552
6:1:1,0,-1,101449,98551
3:4:2,1,1,101448,98552
2:1:6,1,1,101447,98553
2:2:3,2,2,101445,98555
2:6:5,1,1,101444,98556
1:2:2,2,2,101442,98558
6:6:6,0,-1,101443,98557
4:5:2,1,1,101442,98558
6:1:1,0,-1,101443,98557
4:6:6,0,-1,101444,98556
2:5:3,1,1,101443,98557
6:3:3,0,-1,101444,98556
2:5:4,1,1,101443,98557
5:5:3,0,-1,101444,98556
2:1:4,1,1,101443,98557
3:1:4,0,-1,101444,98556
6:2:1,1,1,101443,98557
5:2:4,1,1,101442,98558
3:5:2,1,1,101441,98559
1:1:3,0,-1,101442,98558
3:3:1,0,-1,101443,98557
4:6:5,0,-1,101444,98556
5:3:4,0,-1,101445,98555
6:5:3,0,-1,101446,98554
2:1:5,1,1,101445,98555
4:2:5,1,1,101444,98556
5:3:6,0,-1,101445,98555
4:1:6,0,-1,101446,98554
5:1:5,0,-1,101447,98553
1:1:1,0,-1,101448,98552
6:4:1,0,-1,101449,98551
4:2:2,2,2,101447,98553
2:5:6,1,1,101446,98554
2:2:4,2,2,101444,98556
2:1:6,1,1,101443,98557
1:5:1,0,-1,101444,98556
4:3:1,0,-1,101445,98555
5:4:5,0,-1,101446,98554
4:1:5,0,-1,101447,98553
5:5:5,0,-1,101448,98552
5:2:2,2,2,101446,98554
1:6:3,0,-1,101447,98553
3:4:4,0,-1,101448,98552
6:1:2,1,1,101447,98553
4:4:1,0,-1,101448,98552
5:1:4,0,-1,101449,98551
1:6:1,0,-1,101450,98550
3:1:3,0,-1,101451,98549
1:6:4,0,-1,101452,98548
2:2:4,2,2,101450,98550
6:6:2,1,1,101449,98551
4:1:2,1,1,101448,98552
1:3:5,0,-1,101449,98551
4:6:1,0,-1,101450,98550
2:6:4,1,1,101449,98551
3:6:4,0,-1,101450,98550
6:4:3,0,-1,101451,98549
5:3:3,0,-1,101452,98548
6:2:1,1,1,101451,98549
2:6:4,1,1,101450,98550
1:2:5,1,1,101449,98551
3:6:6,0,-1,101450,98550
5:3:3,0,-1,101451,98549
4:4:4,0,-1,101452,98548
6:4:4,0,-1,101453,98547
4:2:6,1,1,101452,98548
1:3:3,0,-1,101453,98547
6:6:4,0,-1,101454,98546
5:5:5,0,-1,101455,98545
2:2:4,2,2,101453,98547
1:1:2,1,1,101452,98548
4:6:1,0,-1,101453,98547
6:1:6,0,-1,101454,98546
1:3:5,0,-1,101455,98545
6:5:6,0,-1,101456,98544
6:6:4,0,-1,101457,98543
6:1:1,0,-1,101458,98542
4:6:2,1,1,101457,98543
3:1:6,0,-1,101458,98542
2:6:3,1,1,101457,98543
2:3:5,1,1,101456,98544
6:3:2,1,1,101455,98545
5:4:4,0,-1,101456,98544
6:4:4,0,-1,101457,98543
2:2:2,3,3,101454,98546
1:4:6,0,-1,101455,98545
1:4:5,0,-1,101456,98544
1:3:3,0,-1,101457,98543
1:1:5,0,-1,101458,98542
2:3:6,1,1,101457,98543
5:5:3,0,-1,101458,98542
5:5:3,0,-1,101459,98541
4:5:3,0,-1,101460,98540
4:3:2,1,1,101459,98541
3:1:4,0,-1,101460,98540
3:2:2,2,2,101458,98542
3:2:4,1,1,101457,98543
2:4:4,1,1,101456,98544
1:4:6,0,-1,101457,98543
5:1:1,0,-1,101458,98542
2:1:4,1,1,101457,98543
5:4:6,0,-1,101458,98542
1:3:4,0,-1,101459,98541
3:2:2,2,2,101457,98543
2:5:5,1,1,101456,98544
1:2:6,1,1,101455,98545
3:4:1,0,-1,101456,98544
1:6:6,0,-1,101457,98543
6:3:4,0,-1,101458,98542
1:4:6,0,-1,101459,98541
3:2:4,1,1,101458,98542
5:5:1,0,-1,101459,98541
5:6:6,0,-1,101460,98540
3:2:5,1,1,101459,98541
1:6:5,0,-1,101460,98540
6:1:5,0,-1,101461,98539
5:4:2,1,1,101460,98540
1:1:2,1,1,101459,98541
6:5:3,0,-1,101460,98540
2:4:4,1,1,101459,98541
3:6:6,0,-1,101460,98540
5:6:3,0,-1,101461,98539
6:2:6,1,1,101460,98540
1:6:4,0,-1,101461,98539
5:3:3,0,-1,101462,98538
6:1:1,0,-1,101463,98537
3:1:3,0,-1,101464,98536
2:3:5,1,1,101463,98537
5:4:4,0,-1,101464,98536
2:3:4,1,1,101463,98537
3:3:3,0,-1,101464,98536
4:3:2,1,1,101463,98537
2:2:4,2,2,101461,98539
6:3:5,0,-1,101462,98538
4:3:3,0,-1,101463,98537
3:1:1,0,-1,101464,98536
6:1:5,0,-1,101465,98535
6:6:1,0,-1,101466,98534
4:4:2,1,1,101465,98535
4:2:2,2,2,101463,98537
6:5:2,1,1,101462,98538
4:5:4,0,-1,101463,98537
1:2:5,1,1,101462,98538
2:1:6,1,1,101461,98539
4:4:6,0,-1,101462,98538
5:6:6,0,-1,101463,98537
3:6:2,1,1,101462,98538
4:2:6,1,1,101461,98539
5:6:2,1,1,101460,98540
6:3:5,0,-1,101461,98539
4:4:6,0,-1,101462,98538
4:1:3,0,-1,101463,98537
1:6:5,0,-1,101464,98536
6:6:1,0,-1,101465,98535
4:6:1,0,-1,101466,98534
5:3:5,0,-1,101467,98533
3:6:2,1,1,101466,98534
4:2:6,1,1,101465,98535
3:4:3,0,-1,101466,98534
4:1:4,0,-1,101467,98533
5:2:5,1,1,101466,98534
5:6:2,1,1,101465,98535
4:2:2,2,2,101463,98537
2:6:6,1,1,101462,98538
4:6:6,0,-1,101463,98537
1:1:6,0,-1,101464,98536
3:6:6,0,-1,101465,98535
2:6:6,1,1,101464,98536
6:5:3,0,-1,101465,98535
2:3:2,2,2,101463,98537
2:5:1,1,1,101462,98538
6:5:6,0,-1,101463,98537
3:3:1,0,-1,101464,98536
1:2:1,1,1,101463,98537
2:1:2,2,2,101461,98539
2:4:1,1,1,101460,98540
1:5:4,0,-1,101461,98539
1:1:4,0,-1,101462,98538
3:5:6,0,-1,101463,98537
4:5:3,0,-1,101464,98536
1:3:1,0,-1,101465,98535
1:6:4,0,-1,101466,98534
4:6:3,0,-1,101467,98533
1:4:6,0,-1,101468,98532
2:5:1,1,1,101467,98533
5:2:2,2,2,101465,98535
4:1:6,0,-1,101466,98534
6:4:5,0,-1,101467,98533
4:2:3,1,1,101466,98534
4:1:6,0,-1,101467,98533
5:4:6,0,-1,101468,98532
1:6:5,0,-1,101469,98531
6:3:2,1,1,101468,98532
3:6:5,0,-1,101469,98531
3:4:2,1,1,101468,98532
5:2:2,2,2,101466,98534
1:3:4,0,-1,101467,98533
5:1:1,0,-1,101468,98532
6:6:3,0,-1,101469,98531
2:3:3,1,1,101468,98532
1:1:4,0,-1,101469,98531
6:5:1,0,-1,101470,98530
1:2:3,1,1,101469,98531
5:4:2,1,1,101468,98532
5:5:6,0,-1,101469,98531
2:4:6,1,1,101468,98532
1:3:1,0,-1,101469,98531
6:3:1,0,-1,101470,98530
4:1:1,0,-1,101471,98529
5:6:2,1,1,101470,98530
2:3:5,1,1,101469,98531
2:1:5,1,1,101468,98532
6:2:2,2,2,101466,98534
1:3:5,0,-1,101467,98533
4:6:6,0,-1,101468,98532
5:5:4,0,-1,101469,98531
6:4:2,1,1,101468,98532
4:6:6,0,-1,101469,98531
3:5:6,0,-1,101470,98530
5:3:5,0,-1,101471,98529
1:6:4,0,-1,101472,98528
6:1:3,0,-1,101473,98527
6:5:4,0,-1,101474,98526
4:1:6,0,-1,101475,98525
3:5:1,0,-1,101476,98524
4:1:5,0,-1,101477,98523
5:4:4,0,-1,101478,98522
2:1:2,2,2,101476,98524
2:6:4,1,1,101475,98525
3:3:1,0,-1,101476,98524
3:5:3,0,-1,101477,98523
2:4:6,1,1,101476,98524
3:1:4,0,-1,101477,98523
1:3:2,1,1,101476,98524
6:6:6,0,-1,101477,98523
2:4:3,1,1,101476,98524
1:2:3,1,1,101475,98525
5:6:5,0,-1,101476,98524
5:1:2,1,1,101475,98525
3:5:6,0,-1,101476,98524
6:1:4,0,-1,101477,98523
5:3:3,0,-1,101478,98522
4:6:6,0,-1,101479,98521
1:4:1,0,-1,101480,98520
2:1:2,2,2,101478,98522
4:1:5,0,-1,101479,98521
6:4:2,1,1,101478,98522
6:3:5,0,-1,101479,98521
5:6:6,0,-1,101480,98520
6:1:6,0,-1,101481,98519
5:5:5,0,-1,101482,98518
3:6:1,0,-1,101483,98517
3:4:3,0,-1,101484,98516
2:2:2,3,3,101481,98519
3:4:3,0,-1,101482,98518
1:4:3,0,-1,101483,98517
6:2:5,1,1,101482,98518
1:1:5,0,-1,101483,98517
3:4:4,0,-1,101484,98516
4:4:6,0,-1,101485,98515
4:4:2,1,1,101484,98516
1:1:3,0,-1,101485,98515
2:4:2,2,2,101483,98517
3:5:1,0,-1,101484,98516
1:3:3,0,-1,101485,98515
5:2:1,1,1,101484,98516
4:3:6,0,-1,101485,98515
1:3:6,0,-1,101486,98514
6:1:3,0,-1,101487,98513
5:3:6,0,-1,101488,98512
6:5:5,0,-1,101489,98511
3:3:3,0,-1,101490,98510
4:6:5,0,-1,101491,98509
4:6:2,1,1,101490,98510
3:4:6,0,-1,101491,98509
2:3:6,1,1,101490,98510
4:1:2,1,1,101489,98511
6:6:2,1,1,101488,98512
2:1:4,1,1,101487,98513
1:4:2,1,1,101486,98514
4:2:1,1,1,101485,98515
3:1:2,1,1,101484,98516
5:1:5,0,-1,101485,98515
6:6:4,0,-1,101486,98514
5:4:2,1,1,101485,98515
4:3:3,0,-1,101486,98514
1:6:6,0,-1,101487,98513
5:4:6,0,-1,101488,98512
5:5:5,0,-1,101489,98511
5:6:6,0,-1,101490,98510
6:4:1,0,-1,101491,98509
1:5:4,0,-1,101492,98508
2:2:2,3,3,101489,98511
3:6:4,0,-1,101490,98510
3:4:6,0,-1,101491,98509
2:3:2,2,2,101489,98511
2:5:2,2,2,101487,98513
1:4:1,0,-1,101488,98512
2:6:6,1,1,101487,98513
4:3:2,1,1,101486,98514
3:2:6,1,1,101485,98515
4:6:1,0,-1,101486,98514
1:3:2,1,1,101485,98515
4:6:5,0,-1,101486,98514
4:1:1,0,-1,101487,98513
1:6:4,0,-1,101488,98512
2:1:6,1,1,101487,98513
4:4:1,0,-1,101488,98512
3:3:4,0,-1,101489,98511
5:3:1,0,-1,101490,98510
4:3:1,0,-1,101491,98509
6:2:4,1,1,101490,98510
3:5:3,0,-1,101491,98509
1:1:1,0,-1,101492,98508
1:3:6,0,-1,101493,98507
2:2:1,2,2,101491,98509
5:6:5,0,-1,101492,98508
6:4:6,0,-1,101493,98507
6:1:6,0,-1,101494,98506
6:1:3,0,-1,101495,98505
4:4:4,0,-1,101496,98504
6:6:6,0,-1,101497,98503
6:6:2,1,1,101496,98504
4:1:3,0,-1,101497,98503
1:5:3,0,-1,101498,98502
4:4:4,0,-1,101499,98501
3:3:2,1,1,101498,98502
3:6:2,1,1,101497,98503
4:4:4,0,-1,101498,98502
3:4:6,0,-1,101499,98501
6:6:4,0,-1,101500,98500
6:4:5,0,-1,101501,98499
5:5:4,0,-1,101502,98498
5:4:3,0,-1,101503,98497
1:4:2,1,1,101502,98498
6:4:5,0,-1,101503,98497
1:6:5,0,-1,101504,98496
3:2:2,2,2,101502,98498
3:5:3,0,-1,101503,98497
6:3:3,0,-1,101504,98496
2:6:4,1,1,101503,98497
2:6:6,1,1,101502,98498
5:5:1,0,-1,101503,98497
1:2:5,1,1,101502,98498
5:4:1,0,-1,101503,98497
6:1:5,0,-1,101504,98496
3:3:5,0,-1,101505,98495
5:5:2,1,1,101504,98496
5:2:6,1,1,101503,98497
2:5:1,1,1,101502,98498
2:6:5,1,1,101501,98499
5:3:3,0,-1,101502,98498
4:3:2,1,1,101501,98499
5:4:5,0,-1,101502,98498
1:6:2,1,1,101501,98499
3:1:2,1,1,101500,98500
1:4:1,0,-1,101501,98499
5:3:2,1,1,101500,98500
6:1:6,0,-1,101501,98499
1:2:4,1,1,101500,98500
5:6:6,0,-1,101501,98499
1:5:3,0,-1,101502,98498
4:5:6,0,-1,101503,98497
5:1:4,0,-1,101504,98496
6:2:1,1,1,101503,98497
5:2:6,1,1,101502,98498
5:2:3,1,1,101501,98499
6:4:6,0,-1,101502,98498
4:5:1,0,-1,101503,98497
6:6:5,0,-1,101504,98496
1:6:1,0,-1,101505,98495
4:2:5,1,1,101504,98496
6:6:4,0,-1,101505,98495
3:5:2,1,1,101504,98496
5:3:3,0,-1,101505,98495
1:4:6,0,-1,101506,98494
3:1:6,0,-1,101507,98493
3:6:2,1,1,101506,98494
5:3:5,0,-1,101507,98493
3:1:3,0,-1,101508,98492
4:6:2,1,1,101507,98493
3:2:1,1,1,101506,98494
2:3:2,2,2,101504,98496
6:4:4,0,-1,101505,98495
2:1:1,1,1,101504,98496
1:1:1,0,-1,101505,98495
3:1:2,1,1,101504,98496
1:4:2,1,1,101503,98497
5:1:1,0,-1,101504,98496
3:3:3,0,-1,101505,98495
4:6:2,1,1,101504,98496
4:1:6,0,-1,101505,98495
4:1:1,0,-1,101506,98494
1:2:3,1,1,101505,98495
5:5:3,0,-1,101506,98494
6:1:6,0,-1,101507,98493
5:6:6,0,-1,101508,98492
1:2:5,1,1,101507,98493
6:2:4,1,1,101506,98494
3:5:1,0,-1,101507,98493
4:4:2,1,1,101506,98494
4:2:1,1,1,101505,98495
5:2:3,1,1,101504,98496
1:5:3,0,-1,101505,98495
3:2:5,1,1,101504,98496
6:2:2,2,2,101502,98498
4:1:6,0,-1,101503,98497
3:6:4,0,-1,101504,98496
6:2:3,1,1,101503,98497
5:5:6,0,-1,101504,98496
5:3:4,0,-1,101505,98495
2:4:2,2,2,101503,98497
4:3:2,1,1,101502,98498
5:4:5,0,-1,101503,98497
4:1:3,0,-1,101504,98496
5:2:2,2,2,101502,98498
6:4:6,0,-1,101503,98497
6:4:2,1,1,101502,98498
4:4:1,0,-1,101503,98497
5:3:1,0,-1,101504,98496
1:4:3,0,-1,101505,98495
1:2:5,1,1,101504,98496
4:2:1,1,1,101503,98497
5:2:4,1,1,101502,98498
2:6:6,1,1,101501,98499
4:4:2,1,1,101500,98500
3:4:6,0,-1,101501,98499
5:3:4,0,-1,101502,98498
4:5:3,0,-1,101503,98497
4:1:6,0,-1,101504,98496
5:5:3,0,-1,101505,98495
1:6:2,1,1,101504,98496
4:3:2,1,1,101503,98497
5:1:6,0,-1,101504,98496
6:1:1,0,-1,101505,98495
1:2:3,1,1,101504,98496
6:1:2,1,1,101503,98497
1:2:3,1,1,101502,98498
1:4:1,0,-1,101503,98497
3:4:2,1,1,101502,98498
2:2:5,2,2,101500,98500
5:3:2,1,1,101499,98501
4:5:2,1,1,101498,98502
3:1:6,0,-1,101499,98501
1:1:4,0,-1,101500,98500
2:3:6,1,1,101499,98501
6:3:3,0,-1,101500,98500
2:2:1,2,2,101498,98502
5:6:3,0,-1,101499,98501
4:4:5,0,-1,101500,98500
6:5:2,1,1,101499,98501
1:2:1,1,1,101498,98502
5:3:6,0,-1,101499,98501
6:4:4,0,-1,101500,98500
4:3:1,0,-1,101501,98499
2:2:5,2,2,101499,98501
2:5:4,1,1,101498,98502
3:6:4,0,-1,101499,98501
5:6:6,0,-1,101500,98500
2:5:3,1,1,101499,98501
5:4:2,1,1,101498,98502
5:6:2,1,1,101497,98503
1:1:6,0,-1,101498,98502
2:3:5,1,1,101497,98503
4:5:6,0,-1,101498,98502
6:3:6,0,-1,101499,98501
4:3:5,0,-1,101500,98500
1:4:1,0,-1,101501,98499
3:1:2,1,1,101500,98500
3:5:6,0,-1,101501,98499
1:4:1,0,-1,101502,98498
1:1:2,1,1,101501,98499
5:5:3,0,-1,101502,98498
3:2:1,1,1,101501,98499
2:4:6,1,1,101500,98500
2:3:4,1,1,101499,98501
1:5:6,0,-1,101500,98500
2:6:2,2,2,101498,98502
5:2:4,1,1,101497,98503
1:5:1,0,-1,101498,98502
4:3:5,0,-1,101499,98501
6:2:6,1,1,101498,98502
5:4:6,0,-1,101499,98501
4:6:6,0,-1,101500,98500
5:4:3,0,-1,101501,98499
3:6:3,0,-1,101502,98498
1:4:1,0,-1,101503,98497
3:4:2,1,1,101502,98498
6:3:5,0,-1,101503,98497
2:5:5,1,1,101502,98498
3:5:2,1,1,101501,98499
5:3:2,1,1,101500,98500
4:3:3,0,-1,101501,98499
2:3:3,1,1,101500,98500
2:3:1,1,1,101499,98501
5:1:6,0,-1,101500,98500
2:5:6,1,1,101499,98501
3:1:4,0,-1,101500,98500
1:6:6,0,-1,101501,98499
3:6:6,0,-1,101502,98498
5:6:5,0,-1,101503,98497
5:5:6,0,-1,101504,98496
2:2:6,2,2,101502,98498
1:4:5,0,-1,101503,98497
5:1:3,0,-1,101504,98496
4:1:2,1,1,101503,98497
2:5:5,1,1,101502,98498
3:3:6,0,-1,101503,98497
2:2:6,2,2,101501,98499
4:2:1,1,1,101500,98500
2:4:2,2,2,101498,98502
6:4:3,0,-1,101499,98501
6:3:1,0,-1,101500,98500
1:5:2,1,1,101499,98501
1:3:1,0,-1,101500,98500
1:6:3,0,-1,101501,98499
5:4:5,0,-1,101502,98498
1:5:2,1,1,101501,98499
2:1:2,2,2,101499,98501
3:5:2,1,1,101498,98502
2:5:2,2,2,101496,98504
1:4:5,0,-1,101497,98503
1:2:3,1,1,101496,98504
1:2:5,1,1,101495,98505
3:3:3,0,-1,101496,98504
1:3:3,0,-1,101497,98503
4:1:5,0,-1,101498,98502
1:3:3,0,-1,101499,98501
3:3:5,0,-1,101500,98500
5:6:3,0,-1,101501,98499
6:6:4,0,-1,101502,98498
6:4:1,0,-1,101503,98497
6:4:1,0,-1,101504,98496
2:4:5,1,1,101503,98497
3:6:3,0,-1,101504,98496
2:5:4,1,1,101503,98497
4:5:2,1,1,101502,98498
4:2:1,1,1,101501,98499
6:5:1,0,-1,101502,98498
3:1:6,0,-1,101503,98497
5:2:5,1,1,101502,98498
2:3:2,2,2,101500,98500
4:2:3,1,1,101499,98501
6:2:3,1,1,101498,98502
3:3:6,0,-1,101499,98501
2:5:1,1,1,101498,98502
2:1:3,1,1,101497,98503
1:6:2,1,1,101496,98504
1:6:6,0,-1,101497,98503
1:6:4,0,-1,101498,98502
2:2:4,2,2,101496,98504
6:2:1,1,1,101495,98505
4:4:3,0,-1,101496,98504
4:2:4,1,1,101495,98505
1:5:5,0,-1,101496,98504
5:2:1,1,1,101495,98505
4:3:1,0,-1,101496,98504
4:2:4,1,1,101495,98505
2:5:6,1,1,101494,98506
3:2:4,1,1,101493,98507
5:5:3,0,-1,101494,98506
1:3:5,0,-1,101495,98505
5:3:6,0,-1,101496,98504
3:5:4,0,-1,101497,98503
4:4:1,0,-1,101498,98502
5:2:2,2,2,101496,98504
1:5:3,0,-1,101497,98503
6:1:6,0,-1,101498,98502
6:2:2,2,2,101496,98504
3:5:5,0,-1,101497,98503
5:5:4,0,-1,101498,98502
6:4:4,0,-1,101499,98501
1:6:3,0,-1,101500,98500
5:4:5,0,-1,101501,98499
4:2:5,1,1,101500,98500
5:2:1,1,1,101499,98501
1:4:1,0,-1,101500,98500
3:4:5,0,-1,101501,98499
1:1:4,0,-1,101502,98498
6:4:3,0,-1,101503,98497
4:1:3,0,-1,101504,98496
2:4:3,1,1,101503,98497
5:3:6,0,-1,101504,98496
3:1:2,1,1,101503,98497
5:4:2,1,1,101502,98498
2:1:2,2,2,101500,98500
2:4:6,1,1,101499,98501
1:4:1,0,-1,101500,98500
5:5:3,0,-1,101501,98499
4:4:4,0,-1,101502,98498
5:3:3,0,-1,101503,98497
4:5:4,0,-1,101504,98496
3:4:4,0,-1,101505,98495
1:4:5,0,-1,101506,98494
2:2:5,2,2,101504,98496
6:1:6,0,-1,101505,98495
6:3:6,0,-1,101506,98494
3:2:3,1,1,101505,98495
3:5:4,0,-1,101506,98494
2:2:4,2,2,101504,98496
4:5:5,0,-1,101505,98495
6:2:4,1,1,101504,98496
1:5:3,0,-1,101505,98495
6:1:3,0,-1,101506,98494
1:4:3,0,-1,101507,98493
6:6:2,1,1,101506,98494
2:2:5,2,2,101504,98496
1:3:6,0,-1,101505,98495
5:1:3,0,-1,101506,98494
1:4:3,0,-1,101507,98493
4:5:5,0,-1,101508,98492
2:3:1,1,1,101507,98493
2:6:4,1,1,101506,98494
5:4:2,1,1,101505,98495
1:4:6,0,-1,101506,98494
2:6:6,1,1,101505,98495
6:5:4,0,-1,101506,98494
3:5:2,1,1,101505,98495
2:3:4,1,1,101504,98496
6:3:5,0,-1,101505,98495
5:4:2,1,1,101504,98496
2:4:3,1,1,101503,98497
3:6:6,0,-1,101504,98496
5:2:3,1,1,101503,98497
3:5:4,0,-1,101504,98496
3:5:6,0,-1,101505,98495
3:4:4,0,-1,101506,98494
6:2:3,1,1,101505,98495
6:2:2,2,2,101503,98497
5:6:1,0,-1,101504,98496
5:2:5,1,1,101503,98497
3:1:2,1,1,101502,98498
4:4:1,0,-1,101503,98497
1:2:5,1,1,101502,98498
4:3:6,0,-1,101503,98497
5:1:2,1,1,101502,98498
6:4:2,1,1,101501,98499
1:4:2,1,1,101500,98500
1:5:2,1,1,101499,98501
3:4:1,0,-1,101500,98500
4:5:3,0,-1,101501,98499
3:6:1,0,-1,101502,98498
5:4:3,0,-1,101503,98497
6:1:5,0,-1,101504,98496
4:4:3,0,-1,101505,98495
6:5:6,0,-1,101506,98494
5:2:5,1,1,101505,98495
2:1:5,1,1,101504,98496
1:5:2,1,1,101503,98497
1:6:5,0,-1,101504,98496
2:3:3,1,1,101503,98497
3:4:6,0,-1,101504,98496
4:6:1,0,-1,101505,98495
3:6:2,1,1,101504,98496
1:5:2,1,1,101503,98497
2:2:1,2,2,101501,98499
5:3:1,0,-1,101502,98498
6:5:6,0,-1,101503,98497
4:6:4,0,-1,101504,98496
6:3:2,1,1,101503,98497
6:1:3,0,-1,101504,98496
4:5:2,1,1,101503,98497
5:6:2,1,1,101502,98498
2:5:5,1,1,101501,98499
4:2:6,1,1,101500,98500
1:2:1,1,1,101499,98501
6:5:3,0,-1,101500,98500
5:1:2,1,1,101499,98501
4:5:4,0,-1,101500,98500
4:3:1,0,-1,101501,98499
6:4:4,0,-1,101502,98498
2:5:2,2,2,101500,98500
6:2:5,1,1,101499,98501
4:3:2,1,1,101498,98502
3:2:6,1,1,101497,98503
2:3:6,1,1,101496,98504
5:4:2,1,1,101495,98505
2:6:2,2,2,101493,98507
4:2:5,1,1,101492,98508
5:5:4,0,-1,101493,98507
5:5:4,0,-1,101494,98506
5:6:2,1,1,101493,98507
3:5:5,0,-1,101494,98506
6:2:5,1,1,101493,98507
4:6:2,1,1,101492,98508
5:2:4,1,1,101491,98509
2:5:1,1,1,101490,98510
1:6:2,1,1,101489,98511
1:4:1,0,-1,101490,98510
1:6:1,0,-1,101491,98509
3:2:1,1,1,101490,98510
4:5:3,0,-1,101491,98509
1:1:2,1,1,101490,98510
5:5:3,0,-1,101491,98509
3:3:1,0,-1,101492,98508
2:5:1,1,1,101491,98509
6:1:5,0,-1,101492,98508
6:3:3,0,-1,101493,98507
6:6:6,0,-1,101494,98506
5:3:2,1,1,101493,98507
5:2:6,1,1,101492,98508
5:1:1,0,-1,101493,98507
1:3:4,0,-1,101494,98506
1:1:4,0,-1,101495,98505
6:3:4,0,-1,101496,98504
4:3:3,0,-1,101497,98503
6:4:3,0,-1,101498,98502
3:6:6,0,-1,101499,98501
1:1:2,1,1,101498,98502
3:5:5,0,-1,101499,98501
5:5:5,0,-1,101500,98500
4:2:5,1,1,101499,98501
4:5:3,0,-1,101500,98500
1:6:2,1,1,101499,98501
1:1:6,0,-1,101500,98500
4:4:1,0,-1,101501,98499
4:5:4,0,-1,101502,98498
6:5:1,0,-1,101503,98497
3:5:5,0,-1,101504,98496
1:4:6,0,-1,101505,98495
6:4:4,0,-1,101506,98494
1:1:3,0,-1,101507,98493
4:2:2,2,2,101505,98495
2:3:2,2,2,101503,98497
2:4:6,1,1,101502,98498
2:6:3,1,1,101501,98499
4:2:4,1,1,101500,98500
1:1:1,0,-1,101501,98499
4:2:1,1,1,101500,98500
4:1:1,0,-1,101501,98499
1:3:5,0,-1,101502,98498
4:2:2,2,2,101500,98500
3:1:3,0,-1,101501,98499
1:5:3,0,-1,101502,98498
2:3:3,1,1,101501,98499
1:2:5,1,1,101500,98500
1:3:2,1,1,101499,98501
6:4:3,0,-1,101500,98500
6:5:3,0,-1,101501,98499
4:3:5,0,-1,101502,98498
6:5:4,0,-1,101503,98497
3:4:2,1,1,101502,98498
2:1:5,1,1,101501,98499
1:4:6,0,-1,101502,98498
4:3:4,0,-1,101503,98497
5:4:2,1,1,101502,98498
5:5:6,0,-1,101503,98497
2:2:6,2,2,101501,98499
5:5:6,0,-1,101502,98498
2:2:5,2,2,101500,98500
2:3:3,1,1,101499,98501
2:1:4,1,1,101498,98502
3:1:2,1,1,101497,98503
1:6:1,0,-1,101498,98502
1:4:3,0,-1,101499,98501
1:3:6,0,-1,101500,98500
1:2:4,1,1,101499,98501
4:1:1,0,-1,101500,98500
4:2:6,1,1,101499,98501
1:5:5,0,-1,101500,98500
5:2:6,1,1,101499,98501
4:2:4,1,1,101498,98502
5:4:1,0,-1,101499,98501
2:4:5,1,1,101498,98502
6:2:2,2,2,101496,98504
6:1:2,1,1,101495,98505
1:1:6,0,-1,101496,98504
2:6:3,1,1,101495,98505
1:3:2,1,1,101494,98506
6:3:5,0,-1,101495,98505
1:4:3,0,-1,101496,98504
1:5:3,0,-1,101497,98503
4:2:4,1,1,101496,98504
5:5:4,0,-1,101497,98503
1:4:6,0,-1,101498,98502
2:2:2,3,3,101495,98505
6:5:2,1,1,101494,98506
5:2:1,1,1,101493,98507
5:3:6,0,-1,101494,98506
5:5:1,0,-1,101495,98505
1:2:6,1,1,101494,98506
5:1:3,0,-1,101495,98505
6:6:4,0,-1,101496,98504
5:4:1,0,-1,101497,98503
6:4:2,1,1,101496,98504
6:1:2,1,1,101495,98505
2:3:6,1,1,101494,98506
6:6:1,0,-1,101495,98505
3:1:1,0,-1,101496,98504
6:4:6,0,-1,101497,98503
2:4:1,1,1,101496,98504
3:5:5,0,-1,101497,98503
3:3:1,0,-1,101498,98502
2:5:6,1,1,101497,98503
6:5:1,0,-1,101498,98502
2:6:2,2,2,101496,98504
2:6:6,1,1,101495,98505
2:3:1,1,1,101494,98506
6:6:4,0,-1,101495,98505
1:1:1,0,-1,101496,98504
5:5:5,0,-1,101497,98503
1:6:5,0,-1,101498,98502
5:5:3,0,-1,101499,98501
3:4:6,0,-1,101500,98500
1:2:4,1,1,101499,98501
3:1:3,0,-1,101500,98500
5:6:3,0,-1,101501,98499
1:1:1,0,-1,101502,98498
2:4:2,2,2,101500,98500
3:2:4,1,1,101499,98501
5:4:3,0,-1,101500,98500
5:5:6,0,-1,101501,98499
3:5:6,0,-1,101502,98498
4:1:1,0,-1,101503,98497
1:2:5,1,1,101502,98498
1:3:6,0,-1,101503,98497
5:3:2,1,1,101502,98498
4:6:4,0,-1,101503,98497
3:4:6,0,-1,101504,98496
3:5:2,1,1,101503,98497
4:6:6,0,-1,101504,98496
2:5:6,1,1,101503,98497
4:5:2,1,1,101502,98498
3:6:5,0,-1,101503,98497
6:5:6,0,-1,101504,98496
5:4:4,0,-1,101505,98495
6:5:3,0,-1,101506,98494
5:1:4,0,-1,101507,98493
2:2:2,3,3,101504,98496
5:3:3,0,-1,101505,98495
4:1:4,0,-1,101506,98494
1:2:2,2,2,101504,98496
1:1:5,0,-1,101505,98495
3:5:4,0,-1,101506,98494
2:5:1,1,1,101505,98495
5:2:6,1,1,101504,98496
1:2:4,1,1,101503,98497
2:2:6,2,2,101501,98499
5:6:1,0,-1,101502,98498
3:4:6,0,-1,101503,98497
5:2:5,1,1,101502,98498
6:4:2,1,1,101501,98499
6:2:2,2,2,101499,98501
2:2:6,2,2,101497,98503
5:6:4,0,-1,101498,98502
5:1:1,0,-1,101499,98501
1:1:1,0,-1,101500,98500
3:4:2,1,1,101499,98501
2:1:3,1,1,101498,98502
4:5:5,0,-1,101499,98501
5:1:1,0,-1,101500,98500
1:4:1,0,-1,101501,98499
3:2:3,1,1,101500,98500
4:4:4,0,-1,101501,98499
2:3:4,1,1,101500,98500
1:5:4,0,-1,101501,98499
6:3:2,1,1,101500,98500
1:5:2,1,1,101499,98501
1:1:3,0,-1,101500,98500
3:3:1,0,-1,101501,98499
6:1:5,0,-1,101502,98498
1:5:6,0,-1,101503,98497
4:3:2,1,1,101502,98498
4:1:2,1,1,101501,98499
4:5:4,0,-1,101502,98498
6:4:4,0,-1,101503,98497
4:3:3,0,-1,101504,98496
1:2:1,1,1,101503,98497
2:5:5,1,1,101502,98498
6:1:4,0,-1,101503,98497
5:3:6,0,-1,101504,98496
2:2:5,2,2,101502,98498
3:3:6,0,-1,101503,98497
2:3:2,2,2,101501,98499
1:4:3,0,-1,101502,98498
5:2:2,2,2,101500,98500
5:3:6,0,-1,101501,98499
6:2:1,1,1,101500,98500
4:5:3,0,-1,101501,98499
4:6:6,0,-1,101502,98498
4:4:2,1,1,101501,98499
4:6:2,1,1,101500,98500
1:4:3,0,-1,101501,98499
5:6:6,0,-1,101502,98498
3:6:6,0,-1,101503,98497
1:2:1,1,1,101502,98498
1:5:4,0,-1,101503,98497
6:1:1,0,-1,101504,98496
1:5:6,0,-1,101505,98495
2:3:4,1,1,101504,98496
6:6:6,0,-1,101505,98495
1:6:1,0,-1,101506,98494
4:2:3,1,1,101505,98495
2:5:1,1,1,101504,98496
5:2:2,2,2,101502,98498
4:1:1,0,-1,101503,98497
4:4:4,0,-1,101504,98496
5:3:2,1,1,101503,98497
5:3:5,0,-1,101504,98496
4:6:1,0,-1,101505,98495
2:4:1,1,1,101504,98496
2:6:2,2,2,101502,98498
3:5:4,0,-1,101503,98497
5:2:3,1,1,101502,98498
1:6:6,0,-1,101503,98497
6:3:2,1,1,101502,98498
4:1:3,0,-1,101503,98497
2:3:3,1,1,101502,98498
3:5:2,1,1,101501,98499
2:6:1,1,1,101500,98500
4:4:4,0,-1,101501,98499
1:4:5,0,-1,101502,98498
1:6:3,0,-1,101503,98497
5:5:3,0,-1,101504,98496
3:4:2,1,1,101503,98497
2:2:5,2,2,101501,98499
2:2:5,2,2,101499,98501
2:5:4,1,1,101498,98502
2:4:2,2,2,101496,98504
2:1:5,1,1,101495,98505
3:6:3,0,-1,101496,98504
6:3:2,1,1,101495,98505
5:2:4,1,1,101494,98506
1:5:3,0,-1,101495,98505
4:6:1,0,-1,101496,98504
1:3:4,0,-1,101497,98503
2:2:2,3,3,101494,98506
2:4:4,1,1,101493,98507
5:5:3,0,-1,101494,98506
3:3:2,1,1,101493,98507
2:1:1,1,1,101492,98508
2:2:2,3,3,101489,98511
1:6:2,1,1,101488,98512
1:3:6,0,-1,101489,98511
5:4:6,0,-1,101490,98510
3:4:3,0,-1,101491,98509
1:2:2,2,2,101489,98511
3:4:2,1,1,101488,98512
3:6:5,0,-1,101489,98511
2:3:1,1,1,101488,98512
3:3:4,0,-1,101489,98511
5:2:3,1,1,101488,98512
4:6:2,1,1,101487,98513
1:6:1,0,-1,101488,98512
6:2:6,1,1,101487,98513
1:6:2,1,1,101486,98514
1:5:3,0,-1,101487,98513
2:1:4,1,1,101486,98514
6:2:6,1,1,101485,98515
1:2:1,1,1,101484,98516
3:4:6,0,-1,101485,98515
6:5:6,0,-1,101486,98514
2:6:6,1,1,101485,98515
2:1:3,1,1,101484,98516
4:6:1,0,-1,101485,98515
3:1:1,0,-1,101486,98514
6:6:2,1,1,101485,98515
6:2:2,2,2,101483,98517
1:4:2,1,1,101482,98518
4:6:4,0,-1,101483,98517
3:1:2,1,1,101482,98518
1:6:1,0,-1,101483,98517
6:1:4,0,-1,101484,98516
5:5:3,0,-1,101485,98515
3:6:3,0,-1,101486,98514
1:3:4,0,-1,101487,98513
6:1:1,0,-1,101488,98512
5:5:1,0,-1,101489,98511
6:6:4,0,-1,101490,98510
5:5:5,0,-1,101491,98509
4:2:5,1,1,101490,98510
6:4:1,0,-1,101491,98509
4:6:3,0,-1,101492,98508
4:3:4,0,-1,101493,98507
1:5:5,0,-1,101494,98506
5:5:3,0,-1,101495,98505
1:3:1,0,-1,101496,98504
3:3:5,0,-1,101497,98503
5:1:1,0,-1,101498,98502
4:6:2,1,1,101497,98503
6:3:2,1,1,101496,98504
3:2:1,1,1,101495,98505
2:1:6,1,1,101494,98506
6:2:2,2,2,101492,98508
1:3:1,0,-1,101493,98507
3:5:3,0,-1,101494,98506
1:1:1,0,-1,101495,98505
3:6:2,1,1,101494,98506
1:3:3,0,-1,101495,98505
1:1:5,0,-1,101496,98504
5:2:2,2,2,101494,98506
4:5:5,0,-1,101495,98505
6:6:2,1,1,101494,98506
3:4:5,0,-1,101495,98505
4:2:2,2,2,101493,98507
5:5:2,1,1,101492,98508
1:2:4,1,1,101491,98509
2:4:5,1,1,101490,98510
6:4:4,0,-1,101491,98509
3:3:1,0,-1,101492,98508
3:5:1,0,-1,101493,98507
6:1:4,0,-1,101494,98506
3:6:3,0,-1,101495,98505
4:2:6,1,1,101494,98506
4:3:3,0,-1,101495,98505
1:4:3,0,-1,101496,98504
3:4:1,0,-1,101497,98503
5:5:3,0,-1,101498,98502
3:1:4,0,-1,101499,98501
4:6:3,0,-1,101500,98500
6:3:1,0,-1,101501,98499
6:1:3,0,-1,101502,98498
4:2:4,1,1,101501,98499
5:4:4,0,-1,101502,98498
3:2:6,1,1,101501,98499
6:5:1,0,-1,101502,98498
4:4:3,0,-1,101503,98497
4:5:1,0,-1,101504,98496
6:1:4,0,-1,101505,98495
1:3:1,0,-1,101506,98494
5:1:6,0,-1,101507,98493
4:5:4,0,-1,101508,98492
5:1:6,0,-1,101509,98491
3:3:1,0,-1,101510,98490
6:4:3,0,-1,101511,98489
3:3:3,0,-1,101512,98488
6:4:3,0,-1,101513,98487
2:4:6,1,1,101512,98488
3:5:6,0,-1,101513,98487
6:5:5,0,-1,101514,98486
2:4:6,1,1,101513,98487
5:4:6,0,-1,101514,98486
4:2:5,1,1,101513,98487
1:2:5,1,1,101512,98488
1:6:2,1,1,101511,98489
2:5:1,1,1,101510,98490
3:3:5,0,-1,101511,98489
5:4:2,1,1,101510,98490
2:1:5,1,1,101509,98491
3:4:4,0,-1,101510,98490
3:2:5,1,1,101509,98491
5:5:4,0,-1,101510,98490
3:4:1,0,-1,101511,98489
1:4:1,0,-1,101512,98488
2:5:3,1,1,101511,98489
4:2:5,1,1,101510,98490
6:6:1,0,-1,101511,98489
5:2:2,2,2,101509,98491
5:6:3,0,-1,101510,98490
4:5:6,0,-1,101511,98489
6:5:2,1,1,101510,98490
5:3:6,0,-1,101511,98489
3:5:3,0,-1,101512,98488
4:3:3,0,-1,101513,98487
4:6:4,0,-1,101514,98486
4:6:1,0,-1,101515,98485
3:1:2,1,1,101514,98486
6:4:5,0,-1,101515,98485
4:2:5,1,1,101514,98486
4:3:3,0,-1,101515,98485
1:2:2,2,2,101513,98487
4:4:3,0,-1,101514,98486
1:6:2,1,1,101513,98487
4:5:1,0,-1,101514,98486
4:3:6,0,-1,101515,98485
4:4:5,0,-1,101516,98484
4:3:6,0,-1,101517,98483
4:1:5,0,-1,101518,98482
4:3:5,0,-1,101519,98481
6:2:5,1,1,101518,98482
3:6:6,0,-1,101519,98481
6:1:3,0,-1,101520,98480
2:2:6,2,2,101518,98482
1:3:5,0,-1,101519,98481
2:4:2,2,2,101517,98483
5:4:2,1,1,101516,98484
1:2:1,1,1,101515,98485
5:3:4,0,-1,101516,98484
3:4:3,0,-1,101517,98483
6:3:5,0,-1,101518,98482
6:5:3,0,-1,101519,98481
4:6:4,0,-1,101520,98480
3:3:3,0,-1,101521,98479
2:4:1,1,1,101520,98480
6:3:2,1,1,101519,98481
2:5:3,1,1,101518,98482
3:3:1,0,-1,101519,98481
6:2:6,1,1,101518,98482
1:5:6,0,-1,101519,98481
2:3:1,1,1,101518,98482
6:6:6,0,-1,101519,98481
4:5:6,0,-1,101520,98480
1:2:1,1,1,101519,98481
2:2:4,2,2,101517,98483
3:6:3,0,-1,101518,98482
1:1:2,1,1,101517,98483
4:1:5,0,-1,101518,98482
3:4:3,0,-1,101519,98481
2:2:1,2,2,101517,98483
5:2:3,1,1,101516,98484
1:2:2,2,2,101514,98486
6:2:1,1,1,101513,98487
3:2:2,2,2,101511,98489
3:5:6,0,-1,101512,98488
2:6:3,1,1,101511,98489
6:3:2,1,1,101510,98490
6:5:6,0,-1,101511,98489
5:6:4,0,-1,101512,98488
4:1:5,0,-1,101513,98487
5:4:4,0,-1,101514,98486
5:1:1,0,-1,101515,98485
6:4:5,0,-1,101516,98484
6:5:3,0,-1,101517,98483
5:3:4,0,-1,101518,98482
2:2:6,2,2,101516,98484
4:3:2,1,1,101515,98485
3:5:4,0,-1,101516,98484
3:5:3,0,-1,101517,98483
4:3:4,0,-1,101518,98482
5:3:3,0,-1,101519,98481
5:3:3,0,-1,101520,98480
4:1:1,0,-1,101521,98479
2:1:4,1,1,101520,98480
4:1:5,0,-1,101521,98479
5:6:5,0,-1,101522,98478
2:1:2,2,2,101520,98480
4:2:6,1,1,101519,98481
6:1:2,1,1,101518,98482
6:5:6,0,-1,101519,98481
4:6:5,0,-1,101520,98480
5:1:4,0,-1,101521,98479
1:6:2,1,1,101520,98480
2:2:6,2,2,101518,98482
3:4:5,0,-1,101519,98481
4:4:6,0,-1,101520,98480
1:3:5,0,-1,101521,98479
1:4:1,0,-1,101522,98478
6:1:5,0,-1,101523,98477
5:2:2,2,2,101521,98479
6:3:2,1,1,101520,98480
1:1:2,1,1,101519,98481
3:2:4,1,1,101518,98482
6:3:2,1,1,101517,98483
1:2:4,1,1,101516,98484
2:1:1,1,1,101515,98485
6:2:3,1,1,101514,98486
4:3:6,0,-1,101515,98485
4:3:1,0,-1,101516,98484
5:3:1,0,-1,101517,98483
2:3:1,1,1,101516,98484
1:3:3,0,-1,101517,98483
2:4:2,2,2,101515,98485
3:3:4,0,-1,101516,98484
4:1:1,0,-1,101517,98483
5:6:3,0,-1,101518,98482
4:6:2,1,1,101517,98483
3:6:2,1,1,101516,98484
2:4:2,2,2,101514,98486
1:2:1,1,1,101513,98487
6:2:4,1,1,101512,98488
6:2:5,1,1,101511,98489
6:3:1,0,-1,101512,98488
5:5:3,0,-1,101513,98487
4:2:1,1,1,101512,98488
6:4:6,0,-1,101513,98487
1:2:5,1,1,101512,98488
3:6:6,0,-1,101513,98487
1:2:6,1,1,101512,98488
1:5:2,1,1,101511,98489
3:4:1,0,-1,101512,98488
4:4:2,1,1,101511,98489
5:5:6,0,-1,101512,98488
3:4:6,0,-1,101513,98487
3:1:4,0,-1,101514,98486
3:5:1,0,-1,101515,98485
6:1:6,0,-1,101516,98484
5:2:2,2,2,101514,98486
3:6:2,1,1,101513,98487
4:2:1,1,1,101512,98488
1:1:2,1,1,101511,98489
4:2:4,1,1,101510,98490
3:4:1,0,-1,101511,98489
1:4:3,0,-1,101512,98488
1:5:2,1,1,101511,98489
2:5:6,1,1,101510,98490
2:2:3,2,2,101508,98492
1:5:2,1,1,101507,98493
1:5:2,1,1,101506,98494
4:6:1,0,-1,101507,98493
3:5:1,0,-1,101508,98492
5:3:5,0,-1,101509,98491
5:6:4,0,-1,101510,98490
2:1:1,1,1,101509,98491
3:6:3,0,-1,101510,98490
4:2:6,1,1,101509,98491
5:5:6,0,-1,101510,98490
3:4:2,1,1,101509,98491
3:4:2,1,1,101508,98492
4:5:5,0,-1,101509,98491
1:1:5,0,-1,101510,98490
3:4:2,1,1,101509,98491
2:4:3,1,1,101508,98492
3:3:2,1,1,101507,98493
4:2:2,2,2,101505,98495
6:2:5,1,1,101504,98496
2:2:1,2,2,101502,98498
4:1:1,0,-1,101503,98497
4:5:5,0,-1,101504,98496
2:2:4,2,2,101502,98498
1:3:5,0,-1,101503,98497
1:4:5,0,-1,101504,98496
2:2:6,2,2,101502,98498
1:4:2,1,1,101501,98499
4:6:6,0,-1,101502,98498
5:4:2,1,1,101501,98499
3:1:6,0,-1,101502,98498
3:4:6,0,-1,101503,98497
2:2:2,3,3,101500,98500
1:1:3,0,-1,101501,98499
6:1:4,0,-1,101502,98498
2:2:2,3,3,101499,98501
6:1:5,0,-1,101500,98500
4:2:4,1,1,101499,98501
2:5:1,1,1,101498,98502
5:6:3,0,-1,101499,98501
1:6:5,0,-1,101500,98500
6:1:1,0,-1,101501,98499
2:5:5,1,1,101500,98500
1:1:1,0,-1,101501,98499
2:1:1,1,1,101500,98500
3:2:5,1,1,101499,98501
1:1:4,0,-1,101500,98500
2:1:2,2,2,101498,98502
5:4:4,0,-1,101499,98501
3:1:3,0,-1,101500,98500
6:3:6,0,-1,101501,98499
4:5:6,0,-1,101502,98498
1:5:6,0,-1,101503,98497
3:1:6,0,-1,101504,98496
1:1:5,0,-1,101505,98495
3:2:6,1,1,101504,98496
2:5:5,1,1,101503,98497
2:4:6,1,1,101502,98498
4:6:5,0,-1,101503,98497
1:1:4,0,-1,101504,98496
6:2:5,1,1,101503,98497
1:4:3,0,-1,101504,98496
5:3:2,1,1,101503,98497
4:2:2,2,2,101501,98499
2:4:1,1,1,101500,98500
3:6:1,0,-1,101501,98499
4:4:5,0,-1,101502,98498
5:4:4,0,-1,101503,98497
2:2:3,2,2,101501,98499
4:5:3,0,-1,101502,98498
2:2:1,2,2,101500,98500
3:2:6,1,1,101499,98501
3:6:4,0,-1,101500,98500
4:5:1,0,-1,101501,98499
5:4:1,0,-1,101502,98498
6:3:5,0,-1,101503,98497
5:6:4,0,-1,101504,98496
5:5:3,0,-1,101505,98495
5:6:6,0,-1,101506,98494
5:2:3,1,1,101505,98495
4:5:2,1,1,101504,98496
2:5:3,1,1,101503,98497
6:4:6,0,-1,101504,98496
3:5:5,0,-1,101505,98495
6:3:2,1,1,101504,98496
2:5:2,2,2,101502,98498
3:2:6,1,1,101501,98499
4:5:5,0,-1,101502,98498
6:2:4,1,1,101501,98499
5:6:6,0,-1,101502,98498
5:4:1,0,-1,101503,98497
4:4:3,0,-1,101504,98496
4:6:1,0,-1,101505,98495
3:5:3,0,-1,101506,98494
4:2:5,1,1,101505,98495
6:3:5,0,-1,101506,98494
2:5:2,2,2,101504,98496
6:3:5,0,-1,101505,98495
1:4:1,0,-1,101506,98494
3:1:6,0,-1,101507,98493
1:3:5,0,-1,101508,98492
5:3:6,0,-1,101509,98491
3:3:4,0,-1,101510,98490
6:5:5,0,-1,101511,98489
4:5:4,0,-1,101512,98488
2:1:2,2,2,101510,98490
2:4:4,1,1,101509,98491
5:2:4,1,1,101508,98492
6:3:2,1,1,101507,98493
3:2:3,1,1,101506,98494
5:3:6,0,-1,101507,98493
5:1:6,0,-1,101508,98492
3:6:4,0,-1,101509,98491
4:1:1,0,-1,101510,98490
4:2:6,1,1,101509,98491
1:4:1,0,-1,101510,98490
2:4:2,2,2,101508,98492
1:2:1,1,1,101507,98493
3:6:3,0,-1,101508,98492
5:3:6,0,-1,101509,98491
4:3:5,0,-1,101510,98490
4:4:1,0,-1,101511,98489
3:1:5,0,-1,101512,98488
4:4:2,1,1,101511,98489
1:4:5,0,-1,101512,98488
1:2:5,1,1,101511,98489
4:2:2,2,2,101509,98491
1:3:6,0,-1,101510,98490
3:6:1,0,-1,101511,98489
5:1:4,0,-1,101512,98488
5:6:2,1,1,101511,98489
1:3:2,1,1,101510,98490
2:3:1,1,1,101509,98491
6:5:6,0,-1,101510,98490
4:2:5,1,1,101509,98491
2:4:4,1,1,101508,98492
2:2:2,3,3,101505,98495
5:4:6,0,-1,101506,98494
3:5:6,0,-1,101507,98493
5:1:3,0,-1,101508,98492
5:5:5,0,-1,101509,98491
3:3:4,0,-1,101510,98490
4:1:4,0,-1,101511,98489
5:1:5,0,-1,101512,98488
5:2:3,1,1,101511,98489
3:3:3,0,-1,101512,98488
3:4:4,0,-1,101513,98487
3:3:5,0,-1,101514,98486
5:1:1,0,-1,101515,98485
6:5:3,0,-1,101516,98484
4:5:2,1,1,101515,98485
3:5:4,0,-1,101516,98484
4:1:1,0,-1,101517,98483
5:6:3,0,-1,101518,98482
4:3:4,0,-1,101519,98481
1:5:2,1,1,101518,98482
4:4:3,0,-1,101519,98481
6:1:3,0,-1,101520,98480
1:1:1,0,-1,101521,98479
1:2:5,1,1,101520,98480
5:6:5,0,-1,101521,98479
2:3:6,1,1,101520,98480
6:2:1,1,1,101519,98481
5:4:2,1,1,101518,98482
4:4:2,1,1,101517,98483
2:2:3,2,2,101515,98485
4:1:3,0,-1,101516,98484
3:1:4,0,-1,101517,98483
3:5:4,0,-1,101518,98482
3:2:3,1,1,101517,98483
2:2:3,2,2,101515,98485
5:5:1,0,-1,101516,98484
6:4:4,0,-1,101517,98483
6:4:1,0,-1,101518,98482
3:6:3,0,-1,101519,98481
1:2:3,1,1,101518,98482
5:3:1,0,-1,101519,98481
3:4:3,0,-1,101520,98480
1:1:3,0,-1,101521,98479
2:1:4,1,1,101520,98480
6:1:6,0,-1,101521,98479
4:3:6,0,-1,101522,98478
6:4:1,0,-1,101523,98477
3:3:1,0,-1,101524,98476
6:1:2,1,1,101523,98477
2:4:5,1,1,101522,98478
6:1:1,0,-1,101523,98477
1:3:3,0,-1,101524,98476
4:4:6,0,-1,101525,98475
3:1:4,0,-1,101526,98474
2:4:1,1,1,101525,98475
6:3:6,0,-1,101526,98474
6:1:4,0,-1,101527,98473
2:1:2,2,2,101525,98475
5:5:6,0,-1,101526,98474
6:5:4,0,-1,101527,98473
3:4:2,1,1,101526,98474
3:4:3,0,-1,101527,98473
2:1:2,2,2,101525,98475
4:2:2,2,2,101523,98477
2:3:5,1,1,101522,98478
1:2:3,1,1,101521,98479
2:2:2,3,3,101518,98482
2:2:3,2,2,101516,98484
1:6:5,0,-1,101517,98483
6:1:2,1,1,101516,98484
6:5:5,0,-1,101517,98483
5:1:1,0,-1,101518,98482
2:6:2,2,2,101516,98484
5:4:6,0,-1,101517,98483
1:6:2,1,1,101516,98484
6:2:1,1,1,101515,98485
6:3:3,0,-1,101516,98484
6:2:4,1,1,101515,98485
6:6:4,0,-1,101516,98484
2:5:3,1,1,101515,98485
4:2:1,1,1,101514,98486
1:4:5,0,-1,101515,98485
3:6:5,0,-1,101516,98484
1:3:5,0,-1,101517,98483
5:4:3,0,-1,101518,98482
5:1:6,0,-1,101519,98481
4:3:5,0,-1,101520,98480
3:3:5,0,-1,101521,98479
6:4:2,1,1,101520,98480
4:6:6,0,-1,101521,98479
4:3:6,0,-1,101522,98478
5:5:5,0,-1,101523,98477
1:4:4,0,-1,101524,98476
5:1:6,0,-1,101525,98475
4:4:2,1,1,101524,98476
1:4:6,0,-1,101525,98475
4:3:1,0,-1,101526,98474
6:1:6,0,-1,101527,98473
4:4:4,0,-1,101528,98472
4:3:4,0,-1,101529,98471
5:1:1,0,-1,101530,98470
1:3:4,0,-1,101531,98469
4:2:4,1,1,101530,98470
6:4:4,0,-1,101531,98469
4:5:5,0,-1,101532,98468
2:5:6,1,1,101531,98469
4:2:6,1,1,101530,98470
1:1:6,0,-1,101531,98469
6:3:2,1,1,101530,98470
5:2:4,1,1,101529,98471
4:3:6,0,-1,101530,98470
2:4:6,1,1,101529,98471
4:6:4,0,-1,101530,98470
2:5:5,1,1,101529,98471
6:2:5,1,1,101528,98472
1:5:1,0,-1,101529,98471
3:1:3,0,-1,101530,98470
1:3:2,1,1,101529,98471
2:5:4,1,1,101528,98472
6:1:6,0,-1,101529,98471
5:6:5,0,-1,101530,98470
5:4:4,0,-1,101531,98469
1:6:3,0,-1,101532,98468
6:3:6,0,-1,101533,98467
1:6:3,0,-1,101534,98466
3:1:1,0,-1,101535,98465
5:4:3,0,-1,101536,98464
2:6:1,1,1,101535,98465
5:2:3,1,1,101534,98466
2:3:1,1,1,101533,98467
6:4:3,0,-1,101534,98466
2:4:3,1,1,101533,98467
1:1:2,1,1,101532,98468
6:5:2,1,1,101531,98469
3:3:2,1,1,101530,98470
3:3:6,0,-1,101531,98469
2:4:5,1,1,101530,98470
1:3:5,0,-1,101531,98469
3:5:5,0,-1,101532,98468
3:3:5,0,-1,101533,98467
2:5:1,1,1,101532,98468
5:5:5,0,-1,101533,98467
3:4:3,0,-1,101534,98466
1:2:6,1,1,101533,98467
6:2:1,1,1,101532,98468
2:4:6,1,1,101531,98469
1:5:2,1,1,101530,98470
3:5:5,0,-1,101531,98469
6:2:4,1,1,101530,98470
2:6:4,1,1,101529,98471
1:4:5,0,-1,101530,98470
3:1:6,0,-1,101531,98469
4:3:4,0,-1,101532,98468
5:5:5,0,-1,101533,98467
5:6:6,0,-1,101534,98466
1:2:5,1,1,101533,98467
1:3:2,1,1,101532,98468
3:3:6,0,-1,101533,98467
4:4:2,1,1,101532,98468
4:4:4,0,-1,101533,98467
3:5:3,0,-1,101534,98466
2:3:3,1,1,101533,98467
1:3:5,0,-1,101534,98466
6:4:6,0,-1,101535,98465
4:6:3,0,-1,101536,98464
5:6:2,1,1,101535,98465
6:5:1,0,-1,101536,98464
6:3:6,0,-1,101537,98463
3:1:1,0,-1,101538,98462
1:2:5,1,1,101537,98463
3:4:6,0,-1,101538,98462
5:5:1,0,-1,101539,98461
1:4:4,0,-1,101540,98460
3:6:3,0,-1,101541,98459
1:6:6,0,-1,101542,98458
1:5:4,0,-1,101543,98457
6:6:5,0,-1,101544,98456
1:4:1,0,-1,101545,98455
6:5:2,1,1,101544,98456
4:4:2,1,1,101543,98457
4:2:4,1,1,101542,98458
2:3:3,1,1,101541,98459
2:5:3,1,1,101540,98460
4:5:1,0,-1,101541,98459
1:2:2,2,2,101539,98461
1:6:5,0,-1,101540,98460
2:6:1,1,1,101539,98461
2:4:1,1,1,101538,98462
2:4:4,1,1,101537,98463
4:6:4,0,-1,101538,98462
4:3:2,1,1,101537,98463
5:3:5,0,-1,101538,98462
6:6:5,0,-1,101539,98461
3:4:5,0,-1,101540,98460
6:5:2,1,1,101539,98461
2:1:3,1,1,101538,98462
3:2:5,1,1,101537,98463
4:6:6,0,-1,101538,98462
6:2:2,2,2,101536,98464
4:3:6,0,-1,101537,98463
4:6:1,0,-1,101538,98462
1:6:2,1,1,101537,98463
1:2:2,2,2,101535,98465
5:2:3,1,1,101534,98466
2:1:3,1,1,101533,98467
6:6:6,0,-1,101534,98466
1:6:4,0,-1,101535,98465
4:1:2,1,1,101534,98466
1:3:1,0,-1,101535,98465
3:6:5,0,-1,101536,98464
4:6:4,0,-1,101537,98463
1:1:1,0,-1,101538,98462
5:6:2,1,1,101537,98463
3:3:2,1,1,101536,98464
5:5:3,0,-1,101537,98463
3:4:5,0,-1,101538,98462
1:1:6,0,-1,101539,98461
6:6:6,0,-1,101540,98460
6:2:2,2,2,101538,98462
3:5:5,0,-1,101539,98461
1:1:1,0,-1,101540,98460
1:1:2,1,1,101539,98461
3:4:1,0,-1,101540,98460
3:1:1,0,-1,101541,98459
6:1:1,0,-1,101542,98458
3:2:3,1,1,101541,98459
6:6:1,0,-1,101542,98458
5:2:1,1,1,101541,98459
5:3:5,0,-1,101542,98458
4:6:4,0,-1,101543,98457
1:5:3,0,-1,101544,98456
6:4:2,1,1,101543,98457
3:3:1,0,-1,101544,98456
6:1:2,1,1,101543,98457
2:1:4,1,1,101542,98458
5:2:6,1,1,101541,98459
2:2:1,2,2,101539,98461
6:4:5,0,-1,101540,98460
4:3:4,0,-1,101541,98459
2:3:3,1,1,101540,98460
3:2:4,1,1,101539,98461
3:1:3,0,-1,101540,98460
2:3:5,1,1,101539,98461
1:1:3,0,-1,101540,98460
3:4:6,0,-1,101541,98459
6:4:1,0,-1,101542,98458
5:5:4,0,-1,101543,98457
3:5:5,0,-1,101544,98456
2:5:3,1,1,101543,98457
4:4:1,0,-1,101544,98456
1:1:1,0,-1,101545,98455
1:6:4,0,-1,101546,98454
4:6:2,1,1,101545,98455
6:5:5,0,-1,101546,98454
4:4:6,0,-1,101547,98453
2:5:3,1,1,101546,98454
4:6:5,0,-1,101547,98453
5:4:6,0,-1,101548,98452
3:6:6,0,-1,101549,98451
4:4:6,0,-1,101550,98450
6:4:1,0,-1,101551,98449
1:1:5,0,-1,101552,98448
5:4:5,0,-1,101553,98447
2:2:4,2,2,101551,98449
1:1:2,1,1,101550,98450
2:4:3,1,1,101549,98451
2:3:6,1,1,101548,98452
5:1:3,0,-1,101549,98451
5:2:5,1,1,101548,98452
5:3:2,1,1,101547,98453
4:3:6,0,-1,101548,98452
4:5:4,0,-1,101549,98451
6:5:5,0,-1,101550,98450
3:5:5,0,-1,101551,98449
4:4:1,0,-1,101552,98448
1:1:5,0,-1,101553,98447
5:6:5,0,-1,101554,98446
3:6:4,0,-1,101555,98445
4:1:1,0,-1,101556,98444
3:5:2,1,1,101555,98445
4:4:5,0,-1,101556,98444
3:6:4,0,-1,101557,98443
3:2:3,1,1,101556,98444
6:1:4,0,-1,101557,98443
3:1:4,0,-1,101558,98442
2:2:3,2,2,101556,98444
4:5:4,0,-1,101557,98443
2:5:3,1,1,101556,98444
1:5:6,0,-1,101557,98443
6:3:6,0,-1,101558,98442
1:5:1,0,-1,101559,98441
1:2:3,1,1,101558,98442
1:5:4,0,-1,101559,98441
2:5:4,1,1,101558,98442
4:5:5,0,-1,101559,98441
3:6:1,0,-1,101560,98440
1:2:6,1,1,101559,98441
4:4:1,0,-1,101560,98440
5:2:5,1,1,101559,98441
1:6:3,0,-1,101560,98440
5:2:4,1,1,101559,98441
1:2:5,1,1,101558,98442
1:2:6,1,1,101557,98443
2:2:3,2,2,101555,98445
3:2:3,1,1,101554,98446
2:2:6,2,2,101552,98448
2:5:4,1,1,101551,98449
4:6:3,0,-1,101552,98448
1:2:4,1,1,101551,98449
4:2:1,1,1,101550,98450
3:3:3,0,-1,101551,98449
3:5:5,0,-1,101552,98448
6:5:1,0,-1,101553,98447
4:3:4,0,-1,101554,98446
2:1:2,2,2,101552,98448
4:6:4,0,-1,101553,98447
6:3:1,0,-1,101554,98446
3:4:6,0,-1,101555,98445
4:2:6,1,1,101554,98446
2:6:3,1,1,101553,98447
2:6:2,2,2,101551,98449
5:4:6,0,-1,101552,98448
6:1:4,0,-1,101553,98447
4:3:4,0,-1,101554,98446
4:4:4,0,-1,101555,98445
2:6:4,1,1,101554,98446
1:4:5,0,-1,101555,98445
3:4:4,0,-1,101556,98444
4:2:1,1,1,101555,98445
1:1:1,0,-1,101556,98444
6:5:4,0,-1,101557,98443
6:5:2,1,1,101556,98444
6:2:5,1,1,101555,98445
3:4:1,0,-1,101556,98444
6:1:6,0,-1,101557,98443
6:1:6,0,-1,101558,98442
5:2:2,2,2,101556,98444
3:1:6,0,-1,101557,98443
5:1:4,0,-1,101558,98442
4:4:2,1,1,101557,98443
6:3:1,0,-1,101558,98442
3:3:3,0,-1,101559,98441
1:3:1,0,-1,101560,98440
6:3:3,0,-1,101561,98439
4:6:6,0,-1,101562,98438
2:3:1,1,1,101561,98439
3:2:1,1,1,101560,98440
2:5:4,1,1,101559,98441
1:6:6,0,-1,101560,98440
1:6:6,0,-1,101561,98439
5:3:5,0,-1,101562,98438
2:3:6,1,1,101561,98439
1:1:4,0,-1,101562,98438
6:3:4,0,-1,101563,98437
3:4:5,0,-1,101564,98436
3:1:6,0,-1,101565,98435
3:5:3,0,-1,101566,98434
3:5:4,0,-1,101567,98433
4:5:1,0,-1,101568,98432
4:6:2,1,1,101567,98433
6:1:6,0,-1,101568,98432
4:5:1,0,-1,101569,98431
5:6:6,0,-1,101570,98430
2:1:5,1,1,101569,98431
5:2:3,1,1,101568,98432
4:4:2,1,1,101567,98433
3:2:1,1,1,101566,98434
5:4:5,0,-1,101567,98433
5:2:1,1,1,101566,98434
4:4:1,0,-1,101567,98433
2:1:1,1,1,101566,98434
5:2:5,1,1,101565,98435
5:1:5,0,-1,101566,98434
2:6:2,2,2,101564,98436
5:5:4,0,-1,101565,98435
3:1:2,1,1,101564,98436
2:4:2,2,2,101562,98438
4:2:1,1,1,101561,98439
4:2:1,1,1,101560,98440
3:6:1,0,-1,101561,98439
4:5:1,0,-1,101562,98438
1:4:6,0,-1,101563,98437
4:1:5,0,-1,101564,98436
1:5:6,0,-1,101565,98435
3:4:4,0,-1,101566,98434
6:2:6,1,1,101565,98435
3:3:1,0,-1,101566,98434
5:6:3,0,-1,101567,98433
4:1:6,0,-1,101568,98432
1:4:3,0,-1,101569,98431
6:2:5,1,1,101568,98432
4:4:1,0,-1,101569,98431
4:5:2,1,1,101568,98432
2:5:5,1,1,101567,98433
2:1:2,2,2,101565,98435
5:3:1,0,-1,101566,98434
5:6:5,0,-1,101567,98433
5:1:6,0,-1,101568,98432
5:4:1,0,-1,101569,98431
4:2:3,1,1,101568,98432
4:4:5,0,-1,101569,98431
2:3:4,1,1,101568,98432
1:1:3,0,-1,101569,98431
5:2:5,1,1,101568,98432
5:6:2,1,1,101567,98433
4:6:2,1,1,101566,98434
6:2:2,2,2,101564,98436
3:6:4,0,-1,101565,98435
3:3:1,0,-1,101566,98434
6:3:4,0,-1,101567,98433
3:3:3,0,-1,101568,98432
1:5:4,0,-1,101569,98431
4:6:5,0,-1,101570,98430
3:6:1,0,-1,101571,98429
3:6:6,0,-1,101572,98428
4:6:6,0,-1,101573,98427
4:1:4,0,-1,101574,98426
5:1:6,0,-1,101575,98425
1:2:4,1,1,101574,98426
2:6:1,1,1,101573,98427
5:2:2,2,2,101571,98429
3:6:5,0,-1,101572,98428
6:3:5,0,-1,101573,98427
1:5:4,0,-1,101574,98426
2:4:4,1,1,101573,98427
2:5:3,1,1,101572,98428
6:3:4,0,-1,101573,98427
6:4:1,0,-1,101574,98426
3:2:6,1,1,101573,98427
5:2:3,1,1,101572,98428
6:2:2,2,2,101570,98430
4:5:5,0,-1,101571,98429
3:2:3,1,1,101570,98430
5:1:2,1,1,101569,98431
6:2:6,1,1,101568,98432
1:4:2,1,1,101567,98433
4:6:4,0,-1,101568,98432
1:6:6,0,-1,101569,98431
4:2:3,1,1,101568,98432
6:2:1,1,1,101567,98433
5:1:2,1,1,101566,98434
5:2:6,1,1,101565,98435
2:5:6,1,1,101564,98436
4:1:2,1,1,101563,98437
1:5:1,0,-1,101564,98436
1:4:6,0,-1,101565,98435
3:2:1,1,1,101564,98436
3:2:2,2,2,101562,98438
6:4:3,0,-1,101563,98437
4:4:6,0,-1,101564,98436
1:6:5,0,-1,101565,98435
3:2:5,1,1,101564,98436
3:4:4,0,-1,101565,98435
4:1:2,1,1,101564,98436
1:6:3,0,-1,101565,98435
2:6:5,1,1,101564,98436
1:6:4,0,-1,101565,98435
1:6:3,0,-1,101566,98434
3:1:2,1,1,101565,98435
6:6:2,1,1,101564,98436
2:5:5,1,1,101563,98437
2:4:2,2,2,101561,98439
4:3:3,0,-1,101562,98438
6:3:5,0,-1,101563,98437
6:6:3,0,-1,101564,98436
3:4:4,0,-1,101565,98435
4:6:6,0,-1,101566,98434
5:5:3,0,-1,101567,98433
2:1:1,1,1,101566,98434
5:3:5,0,-1,101567,98433
6:3:4,0,-1,101568,98432
1:4:2,1,1,101567,98433
6:2:2,2,2,101565,98435
3:3:5,0,-1,101566,98434
4:6:3,0,-1,101567,98433
5:3:1,0,-1,101568,98432
4:3:2,1,1,101567,98433
6:5:3,0,-1,101568,98432
6:1:2,1,1,101567,98433
3:2:4,1,1,101566,98434
6:1:5,0,-1,101567,98433
3:3:4,0,-1,101568,98432
5:3:2,1,1,101567,98433
2:5:1,1,1,101566,98434
3:1:3,0,-1,101567,98433
3:1:5,0,-1,101568,98432
1:2:2,2,2,101566,98434
2:2:5,2,2,101564,98436
2:5:4,1,1,101563,98437
3:6:4,0,-1,101564,98436
6:1:3,0,-1,101565,98435
5:2:4,1,1,101564,98436
4:4:3,0,-1,101565,98435
1:4:1,0,-1,101566,98434
5:2:2,2,2,101564,98436
5:3:1,0,-1,101565,98435
4:2:5,1,1,101564,98436
4:1:2,1,1,101563,98437
1:6:4,0,-1,101564,98436
2:3:4,1,1,101563,98437
6:3:5,0,-1,101564,98436
4:4:3,0,-1,101565,98435
5:4:6,0,-1,101566,98434
1:2:5,1,1,101565,98435
4:3:2,1,1,101564,98436
3:1:3,0,-1,101565,98435
4:5:1,0,-1,101566,98434
4:1:1,0,-1,101567,98433
3:3:5,0,-1,101568,98432
1:3:5,0,-1,101569,98431
5:4:2,1,1,101568,98432
5:6:2,1,1,101567,98433
5:2:3,1,1,101566,98434
6:2:2,2,2,101564,98436
3:2:2,2,2,101562,98438
2:5:2,2,2,101560,98440
5:1:6,0,-1,101561,98439
2:4:4,1,1,101560,98440
5:5:1,0,-1,101561,98439
5:4:3,0,-1,101562,98438
5:4:1,0,-1,101563,98437
4:5:4,0,-1,101564,98436
1:1:4,0,-1,101565,98435
3:5:6,0,-1,101566,98434
4:3:3,0,-1,101567,98433
2:1:3,1,1,101566,98434
3:4:5,0,-1,101567,98433
4:5:6,0,-1,101568,98432
1:1:3,0,-1,101569,98431
1:2:4,1,1,101568,98432
4:6:3,0,-1,101569,98431
5:3:1,0,-1,101570,98430
2:4:4,1,1,101569,98431
3:5:5,0,-1,101570,98430
1:4:1,0,-1,101571,98429
3:4:4,0,-1,101572,98428
1:2:1,1,1,101571,98429
1:3:4,0,-1,101572,98428
4:5:6,0,-1,101573,98427
1:4:1,0,-1,101574,98426
5:6:2,1,1,101573,98427
6:5:1,0,-1,101574,98426
6:5:6,0,-1,101575,98425
5:6:1,0,-1,101576,98424
5:2:2,2,2,101574,98426
4:4:1,0,-1,101575,98425
1:3:6,0,-1,101576,98424
6:1:5,0,-1,101577,98423
1:5:3,0,-1,101578,98422
6:1:4,0,-1,101579,98421
3:3:6,0,-1,101580,98420
4:2:1,1,1,101579,98421
4:4:3,0,-1,101580,98420
2:6:2,2,2,101578,98422
3:1:2,1,1,101577,98423
2:6:4,1,1,101576,98424
5:6:6,0,-1,101577,98423
4:5:6,0,-1,101578,98422
5:5:2,1,1,101577,98423
4:2:2,2,2,101575,98425
3:1:5,0,-1,101576,98424
6:1:2,1,1,101575,98425
5:2:1,1,1,101574,98426
5:1:2,1,1,101573,98427
5:6:2,1,1,101572,98428
4:3:3,0,-1,101573,98427
6:2:4,1,1,101572,98428
3:1:5,0,-1,101573,98427
5:4:1,0,-1,101574,98426
6:4:1,0,-1,101575,98425
3:2:6,1,1,101574,98426
1:6:6,0,-1,101575,98425
6:1:6,0,-1,101576,98424
5:5:1,0,-1,101577,98423
6:1:5,0,-1,101578,98422
1:1:4,0,-1,101579,98421
1:5:4,0,-1,101580,98420
1:1:4,0,-1,101581,98419
3:6:4,0,-1,101582,98418
1:4:5,0,-1,101583,98417
6:2:1,1,1,101582,98418
5:4:2,1,1,101581,98419
6:6:6,0,-1,101582,98418
5:3:5,0,-1,101583,98417
3:4:2,1,1,101582,98418
3:6:5,0,-1,101583,98417
6:2:4,1,1,101582,98418
5:2:3,1,1,101581,98419
4:2:2,2,2,101579,98421
2:3:2,2,2,101577,98423
2:4:1,1,1,101576,98424
6:2:1,1,1,101575,98425
1:2:3,1,1,101574,98426
5:4:5,0,-1,101575,98425
2:1:6,1,1,101574,98426
6:2:5,1,1,101573,98427
5:5:1,0,-1,101574,98426
1:1:1,0,-1,101575,98425
4:6:3,0,-1,101576,98424
6:6:3,0,-1,101577,98423
4:5:3,0,-1,101578,98422
5:6:4,0,-1,101579,98421
5:3:3,0,-1,101580,98420
3:5:6,0,-1,101581,98419
5:5:5,0,-1,101582,98418
5:2:3,1,1,101581,98419
4:1:2,1,1,101580,98420
6:1:4,0,-1,101581,98419
5:2:3,1,1,101580,98420
5:6:2,1,1,101579,98421
3:3:5,0,-1,101580,98420
3:3:6,0,-1,101581,98419
4:3:1,0,-1,101582,98418
1:5:6,0,-1,101583,98417
1:5:5,0,-1,101584,98416
4:4:5,0,-1,101585,98415
1:4:5,0,-1,101586,98414
6:1:6,0,-1,101587,98413
4:2:6,1,1,101586,98414
1:1:5,0,-1,101587,98413
6:1:4,0,-1,101588,98412
1:2:2,2,2,101586,98414
1:1:3,0,-1,101587,98413
1:2:6,1,1,101586,98414
2:2:3,2,2,101584,98416
1:5:1,0,-1,101585,98415
5:1:6,0,-1,101586,98414
3:1:2,1,1,101585,98415
3:4:3,0,-1,101586,98414
6:6:1,0,-1,101587,98413
6:1:4,0,-1,101588,98412
2:4:3,1,1,101587,98413
3:5:4,0,-1,101588,98412
6:1:6,0,-1,101589,98411
6:3:4,0,-1,101590,98410
6:6:1,0,-1,101591,98409
6:5:3,0,-1,101592,98408
2:5:4,1,1,101591,98409
1:2:1,1,1,101590,98410
1:2:5,1,1,101589,98411
4:5:6,0,-1,101590,98410
1:1:1,0,-1,101591,98409
3:4:6,0,-1,101592,98408
5:4:6,0,-1,101593,98407
6:4:2,1,1,101592,98408
3:2:1,1,1,101591,98409
1:4:4,0,-1,101592,98408
1:2:4,1,1,101591,98409
2:2:3,2,2,101589,98411
1:6:5,0,-1,101590,98410
5:3:6,0,-1,101591,98409
5:4:1,0,-1,101592,98408
4:5:2,1,1,101591,98409
4:6:2,1,1,101590,98410
5:1:5,0,-1,101591,98409
1:1:2,1,1,101590,98410
5:4:1,0,-1,101591,98409
5:2:3,1,1,101590,98410
6:4:3,0,-1,101591,98409
2:2:3,2,2,101589,98411
5:3:2,1,1,101588,98412
1:1:2,1,1,101587,98413
1:4:5,0,-1,101588,98412
3:5:5,0,-1,101589,98411
4:4:1,0,-1,101590,98410
2:4:4,1,1,101589,98411
2:1:6,1,1,101588,98412
1:4:2,1,1,101587,98413
3:2:2,2,2,101585,98415
2:4:4,1,1,101584,98416
5:6:4,0,-1,101585,98415
5:4:6,0,-1,101586,98414
3:6:5,0,-1,101587,98413
2:5:6,1,1,101586,98414
1:4:2,1,1,101585,98415
2:5:1,1,1,101584,98416
3:6:3,0,-1,101585,98415
4:2:1,1,1,101584,98416
6:3:4,0,-1,101585,98415
1:5:1,0,-1,101586,98414
3:6:3,0,-1,101587,98413
6:1:2,1,1,101586,98414
1:2:2,2,2,101584,98416
1:4:3,0,-1,101585,98415
5:5:1,0,-1,101586,98414
1:1:2,1,1,101585,98415
1:1:1,0,-1,101586,98414
6:5:1,0,-1,101587,98413
2:1:1,1,1,101586,98414
2:3:6,1,1,101585,98415
5:2:5,1,1,101584,98416
2:2:2,3,3,101581,98419
3:1:4,0,-1,101582,98418
5:3:5,0,-1,101583,98417
6:5:6,0,-1,101584,98416
5:5:2,1,1,101583,98417
5:1:3,0,-1,101584,98416
6:6:4,0,-1,101585,98415
6:6:5,0,-1,101586,98414
6:1:3,0,-1,101587,98413
6:2:6,1,1,101586,98414
2:5:4,1,1,101585,98415
3:3:3,0,-1,101586,98414
3:6:4,0,-1,101587,98413
2:2:3,2,2,101585,98415
6:3:3,0,-1,101586,98414
2:1:3,1,1,101585,98415
1:6:5,0,-1,101586,98414
5:3:2,1,1,101585,98415
3:2:2,2,2,101583,98417
4:2:5,1,1,101582,98418
6:6:1,0,-1,101583,98417
2:5:3,1,1,101582,98418
6:3:2,1,1,101581,98419
2:4:2,2,2,101579,98421
2:2:3,2,2,101577,98423
6:2:2,2,2,101575,98425
2:4:2,2,2,101573,98427
3:2:3,1,1,101572,98428
6:5:5,0,-1,101573,98427
5:6:5,0,-1,101574,98426
1:4:1,0,-1,101575,98425
2:5:1,1,1,101574,98426
6:3:4,0,-1,101575,98425
1:1:5,0,-1,101576,98424
2:4:3,1,1,101575,98425
6:1:4,0,-1,101576,98424
5:6:4,0,-1,101577,98423
3:4:1,0,-1,101578,98422
3:4:4,0,-1,101579,98421
2:4:3,1,1,101578,98422
1:5:4,0,-1,101579,98421
2:4:3,1,1,101578,98422
4:2:4,1,1,101577,98423
3:2:1,1,1,101576,98424
5:4:3,0,-1,101577,98423
2:2:5,2,2,101575,98425
3:1:3,0,-1,101576,98424
5:6:2,1,1,101575,98425
2:2:3,2,2,101573,98427
4:6:4,0,-1,101574,98426
2:5:3,1,1,101573,98427
6:6:3,0,-1,101574,98426
5:4:1,0,-1,101575,98425
2:6:6,1,1,101574,98426
3:4:5,0,-1,101575,98425
4:1:2,1,1,101574,98426
2:4:2,2,2,101572,98428
1:1:1,0,-1,101573,98427
4:3:2,1,1,101572,98428
4:6:1,0,-1,101573,98427
1:4:2,1,1,101572,98428
3:2:6,1,1,101571,98429
5:5:5,0,-1,101572,98428
4:5:6,0,-1,101573,98427
3:5:3,0,-1,101574,98426
3:3:6,0,-1,101575,98425
2:5:3,1,1,101574,98426
4:2:4,1,1,101573,98427
1:3:4,0,-1,101574,98426
6:4:1,0,-1,101575,98425
3:5:3,0,-1,101576,98424
6:5:2,1,1,101575,98425
4:2:6,1,1,101574,98426
5:1:1,0,-1,101575,98425
1:4:1,0,-1,101576,98424
2:2:3,2,2,101574,98426
3:2:1,1,1,101573,98427
4:1:4,0,-1,101574,98426
4:3:3,0,-1,101575,98425
6:4:2,1,1,101574,98426
2:6:5,1,1,101573,98427
5:4:4,0,-1,101574,98426
3:5:4,0,-1,101575,98425
1:5:5,0,-1,101576,98424
1:4:2,1,1,101575,98425
3:1:1,0,-1,101576,98424
1:6:1,0,-1,101577,98423
4:1:2,1,1,101576,98424
3:4:5,0,-1,101577,98423
6:1:2,1,1,101576,98424
1:2:5,1,1,101575,98425
1:6:6,0,-1,101576,98424
6:4:4,0,-1,101577,98423
3:3:1,0,-1,101578,98422
1:3:1,0,-1,101579,98421
6:5:1,0,-1,101580,98420
2:5:5,1,1,101579,98421
2:5:1,1,1,101578,98422
5:1:2,1,1,101577,98423
5:1:1,0,-1,101578,98422
2:6:6,1,1,101577,98423
4:1:6,0,-1,101578,98422
6:3:6,0,-1,101579,98421
5:4:5,0,-1,101580,98420
2:4:1,1,1,101579,98421
3:5:5,0,-1,101580,98420
1:4:2,1,1,101579,98421
4:1:1,0,-1,101580,98420
3:6:5,0,-1,101581,98419
1:2:1,1,1,101580,98420
4:3:6,0,-1,101581,98419
4:4:5,0,-1,101582,98418
4:4:2,1,1,101581,98419
6:2:4,1,1,101580,98420
3:2:4,1,1,101579,98421
3:4:3,0,-1,101580,98420
4:2:1,1,1,101579,98421
1:1:2,1,1,101578,98422
3:1:5,0,-1,101579,98421
3:2:3,1,1,101578,98422
2:5:4,1,1,101577,98423
1:3:5,0,-1,101578,98422
3:4:5,0,-1,101579,98421
6:3:5,0,-1,101580,98420
6:2:6,1,1,101579,98421
1:4:6,0,-1,101580,98420
1:6:3,0,-1,101581,98419
5:4:4,0,-1,101582,98418
5:1:6,0,-1,101583,98417
2:3:4,1,1,101582,98418
1:6:4,0,-1,101583,98417
4:5:6,0,-1,101584,98416
1:1:3,0,-1,101585,98415
6:3:6,0,-1,101586,98414
4:1:5,0,-1,101587,98413
2:4:1,1,1,101586,98414
2:4:4,1,1,101585,98415
6:3:6,0,-1,101586,98414
4:2:1,1,1,101585,98415
4:3:5,0,-1,101586,98414
4:6:4,0,-1,101587,98413
4:4:5,0,-1,101588,98412
3:5:3,0,-1,101589,98411
2:1:1,1,1,101588,98412
6:4:6,0,-1,101589,98411
3:2:6,1,1,101588,98412
6:5:5,0,-1,101589,98411
5:3:3,0,-1,101590,98410
5:3:5,0,-1,101591,98409
5:3:5,0,-1,101592,98408
1:2:3,1,1,101591,98409
1:2:3,1,1,101590,98410
6:4:2,1,1,101589,98411
3:5:5,0,-1,101590,98410
2:2:2,3,3,101587,98413
6:2:2,2,2,101585,98415
6:5:5,0,-1,101586,98414
6:1:6,0,-1,101587,98413
4:4:4,0,-1,101588,98412
3:6:3,0,-1,101589,98411
6:4:2,1,1,101588,98412
2:5:4,1,1,101587,98413
5:2:5,1,1,101586,98414
2:4:5,1,1,101585,98415
5:5:4,0,-1,101586,98414
1:1:5,0,-1,101587,98413
2:3:4,1,1,101586,98414
6:6:5,0,-1,101587,98413
2:3:6,1,1,101586,98414
1:6:5,0,-1,101587,98413
6:4:4,0,-1,101588,98412
3:6:3,0,-1,101589,98411
2:1:2,2,2,101587,98413
6:1:6,0,-1,101588,98412
3:2:1,1,1,101587,98413
2:4:1,1,1,101586,98414
4:5:5,0,-1,101587,98413
1:2:5,1,1,101586,98414
2:5:6,1,1,101585,98415
3:4:2,1,1,101584,98416
3:5:5,0,-1,101585,98415
3:6:4,0,-1,101586,98414
4:2:2,2,2,101584,98416
2:3:4,1,1,101583,98417
5:1:6,0,-1,101584,98416
4:1:2,1,1,101583,98417
1:2:2,2,2,101581,98419
3:2:5,1,1,101580,98420
6:6:1,0,-1,101581,98419
5:4:3,0,-1,101582,98418
3:4:6,0,-1,101583,98417
1:1:4,0,-1,101584,98416
2:6:3,1,1,101583,98417
3:6:6,0,-1,101584,98416
3:1:2,1,1,101583,98417
4:4:5,0,-1,101584,98416
4:3:2,1,1,101583,98417
5:6:3,0,-1,101584,98416
3:6:1,0,-1,101585,98415
1:2:6,1,1,101584,98416
3:4:1,0,-1,101585,98415
5:3:2,1,1,101584,98416
1:3:6,0,-1,101585,98415
2:2:5,2,2,101583,98417
3:2:3,1,1,101582,98418
6:2:3,1,1,101581,98419
6:5:1,0,-1,101582,98418
4:4:1,0,-1,101583,98417
1:3:2,1,1,101582,98418
3:3:2,1,1,101581,98419
4:5:1,0,-1,101582,98418
1:3:3,0,-1,101583,98417
2:4:1,1,1,101582,98418
6:5:5,0,-1,101583,98417
5:3:6,0,-1,101584,98416
6:1:4,0,-1,101585,98415
2:1:3,1,1,101584,98416
6:4:6,0,-1,101585,98415
4:3:5,0,-1,101586,98414
3:2:5,1,1,101585,98415
6:6:6,0,-1,101586,98414
3:4:5,0,-1,101587,98413
5:2:3,1,1,101586,98414
1:6:5,0,-1,101587,98413
1:4:1,0,-1,101588,98412
5:3:3,0,-1,101589,98411
1:1:3,0,-1,101590,98410
4:2:6,1,1,101589,98411
3:3:3,0,-1,101590,98410
5:5:1,0,-1,101591,98409
2:5:1,1,1,101590,98410
6:1:2,1,1,101589,98411
1:1:5,0,-1,101590,98410
1:4:6,0,-1,101591,98409
6:3:4,0,-1,101592,98408
2:3:1,1,1,101591,98409
2:6:6,1,1,101590,98410
3:5:2,1,1,101589,98411
3:2:4,1,1,101588,98412
4:2:4,1,1,101587,98413
1:2:6,1,1,101586,98414
6:3:3,0,-1,101587,98413
6:2:5,1,1,101586,98414
1:5:2,1,1,101585,98415
6:5:5,0,-1,101586,98414
6:2:2,2,2,101584,98416
6:3:5,0,-1,101585,98415
2:5:2,2,2,101583,98417
1:2:4,1,1,101582,98418
2:1:4,1,1,101581,98419
1:4:6,0,-1,101582,98418
6:1:1,0,-1,101583,98417
3:6:5,0,-1,101584,98416
4:6:1,0,-1,101585,98415
4:2:3,1,1,101584,98416
1:4:4,0,-1,101585,98415
1:4:2,1,1,101584,98416
3:3:3,0,-1,101585,98415
5:2:6,1,1,101584,98416
2:3:5,1,1,101583,98417
5:3:5,0,-1,101584,98416
5:4:2,1,1,101583,98417
3:1:1,0,-1,101584,98416
2:6:1,1,1,101583,98417
1:3:6,0,-1,101584,98416
5:3:2,1,1,101583,98417
6:3:6,0,-1,101584,98416
4:2:6,1,1,101583,98417
3:2:1,1,1,101582,98418
2:2:2,3,3,101579,98421
6:5:6,0,-1,101580,98420
6:1:3,0,-1,101581,98419
1:2:6,1,1,101580,98420
3:4:2,1,1,101579,98421
2:1:1,1,1,101578,98422
4:5:3,0,-1,101579,98421
2:5:3,1,1,101578,98422
2:2:4,2,2,101576,98424
4:5:4,0,-1,101577,98423
4:5:5,0,-1,101578,98422
4:4:2,1,1,101577,98423
6:1:3,0,-1,101578,98422
2:2:2,3,3,101575,98425
3:3:1,0,-1,101576,98424
3:1:1,0,-1,101577,98423
4:4:1,0,-1,101578,98422
6:6:5,0,-1,101579,98421
3:4:5,0,-1,101580,98420
5:4:5,0,-1,101581,98419
6:1:3,0,-1,101582,98418
1:3:3,0,-1,101583,98417
6:2:6,1,1,101582,98418
6:1:2,1,1,101581,98419
6:4:6,0,-1,101582,98418
5:5:2,1,1,101581,98419
5:6:2,1,1,101580,98420
1:2:1,1,1,101579,98421
2:3:5,1,1,101578,98422
6:1:1,0,-1,101579,98421
4:3:6,0,-1,101580,98420
2:4:2,2,2,101578,98422
4:6:2,1,1,101577,98423
3:3:3,0,-1,101578,98422
5:1:1,0,-1,101579,98421
2:3:5,1,1,101578,98422
6:5:3,0,-1,101579,98421
2:2:6,2,2,101577,98423
5:1:2,1,1,101576,98424
1:5:3,0,-1,101577,98423
5:4:1,0,-1,101578,98422
4:2:6,1,1,101577,98423
6:6:2,1,1,101576,98424
6:6:4,0,-1,101577,98423
3:4:6,0,-1,101578,98422
1:2:6,1,1,101577,98423
2:2:4,2,2,101575,98425
3:1:4,0,-1,101576,98424
5:4:5,0,-1,101577,98423
6:5:3,0,-1,101578,98422
3:4:5,0,-1,101579,98421
6:1:3,0,-1,101580,98420
6:3:4,0,-1,101581,98419
4:1:1,0,-1,101582,98418
1:4:1,0,-1,101583,98417
3:2:1,1,1,101582,98418
5:2:1,1,1,101581,98419
4:3:3,0,-1,101582,98418
4:3:6,0,-1,101583,98417
3:2:6,1,1,101582,98418
2:4:1,1,1,101581,98419
1:2:2,2,2,101579,98421
6:3:5,0,-1,101580,98420
4:5:3,0,-1,101581,98419
6:6:3,0,-1,101582,98418
6:6:5,0,-1,101583,98417
4:1:5,0,-1,101584,98416
4:4:5,0,-1,101585,98415
6:5:1,0,-1,101586,98414
1:6:1,0,-1,101587,98413
2:2:5,2,2,101585,98415
1:3:3,0,-1,101586,98414
3:3:4,0,-1,101587,98413
1:5:5,0,-1,101588,98412
4:5:2,1,1,101587,98413
3:5:6,0,-1,101588,98412
1:3:6,0,-1,101589,98411
6:4:5,0,-1,101590,98410
3:3:2,1,1,101589,98411
3:2:6,1,1,101588,98412
4:1:4,0,-1,101589,98411
4:6:3,0,-1,101590,98410
3:5:3,0,-1,101591,98409
6:1:6,0,-1,101592,98408
1:2:3,1,1,101591,98409
3:4:2,1,1,101590,98410
4:5:1,0,-1,101591,98409
5:5:1,0,-1,101592,98408
1:3:4,0,-1,101593,98407
3:1:5,0,-1,101594,98406
3:1:3,0,-1,101595,98405
3:2:4,1,1,101594,98406
1:2:4,1,1,101593,98407
4:1:2,1,1,101592,98408
1:6:1,0,-1,101593,98407
2:5:4,1,1,101592,98408
3:2:5,1,1,101591,98409
6:1:2,1,1,101590,98410
3:1:6,0,-1,101591,98409
4:5:1,0,-1,101592,98408
3:2:1,1,1,101591,98409
1:2:5,1,1,101590,98410
5:2:3,1,1,101589,98411
3:5:2,1,1,101588,98412
3:1:4,0,-1,101589,98411
1:3:2,1,1,101588,98412
1:1:5,0,-1,101589,98411
1:1:5,0,-1,101590,98410
4:6:2,1,1,101589,98411
1:1:3,0,-1,101590,98410
1:4:3,0,-1,101591,98409
5:3:1,0,-1,101592,98408
3:1:1,0,-1,101593,98407
6:4:2,1,1,101592,98408
4:2:6,1,1,101591,98409
4:5:6,0,-1,101592,98408
2:5:6,1,1,101591,98409
5:2:1,1,1,101590,98410
5:1:6,0,-1,101591,98409
1:1:2,1,1,101590,98410
4:4:6,0,-1,101591,98409
4:4:6,0,-1,101592,98408
1:3:4,0,-1,101593,98407
3:2:3,1,1,101592,98408
3:4:1,0,-1,101593,98407
6:5:3,0,-1,101594,98406
2:4:5,1,1,101593,98407
1:1:5,0,-1,101594,98406
6:5:3,0,-1,101595,98405
2:6:1,1,1,101594,98406
2:5:1,1,1,101593,98407
3:4:3,0,-1,101594,98406
2:3:5,1,1,101593,98407
5:5:5,0,-1,101594,98406
1:6:2,1,1,101593,98407
4:6:2,1,1,101592,98408
2:2:6,2,2,101590,98410
2:5:5,1,1,101589,98411
4:1:2,1,1,101588,98412
1:6:3,0,-1,101589,98411
1:6:4,0,-1,101590,98410
3:6:4,0,-1,101591,98409
6:5:4,0,-1,101592,98408
6:5:6,0,-1,101593,98407
1:3:5,0,-1,101594,98406
5:2:6,1,1,101593,98407
4:2:4,1,1,101592,98408
6:5:2,1,1,101591,98409
5:2:1,1,1,101590,98410
5:3:6,0,-1,101591,98409
6:2:4,1,1,101590,98410
3:3:4,0,-1,101591,98409
1:3:6,0,-1,101592,98408
6:5:4,0,-1,101593,98407
3:3:2,1,1,101592,98408
3:2:6,1,1,101591,98409
6:2:3,1,1,101590,98410
2:1:2,2,2,101588,98412
2:3:3,1,1,101587,98413
4:1:2,1,1,101586,98414
3:3:3,0,-1,101587,98413
2:3:1,1,1,101586,98414
5:6:2,1,1,101585,98415
4:6:4,0,-1,101586,98414
3:5:2,1,1,101585,98415
1:3:2,1,1,101584,98416
4:5:2,1,1,101583,98417
1:2:4,1,1,101582,98418
5:2:4,1,1,101581,98419
3:5:6,0,-1,101582,98418
1:5:5,0,-1,101583,98417
6:4:2,1,1,101582,98418
2:5:2,2,2,101580,98420
5:3:4,0,-1,101581,98419
2:3:3,1,1,101580,98420
5:3:6,0,-1,101581,98419
6:3:3,0,-1,101582,98418
1:5:3,0,-1,101583,98417
5:1:6,0,-1,101584,98416
1:3:4,0,-1,101585,98415
3:5:6,0,-1,101586,98414
6:5:4,0,-1,101587,98413
3:3:2,1,1,101586,98414
1:5:1,0,-1,101587,98413
2:3:1,1,1,101586,98414
6:6:1,0,-1,101587,98413
3:4:3,0,-1,101588,98412
3:6:4,0,-1,101589,98411
6:3:5,0,-1,101590,98410
1:2:4,1,1,101589,98411
1:5:2,1,1,101588,98412
2:3:2,2,2,101586,98414
3:2:6,1,1,101585,98415
1:5:5,0,-1,101586,98414
4:2:2,2,2,101584,98416
5:6:5,0,-1,101585,98415
3:5:3,0,-1,101586,98414
6:2:6,1,1,101585,98415
6:2:5,1,1,101584,98416
2:4:4,1,1,101583,98417
6:3:3,0,-1,101584,98416
5:2:2,2,2,101582,98418
4:3:6,0,-1,101583,98417
2:4:4,1,1,101582,98418
3:5:6,0,-1,101583,98417
3:4:2,1,1,101582,98418
1:4:6,0,-1,101583,98417
3:1:6,0,-1,101584,98416
2:2:6,2,2,101582,98418
4:1:1,0,-1,101583,98417
5:6:1,0,-1,101584,98416
4:2:4,1,1,101583,98417
2:5:1,1,1,101582,98418
5:5:3,0,-1,101583,98417
1:3:2,1,1,101582,98418
1:3:5,0,-1,101583,98417
6:6:5,0,-1,101584,98416
5:2:1,1,1,101583,98417
6:6:5,0,-1,101584,98416
4:5:2,1,1,101583,98417
3:4:1,0,-1,101584,98416
1:4:6,0,-1,101585,98415
3:3:1,0,-1,101586,98414
1:6:2,1,1,101585,98415
1:3:5,0,-1,101586,98414
3:6:4,0,-1,101587,98413
3:5:4,0,-1,101588,98412
4:6:4,0,-1,101589,98411
6:5:4,0,-1,101590,98410
3:6:1,0,-1,101591,98409
5:2:1,1,1,101590,98410
5:4:5,0,-1,101591,98409
3:6:6,0,-1,101592,98408
1:5:3,0,-1,101593,98407
6:6:2,1,1,101592,98408
4:1:5,0,-1,101593,98407
2:6:4,1,1,101592,98408
2:2:6,2,2,101590,98410
6:6:1,0,-1,101591,98409
5:1:5,0,-1,101592,98408
5:5:1,0,-1,101593,98407
3:1:5,0,-1,101594,98406
2:1:5,1,1,101593,98407
2:6:5,1,1,101592,98408
3:5:3,0,-1,101593,98407
5:5:6,0,-1,101594,98406
2:6:4,1,1,101593,98407
1:6:1,0,-1,101594,98406
3:3:5,0,-1,101595,98405
3:2:2,2,2,101593,98407
6:2:6,1,1,101592,98408
5:3:2,1,1,101591,98409
6:4:3,0,-1,101592,98408
2:6:1,1,1,101591,98409
3:4:3,0,-1,101592,98408
5:6:2,1,1,101591,98409
5:6:5,0,-1,101592,98408
4:6:3,0,-1,101593,98407
2:4:6,1,1,101592,98408
5:3:3,0,-1,101593,98407
4:1:6,0,-1,101594,98406
6:3:3,0,-1,101595,98405
2:4:5,1,1,101594,98406
1:2:6,1,1,101593,98407
2:4:1,1,1,101592,98408
6:4:5,0,-1,101593,98407
6:2:6,1,1,101592,98408
3:5:1,0,-1,101593,98407
3:6:1,0,-1,101594,98406
2:1:4,1,1,101593,98407
2:2:3,2,2,101591,98409
1:5:6,0,-1,101592,98408
5:1:4,0,-1,101593,98407
3:3:5,0,-1,101594,98406
1:4:5,0,-1,101595,98405
6:3:3,0,-1,101596,98404
5:5:5,0,-1,101597,98403
4:2:1,1,1,101596,98404
6:2:3,1,1,101595,98405
5:1:6,0,-1,101596,98404
1:1:5,0,-1,101597,98403
6:6:3,0,-1,101598,98402
6:3:1,0,-1,101599,98401
5:1:6,0,-1,101600,98400
4:2:5,1,1,101599,98401
4:6:2,1,1,101598,98402
1:3:5,0,-1,101599,98401
5:3:5,0,-1,101600,98400
5:2:3,1,1,101599,98401
6:3:4,0,-1,101600,98400
1:4:3,0,-1,101601,98399
1:2:1,1,1,101600,98400
4:4:6,0,-1,101601,98399
1:3:5,0,-1,101602,98398
5:5:1,0,-1,101603,98397
1:4:3,0,-1,101604,98396
2:3:2,2,2,101602,98398
4:1:5,0,-1,101603,98397
4:5:2,1,1,101602,98398
1:5:6,0,-1,101603,98397
5:6:4,0,-1,101604,98396
4:5:1,0,-1,101605,98395
5:3:1,0,-1,101606,98394
3:2:3,1,1,101605,98395
1:3:1,0,-1,101606,98394
1:5:1,0,-1,101607,98393
4:1:5,0,-1,101608,98392
2:2:4,2,2,101606,98394
6:6:2,1,1,101605,98395
6:4:2,1,1,101604,98396
3:4:4,0,-1,101605,98395
6:5:6,0,-1,101606,98394
3:1:4,0,-1,101607,98393
6:6:5,0,-1,101608,98392
1:2:4,1,1,101607,98393
3:5:3,0,-1,101608,98392
3:6:5,0,-1,101609,98391
6:3:6,0,-1,101610,98390
2:6:5,1,1,101609,98391
6:5:6,0,-1,101610,98390
5:5:5,0,-1,101611,98389
5:5:4,0,-1,101612,98388
3:5:4,0,-1,101613,98387
2:2:4,2,2,101611,98389
3:4:5,0,-1,101612,98388
5:2:4,1,1,101611,98389
4:6:3,0,-1,101612,98388
6:3:1,0,-1,101613,98387
3:2:5,1,1,101612,98388
2:6:1,1,1,101611,98389
6:5:3,0,-1,101612,98388
2:3:6,1,1,101611,98389
5:1:1,0,-1,101612,98388
4:3:6,0,-1,101613,98387
5:6:6,0,-1,101614,98386
6:6:3,0,-1,101615,98385
4:4:4,0,-1,101616,98384
4:3:1,0,-1,101617,98383
6:2:2,2,2,101615,98385
6:6:3,0,-1,101616,98384
2:4:1,1,1,101615,98385
1:1:6,0,-1,101616,98384
5:1:3,0,-1,101617,98383
2:5:3,1,1,101616,98384
2:3:2,2,2,101614,98386
2:1:1,1,1,101613,98387
2:5:4,1,1,101612,98388
2:5:4,1,1,101611,98389
5:6:1,0,-1,101612,98388
6:3:3,0,-1,101613,98387
4:3:1,0,-1,101614,98386
5:5:2,1,1,101613,98387
4:5:5,0,-1,101614,98386
2:3:6,1,1,101613,98387
3:2:5,1,1,101612,98388
3:5:4,0,-1,101613,98387
4:6:3,0,-1,101614,98386
5:6:3,0,-1,101615,98385
4:3:6,0,-1,101616,98384
5:6:4,0,-1,101617,98383
3:2:2,2,2,101615,98385
5:3:5,0,-1,101616,98384
1:5:1,0,-1,101617,98383
3:4:3,0,-1,101618,98382
6:6:4,0,-1,101619,98381
6:2:4,1,1,101618,98382
6:4:5,0,-1,101619,98381
5:2:3,1,1,101618,98382
4:6:4,0,-1,101619,98381
5:5:2,1,1,101618,98382
4:3:4,0,-1,101619,98381
2:3:6,1,1,101618,98382
1:5:5,0,-1,101619,98381
4:3:1,0,-1,101620,98380
6:6:2,1,1,101619,98381
3:6:1,0,-1,101620,98380
5:2:1,1,1,101619,98381
5:6:3,0,-1,101620,98380
4:6:3,0,-1,101621,98379
4:1:6,0,-1,101622,98378
4:6:1,0,-1,101623,98377
2:6:1,1,1,101622,98378
1:6:6,0,-1,101623,98377
3:3:1,0,-1,101624,98376
4:6:4,0,-1,101625,98375
2:1:1,1,1,101624,98376
3:2:3,1,1,101623,98377
6:6:6,0,-1,101624,98376
1:1:2,1,1,101623,98377
6:5:1,0,-1,101624,98376
6:4:5,0,-1,101625,98375
5:1:6,0,-1,101626,98374
4:3:1,0,-1,101627,98373
4:5:2,1,1,101626,98374
4:4:1,0,-1,101627,98373
5:4:4,0,-1,101628,98372
1:1:5,0,-1,101629,98371
4:3:5,0,-1,101630,98370
3:4:3,0,-1,101631,98369
1:6:1,0,-1,101632,98368
1:3:6,0,-1,101633,98367
6:1:1,0,-1,101634,98366
4:3:1,0,-1,101635,98365
4:2:3,1,1,101634,98366
5:4:3,0,-1,101635,98365
6:3:2,1,1,101634,98366
3:1:6,0,-1,101635,98365
4:4:4,0,-1,101636,98364
5:5:6,0,-1,101637,98363
4:1:4,0,-1,101638,98362
1:1:2,1,1,101637,98363
4:3:2,1,1,101636,98364
2:4:1,1,1,101635,98365
1:3:5,0,-1,101636,98364
5:3:5,0,-1,101637,98363
1:1:3,0,-1,101638,98362
2:6:3,1,1,101637,98363
3:6:2,1,1,101636,98364
4:3:4,0,-1,101637,98363
3:4:5,0,-1,101638,98362
6:3:2,1,1,101637,98363
5:1:5,0,-1,101638,98362
6:6:2,1,1,101637,98363
4:2:4,1,1,101636,98364
4:1:1,0,-1,101637,98363
2:5:3,1,1,101636,98364
3:4:2,1,1,101635,98365
5:5:3,0,-1,101636,98364
3:4:6,0,-1,101637,98363
1:1:6,0,-1,101638,98362
6:2:5,1,1,101637,98363
5:2:3,1,1,101636,98364
1:2:4,1,1,101635,98365
4:4:4,0,-1,101636,98364
2:4:2,2,2,101634,98366
1:6:2,1,1,101633,98367
4:3:6,0,-1,101634,98366
3:1:2,1,1,101633,98367
5:2:1,1,1,101632,98368
3:5:5,0,-1,101633,98367
3:6:5,0,-1,101634,98366
5:3:2,1,1,101633,98367
2:6:2,2,2,101631,98369
3:3:4,0,-1,101632,98368
3:5:2,1,1,101631,98369
5:1:1,0,-1,101632,98368
2:4:2,2,2,101630,98370
2:4:2,2,2,101628,98372
4:2:4,1,1,101627,98373
3:5:3,0,-1,101628,98372
4:2:5,1,1,101627,98373
4:1:2,1,1,101626,98374
2:6:4,1,1,101625,98375
6:6:2,1,1,101624,98376
3:6:2,1,1,101623,98377
4:5:4,0,-1,101624,98376
3:1:2,1,1,101623,98377
4:3:6,0,-1,101624,98376
1:4:2,1,1,101623,98377
3:2:1,1,1,101622,98378
4:6:6,0,-1,101623,98377
3:3:4,0,-1,101624,98376
6:1:4,0,-1,101625,98375
5:6:4,0,-1,101626,98374
4:5:2,1,1,101625,98375
6:1:3,0,-1,101626,98374
5:2:1,1,1,101625,98375
4:4:6,0,-1,101626,98374
4:1:1,0,-1,101627,98373
2:5:3,1,1,101626,98374
3:4:2,1,1,101625,98375
5:2:6,1,1,101624,98376
1:3:2,1,1,101623,98377
2:2:6,2,2,101621,98379
1:6:5,0,-1,101622,98378
5:6:6,0,-1,101623,98377
2:1:1,1,1,101622,98378
2:2:2,3,3,101619,98381
5:4:4,0,-1,101620,98380
4:4:1,0,-1,101621,98379
6:1:2,1,1,101620,98380
1:3:4,0,-1,101621,98379
2:5:5,1,1,101620,98380
5:1:5,0,-1,101621,98379
4:2:1,1,1,101620,98380
3:5:3,0,-1,101621,98379
1:3:1,0,-1,101622,98378
3:3:6,0,-1,101623,98377
6:3:6,0,-1,101624,98376
1:3:1,0,-1,101625,98375
3:2:3,1,1,101624,98376
3:3:6,0,-1,101625,98375
6:6:2,1,1,101624,98376
3:1:1,0,-1,101625,98375
6:3:2,1,1,101624,98376
5:2:6,1,1,101623,98377
2:2:3,2,2,101621,98379
6:2:6,1,1,101620,98380
6:4:3,0,-1,101621,98379
1:5:1,0,-1,101622,98378
1:3:5,0,-1,101623,98377
6:3:3,0,-1,101624,98376
3:4:2,1,1,101623,98377
2:4:2,2,2,101621,98379
3:6:3,0,-1,101622,98378
4:5:4,0,-1,101623,98377
1:3:6,0,-1,101624,98376
2:5:3,1,1,101623,98377
1:6:1,0,-1,101624,98376
3:2:2,2,2,101622,98378
6:6:6,0,-1,101623,98377
6:1:5,0,-1,101624,98376
4:5:6,0,-1,101625,98375
2:4:3,1,1,101624,98376
4:4:2,1,1,101623,98377
3:1:2,1,1,101622,98378
6:5:6,0,-1,101623,98377
2:2:4,2,2,101621,98379
2:1:3,1,1,101620,98380
3:5:5,0,-1,101621,98379
4:4:6,0,-1,101622,98378
2:6:5,1,1,101621,98379
5:6:1,0,-1,101622,98378
1:2:1,1,1,101621,98379
5:5:6,0,-1,101622,98378
6:1:1,0,-1,101623,98377
6:3:2,1,1,101622,98378
2:4:4,1,1,101621,98379
6:6:2,1,1,101620,98380
4:4:3,0,-1,101621,98379
2:4:4,1,1,101620,98380
2:1:1,1,1,101619,98381
3:2:4,1,1,101618,98382
4:1:3,0,-1,101619,98381
1:6:1,0,-1,101620,98380
3:4:5,0,-1,101621,98379
2:6:6,1,1,101620,98380
3:3:1,0,-1,101621,98379
4:2:5,1,1,101620,98380
2:2:5,2,2,101618,98382
4:2:5,1,1,101617,98383
3:6:6,0,-1,101618,98382
4:2:5,1,1,101617,98383
1:1:1,0,-1,101618,98382
1:1:3,0,-1,101619,98381
3:3:5,0,-1,101620,98380
3:5:1,0,-1,101621,98379
5:2:2,2,2,101619,98381
2:1:6,1,1,101618,98382
1:4:3,0,-1,101619,98381
6:3:2,1,1,101618,98382
4:6:3,0,-1,101619,98381
4:2:6,1,1,101618,98382
6:4:4,0,-1,101619,98381
2:5:5,1,1,101618,98382
1:1:3,0,-1,101619,98381
6:2:5,1,1,101618,98382
2:4:6,1,1,101617,98383
4:4:3,0,-1,101618,98382
4:5:3,0,-1,101619,98381
5:5:4,0,-1,101620,98380
4:2:4,1,1,101619,98381
4:1:1,0,-1,101620,98380
3:2:5,1,1,101619,98381
5:2:4,1,1,101618,98382
5:2:5,1,1,101617,98383
5:6:2,1,1,101616,98384
4:5:5,0,-1,101617,98383
6:3:4,0,-1,101618,98382
6:6:2,1,1,101617,98383
5:5:4,0,-1,101618,98382
5:6:2,1,1,101617,98383
1:4:3,0,-1,101618,98382
6:6:3,0,-1,101619,98381
4:5:3,0,-1,101620,98380
4:2:2,2,2,101618,98382
1:6:6,0,-1,101619,98381
2:2:3,2,2,101617,98383
5:2:5,1,1,101616,98384
2:2:6,2,2,101614,98386
2:5:3,1,1,101613,98387
2:4:1,1,1,101612,98388
5:6:6,0,-1,101613,98387
3:5:6,0,-1,101614,98386
4:3:5,0,-1,101615,98385
4:1:1,0,-1,101616,98384
3:5:4,0,-1,101617,98383
3:3:4,0,-1,101618,98382
6:3:4,0,-1,101619,98381
1:4:4,0,-1,101620,98380
5:4:6,0,-1,101621,98379
3:4:4,0,-1,101622,98378
2:4:2,2,2,101620,98380
3:5:3,0,-1,101621,98379
5:3:5,0,-1,101622,98378
2:4:2,2,2,101620,98380
6:1:3,0,-1,101621,98379
1:6:1,0,-1,101622,98378
4:5:4,0,-1,101623,98377
1:2:5,1,1,101622,98378
2:2:4,2,2,101620,98380
6:4:2,1,1,101619,98381
4:1:5,0,-1,101620,98380
5:6:4,0,-1,101621,98379
4:1:3,0,-1,101622,98378
5:4:6,0,-1,101623,98377
4:5:1,0,-1,101624,98376
4:4:4,0,-1,101625,98375
3:3:6,0,-1,101626,98374
2:3:4,1,1,101625,98375
4:6:6,0,-1,101626,98374
1:1:1,0,-1,101627,98373
1:6:4,0,-1,101628,98372
5:5:4,0,-1,101629,98371
6:4:1,0,-1,101630,98370
3:2:1,1,1,101629,98371
1:3:3,0,-1,101630,98370
3:4:3,0,-1,101631,98369
6:5:1,0,-1,101632,98368
2:1:3,1,1,101631,98369
4:1:4,0,-1,101632,98368
2:2:3,2,2,101630,98370
1:3:1,0,-1,101631,98369
3:3:3,0,-1,101632,98368
2:1:4,1,1,101631,98369
3:2:5,1,1,101630,98370
4:6:2,1,1,101629,98371
2:4:4,1,1,101628,98372
4:2:4,1,1,101627,98373
4:3:1,0,-1,101628,98372
1:4:2,1,1,101627,98373
6:4:4,0,-1,101628,98372
1:3:4,0,-1,101629,98371
5:6:3,0,-1,101630,98370
4:2:6,1,1,101629,98371
4:3:5,0,-1,101630,98370
1:2:6,1,1,101629,98371
1:3:6,0,-1,101630,98370
6:6:1,0,-1,101631,98369
4:2:6,1,1,101630,98370
3:3:1,0,-1,101631,98369
1:5:1,0,-1,101632,98368
4:5:3,0,-1,101633,98367
2:5:6,1,1,101632,98368
1:2:1,1,1,101631,98369
5:4:6,0,-1,101632,98368
6:2:4,1,1,101631,98369
4:4:2,1,1,101630,98370
3:2:3,1,1,101629,98371
5:2:3,1,1,101628,98372
2:4:3,1,1,101627,98373
1:3:4,0,-1,101628,98372
4:4:2,1,1,101627,98373
6:1:4,0,-1,101628,98372
6:2:2,2,2,101626,98374
6:2:4,1,1,101625,98375
1:2:5,1,1,101624,98376
4:5:6,0,-1,101625,98375
2:5:4,1,1,101624,98376
4:5:6,0,-1,101625,98375
3:4:3,0,-1,101626,98374
6:1:6,0,-1,101627,98373
1:5:3,0,-1,101628,98372
6:6:5,0,-1,101629,98371
2:5:2,2,2,101627,98373
6:3:1,0,-1,101628,98372
5:6:2,1,1,101627,98373
2:4:4,1,1,101626,98374
5:4:1,0,-1,101627,98373
5:3:2,1,1,101626,98374
6:3:5,0,-1,101627,98373
4:2:1,1,1,101626,98374
5:4:5,0,-1,101627,98373
5:5:4,0,-1,101628,98372
1:1:4,0,-1,101629,98371
2:6:6,1,1,101628,98372
6:4:4,0,-1,101629,98371
6:1:1,0,-1,101630,98370
6:1:2,1,1,101629,98371
4:5:4,0,-1,101630,98370
6:4:3,0,-1,101631,98369
4:5:2,1,1,101630,98370
2:4:4,1,1,101629,98371
3:2:3,1,1,101628,98372
6:4:3,0,-1,101629,98371
4:1:3,0,-1,101630,98370
4:5:3,0,-1,101631,98369
1:2:1,1,1,101630,98370
6:2:2,2,2,101628,98372
1:4:2,1,1,101627,98373
4:6:5,0,-1,101628,98372
6:3:3,0,-1,101629,98371
3:4:1,0,-1,101630,98370
4:2:1,1,1,101629,98371
6:1:2,1,1,101628,98372
5:3:5,0,-1,101629,98371
2:6:1,1,1,101628,98372
1:5:1,0,-1,101629,98371
1:3:2,1,1,101628,98372
1:3:5,0,-1,101629,98371
4:4:4,0,-1,101630,98370
5:1:5,0,-1,101631,98369
6:2:3,1,1,101630,98370
4:2:4,1,1,101629,98371
4:4:3,0,-1,101630,98370
3:6:2,1,1,101629,98371
4:2:6,1,1,101628,98372
6:2:5,1,1,101627,98373
6:5:2,1,1,101626,98374
4:1:2,1,1,101625,98375
5:1:2,1,1,101624,98376
1:1:5,0,-1,101625,98375
3:6:3,0,-1,101626,98374
5:2:6,1,1,101625,98375
1:1:2,1,1,101624,98376
5:6:5,0,-1,101625,98375
5:1:1,0,-1,101626,98374
6:2:4,1,1,101625,98375
2:1:2,2,2,101623,98377
6:1:2,1,1,101622,98378
5:5:3,0,-1,101623,98377
4:1:5,0,-1,101624,98376
6:4:1,0,-1,101625,98375
3:3:4,0,-1,101626,98374
6:3:3,0,-1,101627,98373
1:4:5,0,-1,101628,98372
3:1:6,0,-1,101629,98371
6:2:1,1,1,101628,98372
3:3:4,0,-1,101629,98371
1:2:2,2,2,101627,98373
1:6:1,0,-1,101628,98372
2:1:3,1,1,101627,98373
6:3:5,0,-1,101628,98372
3:2:1,1,1,101627,98373
3:6:6,0,-1,101628,98372
3:5:5,0,-1,101629,98371
3:6:6,0,-1,101630,98370
6:6:5,0,-1,101631,98369
5:1:3,0,-1,101632,98368
4:4:4,0,-1,101633,98367
6:3:6,0,-1,101634,98366
1:2:1,1,1,101633,98367
6:3:3,0,-1,101634,98366
6:6:3,0,-1,101635,98365
5:5:4,0,-1,101636,98364
3:3:2,1,1,101635,98365
5:2:1,1,1,101634,98366
2:2:6,2,2,101632,98368
5:3:5,0,-1,101633,98367
3:4:1,0,-1,101634,98366
2:4:2,2,2,101632,98368
5:5:3,0,-1,101633,98367
4:5:5,0,-1,101634,98366
5:6:2,1,1,101633,98367
6:3:5,0,-1,101634,98366
2:2:1,2,2,101632,98368
1:1:3,0,-1,101633,98367
2:5:1,1,1,101632,98368
3:6:3,0,-1,101633,98367
5:4:3,0,-1,101634,98366
6:6:5,0,-1,101635,98365
6:5:3,0,-1,101636,98364
1:4:5,0,-1,101637,98363
5:1:4,0,-1,101638,98362
5:1:2,1,1,101637,98363
6:4:1,0,-1,101638,98362
4:2:5,1,1,101637,98363
4:3:4,0,-1,101638,98362
5:2:6,1,1,101637,98363
5:1:6,0,-1,101638,98362
1:4:6,0,-1,101639,98361
1:6:3,0,-1,101640,98360
5:6:1,0,-1,101641,98359
2:4:2,2,2,101639,98361
3:1:3,0,-1,101640,98360
5:2:5,1,1,101639,98361
6:2:4,1,1,101638,98362
3:6:6,0,-1,101639,98361
5:5:5,0,-1,101640,98360
4:4:2,1,1,101639,98361
6:6:4,0,-1,101640,98360
3:2:5,1,1,101639,98361
2:1:6,1,1,101638,98362
5:3:6,0,-1,101639,98361
5:6:4,0,-1,101640,98360
6:3:3,0,-1,101641,98359
2:2:3,2,2,101639,98361
1:3:3,0,-1,101640,98360
2:1:5,1,1,101639,98361
4:2:6,1,1,101638,98362
4:3:6,0,-1,101639,98361
3:5:3,0,-1,101640,98360
5:2:2,2,2,101638,98362
3:4:5,0,-1,101639,98361
4:5:4,0,-1,101640,98360
1:1:1,0,-1,101641,98359
3:4:6,0,-1,101642,98358
4:1:2,1,1,101641,98359
3:5:2,1,1,101640,98360
2:2:5,2,2,101638,98362
4:5:6,0,-1,101639,98361
6:1:4,0,-1,101640,98360
4:2:4,1,1,101639,98361
4:3:2,1,1,101638,98362
6:3:6,0,-1,101639,98361
6:2:1,1,1,101638,98362
4:3:6,0,-1,101639,98361
2:2:3,2,2,101637,98363
5:5:1,0,-1,101638,98362
4:4:2,1,1,101637,98363
3:2:2,2,2,101635,98365
3:6:6,0,-1,101636,98364
5:3:1,0,-1,101637,98363
1:5:4,0,-1,101638,98362
3:1:3,0,-1,101639,98361
6:5:1,0,-1,101640,98360
6:3:2,1,1,101639,98361
6:4:1,0,-1,101640,98360
5:6:6,0,-1,101641,98359
4:1:4,0,-1,101642,98358
4:4:6,0,-1,101643,98357
6:2:1,1,1,101642,98358
3:3:2,1,1,101641,98359
6:1:2,1,1,101640,98360
3:6:1,0,-1,101641,98359
2:1:3,1,1,101640,98360
1:3:5,0,-1,101641,98359
4:1:4,0,-1,101642,98358
6:6:1,0,-1,101643,98357
2:2:5,2,2,101641,98359
1:1:3,0,-1,101642,98358
5:1:5,0,-1,101643,98357
3:5:1,0,-1,101644,98356
1:6:1,0,-1,101645,98355
3:6:6,0,-1,101646,98354
1:1:2,1,1,101645,98355
5:5:1,0,-1,101646,98354
2:5:4,1,1,101645,98355
1:5:4,0,-1,101646,98354
1:3:2,1,1,101645,98355
4:3:4,0,-1,101646,98354
1:5:6,0,-1,101647,98353
3:1:1,0,-1,101648,98352
6:2:1,1,1,101647,98353
2:4:2,2,2,101645,98355
1:5:5,0,-1,101646,98354
5:6:3,0,-1,101647,98353
4:2:2,2,2,101645,98355
5:6:1,0,-1,101646,98354
2:3:4,1,1,101645,98355
2:1:3,1,1,101644,98356
6:1:2,1,1,101643,98357
6:2:5,1,1,101642,98358
4:4:5,0,-1,101643,98357
6:4:4,0,-1,101644,98356
2:4:4,1,1,101643,98357
6:2:3,1,1,101642,98358
3:3:4,0,-1,101643,98357
1:6:4,0,-1,101644,98356
4:6:1,0,-1,101645,98355
5:4:2,1,1,101644,98356
1:5:4,0,-1,101645,98355
4:5:3,0,-1,101646,98354
3:1:2,1,1,101645,98355
3:2:2,2,2,101643,98357
2:2:1,2,2,101641,98359
4:4:4,0,-1,101642,98358
5:1:4,0,-1,101643,98357
1:2:1,1,1,101642,98358
4:6:4,0,-1,101643,98357
3:5:4,0,-1,101644,98356
2:2:2,3,3,101641,98359
3:5:1,0,-1,101642,98358
5:1:2,1,1,101641,98359
2:2:2,3,3,101638,98362
6:1:1,0,-1,101639,98361
4:2:1,1,1,101638,98362
3:1:1,0,-1,101639,98361
4:5:1,0,-1,101640,98360
3:3:2,1,1,101639,98361
4:4:5,0,-1,101640,98360
2:2:4,2,2,101638,98362
3:4:1,0,-1,101639,98361
4:4:5,0,-1,101640,98360
1:1:5,0,-1,101641,98359
4:1:5,0,-1,101642,98358
2:6:1,1,1,101641,98359
5:2:3,1,1,101640,98360
3:3:3,0,-1,101641,98359
1:1:5,0,-1,101642,98358
5:1:3,0,-1,101643,98357
1:2:4,1,1,101642,98358
3:5:1,0,-1,101643,98357
4:3:6,0,-1,101644,98356
2:1:1,1,1,101643,98357
3:5:5,0,-1,101644,98356
2:4:6,1,1,101643,98357
1:4:5,0,-1,101644,98356
3:2:1,1,1,101643,98357
5:6:2,1,1,101642,98358
1:4:1,0,-1,101643,98357
3:3:6,0,-1,101644,98356
3:3:1,0,-1,101645,98355
4:2:2,2,2,101643,98357
1:3:5,0,-1,101644,98356
5:1:5,0,-1,101645,98355
4:1:6,0,-1,101646,98354
5:1:1,0,-1,101647,98353
4:4:1,0,-1,101648,98352
3:5:3,0,-1,101649,98351
4:6:1,0,-1,101650,98350
2:4:1,1,1,101649,98351
1:2:5,1,1,101648,98352
6:3:2,1,1,101647,98353
5:5:3,0,-1,101648,98352
1:3:6,0,-1,101649,98351
3:6:6,0,-1,101650,98350
5:5:6,0,-1,101651,98349
3:6:3,0,-1,101652,98348
5:3:3,0,-1,101653,98347
3:6:4,0,-1,101654,98346
3:2:6,1,1,101653,98347
4:4:4,0,-1,101654,98346
4:3:2,1,1,101653,98347
5:3:1,0,-1,101654,98346
3:5:6,0,-1,101655,98345
2:4:3,1,1,101654,98346
1:6:2,1,1,101653,98347
6:5:1,0,-1,101654,98346
3:2:2,2,2,101652,98348
2:5:2,2,2,101650,98350
2:6:4,1,1,101649,98351
1:2:6,1,1,101648,98352
1:6:5,0,-1,101649,98351
3:2:3,1,1,101648,98352
2:1:3,1,1,101647,98353
3:5:4,0,-1,101648,98352
1:5:2,1,1,101647,98353
5:3:5,0,-1,101648,98352
4:2:5,1,1,101647,98353
4:3:2,1,1,101646,98354
2:3:5,1,1,101645,98355
5:3:4,0,-1,101646,98354
2:1:6,1,1,101645,98355
2:6:6,1,1,101644,98356
5:6:4,0,-1,101645,98355
2:3:3,1,1,101644,98356
6:5:1,0,-1,101645,98355
3:1:4,0,-1,101646,98354
6:4:2,1,1,101645,98355
6:2:1,1,1,101644,98356
5:3:4,0,-1,101645,98355
2:2:2,3,3,101642,98358
3:1:4,0,-1,101643,98357
2:3:6,1,1,101642,98358
4:4:5,0,-1,101643,98357
5:2:3,1,1,101642,98358
6:6:3,0,-1,101643,98357
5:6:1,0,-1,101644,98356
6:6:5,0,-1,101645,98355
6:4:3,0,-1,101646,98354
6:2:6,1,1,101645,98355
1:3:1,0,-1,101646,98354
3:2:1,1,1,101645,98355
4:3:1,0,-1,101646,98354
6:2:2,2,2,101644,98356
4:1:4,0,-1,101645,98355
5:4:5,0,-1,101646,98354
2:4:3,1,1,101645,98355
3:3:5,0,-1,101646,98354
5:4:5,0,-1,101647,98353
1:1:3,0,-1,101648,98352
6:6:5,0,-1,101649,98351
6:3:6,0,-1,101650,98350
5:2:1,1,1,101649,98351
2:1:4,1,1,101648,98352
4:6:5,0,-1,101649,98351
3:2:1,1,1,101648,98352
1:6:5,0,-1,101649,98351
6:5:1,0,-1,101650,98350
1:4:6,0,-1,101651,98349
4:3:3,0,-1,101652,98348
1:3:2,1,1,101651,98349
4:5:4,0,-1,101652,98348
4:3:3,0,-1,101653,98347
5:5:6,0,-1,101654,98346
5:5:4,0,-1,101655,98345
2:3:3,1,1,101654,98346
2:3:1,1,1,101653,98347
5:5:1,0,-1,101654,98346
2:4:4,1,1,101653,98347
6:5:4,0,-1,101654,98346
4:6:3,0,-1,101655,98345
4:3:3,0,-1,101656,98344
1:6:4,0,-1,101657,98343
5:1:3,0,-1,101658,98342
3:4:4,0,-1,101659,98341
4:3:4,0,-1,101660,98340
3:1:2,1,1,101659,98341
1:4:2,1,1,101658,98342
3:6:2,1,1,101657,98343
6:1:2,1,1,101656,98344
2:3:5,1,1,101655,98345
3:6:6,0,-1,101656,98344
1:6:6,0,-1,101657,98343
1:2:5,1,1,101656,98344
5:2:5,1,1,101655,98345
5:4:6,0,-1,101656,98344
5:3:5,0,-1,101657,98343
1:2:1,1,1,101656,98344
6:3:5,0,-1,101657,98343
2:1:4,1,1,101656,98344
3:6:3,0,-1,101657,98343
6:4:5,0,-1,101658,98342
6:4:3,0,-1,101659,98341
1:5:1,0,-1,101660,98340
1:3:6,0,-1,101661,98339
4:5:4,0,-1,101662,98338
2:2:3,2,2,101660,98340
4:6:4,0,-1,101661,98339
6:2:5,1,1,101660,98340
1:1:2,1,1,101659,98341
6:5:2,1,1,101658,98342
1:1:2,1,1,101657,98343
4:4:2,1,1,101656,98344
1:3:2,1,1,101655,98345
2:2:4,2,2,101653,98347
5:1:4,0,-1,101654,98346
2:1:6,1,1,101653,98347
6:3:1,0,-1,101654,98346
3:1:3,0,-1,101655,98345
4:1:6,0,-1,101656,98344
6:2:4,1,1,101655,98345
2:5:6,1,1,101654,98346
2:2:6,2,2,101652,98348
6:3:2,1,1,101651,98349
2:6:5,1,1,101650,98350
6:2:1,1,1,101649,98351
2:5:5,1,1,101648,98352
4:4:2,1,1,101647,98353
3:3:2,1,1,101646,98354
5:3:3,0,-1,101647,98353
4:5:6,0,-1,101648,98352
1:2:6,1,1,101647,98353
4:5:6,0,-1,101648,98352
4:6:2,1,1,101647,98353
4:4:6,0,-1,101648,98352
5:6:6,0,-1,101649,98351
4:6:2,1,1,101648,98352
6:6:2,1,1,101647,98353
1:4:4,0,-1,101648,98352
4:3:6,0,-1,101649,98351
4:3:4,0,-1,101650,98350
4:6:5,0,-1,101651,98349
6:1:1,0,-1,101652,98348
6:4:4,0,-1,101653,98347
6:2:1,1,1,101652,98348
5:6:1,0,-1,101653,98347
1:5:6,0,-1,101654,98346
4:5:6,0,-1,101655,98345
1:6:3,0,-1,101656,98344
3:6:1,0,-1,101657,98343
2:3:4,1,1,101656,98344
1:3:5,0,-1,101657,98343
4:1:4,0,-1,101658,98342
6:5:1,0,-1,101659,98341
6:6:1,0,-1,101660,98340
2:5:6,1,1,101659,98341
6:5:1,0,-1,101660,98340
2:6:3,1,1,101659,98341
3:4:1,0,-1,101660,98340
6:3:3,0,-1,101661,98339
5:3:5,0,-1,101662,98338
5:6:2,1,1,101661,98339
4:6:5,0,-1,101662,98338
2:4:2,2,2,101660,98340
2:3:6,1,1,101659,98341
3:3:1,0,-1,101660,98340
4:5:6,0,-1,101661,98339
3:1:3,0,-1,101662,98338
5:6:2,1,1,101661,98339
6:2:6,1,1,101660,98340
5:4:2,1,1,101659,98341
2:5:3,1,1,101658,98342
6:4:6,0,-1,101659,98341
3:1:5,0,-1,101660,98340
1:6:5,0,-1,101661,98339
4:2:3,1,1,101660,98340
4:3:2,1,1,101659,98341
3:5:4,0,-1,101660,98340
1:3:2,1,1,101659,98341
4:4:1,0,-1,101660,98340
3:4:4,0,-1,101661,98339
4:5:2,1,1,101660,98340
3:6:6,0,-1,101661,98339
4:1:2,1,1,101660,98340
6:2:1,1,1,101659,98341
4:6:3,0,-1,101660,98340
4:3:3,0,-1,101661,98339
2:1:2,2,2,101659,98341
2:4:2,2,2,101657,98343
5:4:5,0,-1,101658,98342
3:6:6,0,-1,101659,98341
6:5:5,0,-1,101660,98340
4:3:5,0,-1,101661,98339
4:5:3,0,-1,101662,98338
5:3:6,0,-1,101663,98337
1:3:5,0,-1,101664,98336
5:6:6,0,-1,101665,98335
1:3:3,0,-1,101666,98334
6:3:2,1,1,101665,98335
5:3:6,0,-1,101666,98334
3:3:4,0,-1,101667,98333
3:5:3,0,-1,101668,98332
3:5:5,0,-1,101669,98331
4:6:5,0,-1,101670,98330
2:1:5,1,1,101669,98331
5:5:2,1,1,101668,98332
5:3:3,0,-1,101669,98331
6:4:4,0,-1,101670,98330
3:6:3,0,-1,101671,98329
6:2:4,1,1,101670,98330
1:4:2,1,1,101669,98331
6:6:6,0,-1,101670,98330
6:3:6,0,-1,101671,98329
5:1:1,0,-1,101672,98328
4:2:6,1,1,101671,98329
1:5:2,1,1,101670,98330
3:3:4,0,-1,101671,98329
3:2:2,2,2,101669,98331
3:6:6,0,-1,101670,98330
1:2:5,1,1,101669,98331
3:3:4,0,-1,101670,98330
6:1:6,0,-1,101671,98329
4:5:3,0,-1,101672,98328
2:6:5,1,1,101671,98329
4:6:5,0,-1,101672,98328
1:2:2,2,2,101670,98330
6:3:4,0,-1,101671,98329
2:3:5,1,1,101670,98330
1:1:3,0,-1,101671,98329
3:4:3,0,-1,101672,98328
6:3:3,0,-1,101673,98327
5:2:5,1,1,101672,98328
1:6:1,0,-1,101673,98327
2:2:3,2,2,101671,98329
1:6:2,1,1,101670,98330
1:5:2,1,1,101669,98331
5:4:6,0,-1,101670,98330
2:1:2,2,2,101668,98332
4:4:3,0,-1,101669,98331
5:5:1,0,-1,101670,98330
6:3:4,0,-1,101671,98329
5:2:3,1,1,101670,98330
5:1:6,0,-1,101671,98329
6:2:5,1,1,101670,98330
4:4:2,1,1,101669,98331
4:1:6,0,-1,101670,98330
2:4:6,1,1,101669,98331
2:6:5,1,1,101668,98332
5:3:3,0,-1,101669,98331
4:3:4,0,-1,101670,98330
1:1:6,0,-1,101671,98329
3:5:5,0,-1,101672,98328
3:4:3,0,-1,101673,98327
3:6:3,0,-1,101674,98326
2:2:4,2,2,101672,98328
5:4:2,1,1,101671,98329
1:3:1,0,-1,101672,98328
1:4:4,0,-1,101673,98327
6:3:1,0,-1,101674,98326
6:4:6,0,-1,101675,98325
4:5:3,0,-1,101676,98324
6:6:4,0,-1,101677,98323
5:5:6,0,-1,101678,98322
6:3:6,0,-1,101679,98321
2:6:3,1,1,101678,98322
2:3:6,1,1,101677,98323
3:1:4,0,-1,101678,98322
1:5:4,0,-1,101679,98321
5:2:3,1,1,101678,98322
6:4:3,0,-1,101679,98321
6:4:4,0,-1,101680,98320
4:2:1,1,1,101679,98321
1:2:1,1,1,101678,98322
1:1:6,0,-1,101679,98321
1:6:1,0,-1,101680,98320
4:6:4,0,-1,101681,98319
4:3:1,0,-1,101682,98318
3:3:4,0,-1,101683,98317
1:3:1,0,-1,101684,98316
1:6:6,0,-1,101685,98315
4:4:1,0,-1,101686,98314
4:5:3,0,-1,101687,98313
1:3:6,0,-1,101688,98312
2:3:2,2,2,101686,98314
2:4:4,1,1,101685,98315
1:5:1,0,-1,101686,98314
4:4:6,0,-1,101687,98313
3:4:3,0,-1,101688,98312
2:5:1,1,1,101687,98313
6:3:2,1,1,101686,98314
3:6:2,1,1,101685,98315
1:5:2,1,1,101684,98316
2:6:2,2,2,101682,98318
3:3:4,0,-1,101683,98317
1:4:6,0,-1,101684,98316
5:5:5,0,-1,101685,98315
6:1:3,0,-1,101686,98314
4:5:6,0,-1,101687,98313
6:1:4,0,-1,101688,98312
5:3:4,0,-1,101689,98311
5:1:4,0,-1,101690,98310
6:1:5,0,-1,101691,98309
6:6:2,1,1,101690,98310
3:4:6,0,-1,101691,98309
2:5:2,2,2,101689,98311
3:3:6,0,-1,101690,98310
2:5:1,1,1,101689,98311
4:1:3,0,-1,101690,98310
2:3:1,1,1,101689,98311
6:2:1,1,1,101688,98312
4:5:6,0,-1,101689,98311
5:4:5,0,-1,101690,98310
3:1:2,1,1,101689,98311
3:4:2,1,1,101688,98312
1:5:6,0,-1,101689,98311
2:4:5,1,1,101688,98312
4:4:4,0,-1,101689,98311
5:6:1,0,-1,101690,98310
3:4:2,1,1,101689,98311
3:1:1,0,-1,101690,98310
3:2:1,1,1,101689,98311
1:4:6,0,-1,101690,98310
3:6:2,1,1,101689,98311
2:1:3,1,1,101688,98312
3:2:3,1,1,101687,98313
4:3:6,0,-1,101688,98312
6:1:1,0,-1,101689,98311
6:2:1,1,1,101688,98312
1:3:3,0,-1,101689,98311
4:5:6,0,-1,101690,98310
6:2:6,1,1,101689,98311
4:5:6,0,-1,101690,98310
6:3:3,0,-1,101691,98309
4:5:5,0,-1,101692,98308
2:2:2,3,3,101689,98311
5:5:4,0,-1,101690,98310
6:2:5,1,1,101689,98311
5:6:2,1,1,101688,98312
6:4:5,0,-1,101689,98311
4:5:2,1,1,101688,98312
1:5:3,0,-1,101689,98311
2:6:5,1,1,101688,98312
6:5:3,0,-1,101689,98311
1:5:2,1,1,101688,98312
2:5:3,1,1,101687,98313
5:5:4,0,-1,101688,98312
2:2:5,2,2,101686,98314
6:3:6,0,-1,101687,98313
4:5:6,0,-1,101688,98312
6:3:5,0,-1,101689,98311
5:4:4,0,-1,101690,98310
4:6:5,0,-1,101691,98309
2:4:5,1,1,101690,98310
4:3:3,0,-1,101691,98309
3:6:2,1,1,101690,98310
4:3:2,1,1,101689,98311
2:2:1,2,2,101687,98313
4:2:1,1,1,101686,98314
6:2:6,1,1,101685,98315
3:4:2,1,1,101684,98316
2:5:4,1,1,101683,98317
5:4:5,0,-1,101684,98316
1:6:5,0,-1,101685,98315
2:4:2,2,2,101683,98317
4:2:2,2,2,101681,98319
2:6:6,1,1,101680,98320
5:4:4,0,-1,101681,98319
4:2:6,1,1,101680,98320
5:5:3,0,-1,101681,98319
4:4:6,0,-1,101682,98318
1:4:5,0,-1,101683,98317
2:6:1,1,1,101682,98318
3:6:1,0,-1,101683,98317
4:4:4,0,-1,101684,98316
5:2:6,1,1,101683,98317
3:3:4,0,-1,101684,98316
6:3:6,0,-1,101685,98315
6:4:3,0,-1,101686,98314
3:2:6,1,1,101685,98315
5:2:4,1,1,101684,98316
2:2:3,2,2,101682,98318
3:2:4,1,1,101681,98319
4:6:1,0,-1,101682,98318
2:6:1,1,1,101681,98319
6:1:3,0,-1,101682,98318
4:5:2,1,1,101681,98319
5:1:2,1,1,101680,98320
1:1:3,0,-1,101681,98319
2:3:5,1,1,101680,98320
1:5:2,1,1,101679,98321
1:6:2,1,1,101678,98322
5:5:1,0,-1,101679,98321
2:6:6,1,1,101678,98322
3:2:6,1,1,101677,98323
1:3:2,1,1,101676,98324
5:5:2,1,1,101675,98325
2:4:3,1,1,101674,98326
5:5:5,0,-1,101675,98325
6:5:2,1,1,101674,98326
6:4:4,0,-1,101675,98325
1:1:4,0,-1,101676,98324
2:4:1,1,1,101675,98325
1:6:2,1,1,101674,98326
3:3:3,0,-1,101675,98325
3:4:6,0,-1,101676,98324
1:3:2,1,1,101675,98325
3:3:4,0,-1,101676,98324
6:2:3,1,1,101675,98325
5:6:4,0,-1,101676,98324
3:4:3,0,-1,101677,98323
4:3:5,0,-1,101678,98322
2:5:3,1,1,101677,98323
6:2:2,2,2,101675,98325
2:3:6,1,1,101674,98326
5:4:1,0,-1,101675,98325
4:4:3,0,-1,101676,98324
3:5:3,0,-1,101677,98323
1:3:1,0,-1,101678,98322
3:1:6,0,-1,101679,98321
2:1:6,1,1,101678,98322
4:1:3,0,-1,101679,98321
5:2:5,1,1,101678,98322
6:5:2,1,1,101677,98323
3:4:1,0,-1,101678,98322
3:1:4,0,-1,101679,98321
1:6:3,0,-1,101680,98320
2:6:3,1,1,101679,98321
3:3:6,0,-1,101680,98320
1:1:5,0,-1,101681,98319
5:6:4,0,-1,101682,98318
4:1:6,0,-1,101683,98317
5:3:2,1,1,101682,98318
5:6:1,0,-1,101683,98317
1:3:1,0,-1,101684,98316
5:1:5,0,-1,101685,98315
5:5:1,0,-1,101686,98314
6:6:3,0,-1,101687,98313
6:2:4,1,1,101686,98314
5:1:5,0,-1,101687,98313
6:1:1,0,-1,101688,98312
3:4:3,0,-1,101689,98311
1:6:4,0,-1,101690,98310
4:5:3,0,-1,101691,98309
6:3:4,0,-1,101692,98308
5:4:2,1,1,101691,98309
4:5:2,1,1,101690,98310
6:5:5,0,-1,101691,98309
3:1:3,0,-1,101692,98308
6:3:2,1,1,101691,98309
1:6:6,0,-1,101692,98308
1:4:1,0,-1,101693,98307
6:6:6,0,-1,101694,98306
1:4:5,0,-1,101695,98305
3:5:3,0,-1,101696,98304
4:4:1,0,-1,101697,98303
1:4:5,0,-1,101698,98302
4:1:5,0,-1,101699,98301
4:6:1,0,-1,101700,98300
4:2:1,1,1,101699,98301
6:2:5,1,1,101698,98302
2:5:4,1,1,101697,98303
3:5:4,0,-1,101698,98302
4:1:5,0,-1,101699,98301
6:6:2,1,1,101698,98302
5:5:2,1,1,101697,98303
1:3:1,0,-1,101698,98302
1:3:2,1,1,101697,98303
2:6:6,1,1,101696,98304
1:1:1,0,-1,101697,98303
4:1:6,0,-1,101698,98302
4:3:3,0,-1,101699,98301
5:4:6,0,-1,101700,98300
3:4:1,0,-1,101701,98299
3:3:1,0,-1,101702,98298
5:3:6,0,-1,101703,98297
5:6:5,0,-1,101704,98296
2:1:3,1,1,101703,98297
5:4:4,0,-1,101704,98296
6:6:3,0,-1,101705,98295
6:2:4,1,1,101704,98296
1:6:5,0,-1,101705,98295
2:3:3,1,1,101704,98296
4:1:4,0,-1,101705,98295
6:3:3,0,-1,101706,98294
5:6:5,0,-1,101707,98293
6:2:1,1,1,101706,98294
2:6:2,2,2,101704,98296
1:3:3,0,-1,101705,98295
3:6:6,0,-1,101706,98294
2:3:1,1,1,101705,98295
3:5:3,0,-1,101706,98294
2:2:4,2,2,101704,98296
2:4:3,1,1,101703,98297
5:6:1,0,-1,101704,98296
2:1:5,1,1,101703,98297
2:2:3,2,2,101701,98299
6:4:6,0,-1,101702,98298
6:6:5,0,-1,101703,98297
3:4:5,0,-1,101704,98296
2:1:1,1,1,101703,98297
1:1:2,1,1,101702,98298
5:2:4,1,1,101701,98299
5:5:6,0,-1,101702,98298
2:5:1,1,1,101701,98299
1:4:2,1,1,101700,98300
3:1:4,0,-1,101701,98299
4:3:3,0,-1,101702,98298
6:2:5,1,1,101701,98299
4:2:2,2,2,101699,98301
3:2:4,1,1,101698,98302
6:3:1,0,-1,101699,98301
3:3:1,0,-1,101700,98300
6:5:1,0,-1,101701,98299
3:4:3,0,-1,101702,98298
5:6:4,0,-1,101703,98297
5:1:2,1,1,101702,98298
1:1:2,1,1,101701,98299
6:3:2,1,1,101700,98300
1:3:3,0,-1,101701,98299
3:2:6,1,1,101700,98300
6:5:4,0,-1,101701,98299
4:1:3,0,-1,101702,98298
4:3:5,0,-1,101703,98297
5:1:5,0,-1,101704,98296
3:2:1,1,1,101703,98297
1:5:5,0,-1,101704,98296
2:5:1,1,1,101703,98297
4:6:2,1,1,101702,98298
2:2:6,2,2,101700,98300
5:3:3,0,-1,101701,98299
5:5:5,0,-1,101702,98298
1:3:4,0,-1,101703,98297
3:6:2,1,1,101702,98298
3:5:4,0,-1,101703,98297
6:6:5,0,-1,101704,98296
2:4:3,1,1,101703,98297
6:1:6,0,-1,101704,98296
1:5:1,0,-1,101705,98295
3:4:2,1,1,101704,98296
4:6:3,0,-1,101705,98295
2:2:5,2,2,101703,98297
5:3:6,0,-1,101704,98296
6:1:1,0,-1,101705,98295
6:6:1,0,-1,101706,98294
6:6:4,0,-1,101707,98293
5:4:6,0,-1,101708,98292
3:3:2,1,1,101707,98293
6:4:6,0,-1,101708,98292
6:2:4,1,1,101707,98293
5:2:3,1,1,101706,98294
3:3:1,0,-1,101707,98293
5:3:1,0,-1,101708,98292
4:3:3,0,-1,101709,98291
3:1:1,0,-1,101710,98290
5:6:4,0,-1,101711,98289
2:6:4,1,1,101710,98290
3:6:3,0,-1,101711,98289
5:2:5,1,1,101710,98290
5:6:6,0,-1,101711,98289
4:6:2,1,1,101710,98290
3:2:6,1,1,101709,98291
5:5:5,0,-1,101710,98290
2:3:5,1,1,101709,98291
4:6:6,0,-1,101710,98290
5:4:1,0,-1,101711,98289
5:5:3,0,-1,101712,98288
5:3:2,1,1,101711,98289
2:4:4,1,1,101710,98290
6:4:2,1,1,101709,98291
2:4:1,1,1,101708,98292
4:1:1,0,-1,101709,98291
3:5:6,0,-1,101710,98290
1:4:3,0,-1,101711,98289
6:6:2,1,1,101710,98290
3:6:2,1,1,101709,98291
3:2:6,1,1,101708,98292
6:1:3,0,-1,101709,98291
1:6:5,0,-1,101710,98290
1:1:4,0,-1,101711,98289
6:3:6,0,-1,101712,98288
5:2:3,1,1,101711,98289
1:3:5,0,-1,101712,98288
2:4:4,1,1,101711,98289
2:4:3,1,1,101710,98290
2:5:6,1,1,101709,98291
3:4:6,0,-1,101710,98290
1:1:1,0,-1,101711,98289
1:5:1,0,-1,101712,98288
2:3:4,1,1,101711,98289
6:3:5,0,-1,101712,98288
1:1:2,1,1,101711,98289
3:4:2,1,1,101710,98290
5:4:5,0,-1,101711,98289
1:4:3,0,-1,101712,98288
1:1:2,1,1,101711,98289
4:3:3,0,-1,101712,98288
1:2:4,1,1,101711,98289
6:2:5,1,1,101710,98290
3:4:6,0,-1,101711,98289
1:6:4,0,-1,101712,98288
5:1:4,0,-1,101713,98287
5:4:2,1,1,101712,98288
3:6:4,0,-1,101713,98287
3:6:2,1,1,101712,98288
2:4:6,1,1,101711,98289
3:5:4,0,-1,101712,98288
6:5:6,0,-1,101713,98287
5:1:6,0,-1,101714,98286
5:6:4,0,-1,101715,98285
3:6:2,1,1,101714,98286
6:1:1,0,-1,101715,98285
1:4:2,1,1,101714,98286
2:4:5,1,1,101713,98287
1:1:6,0,-1,101714,98286
6:3:1,0,-1,101715,98285
6:1:4,0,-1,101716,98284
1:2:6,1,1,101715,98285
2:4:2,2,2,101713,98287
1:3:2,1,1,101712,98288
6:6:4,0,-1,101713,98287
6:2:1,1,1,101712,98288
4:6:6,0,-1,101713,98287
4:1:5,0,-1,101714,98286
1:6:3,0,-1,101715,98285
5:5:4,0,-1,101716,98284
1:2:6,1,1,101715,98285
1:2:3,1,1,101714,98286
6:4:5,0,-1,101715,98285
5:1:2,1,1,101714,98286
4:6:1,0,-1,101715,98285
3:5:1,0,-1,101716,98284
5:4:3,0,-1,101717,98283
3:5:4,0,-1,101718,98282
6:5:2,1,1,101717,98283
1:2:1,1,1,101716,98284
1:1:4,0,-1,101717,98283
4:3:6,0,-1,101718,98282
6:5:1,0,-1,101719,98281
6:5:3,0,-1,101720,98280
1:6:6,0,-1,101721,98279
2:5:1,1,1,101720,98280
6:4:6,0,-1,101721,98279
4:4:4,0,-1,101722,98278
4:2:1,1,1,101721,98279
5:1:6,0,-1,101722,98278
2:4:2,2,2,101720,98280
5:6:6,0,-1,101721,98279
2:2:1,2,2,101719,98281
4:4:3,0,-1,101720,98280
2:2:3,2,2,101718,98282
5:3:4,0,-1,101719,98281
2:1:6,1,1,101718,98282
2:6:3,1,1,101717,98283
4:4:2,1,1,101716,98284
6:6:1,0,-1,101717,98283
5:2:4,1,1,101716,98284
4:5:1,0,-1,101717,98283
6:4:5,0,-1,101718,98282
6:3:4,0,-1,101719,98281
3:5:4,0,-1,101720,98280
1:5:6,0,-1,101721,98279
3:5:5,0,-1,101722,98278
5:5:5,0,-1,101723,98277
6:1:6,0,-1,101724,98276
3:4:1,0,-1,101725,98275
6:2:6,1,1,101724,98276
5:4:6,0,-1,101725,98275
2:3:4,1,1,101724,98276
2:2:3,2,2,101722,98278
2:6:6,1,1,101721,98279
3:4:6,0,-1,101722,98278
1:3:5,0,-1,101723,98277
2:1:6,1,1,101722,98278
1:1:4,0,-1,101723,98277
3:1:1,0,-1,101724,98276
1:3:4,0,-1,101725,98275
3:3:3,0,-1,101726,98274
6:1:1,0,-1,101727,98273
2:6:6,1,1,101726,98274
6:3:5,0,-1,101727,98273
6:6:4,0,-1,101728,98272
1:4:4,0,-1,101729,98271
5:2:3,1,1,101728,98272
6:2:5,1,1,101727,98273
6:6:3,0,-1,101728,98272
3:6:4,0,-1,101729,98271
1:1:2,1,1,101728,98272
4:5:4,0,-1,101729,98271
5:6:1,0,-1,101730,98270
5:4:1,0,-1,101731,98269
6:6:1,0,-1,101732,98268
2:3:6,1,1,101731,98269
2:4:1,1,1,101730,98270
3:1:5,0,-1,101731,98269
5:4:2,1,1,101730,98270
1:3:1,0,-1,101731,98269
2:6:2,2,2,101729,98271
6:6:2,1,1,101728,98272
3:3:6,0,-1,101729,98271
1:1:4,0,-1,101730,98270
3:4:5,0,-1,101731,98269
1:6:6,0,-1,101732,98268
3:6:3,0,-1,101733,98267
1:3:2,1,1,101732,98268
1:3:5,0,-1,101733,98267
4:6:3,0,-1,101734,98266
2:3:5,1,1,101733,98267
1:6:6,0,-1,101734,98266
4:4:1,0,-1,101735,98265
4:6:1,0,-1,101736,98264
4:5:6,0,-1,101737,98263
2:3:5,1,1,101736,98264
5:4:6,0,-1,101737,98263
3:1:4,0,-1,101738,98262
5:6:5,0,-1,101739,98261
3:4:2,1,1,101738,98262
6:5:2,1,1,101737,98263
6:3:5,0,-1,101738,98262
3:2:1,1,1,101737,98263
3:3:4,0,-1,101738,98262
5:4:5,0,-1,101739,98261
2:2:4,2,2,101737,98263
6:4:2,1,1,101736,98264
3:6:1,0,-1,101737,98263
1:2:6,1,1,101736,98264
6:2:1,1,1,101735,98265
6:3:5,0,-1,101736,98264
2:4:3,1,1,101735,98265
1:1:1,0,-1,101736,98264
5:6:1,0,-1,101737,98263
4:4:3,0,-1,101738,98262
2:5:3,1,1,101737,98263
6:1:4,0,-1,101738,98262
4:4:5,0,-1,101739,98261
3:4:5,0,-1,101740,98260
1:1:1,0,-1,101741,98259
3:3:3,0,-1,101742,98258
3:4:5,0,-1,101743,98257
6:2:6,1,1,101742,98258
5:1:4,0,-1,101743,98257
2:6:3,1,1,101742,98258
5:2:1,1,1,101741,98259
5:1:5,0,-1,101742,98258
4:4:5,0,-1,101743,98257
1:2:3,1,1,101742,98258
6:3:6,0,-1,101743,98257
3:1:6,0,-1,101744,98256
1:5:3,0,-1,101745,98255
4:2:5,1,1,101744,98256
6:4:5,0,-1,101745,98255
3:5:5,0,-1,101746,98254
2:6:3,1,1,101745,98255
4:3:2,1,1,101744,98256
3:2:5,1,1,101743,98257
2:4:4,1,1,101742,98258
1:3:2,1,1,101741,98259
5:1:4,0,-1,101742,98258
3:3:2,1,1,101741,98259
3:2:3,1,1,101740,98260
4:5:2,1,1,101739,98261
2:1:1,1,1,101738,98262
2:1:6,1,1,101737,98263
6:6:2,1,1,101736,98264
3:2:5,1,1,101735,98265
6:2:5,1,1,101734,98266
2:1:6,1,1,101733,98267
2:2:4,2,2,101731,98269
2:4:4,1,1,101730,98270
1:3:5,0,-1,101731,98269
1:4:2,1,1,101730,98270
2:4:5,1,1,101729,98271
3:5:2,1,1,101728,98272
3:3:5,0,-1,101729,98271
4:3:3,0,-1,101730,98270
3:4:5,0,-1,101731,98269
6:6:4,0,-1,101732,98268
2:4:3,1,1,101731,98269
1:3:6,0,-1,101732,98268
2:1:4,1,1,101731,98269
6:3:1,0,-1,101732,98268
1:6:5,0,-1,101733,98267
2:2:1,2,2,101731,98269
3:2:3,1,1,101730,98270
3:1:2,1,1,101729,98271
5:2:5,1,1,101728,98272
3:2:6,1,1,101727,98273
3:1:1,0,-1,101728,98272
3:3:4,0,-1,101729,98271
4:3:4,0,-1,101730,98270
6:1:4,0,-1,101731,98269
3:2:5,1,1,101730,98270
2:2:2,3,3,101727,98273
5:1:2,1,1,101726,98274
6:2:2,2,2,101724,98276
3:2:3,1,1,101723,98277
2:5:6,1,1,101722,98278
2:6:3,1,1,101721,98279
6:6:3,0,-1,101722,98278
5:2:6,1,1,101721,98279
1:2:3,1,1,101720,98280
1:4:5,0,-1,101721,98279
5:6:1,0,-1,101722,98278
6:4:1,0,-1,101723,98277
4:5:2,1,1,101722,98278
4:4:4,0,-1,101723,98277
5:5:5,0,-1,101724,98276
4:2:4,1,1,101723,98277
2:4:6,1,1,101722,98278
5:6:5,0,-1,101723,98277
1:1:6,0,-1,101724,98276
6:1:1,0,-1,101725,98275
5:3:6,0,-1,101726,98274
1:1:4,0,-1,101727,98273
3:6:6,0,-1,101728,98272
5:6:1,0,-1,101729,98271
2:4:6,1,1,101728,98272
4:1:3,0,-1,101729,98271
6:4:2,1,1,101728,98272
1:1:6,0,-1,101729,98271
1:6:2,1,1,101728,98272
4:1:3,0,-1,101729,98271
3:2:6,1,1,101728,98272
1:6:5,0,-1,101729,98271
4:6:3,0,-1,101730,98270
3:1:2,1,1,101729,98271
6:3:4,0,-1,101730,98270
2:5:6,1,1,101729,98271
2:6:3,1,1,101728,98272
3:2:6,1,1,101727,98273
4:1:6,0,-1,101728,98272
1:1:5,0,-1,101729,98271
1:1:4,0,-1,101730,98270
4:3:5,0,-1,101731,98269
1:1:4,0,-1,101732,98268
6:6:5,0,-1,101733,98267
5:6:1,0,-1,101734,98266
3:4:3,0,-1,101735,98265
3:6:3,0,-1,101736,98264
5:2:5,1,1,101735,98265
3:4:6,0,-1,101736,98264
3:1:2,1,1,101735,98265
6:6:3,0,-1,101736,98264
3:4:3,0,-1,101737,98263
3:6:1,0,-1,101738,98262
4:2:4,1,1,101737,98263
4:4:6,0,-1,101738,98262
6:5:6,0,-1,101739,98261
6:6:2,1,1,101738,98262
5:4:2,1,1,101737,98263
3:1:1,0,-1,101738,98262
6:3:2,1,1,101737,98263
3:4:5,0,-1,101738,98262
1:2:1,1,1,101737,98263
5:1:3,0,-1,101738,98262
6:1:5,0,-1,101739,98261
5:3:3,0,-1,101740,98260
4:5:6,0,-1,101741,98259
1:1:1,0,-1,101742,98258
6:6:3,0,-1,101743,98257
3:5:1,0,-1,101744,98256
1:2:2,2,2,101742,98258
2:5:3,1,1,101741,98259
2:4:3,1,1,101740,98260
3:4:3,0,-1,101741,98259
3:3:4,0,-1,101742,98258
3:1:6,0,-1,101743,98257
5:2:5,1,1,101742,98258
2:5:6,1,1,101741,98259
5:5:5,0,-1,101742,98258
3:1:4,0,-1,101743,98257
1:1:5,0,-1,101744,98256
3:4:1,0,-1,101745,98255
1:4:3,0,-1,101746,98254
4:3:2,1,1,101745,98255
5:5:2,1,1,101744,98256
5:4:2,1,1,101743,98257
1:6:6,0,-1,101744,98256
4:1:1,0,-1,101745,98255
3:3:5,0,-1,101746,98254
4:2:1,1,1,101745,98255
3:6:4,0,-1,101746,98254
2:6:3,1,1,101745,98255
4:2:4,1,1,101744,98256
4:5:2,1,1,101743,98257
1:3:4,0,-1,101744,98256
6:1:3,0,-1,101745,98255
1:1:3,0,-1,101746,98254
5:2:4,1,1,101745,98255
5:4:4,0,-1,101746,98254
3:6:4,0,-1,101747,98253
2:2:2,3,3,101744,98256
6:3:4,0,-1,101745,98255
5:1:4,0,-1,101746,98254
3:3:4,0,-1,101747,98253
4:2:5,1,1,101746,98254
1:1:3,0,-1,101747,98253
6:1:3,0,-1,101748,98252
1:4:2,1,1,101747,98253
1:2:4,1,1,101746,98254
3:6:6,0,-1,101747,98253
4:3:6,0,-1,101748,98252
4:2:1,1,1,101747,98253
4:3:4,0,-1,101748,98252
6:5:2,1,1,101747,98253
1:6:3,0,-1,101748,98252
2:4:3,1,1,101747,98253
2:3:2,2,2,101745,98255
2:1:1,1,1,101744,98256
6:4:6,0,-1,101745,98255
1:3:5,0,-1,101746,98254
1:3:2,1,1,101745,98255
2:6:5,1,1,101744,98256
6:3:1,0,-1,101745,98255
5:6:4,0,-1,101746,98254
6:6:3,0,-1,101747,98253
3:4:4,0,-1,101748,98252
2:5:5,1,1,101747,98253
6:6:3,0,-1,101748,98252
4:5:5,0,-1,101749,98251
3:2:6,1,1,101748,98252
5:5:5,0,-1,101749,98251
4:5:4,0,-1,101750,98250
2:1:5,1,1,101749,98251
3:6:3,0,-1,101750,98250
1:3:6,0,-1,101751,98249
3:4:6,0,-1,101752,98248
1:5:1,0,-1,101753,98247
3:5:6,0,-1,101754,98246
5:4:4,0,-1,101755,98245
3:1:1,0,-1,101756,98244
3:1:6,0,-1,101757,98243
3:2:2,2,2,101755,98245
4:6:5,0,-1,101756,98244
3:4:6,0,-1,101757,98243
4:2:6,1,1,101756,98244
4:5:1,0,-1,101757,98243
5:1:1,0,-1,101758,98242
3:4:3,0,-1,101759,98241
5:2:3,1,1,101758,98242
6:4:6,0,-1,101759,98241
1:4:5,0,-1,101760,98240
4:3:5,0,-1,101761,98239
1:6:4,0,-1,101762,98238
3:1:4,0,-1,101763,98237
5:6:6,0,-1,101764,98236
2:5:3,1,1,101763,98237
1:1:1,0,-1,101764,98236
5:4:6,0,-1,101765,98235
4:6:2,1,1,101764,98236
1:6:1,0,-1,101765,98235
2:5:4,1,1,101764,98236
6:2:2,2,2,101762,98238
2:5:2,2,2,101760,98240
2:3:1,1,1,101759,98241
6:4:4,0,-1,101760,98240
5:2:4,1,1,101759,98241
2:5:6,1,1,101758,98242
3:1:6,0,-1,101759,98241
6:2:6,1,1,101758,98242
6:1:6,0,-1,101759,98241
6:2:6,1,1,101758,98242
2:5:1,1,1,101757,98243
4:6:3,0,-1,101758,98242
4:1:5,0,-1,101759,98241
6:6:4,0,-1,101760,98240
1:1:1,0,-1,101761,98239
5:5:4,0,-1,101762,98238
6:2:5,1,1,101761,98239
5:1:6,0,-1,101762,98238
6:2:4,1,1,101761,98239
3:4:3,0,-1,101762,98238
6:3:1,0,-1,101763,98237
1:6:6,0,-1,101764,98236
6:4:4,0,-1,101765,98235
5:6:6,0,-1,101766,98234
3:3:6,0,-1,101767,98233
4:5:5,0,-1,101768,98232
5:1:3,0,-1,101769,98231
3:3:3,0,-1,101770,98230
2:6:1,1,1,101769,98231
1:6:4,0,-1,101770,98230
3:6:4,0,-1,101771,98229
6:5:4,0,-1,101772,98228
6:6:1,0,-1,101773,98227
6:6:5,0,-1,101774,98226
6:2:6,1,1,101773,98227
2:3:2,2,2,101771,98229
1:2:3,1,1,101770,98230
2:4:4,1,1,101769,98231
4:3:4,0,-1,101770,98230
1:2:3,1,1,101769,98231
6:2:6,1,1,101768,98232
6:6:1,0,-1,101769,98231
5:6:6,0,-1,101770,98230
3:3:4,0,-1,101771,98229
1:3:4,0,-1,101772,98228
5:6:3,0,-1,101773,98227
6:4:2,1,1,101772,98228
3:6:6,0,-1,101773,98227
5:3:4,0,-1,101774,98226
1:3:4,0,-1,101775,98225
1:1:2,1,1,101774,98226
6:4:1,0,-1,101775,98225
5:3:2,1,1,101774,98226
3:6:5,0,-1,101775,98225
6:4:3,0,-1,101776,98224
6:2:1,1,1,101775,98225
4:4:3,0,-1,101776,98224
1:2:2,2,2,101774,98226
5:3:4,0,-1,101775,98225
3:1:4,0,-1,101776,98224
1:4:1,0,-1,101777,98223
4:6:1,0,-1,101778,98222
2:6:2,2,2,101776,98224
1:4:5,0,-1,101777,98223
6:6:4,0,-1,101778,98222
2:4:3,1,1,101777,98223
1:4:2,1,1,101776,98224
4:4:1,0,-1,101777,98223
1:2:6,1,1,101776,98224
5:2:6,1,1,101775,98225
1:5:5,0,-1,101776,98224
5:4:1,0,-1,101777,98223
6:4:1,0,-1,101778,98222
3:2:1,1,1,101777,98223
6:5:5,0,-1,101778,98222
1:2:1,1,1,101777,98223
1:6:1,0,-1,101778,98222
1:3:3,0,-1,101779,98221
5:5:2,1,1,101778,98222
2:1:4,1,1,101777,98223
5:4:2,1,1,101776,98224
4:5:5,0,-1,101777,98223
3:4:4,0,-1,101778,98222
3:5:3,0,-1,101779,98221
2:2:5,2,2,101777,98223
2:1:4,1,1,101776,98224
5:3:1,0,-1,101777,98223
1:1:1,0,-1,101778,98222
5:3:2,1,1,101777,98223
4:4:4,0,-1,101778,98222
3:1:6,0,-1,101779,98221
1:5:3,0,-1,101780,98220
6:3:6,0,-1,101781,98219
1:2:3,1,1,101780,98220
5:3:5,0,-1,101781,98219
3:6:4,0,-1,101782,98218
3:6:4,0,-1,101783,98217
1:2:6,1,1,101782,98218
4:4:5,0,-1,101783,98217
1:6:2,1,1,101782,98218
5:5:2,1,1,101781,98219
5:4:6,0,-1,101782,98218
3:4:4,0,-1,101783,98217
4:3:2,1,1,101782,98218
6:5:2,1,1,101781,98219
5:3:1,0,-1,101782,98218
2:6:5,1,1,101781,98219
3:3:3,0,-1,101782,98218
2:1:3,1,1,101781,98219
4:5:2,1,1,101780,98220
1:6:5,0,-1,101781,98219
4:5:2,1,1,101780,98220
3:1:1,0,-1,101781,98219
1:4:2,1,1,101780,98220
5:3:4,0,-1,101781,98219
6:5:4,0,-1,101782,98218
4:1:2,1,1,101781,98219
2:1:1,1,1,101780,98220
4:4:2,1,1,101779,98221
1:3:6,0,-1,101780,98220
1:4:3,0,-1,101781,98219
6:5:2,1,1,101780,98220
1:3:1,0,-1,101781,98219
6:5:2,1,1,101780,98220
2:1:2,2,2,101778,98222
5:2:2,2,2,101776,98224
6:3:3,0,-1,101777,98223
3:6:4,0,-1,101778,98222
1:3:4,0,-1,101779,98221
4:4:2,1,1,101778,98222
5:4:6,0,-1,101779,98221
6:2:3,1,1,101778,98222
5:6:5,0,-1,101779,98221
3:6:4,0,-1,101780,98220
4:1:3,0,-1,101781,98219
3:2:4,1,1,101780,98220
6:1:6,0,-1,101781,98219
4:4:4,0,-1,101782,98218
6:4:3,0,-1,101783,98217
6:2:6,1,1,101782,98218
5:3:4,0,-1,101783,98217
3:5:3,0,-1,101784,98216
3:6:6,0,-1,101785,98215
1:2:5,1,1,101784,98216
2:3:5,1,1,101783,98217
2:1:2,2,2,101781,98219
3:1:4,0,-1,101782,98218
5:3:4,0,-1,101783,98217
5:2:4,1,1,101782,98218
1:6:4,0,-1,101783,98217
5:1:5,0,-1,101784,98216
3:5:4,0,-1,101785,98215
4:5:3,0,-1,101786,98214
4:5:6,0,-1,101787,98213
5:2:4,1,1,101786,98214
1:6:1,0,-1,101787,98213
1:2:6,1,1,101786,98214
2:3:2,2,2,101784,98216
3:2:6,1,1,101783,98217
6:2:3,1,1,101782,98218
3:3:1,0,-1,101783,98217
3:2:6,1,1,101782,98218
1:6:5,0,-1,101783,98217
6:1:3,0,-1,101784,98216
1:2:4,1,1,101783,98217
4:2:2,2,2,101781,98219
3:1:4,0,-1,101782,98218
3:6:1,0,-1,101783,98217
2:2:3,2,2,101781,98219
6:1:3,0,-1,101782,98218
2:4:3,1,1,101781,98219
2:4:4,1,1,101780,98220
5:1:5,0,-1,101781,98219
3:4:1,0,-1,101782,98218
3:1:6,0,-1,101783,98217
3:4:1,0,-1,101784,98216
6:4:6,0,-1,101785,98215
1:2:3,1,1,101784,98216
3:2:2,2,2,101782,98218
6:4:5,0,-1,101783,98217
2:4:3,1,1,101782,98218
5:6:6,0,-1,101783,98217
3:2:1,1,1,101782,98218
2:3:1,1,1,101781,98219
6:2:6,1,1,101780,98220
1:4:6,0,-1,101781,98219
4:2:4,1,1,101780,98220
6:4:1,0,-1,101781,98219
4:6:6,0,-1,101782,98218
1:1:6,0,-1,101783,98217
5:3:2,1,1,101782,98218
2:6:4,1,1,101781,98219
6:5:4,0,-1,101782,98218
4:3:1,0,-1,101783,98217
2:6:4,1,1,101782,98218
1:3:6,0,-1,101783,98217
6:6:3,0,-1,101784,98216
4:4:4,0,-1,101785,98215
4:1:2,1,1,101784,98216
6:6:6,0,-1,101785,98215
3:5:4,0,-1,101786,98214
6:5:1,0,-1,101787,98213
5:3:5,0,-1,101788,98212
6:6:2,1,1,101787,98213
4:1:5,0,-1,101788,98212
2:5:3,1,1,101787,98213
1:4:2,1,1,101786,98214
4:2:5,1,1,101785,98215
1:3:2,1,1,101784,98216
2:4:6,1,1,101783,98217
6:5:6,0,-1,101784,98216
2:6:1,1,1,101783,98217
1:2:2,2,2,101781,98219
4:6:3,0,-1,101782,98218
6:4:3,0,-1,101783,98217
2:2:6,2,2,101781,98219
1:3:2,1,1,101780,98220
4:5:1,0,-1,101781,98219
6:4:2,1,1,101780,98220
2:5:1,1,1,101779,98221
1:6:2,1,1,101778,98222
4:3:5,0,-1,101779,98221
4:1:5,0,-1,101780,98220
2:6:4,1,1,101779,98221
5:5:1,0,-1,101780,98220
3:5:4,0,-1,101781,98219
6:6:2,1,1,101780,98220
1:3:2,1,1,101779,98221
1:6:5,0,-1,101780,98220
3:3:3,0,-1,101781,98219
5:3:4,0,-1,101782,98218
5:1:1,0,-1,101783,98217
6:6:6,0,-1,101784,98216
4:1:5,0,-1,101785,98215
6:5:6,0,-1,101786,98214
4:5:1,0,-1,101787,98213
2:6:4,1,1,101786,98214
2:5:5,1,1,101785,98215
3:3:4,0,-1,101786,98214
4:2:1,1,1,101785,98215
4:4:4,0,-1,101786,98214
6:2:4,1,1,101785,98215
5:1:4,0,-1,101786,98214
4:1:4,0,-1,101787,98213
5:1:2,1,1,101786,98214
5:6:5,0,-1,101787,98213
1:4:3,0,-1,101788,98212
1:2:1,1,1,101787,98213
6:4:4,0,-1,101788,98212
3:6:4,0,-1,101789,98211
5:4:4,0,-1,101790,98210
3:1:1,0,-1,101791,98209
2:1:3,1,1,101790,98210
4:6:5,0,-1,101791,98209
2:2:5,2,2,101789,98211
2:3:4,1,1,101788,98212
3:5:6,0,-1,101789,98211
6:4:2,1,1,101788,98212
5:2:5,1,1,101787,98213
4:3:3,0,-1,101788,98212
4:2:6,1,1,101787,98213
5:1:1,0,-1,101788,98212
5:1:5,0,-1,101789,98211
3:1:3,0,-1,101790,98210
2:2:2,3,3,101787,98213
6:6:2,1,1,101786,98214
4:1:3,0,-1,101787,98213
3:1:6,0,-1,101788,98212
1:1:2,1,1,101787,98213
3:6:5,0,-1,101788,98212
5:6:5,0,-1,101789,98211
4:3:5,0,-1,101790,98210
1:6:3,0,-1,101791,98209
5:2:3,1,1,101790,98210
2:1:6,1,1,101789,98211
3:5:4,0,-1,101790,98210
2:5:2,2,2,101788,98212
6:3:6,0,-1,101789,98211
4:1:6,0,-1,101790,98210
5:1:4,0,-1,101791,98209
4:1:3,0,-1,101792,98208
4:5:4,0,-1,101793,98207
4:5:6,0,-1,101794,98206
5:6:6,0,-1,101795,98205
4:4:5,0,-1,101796,98204
5:4:5,0,-1,101797,98203
4:3:1,0,-1,101798,98202
6:3:1,0,-1,101799,98201
1:2:6,1,1,101798,98202
1:5:4,0,-1,101799,98201
5:4:5,0,-1,101800,98200
2:1:1,1,1,101799,98201
1:6:2,1,1,101798,98202
5:1:2,1,1,101797,98203
4:6:6,0,-1,101798,98202
6:4:5,0,-1,101799,98201
6:4:1,0,-1,101800,98200
2:6:1,1,1,101799,98201
6:4:3,0,-1,101800,98200
1:5:5,0,-1,101801,98199
6:5:6,0,-1,101802,98198
3:4:1,0,-1,101803,98197
6:1:5,0,-1,101804,98196
5:6:6,0,-1,101805,98195
4:5:3,0,-1,101806,98194
2:4:4,1,1,101805,98195
6:3:4,0,-1,101806,98194
3:3:6,0,-1,101807,98193
2:1:3,1,1,101806,98194
2:5:4,1,1,101805,98195
4:1:5,0,-1,101806,98194
5:3:3,0,-1,101807,98193
3:4:5,0,-1,101808,98192
3:1:3,0,-1,101809,98191
1:6:5,0,-1,101810,98190
4:2:2,2,2,101808,98192
2:6:4,1,1,101807,98193
2:1:4,1,1,101806,98194
4:3:1,0,-1,101807,98193
3:1:2,1,1,101806,98194
5:1:4,0,-1,101807,98193
3:4:1,0,-1,101808,98192
5:5:5,0,-1,101809,98191
3:4:4,0,-1,101810,98190
1:1:4,0,-1,101811,98189
4:4:1,0,-1,101812,98188
3:5:6,0,-1,101813,98187
3:5:5,0,-1,101814,98186
2:4:6,1,1,101813,98187
1:1:6,0,-1,101814,98186
2:6:1,1,1,101813,98187
4:2:5,1,1,101812,98188
4:2:4,1,1,101811,98189
2:3:6,1,1,101810,98190
3:3:2,1,1,101809,98191
2:2:2,3,3,101806,98194
6:6:4,0,-1,101807,98193
2:6:5,1,1,101806,98194
3:5:1,0,-1,101807,98193
1:2:4,1,1,101806,98194
6:6:6,0,-1,101807,98193
2:2:6,2,2,101805,98195
2:4:6,1,1,101804,98196
6:4:3,0,-1,101805,98195
1:6:5,0,-1,101806,98194
2:5:6,1,1,101805,98195
6:4:2,1,1,101804,98196
1:5:2,1,1,101803,98197
4:5:2,1,1,101802,98198
6:2:3,1,1,101801,98199
3:2:2,2,2,101799,98201
2:3:1,1,1,101798,98202
4:6:6,0,-1,101799,98201
6:4:5,0,-1,101800,98200
2:5:4,1,1,101799,98201
3:6:5,0,-1,101800,98200
3:1:5,0,-1,101801,98199
6:1:4,0,-1,101802,98198
1:3:2,1,1,101801,98199
3:1:3,0,-1,101802,98198
6:3:5,0,-1,101803,98197
1:4:6,0,-1,101804,98196
2:2:5,2,2,101802,98198
3:5:1,0,-1,101803,98197
3:4:4,0,-1,101804,98196
5:3:4,0,-1,101805,98195
1:6:3,0,-1,101806,98194
2:3:1,1,1,101805,98195
5:1:6,0,-1,101806,98194
1:6:3,0,-1,101807,98193
5:3:1,0,-1,101808,98192
2:5:3,1,1,101807,98193
2:3:4,1,1,101806,98194
5:3:4,0,-1,101807,98193
1:1:3,0,-1,101808,98192
5:2:2,2,2,101806,98194
5:3:5,0,-1,101807,98193
4:3:1,0,-1,101808,98192
2:5:5,1,1,101807,98193
3:2:6,1,1,101806,98194
2:6:5,1,1,101805,98195
6:3:3,0,-1,101806,98194
3:6:5,0,-1,101807,98193
4:5:3,0,-1,101808,98192
4:3:5,0,-1,101809,98191
4:6:1,0,-1,101810,98190
3:4:5,0,-1,101811,98189
1:4:1,0,-1,101812,98188
4:4:4,0,-1,101813,98187
5:5:6,0,-1,101814,98186
1:5:3,0,-1,101815,98185
6:4:4,0,-1,101816,98184
5:1:2,1,1,101815,98185
6:3:6,0,-1,101816,98184
4:4:2,1,1,101815,98185
1:1:6,0,-1,101816,98184
6:5:4,0,-1,101817,98183
3:3:4,0,-1,101818,98182
4:2:2,2,2,101816,98184
2:3:1,1,1,101815,98185
2:2:1,2,2,101813,98187
5:5:6,0,-1,101814,98186
5:2:2,2,2,101812,98188
1:1:3,0,-1,101813,98187
2:1:4,1,1,101812,98188
4:3:5,0,-1,101813,98187
6:5:6,0,-1,101814,98186
5:4:3,0,-1,101815,98185
5:2:3,1,1,101814,98186
2:4:4,1,1,101813,98187
6:1:6,0,-1,101814,98186
3:4:4,0,-1,101815,98185
5:3:6,0,-1,101816,98184
1:4:5,0,-1,101817,98183
1:4:1,0,-1,101818,98182
1:2:2,2,2,101816,98184
2:2:3,2,2,101814,98186
3:2:2,2,2,101812,98188
4:4:2,1,1,101811,98189
6:1:4,0,-1,101812,98188
4:2:6,1,1,101811,98189
2:1:2,2,2,101809,98191
6:3:3,0,-1,101810,98190
2:4:2,2,2,101808,98192
2:6:6,1,1,101807,98193
3:3:4,0,-1,101808,98192
2:2:2,3,3,101805,98195
4:5:4,0,-1,101806,98194
3:5:1,0,-1,101807,98193
4:2:5,1,1,101806,98194
6:3:5,0,-1,101807,98193
2:6:1,1,1,101806,98194
4:1:5,0,-1,101807,98193
3:4:6,0,-1,101808,98192
5:5:6,0,-1,101809,98191
4:3:6,0,-1,101810,98190
6:6:5,0,-1,101811,98189
4:4:3,0,-1,101812,98188
5:2:5,1,1,101811,98189
2:6:6,1,1,101810,98190
1:4:6,0,-1,101811,98189
5:4:6,0,-1,101812,98188
6:3:5,0,-1,101813,98187
2:5:2,2,2,101811,98189
1:5:6,0,-1,101812,98188
3:6:3,0,-1,101813,98187
2:2:4,2,2,101811,98189
4:4:6,0,-1,101812,98188
3:6:5,0,-1,101813,98187
2:2:1,2,2,101811,98189
3:6:1,0,-1,101812,98188
4:4:6,0,-1,101813,98187
2:5:5,1,1,101812,98188
3:1:2,1,1,101811,98189
6:4:3,0,-1,101812,98188
1:4:6,0,-1,101813,98187
4:5:3,0,-1,101814,98186
2:1:1,1,1,101813,98187
4:1:1,0,-1,101814,98186
3:6:1,0,-1,101815,98185
1:6:6,0,-1,101816,98184
2:2:2,3,3,101813,98187
2:6:5,1,1,101812,98188
6:6:2,1,1,101811,98189
2:6:5,1,1,101810,98190
6:2:2,2,2,101808,98192
4:5:4,0,-1,101809,98191
1:3:3,0,-1,101810,98190
5:3:1,0,-1,101811,98189
2:2:1,2,2,101809,98191
3:6:4,0,-1,101810,98190
5:2:6,1,1,101809,98191
2:2:6,2,2,101807,98193
1:2:6,1,1,101806,98194
1:2:3,1,1,101805,98195
4:6:6,0,-1,101806,98194
6:1:3,0,-1,101807,98193
2:1:4,1,1,101806,98194
2:2:1,2,2,101804,98196
4:5:3,0,-1,101805,98195
4:2:5,1,1,101804,98196
1:4:4,0,-1,101805,98195
4:2:2,2,2,101803,98197
1:2:6,1,1,101802,98198
3:1:5,0,-1,101803,98197
5:6:3,0,-1,101804,98196
3:6:1,0,-1,101805,98195
2:5:6,1,1,101804,98196
3:2:5,1,1,101803,98197
4:4:3,0,-1,101804,98196
1:5:5,0,-1,101805,98195
3:1:5,0,-1,101806,98194
1:1:3,0,-1,101807,98193
2:3:5,1,1,101806,98194
3:5:4,0,-1,101807,98193
5:2:2,2,2,101805,98195
1:2:3,1,1,101804,98196
5:3:5,0,-1,101805,98195
4:1:5,0,-1,101806,98194
3:6:3,0,-1,101807,98193
2:5:4,1,1,101806,98194
4:2:4,1,1,101805,98195
3:4:6,0,-1,101806,98194
6:2:1,1,1,101805,98195
1:1:3,0,-1,101806,98194
4:2:2,2,2,101804,98196
2:5:6,1,1,101803,98197
5:1:4,0,-1,101804,98196
2:3:4,1,1,101803,98197
4:6:1,0,-1,101804,98196
5:4:3,0,-1,101805,98195
4:6:2,1,1,101804,98196
2:6:5,1,1,101803,98197
5:4:2,1,1,101802,98198
3:6:3,0,-1,101803,98197
3:5:6,0,-1,101804,98196
3:2:4,1,1,101803,98197
1:2:4,1,1,101802,98198
5:6:3,0,-1,101803,98197
6:3:2,1,1,101802,98198
3:3:1,0,-1,101803,98197
4:2:1,1,1,101802,98198
1:5:6,0,-1,101803,98197
6:6:1,0,-1,101804,98196
3:5:1,0,-1,101805,98195
5:2:5,1,1,101804,98196
1:2:2,2,2,101802,98198
3:4:4,0,-1,101803,98197
5:2:5,1,1,101802,98198
1:4:4,0,-1,101803,98197
1:4:2,1,1,101802,98198
3:5:2,1,1,101801,98199
1:4:1,0,-1,101802,98198
4:3:2,1,1,101801,98199
1:4:6,0,-1,101802,98198
4:3:5,0,-1,101803,98197
3:5:4,0,-1,101804,98196
4:6:4,0,-1,101805,98195
2:4:2,2,2,101803,98197
3:1:5,0,-1,101804,98196
4:4:5,0,-1,101805,98195
6:4:1,0,-1,101806,98194
4:3:1,0,-1,101807,98193
2:6:6,1,1,101806,98194
5:5:5,0,-1,101807,98193
1:6:5,0,-1,101808,98192
6:4:3,0,-1,101809,98191
4:4:3,0,-1,101810,98190
1:1:3,0,-1,101811,98189
4:6:1,0,-1,101812,98188
3:2:3,1,1,101811,98189
2:6:2,2,2,101809,98191
3:3:4,0,-1,101810,98190
3:5:5,0,-1,101811,98189
4:2:2,2,2,101809,98191
1:2:4,1,1,101808,98192
2:1:6,1,1,101807,98193
1:6:1,0,-1,101808,98192
5:1:3,0,-1,101809,98191
2:6:5,1,1,101808,98192
5:3:6,0,-1,101809,98191
2:6:1,1,1,101808,98192
6:2:6,1,1,101807,98193
3:2:5,1,1,101806,98194
3:2:5,1,1,101805,98195
2:1:3,1,1,101804,98196
5:1:1,0,-1,101805,98195
1:1:6,0,-1,101806,98194
4:3:5,0,-1,101807,98193
1:2:6,1,1,101806,98194
5:3:6,0,-1,101807,98193
6:3:5,0,-1,101808,98192
1:5:3,0,-1,101809,98191
4:1:1,0,-1,101810,98190
4:3:1,0,-1,101811,98189
5:1:3,0,-1,101812,98188
2:5:2,2,2,101810,98190
1:3:1,0,-1,101811,98189
5:1:4,0,-1,101812,98188
4:2:6,1,1,101811,98189
3:4:5,0,-1,101812,98188
4:1:1,0,-1,101813,98187
6:3:2,1,1,101812,98188
4:5:4,0,-1,101813,98187
4:1:4,0,-1,101814,98186
4:1:6,0,-1,101815,98185
2:6:1,1,1,101814,98186
2:4:2,2,2,101812,98188
6:4:3,0,-1,101813,98187
4:1:2,1,1,101812,98188
5:3:6,0,-1,101813,98187
1:3:3,0,-1,101814,98186
5:4:5,0,-1,101815,98185
4:1:4,0,-1,101816,98184
3:6:5,0,-1,101817,98183
1:4:1,0,-1,101818,98182
3:4:6,0,-1,101819,98181
1:1:3,0,-1,101820,98180
6:6:5,0,-1,101821,98179
2:6:3,1,1,101820,98180
3:1:2,1,1,101819,98181
1:5:6,0,-1,101820,98180
6:1:1,0,-1,101821,98179
3:4:6,0,-1,101822,98178
5:2:6,1,1,101821,98179
1:1:2,1,1,101820,98180
6:4:4,0,-1,101821,98179
1:3:5,0,-1,101822,98178
5:5:3,0,-1,101823,98177
1:6:1,0,-1,101824,98176
3:5:4,0,-1,101825,98175
6:6:6,0,-1,101826,98174
6:4:2,1,1,101825,98175
1:4:6,0,-1,101826,98174
6:2:2,2,2,101824,98176
4:4:4,0,-1,101825,98175
3:2:5,1,1,101824,98176
5:5:3,0,-1,101825,98175
5:3:4,0,-1,101826,98174
2:2:5,2,2,101824,98176
4:3:6,0,-1,101825,98175
1:1:4,0,-1,101826,98174
6:3:4,0,-1,101827,98173
2:2:5,2,2,101825,98175
2:3:6,1,1,101824,98176
2:4:4,1,1,101823,98177
6:1:5,0,-1,101824,98176
6:4:3,0,-1,101825,98175
3:1:4,0,-1,101826,98174
4:4:6,0,-1,101827,98173
4:5:5,0,-1,101828,98172
6:6:1,0,-1,101829,98171
2:2:3,2,2,101827,98173
2:3:5,1,1,101826,98174
5:1:3,0,-1,101827,98173
2:5:4,1,1,101826,98174
4:5:1,0,-1,101827,98173
1:3:4,0,-1,101828,98172
3:6:3,0,-1,101829,98171
6:6:4,0,-1,101830,98170
3:2:4,1,1,101829,98171
3:1:5,0,-1,101830,98170
2:4:4,1,1,101829,98171
4:5:4,0,-1,101830,98170
4:3:1,0,-1,101831,98169
5:1:6,0,-1,101832,98168
6:6:6,0,-1,101833,98167
3:2:5,1,1,101832,98168
6:6:1,0,-1,101833,98167
2:3:2,2,2,101831,98169
6:3:3,0,-1,101832,98168
5:4:3,0,-1,101833,98167
4:2:3,1,1,101832,98168
1:1:2,1,1,101831,98169
6:1:4,0,-1,101832,98168
3:6:6,0,-1,101833,98167
6:1:4,0,-1,101834,98166
6:6:4,0,-1,101835,98165
6:6:1,0,-1,101836,98164
3:2:1,1,1,101835,98165
1:5:5,0,-1,101836,98164
1:2:6,1,1,101835,98165
4:3:3,0,-1,101836,98164
5:4:4,0,-1,101837,98163
6:3:1,0,-1,101838,98162
3:1:4,0,-1,101839,98161
6:3:3,0,-1,101840,98160
6:6:6,0,-1,101841,98159
1:4:1,0,-1,101842,98158
1:2:1,1,1,101841,98159
3:4:4,0,-1,101842,98158
1:6:2,1,1,101841,98159
5:2:6,1,1,101840,98160
2:1:4,1,1,101839,98161
2:3:4,1,1,101838,98162
4:2:6,1,1,101837,98163
1:2:1,1,1,101836,98164
2:3:3,1,1,101835,98165
5:3:3,0,-1,101836,98164
1:3:6,0,-1,101837,98163
5:6:4,0,-1,101838,98162
1:3:2,1,1,101837,98163
5:4:2,1,1,101836,98164
2:2:2,3,3,101833,98167
4:2:4,1,1,101832,98168
4:4:3,0,-1,101833,98167
3:6:1,0,-1,101834,98166
2:6:2,2,2,101832,98168
2:5:3,1,1,101831,98169
3:6:5,0,-1,101832,98168
1:5:2,1,1,101831,98169
6:4:6,0,-1,101832,98168
1:4:4,0,-1,101833,98167
4:2:1,1,1,101832,98168
3:2:5,1,1,101831,98169
5:1:3,0,-1,101832,98168
1:3:5,0,-1,101833,98167
1:3:1,0,-1,101834,98166
2:2:3,2,2,101832,98168
1:1:1,0,-1,101833,98167
3:2:3,1,1,101832,98168
1:1:4,0,-1,101833,98167
5:3:1,0,-1,101834,98166
6:2:3,1,1,101833,98167
2:6:3,1,1,101832,98168
3:5:6,0,-1,101833,98167
3:5:4,0,-1,101834,98166
5:1:2,1,1,101833,98167
6:5:6,0,-1,101834,98166
6:6:3,0,-1,101835,98165
3:3:1,0,-1,101836,98164
6:5:6,0,-1,101837,98163
2:5:6,1,1,101836,98164
5:4:1,0,-1,101837,98163
3:5:1,0,-1,101838,98162
4:2:6,1,1,101837,98163
1:6:5,0,-1,101838,98162
3:2:1,1,1,101837,98163
6:2:3,1,1,101836,98164
5:3:6,0,-1,101837,98163
4:2:2,2,2,101835,98165
6:3:5,0,-1,101836,98164
5:6:1,0,-1,101837,98163
5:3:4,0,-1,101838,98162
1:1:6,0,-1,101839,98161
5:2:1,1,1,101838,98162
4:5:2,1,1,101837,98163
2:4:2,2,2,101835,98165
2:6:4,1,1,101834,98166
2:6:1,1,1,101833,98167
2:2:5,2,2,101831,98169
5:4:4,0,-1,101832,98168
2:3:1,1,1,101831,98169
6:6:4,0,-1,101832,98168
4:1:3,0,-1,101833,98167
2:5:2,2,2,101831,98169
2:1:2,2,2,101829,98171
4:2:4,1,1,101828,98172
4:1:4,0,-1,101829,98171
3:6:2,1,1,101828,98172
4:5:6,0,-1,101829,98171
2:1:2,2,2,101827,98173
5:2:6,1,1,101826,98174
1:5:5,0,-1,101827,98173
3:1:3,0,-1,101828,98172
5:3:1,0,-1,101829,98171
5:1:5,0,-1,101830,98170
3:3:6,0,-1,101831,98169
4:3:2,1,1,101830,98170
1:2:5,1,1,101829,98171
2:1:4,1,1,101828,98172
4:3:5,0,-1,101829,98171
6:3:6,0,-1,101830,98170
2:3:5,1,1,101829,98171
3:1:1,0,-1,101830,98170
3:1:4,0,-1,101831,98169
1:2:1,1,1,101830,98170
3:5:4,0,-1,101831,98169
5:3:4,0,-1,101832,98168
5:1:1,0,-1,101833,98167
1:6:1,0,-1,101834,98166
3:3:2,1,1,101833,98167
4:5:5,0,-1,101834,98166
5:6:6,0,-1,101835,98165
3:1:5,0,-1,101836,98164
6:3:4,0,-1,101837,98163
2:4:5,1,1,101836,98164
5:3:6,0,-1,101837,98163
5:4:6,0,-1,101838,98162
4:1:3,0,-1,101839,98161
1:1:4,0,-1,101840,98160
2:2:1,2,2,101838,98162
2:3:1,1,1,101837,98163
4:4:1,0,-1,101838,98162
3:4:6,0,-1,101839,98161
3:5:6,0,-1,101840,98160
6:3:6,0,-1,101841,98159
3:6:5,0,-1,101842,98158
6:3:6,0,-1,101843,98157
5:5:3,0,-1,101844,98156
4:4:1,0,-1,101845,98155
3:6:5,0,-1,101846,98154
4:4:5,0,-1,101847,98153
1:4:5,0,-1,101848,98152
5:5:1,0,-1,101849,98151
4:2:2,2,2,101847,98153
6:6:1,0,-1,101848,98152
4:4:1,0,-1,101849,98151
1:3:1,0,-1,101850,98150
3:4:3,0,-1,101851,98149
4:4:2,1,1,101850,98150
2:1:5,1,1,101849,98151
3:2:3,1,1,101848,98152
2:1:2,2,2,101846,98154
5:5:1,0,-1,101847,98153
4:5:4,0,-1,101848,98152
1:4:6,0,-1,101849,98151
2:1:2,2,2,101847,98153
4:3:4,0,-1,101848,98152
2:4:1,1,1,101847,98153
1:2:5,1,1,101846,98154
4:2:4,1,1,101845,98155
6:5:6,0,-1,101846,98154
5:3:6,0,-1,101847,98153
6:1:4,0,-1,101848,98152
3:3:5,0,-1,101849,98151
4:4:5,0,-1,101850,98150
5:2:4,1,1,101849,98151
6:2:3,1,1,101848,98152
2:2:4,2,2,101846,98154
6:5:4,0,-1,101847,98153
4:6:4,0,-1,101848,98152
3:1:1,0,-1,101849,98151
1:5:2,1,1,101848,98152
2:4:3,1,1,101847,98153
3:3:1,0,-1,101848,98152
3:3:5,0,-1,101849,98151
3:4:2,1,1,101848,98152
2:3:5,1,1,101847,98153
1:3:5,0,-1,101848,98152
3:2:6,1,1,101847,98153
5:1:1,0,-1,101848,98152
3:6:5,0,-1,101849,98151
5:1:1,0,-1,101850,98150
5:2:3,1,1,101849,98151
3:2:6,1,1,101848,98152
1:4:4,0,-1,101849,98151
3:6:2,1,1,101848,98152
2:5:5,1,1,101847,98153
3:6:6,0,-1,101848,98152
4:4:6,0,-1,101849,98151
1:3:4,0,-1,101850,98150
4:1:2,1,1,101849,98151
2:3:6,1,1,101848,98152
6:4:6,0,-1,101849,98151
2:6:5,1,1,101848,98152
6:6:4,0,-1,101849,98151
5:6:5,0,-1,101850,98150
5:3:1,0,-1,101851,98149
4:1:3,0,-1,101852,98148
3:4:5,0,-1,101853,98147
2:1:3,1,1,101852,98148
2:6:1,1,1,101851,98149
4:6:5,0,-1,101852,98148
1:2:2,2,2,101850,98150
2:3:4,1,1,101849,98151
4:4:5,0,-1,101850,98150
4:4:2,1,1,101849,98151
1:5:1,0,-1,101850,98150
3:1:5,0,-1,101851,98149
4:5:6,0,-1,101852,98148
3:2:5,1,1,101851,98149
3:2:1,1,1,101850,98150
6:5:3,0,-1,101851,98149
2:6:1,1,1,101850,98150
2:6:5,1,1,101849,98151
1:4:4,0,-1,101850,98150
4:1:2,1,1,101849,98151
4:3:2,1,1,101848,98152
4:3:2,1,1,101847,98153
5:3:6,0,-1,101848,98152
5:3:5,0,-1,101849,98151
1:1:6,0,-1,101850,98150
5:2:1,1,1,101849,98151
2:1:1,1,1,101848,98152
2:1:1,1,1,101847,98153
2:3:3,1,1,101846,98154
4:3:1,0,-1,101847,98153
4:3:4,0,-1,101848,98152
3:6:4,0,-1,101849,98151
3:4:5,0,-1,101850,98150
6:5:5,0,-1,101851,98149
1:2:4,1,1,101850,98150
4:4:2,1,1,101849,98151
1:1:5,0,-1,101850,98150
5:4:5,0,-1,101851,98149
6:1:4,0,-1,101852,98148
3:3:1,0,-1,101853,98147
3:5:3,0,-1,101854,98146
2:6:4,1,1,101853,98147
6:2:5,1,1,101852,98148
5:3:6,0,-1,101853,98147
3:1:5,0,-1,101854,98146
3:1:4,0,-1,101855,98145
6:5:1,0,-1,101856,98144
1:1:1,0,-1,101857,98143
1:2:1,1,1,101856,98144
5:1:2,1,1,101855,98145
3:1:3,0,-1,101856,98144
3:1:2,1,1,101855,98145
6:2:1,1,1,101854,98146
4:3:3,0,-1,101855,98145
2:4:3,1,1,101854,98146
2:6:6,1,1,101853,98147
6:4:3,0,-1,101854,98146
1:6:6,0,-1,101855,98145
1:1:1,0,-1,101856,98144
6:4:1,0,-1,101857,98143
1:6:3,0,-1,101858,98142
3:5:1,0,-1,101859,98141
6:1:1,0,-1,101860,98140
5:5:6,0,-1,101861,98139
2:5:2,2,2,101859,98141
4:2:1,1,1,101858,98142
1:5:3,0,-1,101859,98141
2:4:4,1,1,101858,98142
1:4:6,0,-1,101859,98141
1:2:2,2,2,101857,98143
5:3:4,0,-1,101858,98142
1:5:1,0,-1,101859,98141
6:3:4,0,-1,101860,98140
1:1:3,0,-1,101861,98139
2:2:2,3,3,101858,98142
3:1:5,0,-1,101859,98141
6:4:3,0,-1,101860,98140
5:2:6,1,1,101859,98141
4:4:2,1,1,101858,98142
4:5:4,0,-1,101859,98141
3:3:4,0,-1,101860,98140
6:3:6,0,-1,101861,98139
3:3:5,0,-1,101862,98138
6:1:5,0,-1,101863,98137
1:2:4,1,1,101862,98138
4:6:5,0,-1,101863,98137
2:4:5,1,1,101862,98138
4:4:5,0,-1,101863,98137
6:3:1,0,-1,101864,98136
2:4:4,1,1,101863,98137
3:6:3,0,-1,101864,98136
5:4:3,0,-1,101865,98135
6:2:4,1,1,101864,98136
1:1:3,0,-1,101865,98135
2:5:6,1,1,101864,98136
3:5:2,1,1,101863,98137
2:5:4,1,1,101862,98138
4:1:1,0,-1,101863,98137
4:1:1,0,-1,101864,98136
1:5:2,1,1,101863,98137
4:1:1,0,-1,101864,98136
4:6:6,0,-1,101865,98135
5:1:5,0,-1,101866,98134
1:2:1,1,1,101865,98135
2:3:4,1,1,101864,98136
3:2:2,2,2,101862,98138
5:4:4,0,-1,101863,98137
4:4:3,0,-1,101864,98136
3:2:6,1,1,101863,98137
4:2:6,1,1,101862,98138
6:1:5,0,-1,101863,98137
5:3:3,0,-1,101864,98136
1:4:6,0,-1,101865,98135
1:4:2,1,1,101864,98136
5:3:6,0,-1,101865,98135
6:2:2,2,2,101863,98137
2:3:1,1,1,101862,98138
6:5:3,0,-1,101863,98137
5:5:6,0,-1,101864,98136
2:1:4,1,1,101863,98137
3:1:1,0,-1,101864,98136
2:1:1,1,1,101863,98137
4:2:4,1,1,101862,98138
4:4:4,0,-1,101863,98137
1:4:1,0,-1,101864,98136
5:6:5,0,-1,101865,98135
5:1:4,0,-1,101866,98134
6:1:6,0,-1,101867,98133
5:3:4,0,-1,101868,98132
3:3:2,1,1,101867,98133
3:2:5,1,1,101866,98134
6:3:2,1,1,101865,98135
5:3:3,0,-1,101866,98134
1:1:3,0,-1,101867,98133
4:2:6,1,1,101866,98134
3:3:6,0,-1,101867,98133
2:6:6,1,1,101866,98134
5:3:2,1,1,101865,98135
4:6:4,0,-1,101866,98134
3:3:2,1,1,101865,98135
4:3:3,0,-1,101866,98134
4:5:5,0,-1,101867,98133
3:4:3,0,-1,101868,98132
4:5:3,0,-1,101869,98131
5:2:4,1,1,101868,98132
6:3:6,0,-1,101869,98131
1:6:3,0,-1,101870,98130
6:5:6,0,-1,101871,98129
1:1:2,1,1,101870,98130
4:3:4,0,-1,101871,98129
1:3:2,1,1,101870,98130
2:1:2,2,2,101868,98132
5:1:6,0,-1,101869,98131
3:2:2,2,2,101867,98133
2:4:1,1,1,101866,98134
3:5:4,0,-1,101867,98133
6:4:1,0,-1,101868,98132
5:4:4,0,-1,101869,98131
2:6:1,1,1,101868,98132
1:6:5,0,-1,101869,98131
5:5:4,0,-1,101870,98130
6:4:6,0,-1,101871,98129
6:1:2,1,1,101870,98130
1:2:2,2,2,101868,98132
6:1:3,0,-1,101869,98131
6:6:2,1,1,101868,98132
1:4:6,0,-1,101869,98131
1:4:6,0,-1,101870,98130
4:1:1,0,-1,101871,98129
6:1:4,0,-1,101872,98128
5:3:6,0,-1,101873,98127
2:2:4,2,2,101871,98129
6:3:4,0,-1,101872,98128
4:6:6,0,-1,101873,98127
6:4:5,0,-1,101874,98126
3:2:2,2,2,101872,98128
3:5:2,1,1,101871,98129
4:5:5,0,-1,101872,98128
2:5:4,1,1,101871,98129
2:3:5,1,1,101870,98130
4:5:4,0,-1,101871,98129
5:3:5,0,-1,101872,98128
6:6:1,0,-1,101873,98127
6:5:6,0,-1,101874,98126
6:5:2,1,1,101873,98127
4:1:3,0,-1,101874,98126
5:1:3,0,-1,101875,98125
6:4:3,0,-1,101876,98124
4:2:2,2,2,101874,98126
1:2:1,1,1,101873,98127
6:5:1,0,-1,101874,98126
2:2:6,2,2,101872,98128
1:1:5,0,-1,101873,98127
5:5:5,0,-1,101874,98126
4:3:5,0,-1,101875,98125
4:6:6,0,-1,101876,98124
3:1:2,1,1,101875,98125
2:5:4,1,1,101874,98126
4:4:6,0,-1,101875,98125
6:3:5,0,-1,101876,98124
5:4:3,0,-1,101877,98123
1:1:1,0,-1,101878,98122
4:2:6,1,1,101877,98123
5:4:6,0,-1,101878,98122
6:6:1,0,-1,101879,98121
5:5:2,1,1,101878,98122
1:3:5,0,-1,101879,98121
2:4:3,1,1,101878,98122
6:1:6,0,-1,101879,98121
1:5:1,0,-1,101880,98120
2:6:3,1,1,101879,98121
2:6:3,1,1,101878,98122
5:2:5,1,1,101877,98123
6:4:4,0,-1,101878,98122
5:5:3,0,-1,101879,98121
2:4:6,1,1,101878,98122
4:4:4,0,-1,101879,98121
3:1:6,0,-1,101880,98120
1:3:1,0,-1,101881,98119
6:4:3,0,-1,101882,98118
3:2:1,1,1,101881,98119
5:2:3,1,1,101880,98120
5:1:2,1,1,101879,98121
2:5:3,1,1,101878,98122
5:6:6,0,-1,101879,98121
6:2:6,1,1,101878,98122
4:5:4,0,-1,101879,98121
3:2:2,2,2,101877,98123
2:3:3,1,1,101876,98124
4:4:3,0,-1,101877,98123
5:1:3,0,-1,101878,98122
1:6:6,0,-1,101879,98121
6:4:4,0,-1,101880,98120
5:4:3,0,-1,101881,98119
2:3:4,1,1,101880,98120
6:4:4,0,-1,101881,98119
2:6:5,1,1,101880,98120
5:2:6,1,1,101879,98121
6:5:4,0,-1,101880,98120
4:6:5,0,-1,101881,98119
1:6:6,0,-1,101882,98118
6:4:4,0,-1,101883,98117
1:6:6,0,-1,101884,98116
6:3:4,0,-1,101885,98115
1:1:5,0,-1,101886,98114
2:2:4,2,2,101884,98116
4:6:4,0,-1,101885,98115
1:6:3,0,-1,101886,98114
5:1:2,1,1,101885,98115
1:6:6,0,-1,101886,98114
2:3:1,1,1,101885,98115
2:5:1,1,1,101884,98116
3:5:4,0,-1,101885,98115
5:5:2,1,1,101884,98116
2:5:6,1,1,101883,98117
3:3:3,0,-1,101884,98116
2:4:3,1,1,101883,98117
3:3:4,0,-1,101884,98116
5:5:5,0,-1,101885,98115
2:4:2,2,2,101883,98117
1:2:6,1,1,101882,98118
6:1:4,0,-1,101883,98117
6:6:6,0,-1,101884,98116
1:6:3,0,-1,101885,98115
4:2:5,1,1,101884,98116
1:6:2,1,1,101883,98117
3:1:3,0,-1,101884,98116
4:5:2,1,1,101883,98117
3:1:3,0,-1,101884,98116
5:5:4,0,-1,101885,98115
5:3:3,0,-1,101886,98114
1:2:4,1,1,101885,98115
1:5:3,0,-1,101886,98114
6:5:6,0,-1,101887,98113
6:6:3,0,-1,101888,98112
4:3:1,0,-1,101889,98111
3:3:4,0,-1,101890,98110
1:1:4,0,-1,101891,98109
1:5:3,0,-1,101892,98108
4:1:2,1,1,101891,98109
4:1:4,0,-1,101892,98108
1:1:3,0,-1,101893,98107
6:3:5,0,-1,101894,98106
5:1:3,0,-1,101895,98105
4:5:2,1,1,101894,98106
6:6:1,0,-1,101895,98105
5:6:4,0,-1,101896,98104
2:3:2,2,2,101894,98106
6:5:6,0,-1,101895,98105
1:6:3,0,-1,101896,98104
6:4:5,0,-1,101897,98103
3:4:2,1,1,101896,98104
6:5:6,0,-1,101897,98103
6:2:6,1,1,101896,98104
1:3:3,0,-1,101897,98103
3:3:2,1,1,101896,98104
3:5:3,0,-1,101897,98103
5:1:4,0,-1,101898,98102
1:6:6,0,-1,101899,98101
3:3:4,0,-1,101900,98100
6:4:2,1,1,101899,98101
1:2:1,1,1,101898,98102
5:3:4,0,-1,101899,98101
1:4:6,0,-1,101900,98100
6:1:3,0,-1,101901,98099
2:6:4,1,1,101900,98100
5:5:6,0,-1,101901,98099
3:5:3,0,-1,101902,98098
1:6:6,0,-1,101903,98097
3:1:6,0,-1,101904,98096
4:2:1,1,1,101903,98097
1:1:4,0,-1,101904,98096
5:2:5,1,1,101903,98097
5:5:5,0,-1,101904,98096
2:1:5,1,1,101903,98097
5:6:6,0,-1,101904,98096
2:5:4,1,1,101903,98097
4:3:3,0,-1,101904,98096
2:4:4,1,1,101903,98097
4:2:5,1,1,101902,98098
4:4:3,0,-1,101903,98097
2:1:6,1,1,101902,98098
4:4:1,0,-1,101903,98097
4:2:5,1,1,101902,98098
6:4:5,0,-1,101903,98097
6:2:1,1,1,101902,98098
5:3:2,1,1,101901,98099
3:3:6,0,-1,101902,98098
3:4:3,0,-1,101903,98097
6:4:1,0,-1,101904,98096
4:2:4,1,1,101903,98097
6:1:3,0,-1,101904,98096
3:4:3,0,-1,101905,98095
6:4:5,0,-1,101906,98094
5:6:5,0,-1,101907,98093
1:3:2,1,1,101906,98094
1:3:6,0,-1,101907,98093
6:1:5,0,-1,101908,98092
6:3:3,0,-1,101909,98091
4:4:2,1,1,101908,98092
6:2:2,2,2,101906,98094
5:2:3,1,1,101905,98095
5:5:3,0,-1,101906,98094
2:4:6,1,1,101905,98095
1:5:1,0,-1,101906,98094
4:6:5,0,-1,101907,98093
4:5:4,0,-1,101908,98092
6:1:5,0,-1,101909,98091
2:2:3,2,2,101907,98093
4:1:6,0,-1,101908,98092
2:1:5,1,1,101907,98093
6:6:2,1,1,101906,98094
4:2:4,1,1,101905,98095
2:5:5,1,1,101904,98096
4:2:2,2,2,101902,98098
6:3:4,0,-1,101903,98097
3:1:5,0,-1,101904,98096
1:4:1,0,-1,101905,98095
3:4:4,0,-1,101906,98094
1:5:4,0,-1,101907,98093
6:4:1,0,-1,101908,98092
4:3:4,0,-1,101909,98091
6:1:2,1,1,101908,98092
5:4:3,0,-1,101909,98091
4:1:2,1,1,101908,98092
1:6:6,0,-1,101909,98091
6:6:4,0,-1,101910,98090
4:5:4,0,-1,101911,98089
2:2:3,2,2,101909,98091
4:4:3,0,-1,101910,98090
2:4:6,1,1,101909,98091
5:2:5,1,1,101908,98092
1:2:3,1,1,101907,98093
3:5:1,0,-1,101908,98092
6:2:2,2,2,101906,98094
5:2:1,1,1,101905,98095
2:6:1,1,1,101904,98096
5:4:2,1,1,101903,98097
3:5:2,1,1,101902,98098
6:5:4,0,-1,101903,98097
4:2:6,1,1,101902,98098
1:1:5,0,-1,101903,98097
2:1:2,2,2,101901,98099
3:1:1,0,-1,101902,98098
5:3:4,0,-1,101903,98097
5:5:5,0,-1,101904,98096
5:2:3,1,1,101903,98097
6:6:6,0,-1,101904,98096
5:1:6,0,-1,101905,98095
4:5:1,0,-1,101906,98094
5:1:4,0,-1,101907,98093
4:4:1,0,-1,101908,98092
3:5:5,0,-1,101909,98091
6:3:2,1,1,101908,98092
3:4:1,0,-1,101909,98091
6:4:4,0,-1,101910,98090
3:5:4,0,-1,101911,98089
3:1:2,1,1,101910,98090
2:3:5,1,1,101909,98091
4:6:1,0,-1,101910,98090
1:3:3,0,-1,101911,98089
1:3:3,0,-1,101912,98088
4:5:4,0,-1,101913,98087
6:6:1,0,-1,101914,98086
5:5:3,0,-1,101915,98085
5:5:6,0,-1,101916,98084
1:4:4,0,-1,101917,98083
3:5:6,0,-1,101918,98082
1:5:3,0,-1,101919,98081
3:6:3,0,-1,101920,98080
1:3:2,1,1,101919,98081
6:6:5,0,-1,101920,98080
6:4:1,0,-1,101921,98079
2:3:5,1,1,101920,98080
2:3:4,1,1,101919,98081
1:1:2,1,1,101918,98082
5:6:6,0,-1,101919,98081
2:2:4,2,2,101917,98083
3:4:2,1,1,101916,98084
6:2:3,1,1,101915,98085
1:6:4,0,-1,101916,98084
6:5:5,0,-1,101917,98083
3:1:4,0,-1,101918,98082
1:2:1,1,1,101917,98083
6:6:4,0,-1,101918,98082
1:5:5,0,-1,101919,98081
5:4:1,0,-1,101920,98080
1:5:1,0,-1,101921,98079
6:3:6,0,-1,101922,98078
6:2:6,1,1,101921,98079
6:1:1,0,-1,101922,98078
1:2:3,1,1,101921,98079
3:6:2,1,1,101920,98080
1:4:1,0,-1,101921,98079
1:3:4,0,-1,101922,98078
3:6:1,0,-1,101923,98077
3:2:4,1,1,101922,98078
3:6:2,1,1,101921,98079
1:1:3,0,-1,101922,98078
6:6:2,1,1,101921,98079
6:6:2,1,1,101920,98080
4:5:5,0,-1,101921,98079
6:1:4,0,-1,101922,98078
1:3:3,0,-1,101923,98077
2:1:5,1,1,101922,98078
1:1:6,0,-1,101923,98077
6:2:1,1,1,101922,98078
5:4:6,0,-1,101923,98077
6:4:5,0,-1,101924,98076
6:5:3,0,-1,101925,98075
5:5:4,0,-1,101926,98074
4:4:2,1,1,101925,98075
6:6:5,0,-1,101926,98074
6:5:4,0,-1,101927,98073
3:5:1,0,-1,101928,98072
3:2:5,1,1,101927,98073
1:2:5,1,1,101926,98074
4:3:1,0,-1,101927,98073
4:3:3,0,-1,101928,98072
4:5:3,0,-1,101929,98071
3:3:1,0,-1,101930,98070
1:3:3,0,-1,101931,98069
3:6:4,0,-1,101932,98068
1:6:6,0,-1,101933,98067
4:6:4,0,-1,101934,98066
6:2:1,1,1,101933,98067
4:3:3,0,-1,101934,98066
4:4:3,0,-1,101935,98065
2:2:2,3,3,101932,98068
1:1:1,0,-1,101933,98067
2:3:1,1,1,101932,98068
3:1:3,0,-1,101933,98067
6:2:6,1,1,101932,98068
1:4:6,0,-1,101933,98067
2:3:1,1,1,101932,98068
4:3:5,0,-1,101933,98067
5:4:1,0,-1,101934,98066
5:3:4,0,-1,101935,98065
4:1:6,0,-1,101936,98064
1:3:3,0,-1,101937,98063
1:2:1,1,1,101936,98064
4:2:4,1,1,101935,98065
4:2:6,1,1,101934,98066
1:2:3,1,1,101933,98067
6:2:4,1,1,101932,98068
2:2:1,2,2,101930,98070
3:2:4,1,1,101929,98071
5:6:1,0,-1,101930,98070
1:4:3,0,-1,101931,98069
5:3:6,0,-1,101932,98068
6:3:6,0,-1,101933,98067
6:6:2,1,1,101932,98068
5:2:5,1,1,101931,98069
3:6:4,0,-1,101932,98068
2:5:3,1,1,101931,98069
6:2:3,1,1,101930,98070
6:1:1,0,-1,101931,98069
5:6:6,0,-1,101932,98068
3:6:4,0,-1,101933,98067
1:6:3,0,-1,101934,98066
6:4:2,1,1,101933,98067
4:3:2,1,1,101932,98068
1:5:2,1,1,101931,98069
5:3:3,0,-1,101932,98068
5:5:6,0,-1,101933,98067
6:5:6,0,-1,101934,98066
3:1:4,0,-1,101935,98065
2:4:2,2,2,101933,98067
3:1:1,0,-1,101934,98066
6:1:4,0,-1,101935,98065
6:4:1,0,-1,101936,98064
6:3:5,0,-1,101937,98063
2:4:5,1,1,101936,98064
6:2:1,1,1,101935,98065
1:1:6,0,-1,101936,98064
6:6:3,0,-1,101937,98063
4:4:4,0,-1,101938,98062
4:1:4,0,-1,101939,98061
6:2:3,1,1,101938,98062
6:3:2,1,1,101937,98063
2:1:6,1,1,101936,98064
1:5:6,0,-1,101937,98063
1:5:2,1,1,101936,98064
1:5:2,1,1,101935,98065
2:3:2,2,2,101933,98067
3:6:5,0,-1,101934,98066
2:5:5,1,1,101933,98067
4:1:1,0,-1,101934,98066
1:4:2,1,1,101933,98067
2:1:4,1,1,101932,98068
3:2:5,1,1,101931,98069
4:4:2,1,1,101930,98070
2:1:2,2,2,101928,98072
3:1:1,0,-1,101929,98071
1:5:2,1,1,101928,98072
3:4:6,0,-1,101929,98071
5:6:2,1,1,101928,98072
2:1:5,1,1,101927,98073
6:5:1,0,-1,101928,98072
4:1:2,1,1,101927,98073
4:4:3,0,-1,101928,98072
4:4:1,0,-1,101929,98071
5:5:1,0,-1,101930,98070
6:2:2,2,2,101928,98072
4:6:5,0,-1,101929,98071
1:1:5,0,-1,101930,98070
2:4:2,2,2,101928,98072
2:3:3,1,1,101927,98073
6:1:6,0,-1,101928,98072
5:4:5,0,-1,101929,98071
3:4:5,0,-1,101930,98070
2:5:6,1,1,101929,98071
2:4:4,1,1,101928,98072
4:5:3,0,-1,101929,98071
3:5:6,0,-1,101930,98070
5:4:2,1,1,101929,98071
5:3:4,0,-1,101930,98070
3:4:5,0,-1,101931,98069
5:3:5,0,-1,101932,98068
1:3:2,1,1,101931,98069
5:5:3,0,-1,101932,98068
5:6:1,0,-1,101933,98067
3:4:2,1,1,101932,98068
4:6:4,0,-1,101933,98067
5:1:6,0,-1,101934,98066
4:4:5,0,-1,101935,98065
2:3:3,1,1,101934,98066
3:5:3,0,-1,101935,98065
1:4:2,1,1,101934,98066
6:2:2,2,2,101932,98068
5:5:3,0,-1,101933,98067
3:3:3,0,-1,101934,98066
5:6:3,0,-1,101935,98065
5:1:2,1,1,101934,98066
6:6:4,0,-1,101935,98065
6:5:2,1,1,101934,98066
6:1:6,0,-1,101935,98065
4:2:5,1,1,101934,98066
1:6:5,0,-1,101935,98065
1:5:5,0,-1,101936,98064
2:3:6,1,1,101935,98065
3:1:2,1,1,101934,98066
5:4:6,0,-1,101935,98065
4:1:2,1,1,101934,98066
2:1:6,1,1,101933,98067
5:3:4,0,-1,101934,98066
6:3:1,0,-1,101935,98065
2:2:4,2,2,101933,98067
2:3:6,1,1,101932,98068
4:4:6,0,-1,101933,98067
4:3:1,0,-1,101934,98066
1:5:2,1,1,101933,98067
3:2:1,1,1,101932,98068
5:1:3,0,-1,101933,98067
2:4:3,1,1,101932,98068
4:5:3,0,-1,101933,98067
3:2:2,2,2,101931,98069
5:5:5,0,-1,101932,98068
1:5:6,0,-1,101933,98067
2:5:3,1,1,101932,98068
4:3:2,1,1,101931,98069
2:1:6,1,1,101930,98070
4:1:6,0,-1,101931,98069
3:1:6,0,-1,101932,98068
5:6:1,0,-1,101933,98067
6:6:4,0,-1,101934,98066
6:4:4,0,-1,101935,98065
3:6:1,0,-1,101936,98064
1:4:1,0,-1,101937,98063
5:2:4,1,1,101936,98064
1:4:3,0,-1,101937,98063
4:3:2,1,1,101936,98064
6:2:5,1,1,101935,98065
6:2:6,1,1,101934,98066
2:6:1,1,1,101933,98067
5:3:6,0,-1,101934,98066
5:1:5,0,-1,101935,98065
3:4:2,1,1,101934,98066
2:3:5,1,1,101933,98067
5:1:1,0,-1,101934,98066
1:3:3,0,-1,101935,98065
6:5:2,1,1,101934,98066
4:2:3,1,1,101933,98067
6:4:1,0,-1,101934,98066
3:6:6,0,-1,101935,98065
1:6:4,0,-1,101936,98064
4:5:5,0,-1,101937,98063
3:2:4,1,1,101936,98064
4:4:4,0,-1,101937,98063
4:3:5,0,-1,101938,98062
6:6:6,0,-1,101939,98061
4:6:3,0,-1,101940,98060
4:4:1,0,-1,101941,98059
4:2:6,1,1,101940,98060
6:2:5,1,1,101939,98061
3:4:4,0,-1,101940,98060
1:4:3,0,-1,101941,98059
4:2:1,1,1,101940,98060
1:5:1,0,-1,101941,98059
5:4:5,0,-1,101942,98058
4:3:2,1,1,101941,98059
4:1:2,1,1,101940,98060
2:3:1,1,1,101939,98061
5:1:5,0,-1,101940,98060
3:1:2,1,1,101939,98061
3:1:6,0,-1,101940,98060
2:2:3,2,2,101938,98062
1:5:6,0,-1,101939,98061
5:4:6,0,-1,101940,98060
4:4:1,0,-1,101941,98059
4:5:2,1,1,101940,98060
6:6:2,1,1,101939,98061
1:5:1,0,-1,101940,98060
1:3:1,0,-1,101941,98059
2:2:4,2,2,101939,98061
5:6:1,0,-1,101940,98060
5:5:4,0,-1,101941,98059
4:1:6,0,-1,101942,98058
2:4:6,1,1,101941,98059
6:6:2,1,1,101940,98060
1:4:5,0,-1,101941,98059
6:5:3,0,-1,101942,98058
3:4:3,0,-1,101943,98057
5:4:6,0,-1,101944,98056
3:3:1,0,-1,101945,98055
1:2:3,1,1,101944,98056
1:1:4,0,-1,101945,98055
2:4:4,1,1,101944,98056
1:2:6,1,1,101943,98057
1:6:5,0,-1,101944,98056
6:2:3,1,1,101943,98057
5:5:2,1,1,101942,98058
5:5:5,0,-1,101943,98057
6:4:6,0,-1,101944,98056
5:5:1,0,-1,101945,98055
6:6:1,0,-1,101946,98054
5:5:4,0,-1,101947,98053
5:1:1,0,-1,101948,98052
4:5:1,0,-1,101949,98051
6:5:4,0,-1,101950,98050
1:1:4,0,-1,101951,98049
1:6:6,0,-1,101952,98048
2:1:4,1,1,101951,98049
3:2:2,2,2,101949,98051
2:4:5,1,1,101948,98052
2:1:6,1,1,101947,98053
5:2:5,1,1,101946,98054
3:2:4,1,1,101945,98055
2:5:1,1,1,101944,98056
6:4:6,0,-1,101945,98055
5:6:1,0,-1,101946,98054
2:6:4,1,1,101945,98055
4:1:4,0,-1,101946,98054
6:1:4,0,-1,101947,98053
5:6:2,1,1,101946,98054
1:2:5,1,1,101945,98055
5:6:4,0,-1,101946,98054
6:4:3,0,-1,101947,98053
3:4:5,0,-1,101948,98052
3:6:2,1,1,101947,98053
4:1:4,0,-1,101948,98052
3:3:6,0,-1,101949,98051
2:5:4,1,1,101948,98052
1:5:5,0,-1,101949,98051
3:5:3,0,-1,101950,98050
4:3:4,0,-1,101951,98049
4:4:3,0,-1,101952,98048
6:1:6,0,-1,101953,98047
2:1:1,1,1,101952,98048
1:6:5,0,-1,101953,98047
4:6:5,0,-1,101954,98046
5:5:1,0,-1,101955,98045
3:5:2,1,1,101954,98046
2:5:5,1,1,101953,98047
4:4:2,1,1,101952,98048
6:2:2,2,2,101950,98050
4:5:4,0,-1,101951,98049
5:1:2,1,1,101950,98050
5:2:6,1,1,101949,98051
2:6:2,2,2,101947,98053
1:5:3,0,-1,101948,98052
2:1:5,1,1,101947,98053
4:5:5,0,-1,101948,98052
3:6:5,0,-1,101949,98051
5:6:3,0,-1,101950,98050
4:2:2,2,2,101948,98052
3:2:1,1,1,101947,98053
4:6:3,0,-1,101948,98052
3:6:2,1,1,101947,98053
4:3:3,0,-1,101948,98052
3:4:4,0,-1,101949,98051
1:2:5,1,1,101948,98052
5:6:3,0,-1,101949,98051
1:6:5,0,-1,101950,98050
3:2:5,1,1,101949,98051
6:4:6,0,-1,101950,98050
5:1:2,1,1,101949,98051
5:6:3,0,-1,101950,98050
4:2:4,1,1,101949,98051
2:2:1,2,2,101947,98053
3:1:6,0,-1,101948,98052
5:3:6,0,-1,101949,98051
6:1:1,0,-1,101950,98050
4:3:3,0,-1,101951,98049
2:3:4,1,1,101950,98050
3:5:4,0,-1,101951,98049
5:1:6,0,-1,101952,98048
3:1:6,0,-1,101953,98047
2:2:1,2,2,101951,98049
4:4:5,0,-1,101952,98048
5:1:1,0,-1,101953,98047
5:4:4,0,-1,101954,98046
6:2:4,1,1,101953,98047
5:6:4,0,-1,101954,98046
2:2:6,2,2,101952,98048
4:4:6,0,-1,101953,98047
3:3:5,0,-1,101954,98046
2:2:5,2,2,101952,98048
2:2:3,2,2,101950,98050
5:4:5,0,-1,101951,98049
3:6:6,0,-1,101952,98048
3:5:6,0,-1,101953,98047
6:2:3,1,1,101952,98048
5:5:1,0,-1,101953,98047
2:3:6,1,1,101952,98048
5:3:3,0,-1,101953,98047
4:2:3,1,1,101952,98048
1:1:5,0,-1,101953,98047
2:6:3,1,1,101952,98048
3:6:3,0,-1,101953,98047
5:2:6,1,1,101952,98048
5:4:3,0,-1,101953,98047
5:3:4,0,-1,101954,98046
4:5:4,0,-1,101955,98045
6:1:3,0,-1,101956,98044
3:6:5,0,-1,101957,98043
6:6:6,0,-1,101958,98042
4:5:1,0,-1,101959,98041
2:2:6,2,2,101957,98043
2:5:5,1,1,101956,98044
5:2:1,1,1,101955,98045
1:4:3,0,-1,101956,98044
4:1:3,0,-1,101957,98043
2:4:5,1,1,101956,98044
1:1:1,0,-1,101957,98043
4:1:5,0,-1,101958,98042
3:1:2,1,1,101957,98043
3:1:3,0,-1,101958,98042
1:2:2,2,2,101956,98044
2:3:2,2,2,101954,98046
5:5:2,1,1,101953,98047
2:1:4,1,1,101952,98048
1:1:2,1,1,101951,98049
5:6:1,0,-1,101952,98048
3:4:4,0,-1,101953,98047
1:5:1,0,-1,101954,98046
6:2:2,2,2,101952,98048
5:2:6,1,1,101951,98049
2:2:4,2,2,101949,98051
5:1:5,0,-1,101950,98050
6:6:1,0,-1,101951,98049
4:2:5,1,1,101950,98050
2:2:1,2,2,101948,98052
1:4:6,0,-1,101949,98051
3:4:4,0,-1,101950,98050
3:6:2,1,1,101949,98051
5:5:1,0,-1,101950,98050
6:5:5,0,-1,101951,98049
6:1:2,1,1,101950,98050
3:1:5,0,-1,101951,98049
4:2:6,1,1,101950,98050
4:2:6,1,1,101949,98051
6:6:1,0,-1,101950,98050
3:3:1,0,-1,101951,98049
5:3:4,0,-1,101952,98048
5:4:1,0,-1,101953,98047
4:6:1,0,-1,101954,98046
3:5:6,0,-1,101955,98045
1:1:1,0,-1,101956,98044
2:2:2,3,3,101953,98047
2:3:6,1,1,101952,98048
6:2:1,1,1,101951,98049
4:2:4,1,1,101950,98050
6:6:5,0,-1,101951,98049
5:4:4,0,-1,101952,98048
2:5:6,1,1,101951,98049
4:1:2,1,1,101950,98050
5:6:3,0,-1,101951,98049
3:6:3,0,-1,101952,98048
3:2:3,1,1,101951,98049
5:2:3,1,1,101950,98050
1:4:3,0,-1,101951,98049
6:6:6,0,-1,101952,98048
1:1:1,0,-1,101953,98047
3:6:6,0,-1,101954,98046
4:1:1,0,-1,101955,98045
6:4:3,0,-1,101956,98044
4:4:6,0,-1,101957,98043
4:6:6,0,-1,101958,98042
6:1:2,1,1,101957,98043
3:5:2,1,1,101956,98044
6:4:1,0,-1,101957,98043
3:4:6,0,-1,101958,98042
2:3:6,1,1,101957,98043
4:1:6,0,-1,101958,98042
1:1:2,1,1,101957,98043
2:4:3,1,1,101956,98044
2:4:3,1,1,101955,98045
4:2:3,1,1,101954,98046
5:1:1,0,-1,101955,98045
5:1:4,0,-1,101956,98044
1:6:1,0,-1,101957,98043
2:1:4,1,1,101956,98044
5:5:5,0,-1,101957,98043
2:6:2,2,2,101955,98045
4:3:3,0,-1,101956,98044
5:3:1,0,-1,101957,98043
6:4:6,0,-1,101958,98042
1:1:2,1,1,101957,98043
3:4:4,0,-1,101958,98042
4:4:5,0,-1,101959,98041
3:3:6,0,-1,101960,98040
6:2:4,1,1,101959,98041
4:3:1,0,-1,101960,98040
5:6:2,1,1,101959,98041
3:3:3,0,-1,101960,98040
4:2:1,1,1,101959,98041
1:3:2,1,1,101958,98042
3:4:3,0,-1,101959,98041
2:4:2,2,2,101957,98043
2:4:3,1,1,101956,98044
3:3:6,0,-1,101957,98043
4:1:6,0,-1,101958,98042
3:6:6,0,-1,101959,98041
2:2:4,2,2,101957,98043
5:5:1,0,-1,101958,98042
2:6:2,2,2,101956,98044
5:4:4,0,-1,101957,98043
5:3:4,0,-1,101958,98042
4:5:2,1,1,101957,98043
5:2:6,1,1,101956,98044
1:6:1,0,-1,101957,98043
5:3:6,0,-1,101958,98042
4:1:3,0,-1,101959,98041
6:6:5,0,-1,101960,98040
4:1:1,0,-1,101961,98039
4:2:2,2,2,101959,98041
6:2:3,1,1,101958,98042
4:5:6,0,-1,101959,98041
6:2:5,1,1,101958,98042
3:3:2,1,1,101957,98043
1:4:2,1,1,101956,98044
3:5:6,0,-1,101957,98043
5:1:6,0,-1,101958,98042
6:3:4,0,-1,101959,98041
4:4:1,0,-1,101960,98040
1:2:3,1,1,101959,98041
4:6:2,1,1,101958,98042
6:4:3,0,-1,101959,98041
1:1:1,0,-1,101960,98040
2:3:6,1,1,101959,98041
3:6:4,0,-1,101960,98040
3:2:6,1,1,101959,98041
6:6:4,0,-1,101960,98040
3:2:4,1,1,101959,98041
3:5:4,0,-1,101960,98040
5:4:5,0,-1,101961,98039
4:5:3,0,-1,101962,98038
6:6:6,0,-1,101963,98037
5:6:4,0,-1,101964,98036
4:3:1,0,-1,101965,98035
1:4:3,0,-1,101966,98034
6:4:2,1,1,101965,98035
4:3:2,1,1,101964,98036
5:6:4,0,-1,101965,98035
1:3:4,0,-1,101966,98034
4:3:1,0,-1,101967,98033
5:5:4,0,-1,101968,98032
1:6:5,0,-1,101969,98031
3:3:5,0,-1,101970,98030
1:2:5,1,1,101969,98031
3:6:2,1,1,101968,98032
6:4:5,0,-1,101969,98031
4:6:3,0,-1,101970,98030
2:1:5,1,1,101969,98031
1:3:2,1,1,101968,98032
5:6:5,0,-1,101969,98031
3:1:1,0,-1,101970,98030
5:4:2,1,1,101969,98031
1:5:2,1,1,101968,98032
4:4:4,0,-1,101969,98031
5:6:6,0,-1,101970,98030
3:3:2,1,1,101969,98031
1:4:4,0,-1,101970,98030
5:1:1,0,-1,101971,98029
5:3:4,0,-1,101972,98028
4:2:2,2,2,101970,98030
6:5:6,0,-1,101971,98029
4:6:3,0,-1,101972,98028
1:2:5,1,1,101971,98029
1:5:5,0,-1,101972,98028
6:5:3,0,-1,101973,98027
5:1:2,1,1,101972,98028
2:6:6,1,1,101971,98029
3:2:6,1,1,101970,98030
3:3:2,1,1,101969,98031
2:4:5,1,1,101968,98032
6:3:4,0,-1,101969,98031
6:6:4,0,-1,101970,98030
2:2:5,2,2,101968,98032
5:1:4,0,-1,101969,98031
5:1:5,0,-1,101970,98030
4:5:3,0,-1,101971,98029
1:1:5,0,-1,101972,98028
1:4:1,0,-1,101973,98027
3:3:2,1,1,101972,98028
4:4:4,0,-1,101973,98027
4:4:2,1,1,101972,98028
4:6:4,0,-1,101973,98027
6:6:5,0,-1,101974,98026
5:6:1,0,-1,101975,98025
2:6:5,1,1,101974,98026
4:6:2,1,1,101973,98027
2:4:5,1,1,101972,98028
2:6:4,1,1,101971,98029
1:5:3,0,-1,101972,98028
5:1:2,1,1,101971,98029
5:1:3,0,-1,101972,98028
4:4:4,0,-1,101973,98027
6:3:4,0,-1,101974,98026
5:2:2,2,2,101972,98028
4:6:3,0,-1,101973,98027
1:2:6,1,1,101972,98028
4:4:6,0,-1,101973,98027
4:4:5,0,-1,101974,98026
4:3:5,0,-1,101975,98025
3:4:4,0,-1,101976,98024
1:6:4,0,-1,101977,98023
2:3:2,2,2,101975,98025
1:5:5,0,-1,101976,98024
1:2:4,1,1,101975,98025
2:3:5,1,1,101974,98026
3:1:4,0,-1,101975,98025
5:3:6,0,-1,101976,98024
2:6:4,1,1,101975,98025
6:5:4,0,-1,101976,98024
5:3:5,0,-1,101977,98023
5:2:1,1,1,101976,98024
1:3:6,0,-1,101977,98023
1:3:6,0,-1,101978,98022
2:4:1,1,1,101977,98023
6:2:6,1,1,101976,98024
3:1:6,0,-1,101977,98023
3:5:2,1,1,101976,98024
6:6:3,0,-1,101977,98023
1:1:5,0,-1,101978,98022
2:2:6,2,2,101976,98024
5:1:6,0,-1,101977,98023
1:5:4,0,-1,101978,98022
4:3:6,0,-1,101979,98021
3:1:3,0,-1,101980,98020
6:4:6,0,-1,101981,98019
6:6:5,0,-1,101982,98018
3:1:1,0,-1,101983,98017
6:6:2,1,1,101982,98018
3:4:4,0,-1,101983,98017
4:3:2,1,1,101982,98018
2:2:5,2,2,101980,98020
6:4:3,0,-1,101981,98019
2:4:2,2,2,101979,98021
5:5:1,0,-1,101980,98020
3:1:6,0,-1,101981,98019
4:6:1,0,-1,101982,98018
6:5:6,0,-1,101983,98017
6:4:5,0,-1,101984,98016
5:3:5,0,-1,101985,98015
1:3:4,0,-1,101986,98014
6:3:1,0,-1,101987,98013
2:2:4,2,2,101985,98015
4:2:2,2,2,101983,98017
3:4:6,0,-1,101984,98016
5:3:3,0,-1,101985,98015
1:2:3,1,1,101984,98016
5:1:1,0,-1,101985,98015
5:2:2,2,2,101983,98017
5:6:2,1,1,101982,98018
2:6:6,1,1,101981,98019
1:1:1,0,-1,101982,98018
2:5:3,1,1,101981,98019
6:6:3,0,-1,101982,98018
1:6:6,0,-1,101983,98017
5:5:4,0,-1,101984,98016
5:1:3,0,-1,101985,98015
4:3:3,0,-1,101986,98014
3:5:4,0,-1,101987,98013
1:5:5,0,-1,101988,98012
6:4:5,0,-1,101989,98011
6:4:2,1,1,101988,98012
1:3:1,0,-1,101989,98011
6:5:1,0,-1,101990,98010
5:4:4,0,-1,101991,98009
4:4:1,0,-1,101992,98008
2:6:5,1,1,101991,98009
2:2:2,3,3,101988,98012
6:4:6,0,-1,101989,98011
3:6:5,0,-1,101990,98010
3:4:2,1,1,101989,98011
3:4:1,0,-1,101990,98010
4:3:3,0,-1,101991,98009
6:1:5,0,-1,101992,98008
3:5:3,0,-1,101993,98007
3:6:5,0,-1,101994,98006
3:5:4,0,-1,101995,98005
5:3:1,0,-1,101996,98004
3:6:3,0,-1,101997,98003
5:1:3,0,-1,101998,98002
5:6:3,0,-1,101999,98001
3:3:4,0,-1,102000,98000
3:4:4,0,-1,102001,97999
1:3:6,0,-1,102002,97998
2:4:5,1,1,102001,97999
4:5:6,0,-1,102002,97998
3:4:5,0,-1,102003,97997
5:6:2,1,1,102002,97998
6:3:6,0,-1,102003,97997
6:3:2,1,1,102002,97998
3:5:4,0,-1,102003,97997
1:4:6,0,-1,102004,97996
3:4:3,0,-1,102005,97995
4:3:3,0,-1,102006,97994
4:2:1,1,1,102005,97995
2:5:4,1,1,102004,97996
3:3:5,0,-1,102005,97995
5:5:6,0,-1,102006,97994
3:2:4,1,1,102005,97995
6:3:1,0,-1,102006,97994
3:5:2,1,1,102005,97995
6:4:4,0,-1,102006,97994
2:2:5,2,2,102004,97996
5:1:3,0,-1,102005,97995
1:1:3,0,-1,102006,97994
1:4:3,0,-1,102007,97993
1:6:6,0,-1,102008,97992
4:6:1,0,-1,102009,97991
4:3:5,0,-1,102010,97990
2:3:1,1,1,102009,97991
3:6:2,1,1,102008,97992
4:5:6,0,-1,102009,97991
2:2:3,2,2,102007,97993
4:3:2,1,1,102006,97994
6:5:3,0,-1,102007,97993
6:5:6,0,-1,102008,97992
6:5:1,0,-1,102009,97991
3:4:2,1,1,102008,97992
1:4:5,0,-1,102009,97991
2:1:2,2,2,102007,97993
5:5:5,0,-1,102008,97992
4:2:5,1,1,102007,97993
4:6:1,0,-1,102008,97992
4:1:1,0,-1,102009,97991
5:1:2,1,1,102008,97992
6:2:4,1,1,102007,97993
6:2:1,1,1,102006,97994
2:3:5,1,1,102005,97995
4:4:3,0,-1,102006,97994
4:6:1,0,-1,102007,97993
2:3:5,1,1,102006,97994
5:1:3,0,-1,102007,97993
1:5:4,0,-1,102008,97992
6:3:1,0,-1,102009,97991
4:5:2,1,1,102008,97992
4:6:1,0,-1,102009,97991
6:2:4,1,1,102008,97992
4:4:1,0,-1,102009,97991
3:3:1,0,-1,102010,97990
1:1:4,0,-1,102011,97989
5:1:1,0,-1,102012,97988
1:3:5,0,-1,102013,97987
3:3:3,0,-1,102014,97986
2:2:3,2,2,102012,97988
6:3:3,0,-1,102013,97987
2:5:5,1,1,102012,97988
6:6:3,0,-1,102013,97987
4:1:1,0,-1,102014,97986
5:3:4,0,-1,102015,97985
3:6:6,0,-1,102016,97984
3:3:5,0,-1,102017,97983
3:1:1,0,-1,102018,97982
6:1:2,1,1,102017,97983
6:5:6,0,-1,102018,97982
5:1:5,0,-1,102019,97981
6:6:3,0,-1,102020,97980
4:4:6,0,-1,102021,97979
6:1:3,0,-1,102022,97978
6:4:4,0,-1,102023,97977
5:4:2,1,1,102022,97978
1:6:2,1,1,102021,97979
3:4:3,0,-1,102022,97978
5:2:2,2,2,102020,97980
3:2:2,2,2,102018,97982
6:6:1,0,-1,102019,97981
5:5:1,0,-1,102020,97980
2:5:6,1,1,102019,97981
3:2:2,2,2,102017,97983
6:3:6,0,-1,102018,97982
2:3:4,1,1,102017,97983
5:5:3,0,-1,102018,97982
2:3:4,1,1,102017,97983
6:3:2,1,1,102016,97984
5:1:2,1,1,102015,97985
2:1:4,1,1,102014,97986
5:4:1,0,-1,102015,97985
3:2:2,2,2,102013,97987
1:6:5,0,-1,102014,97986
2:5:5,1,1,102013,97987
6:1:5,0,-1,102014,97986
1:1:4,0,-1,102015,97985
2:4:2,2,2,102013,97987
4:3:3,0,-1,102014,97986
4:5:3,0,-1,102015,97985
3:3:2,1,1,102014,97986
5:1:6,0,-1,102015,97985
3:4:2,1,1,102014,97986
3:4:6,0,-1,102015,97985
4:4:3,0,-1,102016,97984
2:1:2,2,2,102014,97986
1:1:4,0,-1,102015,97985
2:1:1,1,1,102014,97986
3:4:1,0,-1,102015,97985
5:6:3,0,-1,102016,97984
2:6:3,1,1,102015,97985
6:1:3,0,-1,102016,97984
1:6:5,0,-1,102017,97983
1:5:5,0,-1,102018,97982
3:2:2,2,2,102016,97984
6:2:2,2,2,102014,97986
6:5:2,1,1,102013,97987
4:3:5,0,-1,102014,97986
4:6:4,0,-1,102015,97985
1:1:5,0,-1,102016,97984
1:5:5,0,-1,102017,97983
2:6:1,1,1,102016,97984
5:2:5,1,1,102015,97985
6:2:2,2,2,102013,97987
4:5:4,0,-1,102014,97986
1:1:4,0,-1,102015,97985
3:2:2,2,2,102013,97987
1:5:5,0,-1,102014,97986
5:6:2,1,1,102013,97987
6:1:5,0,-1,102014,97986
1:1:2,1,1,102013,97987
5:2:2,2,2,102011,97989
1:1:5,0,-1,102012,97988
6:3:3,0,-1,102013,97987
3:1:6,0,-1,102014,97986
5:5:2,1,1,102013,97987
5:5:2,1,1,102012,97988
1:6:3,0,-1,102013,97987
1:4:2,1,1,102012,97988
5:4:5,0,-1,102013,97987
5:2:6,1,1,102012,97988
3:6:6,0,-1,102013,97987
2:6:1,1,1,102012,97988
4:6:4,0,-1,102013,97987
4:1:1,0,-1,102014,97986
5:5:4,0,-1,102015,97985
5:1:2,1,1,102014,97986
5:1:1,0,-1,102015,97985
1:3:6,0,-1,102016,97984
6:1:5,0,-1,102017,97983
6:2:2,2,2,102015,97985
6:5:4,0,-1,102016,97984
1:5:2,1,1,102015,97985
6:1:4,0,-1,102016,97984
4:4:5,0,-1,102017,97983
1:1:2,1,1,102016,97984
5:6:6,0,-1,102017,97983
3:6:3,0,-1,102018,97982
6:4:6,0,-1,102019,97981
1:2:5,1,1,102018,97982
4:1:5,0,-1,102019,97981
4:5:1,0,-1,102020,97980
4:2:1,1,1,102019,97981
5:2:6,1,1,102018,97982
2:6:6,1,1,102017,97983
3:6:5,0,-1,102018,97982
6:2:2,2,2,102016,97984
6:6:6,0,-1,102017,97983
1:3:4,0,-1,102018,97982
3:6:2,1,1,102017,97983
3:1:3,0,-1,102018,97982
4:1:6,0,-1,102019,97981
2:4:2,2,2,102017,97983
2:5:3,1,1,102016,97984
3:2:6,1,1,102015,97985
3:3:3,0,-1,102016,97984
2:1:6,1,1,102015,97985
5:6:3,0,-1,102016,97984
6:6:6,0,-1,102017,97983
4:2:4,1,1,102016,97984
6:1:4,0,-1,102017,97983
5:4:5,0,-1,102018,97982
3:5:2,1,1,102017,97983
1:4:5,0,-1,102018,97982
4:3:1,0,-1,102019,97981
1:5:6,0,-1,102020,97980
1:4:3,0,-1,102021,97979
2:6:5,1,1,102020,97980
6:4:2,1,1,102019,97981
3:6:2,1,1,102018,97982
6:6:1,0,-1,102019,97981
5:1:6,0,-1,102020,97980
3:3:5,0,-1,102021,97979
4:3:3,0,-1,102022,97978
4:4:5,0,-1,102023,97977
2:2:3,2,2,102021,97979
1:6:2,1,1,102020,97980
1:4:4,0,-1,102021,97979
3:3:4,0,-1,102022,97978
3:6:2,1,1,102021,97979
2:5:3,1,1,102020,97980
4:4:2,1,1,102019,97981
5:3:5,0,-1,102020,97980
3:6:4,0,-1,102021,97979
6:6:4,0,-1,102022,97978
6:3:1,0,-1,102023,97977
5:5:4,0,-1,102024,97976
1:3:2,1,1,102023,97977
4:5:1,0,-1,102024,97976
2:5:6,1,1,102023,97977
5:2:2,2,2,102021,97979
2:5:3,1,1,102020,97980
3:3:2,1,1,102019,97981
2:4:5,1,1,102018,97982
5:2:6,1,1,102017,97983
6:2:5,1,1,102016,97984
6:3:3,0,-1,102017,97983
6:2:4,1,1,102016,97984
5:4:3,0,-1,102017,97983
5:2:4,1,1,102016,97984
2:4:2,2,2,102014,97986
1:2:4,1,1,102013,97987
4:4:2,1,1,102012,97988
5:6:5,0,-1,102013,97987
6:6:5,0,-1,102014,97986
3:1:6,0,-1,102015,97985
3:6:5,0,-1,102016,97984
6:2:3,1,1,102015,97985
5:1:1,0,-1,102016,97984
4:6:5,0,-1,102017,97983
3:6:1,0,-1,102018,97982
1:6:2,1,1,102017,97983
4:4:4,0,-1,102018,97982
6:4:3,0,-1,102019,97981
1:3:5,0,-1,102020,97980
1:1:4,0,-1,102021,97979
2:2:2,3,3,102018,97982
2:3:6,1,1,102017,97983
1:3:1,0,-1,102018,97982
6:5:1,0,-1,102019,97981
3:3:3,0,-1,102020,97980
4:2:2,2,2,102018,97982
3:5:1,0,-1,102019,97981
1:2:2,2,2,102017,97983
6:6:6,0,-1,102018,97982
2:3:6,1,1,102017,97983
6:1:1,0,-1,102018,97982
1:4:6,0,-1,102019,97981
1:3:2,1,1,102018,97982
2:3:1,1,1,102017,97983
5:3:4,0,-1,102018,97982
2:6:5,1,1,102017,97983
2:2:3,2,2,102015,97985
2:4:1,1,1,102014,97986
1:1:4,0,-1,102015,97985
6:1:4,0,-1,102016,97984
4:5:3,0,-1,102017,97983
2:4:1,1,1,102016,97984
4:2:6,1,1,102015,97985
5:1:4,0,-1,102016,97984
1:4:3,0,-1,102017,97983
4:1:3,0,-1,102018,97982
3:5:6,0,-1,102019,97981
2:1:1,1,1,102018,97982
4:1:4,0,-1,102019,97981
6:6:5,0,-1,102020,97980
1:1:5,0,-1,102021,97979
4:5:3,0,-1,102022,97978
3:2:3,1,1,102021,97979
1:2:2,2,2,102019,97981
4:3:5,0,-1,102020,97980
3:4:4,0,-1,102021,97979
2:2:5,2,2,102019,97981
5:4:4,0,-1,102020,97980
2:2:2,3,3,102017,97983
3:4:4,0,-1,102018,97982
2:2:2,3,3,102015,97985
3:3:1,0,-1,102016,97984
5:4:5,0,-1,102017,97983
5:6:1,0,-1,102018,97982
2:2:6,2,2,102016,97984
3:5:4,0,-1,102017,97983
1:4:3,0,-1,102018,97982
1:6:6,0,-1,102019,97981
4:2:6,1,1,102018,97982
1:4:2,1,1,102017,97983
5:2:1,1,1,102016,97984
2:3:5,1,1,102015,97985
5:3:5,0,-1,102016,97984
4:2:6,1,1,102015,97985
3:3:5,0,-1,102016,97984
1:5:5,0,-1,102017,97983
1:3:3,0,-1,102018,97982
1:6:2,1,1,102017,97983
3:1:3,0,-1,102018,97982
6:5:3,0,-1,102019,97981
5:2:6,1,1,102018,97982
1:1:4,0,-1,102019,97981
3:6:5,0,-1,102020,97980
4:4:5,0,-1,102021,97979
2:5:6,1,1,102020,97980
6:4:2,1,1,102019,97981
1:1:1,0,-1,102020,97980
6:1:6,0,-1,102021,97979
6:1:6,0,-1,102022,97978
2:1:6,1,1,102021,97979
2:4:6,1,1,102020,97980
6:5:6,0,-1,102021,97979
1:2:1,1,1,102020,97980
3:5:1,0,-1,102021,97979
6:1:6,0,-1,102022,97978
4:2:4,1,1,102021,97979
2:5:4,1,1,102020,97980
5:6:3,0,-1,102021,97979
2:1:4,1,1,102020,97980
2:3:1,1,1,102019,97981
6:6:6,0,-1,102020,97980
6:3:2,1,1,102019,97981
1:3:1,0,-1,102020,97980
4:6:5,0,-1,102021,97979
3:3:1,0,-1,102022,97978
4:6:6,0,-1,102023,97977
1:4:1,0,-1,102024,97976
6:6:6,0,-1,102025,97975
2:4:2,2,2,102023,97977
4:1:1,0,-1,102024,97976
5:4:4,0,-1,102025,97975
1:6:6,0,-1,102026,97974
5:2:3,1,1,102025,97975
3:3:5,0,-1,102026,97974
4:4:6,0,-1,102027,97973
1:6:2,1,1,102026,97974
4:4:4,0,-1,102027,97973
6:5:4,0,-1,102028,97972
6:1:3,0,-1,102029,97971
2:1:5,1,1,102028,97972
4:2:1,1,1,102027,97973
1:6:6,0,-1,102028,97972
5:4:4,0,-1,102029,97971
1:6:5,0,-1,102030,97970
4:5:6,0,-1,102031,97969
2:6:6,1,1,102030,97970
3:2:2,2,2,102028,97972
1:3:4,0,-1,102029,97971
6:4:6,0,-1,102030,97970
2:1:1,1,1,102029,97971
4:5:5,0,-1,102030,97970
3:3:4,0,-1,102031,97969
6:2:6,1,1,102030,97970
4:5:5,0,-1,102031,97969
2:5:5,1,1,102030,97970
6:3:3,0,-1,102031,97969
6:5:1,0,-1,102032,97968
1:3:2,1,1,102031,97969
4:5:2,1,1,102030,97970
1:1:3,0,-1,102031,97969
6:2:6,1,1,102030,97970
5:4:1,0,-1,102031,97969
3:1:6,0,-1,102032,97968
1:1:2,1,1,102031,97969
3:2:2,2,2,102029,97971
3:3:6,0,-1,102030,97970
1:3:3,0,-1,102031,97969
1:6:5,0,-1,102032,97968
1:6:3,0,-1,102033,97967
4:6:3,0,-1,102034,97966
6:6:1,0,-1,102035,97965
3:4:4,0,-1,102036,97964
3:1:1,0,-1,102037,97963
4:4:5,0,-1,102038,97962
2:5:6,1,1,102037,97963
3:1:4,0,-1,102038,97962
2:1:5,1,1,102037,97963
5:6:1,0,-1,102038,97962
2:4:5,1,1,102037,97963
5:4:5,0,-1,102038,97962
6:1:6,0,-1,102039,97961
4:6:5,0,-1,102040,97960
2:3:5,1,1,102039,97961
1:4:1,0,-1,102040,97960
3:2:2,2,2,102038,97962
4:1:4,0,-1,102039,97961
3:3:5,0,-1,102040,97960
2:6:3,1,1,102039,97961
1:6:4,0,-1,102040,97960
3:3:3,0,-1,102041,97959
4:2:6,1,1,102040,97960
4:2:3,1,1,102039,97961
5:5:5,0,-1,102040,97960
3:1:3,0,-1,102041,97959
6:1:5,0,-1,102042,97958
3:5:1,0,-1,102043,97957
6:3:6,0,-1,102044,97956
4:1:6,0,-1,102045,97955
3:6:5,0,-1,102046,97954
1:1:1,0,-1,102047,97953
6:1:4,0,-1,102048,97952
2:2:6,2,2,102046,97954
4:3:1,0,-1,102047,97953
4:1:4,0,-1,102048,97952
3:1:2,1,1,102047,97953
1:2:3,1,1,102046,97954
2:2:2,3,3,102043,97957
1:1:2,1,1,102042,97958
2:1:2,2,2,102040,97960
5:1:3,0,-1,102041,97959
6:6:3,0,-1,102042,97958
5:5:6,0,-1,102043,97957
2:1:6,1,1,102042,97958
3:3:2,1,1,102041,97959
5:6:3,0,-1,102042,97958
1:5:6,0,-1,102043,97957
4:6:5,0,-1,102044,97956
4:4:6,0,-1,102045,97955
1:3:5,0,-1,102046,97954
5:5:4,0,-1,102047,97953
4:1:5,0,-1,102048,97952
2:6:4,1,1,102047,97953
6:2:4,1,1,102046,97954
1:4:1,0,-1,102047,97953
3:6:6,0,-1,102048,97952
6:2:1,1,1,102047,97953
1:3:5,0,-1,102048,97952
4:4:2,1,1,102047,97953
5:6:3,0,-1,102048,97952
6:1:3,0,-1,102049,97951
6:3:3,0,-1,102050,97950
3:1:3,0,-1,102051,97949
2:6:2,2,2,102049,97951
2:4:2,2,2,102047,97953
1:1:5,0,-1,102048,97952
5:3:5,0,-1,102049,97951
4:1:6,0,-1,102050,97950
4:3:5,0,-1,102051,97949
1:5:1,0,-1,102052,97948
3:3:2,1,1,102051,97949
6:5:5,0,-1,102052,97948
2:4:1,1,1,102051,97949
1:6:6,0,-1,102052,97948
4:6:1,0,-1,102053,97947
3:2:3,1,1,102052,97948
1:1:2,1,1,102051,97949
2:4:5,1,1,102050,97950
1:5:2,1,1,102049,97951
4:2:5,1,1,102048,97952
6:1:2,1,1,102047,97953
5:3:2,1,1,102046,97954
3:4:3,0,-1,102047,97953
2:1:1,1,1,102046,97954
4:4:5,0,-1,102047,97953
2:6:5,1,1,102046,97954
1:3:5,0,-1,102047,97953
1:6:3,0,-1,102048,97952
4:4:6,0,-1,102049,97951
5:6:4,0,-1,102050,97950
2:2:5,2,2,102048,97952
3:5:1,0,-1,102049,97951
3:5:1,0,-1,102050,97950
5:1:6,0,-1,102051,97949
5:1:6,0,-1,102052,97948
4:4:4,0,-1,102053,97947
5:5:6,0,-1,102054,97946
1:2:4,1,1,102053,97947
2:2:2,3,3,102050,97950
6:5:2,1,1,102049,97951
1:2:6,1,1,102048,97952
3:6:6,0,-1,102049,97951
6:1:2,1,1,102048,97952
1:1:1,0,-1,102049,97951
4:6:2,1,1,102048,97952
3:3:5,0,-1,102049,97951
1:4:1,0,-1,102050,97950
6:2:2,2,2,102048,97952
1:2:6,1,1,102047,97953
3:3:4,0,-1,102048,97952
3:4:6,0,-1,102049,97951
6:3:4,0,-1,102050,97950
4:2:5,1,1,102049,97951
5:5:2,1,1,102048,97952
6:6:5,0,-1,102049,97951
3:3:3,0,-1,102050,97950
6:2:3,1,1,102049,97951
4:5:6,0,-1,102050,97950
3:6:5,0,-1,102051,97949
6:3:4,0,-1,102052,97948
2:1:5,1,1,102051,97949
4:6:5,0,-1,102052,97948
6:2:4,1,1,102051,97949
5:6:4,0,-1,102052,97948
3:3:2,1,1,102051,97949
2:3:4,1,1,102050,97950
5:1:3,0,-1,102051,97949
1:1:4,0,-1,102052,97948
6:5:5,0,-1,102053,97947
6:4:5,0,-1,102054,97946
4:1:1,0,-1,102055,97945
5:4:1,0,-1,102056,97944
2:1:1,1,1,102055,97945
2:5:6,1,1,102054,97946
5:1:3,0,-1,102055,97945
6:2:3,1,1,102054,97946
2:2:5,2,2,102052,97948
2:3:3,1,1,102051,97949
5:2:4,1,1,102050,97950
6:5:6,0,-1,102051,97949
2:3:5,1,1,102050,97950
5:3:2,1,1,102049,97951
4:6:6,0,-1,102050,97950
3:3:5,0,-1,102051,97949
6:2:3,1,1,102050,97950
6:6:3,0,-1,102051,97949
1:6:2,1,1,102050,97950
2:5:4,1,1,102049,97951
6:2:4,1,1,102048,97952
6:6:1,0,-1,102049,97951
2:4:5,1,1,102048,97952
6:3:5,0,-1,102049,97951
3:2:5,1,1,102048,97952
3:1:1,0,-1,102049,97951
1:1:6,0,-1,102050,97950
6:2:3,1,1,102049,97951
2:1:1,1,1,102048,97952
2:6:2,2,2,102046,97954
6:5:4,0,-1,102047,97953
1:3:1,0,-1,102048,97952
4:2:2,2,2,102046,97954
6:4:3,0,-1,102047,97953
1:4:3,0,-1,102048,97952
1:6:1,0,-1,102049,97951
3:6:2,1,1,102048,97952
5:4:4,0,-1,102049,97951
6:6:6,0,-1,102050,97950
4:6:3,0,-1,102051,97949
5:2:6,1,1,102050,97950
4:6:1,0,-1,102051,97949
1:4:4,0,-1,102052,97948
1:4:4,0,-1,102053,97947
3:1:4,0,-1,102054,97946
5:2:3,1,1,102053,97947
1:1:3,0,-1,102054,97946
2:4:1,1,1,102053,97947
4:5:3,0,-1,102054,97946
2:5:4,1,1,102053,97947
4:3:3,0,-1,102054,97946
3:5:3,0,-1,102055,97945
1:1:3,0,-1,102056,97944
5:6:1,0,-1,102057,97943
2:4:3,1,1,102056,97944
4:1:1,0,-1,102057,97943
3:2:2,2,2,102055,97945
6:2:1,1,1,102054,97946
5:3:1,0,-1,102055,97945
4:3:1,0,-1,102056,97944
3:1:1,0,-1,102057,97943
4:6:3,0,-1,102058,97942
4:2:5,1,1,102057,97943
5:5:4,0,-1,102058,97942
4:3:6,0,-1,102059,97941
2:2:2,3,3,102056,97944
5:1:1,0,-1,102057,97943
4:6:4,0,-1,102058,97942
5:4:1,0,-1,102059,97941
2:6:5,1,1,102058,97942
5:6:5,0,-1,102059,97941
3:6:3,0,-1,102060,97940
3:2:6,1,1,102059,97941
6:5:4,0,-1,102060,97940
1:3:2,1,1,102059,97941
1:5:1,0,-1,102060,97940
6:5:6,0,-1,102061,97939
4:5:3,0,-1,102062,97938
6:3:1,0,-1,102063,97937
5:5:2,1,1,102062,97938
2:2:3,2,2,102060,97940
6:6:1,0,-1,102061,97939
3:5:4,0,-1,102062,97938
1:4:5,0,-1,102063,97937
5:4:1,0,-1,102064,97936
5:3:5,0,-1,102065,97935
4:1:2,1,1,102064,97936
1:1:6,0,-1,102065,97935
6:6:1,0,-1,102066,97934
2:2:3,2,2,102064,97936
2:6:1,1,1,102063,97937
2:5:2,2,2,102061,97939
4:5:3,0,-1,102062,97938
2:2:6,2,2,102060,97940
1:5:4,0,-1,102061,97939
1:5:1,0,-1,102062,97938
2:2:4,2,2,102060,97940
5:4:1,0,-1,102061,97939
3:4:3,0,-1,102062,97938
4:4:6,0,-1,102063,97937
3:3:6,0,-1,102064,97936
4:6:1,0,-1,102065,97935
5:4:1,0,-1,102066,97934
5:3:6,0,-1,102067,97933
6:5:4,0,-1,102068,97932
1:2:4,1,1,102067,97933
6:5:1,0,-1,102068,97932
2:2:1,2,2,102066,97934
5:6:2,1,1,102065,97935
2:6:3,1,1,102064,97936
4:6:5,0,-1,102065,97935
6:3:5,0,-1,102066,97934
1:1:2,1,1,102065,97935
5:6:5,0,-1,102066,97934
3:6:4,0,-1,102067,97933
6:3:3,0,-1,102068,97932
2:1:3,1,1,102067,97933
6:5:1,0,-1,102068,97932
6:4:5,0,-1,102069,97931
3:4:1,0,-1,102070,97930
2:6:5,1,1,102069,97931
3:2:5,1,1,102068,97932
2:4:1,1,1,102067,97933
2:6:1,1,1,102066,97934
3:4:4,0,-1,102067,97933
3:4:1,0,-1,102068,97932
4:4:6,0,-1,102069,97931
3:5:5,0,-1,102070,97930
4:5:3,0,-1,102071,97929
5:4:3,0,-1,102072,97928
6:3:3,0,-1,102073,97927
3:2:5,1,1,102072,97928
1:4:3,0,-1,102073,97927
2:5:5,1,1,102072,97928
1:4:2,1,1,102071,97929
3:6:1,0,-1,102072,97928
3:6:3,0,-1,102073,97927
6:5:3,0,-1,102074,97926
4:5:4,0,-1,102075,97925
6:4:4,0,-1,102076,97924
2:2:2,3,3,102073,97927
2:4:3,1,1,102072,97928
5:6:2,1,1,102071,97929
1:4:3,0,-1,102072,97928
4:1:3,0,-1,102073,97927
1:3:6,0,-1,102074,97926
3:6:3,0,-1,102075,97925
5:3:1,0,-1,102076,97924
6:2:4,1,1,102075,97925
6:6:6,0,-1,102076,97924
4:6:3,0,-1,102077,97923
4:6:4,0,-1,102078,97922
3:2:2,2,2,102076,97924
1:1:2,1,1,102075,97925
4:5:2,1,1,102074,97926
2:5:4,1,1,102073,97927
1:6:1,0,-1,102074,97926
1:4:6,0,-1,102075,97925
4:4:3,0,-1,102076,97924
3:3:5,0,-1,102077,97923
3:3:1,0,-1,102078,97922
4:5:2,1,1,102077,97923
4:3:3,0,-1,102078,97922
4:5:4,0,-1,102079,97921
4:1:3,0,-1,102080,97920
2:6:3,1,1,102079,97921
4:2:5,1,1,102078,97922
1:2:5,1,1,102077,97923
3:3:3,0,-1,102078,97922
1:5:5,0,-1,102079,97921
1:5:4,0,-1,102080,97920
1:4:6,0,-1,102081,97919
1:5:3,0,-1,102082,97918
5:1:1,0,-1,102083,97917
3:3:4,0,-1,102084,97916
2:5:2,2,2,102082,97918
1:6:4,0,-1,102083,97917
6:6:1,0,-1,102084,97916
5:5:4,0,-1,102085,97915
2:2:2,3,3,102082,97918
1:6:1,0,-1,102083,97917
2:3:2,2,2,102081,97919
2:3:4,1,1,102080,97920
5:4:2,1,1,102079,97921
5:5:2,1,1,102078,97922
3:1:6,0,-1,102079,97921
6:3:2,1,1,102078,97922
5:3:1,0,-1,102079,97921
2:4:2,2,2,102077,97923
3:6:4,0,-1,102078,97922
2:2:1,2,2,102076,97924
1:2:2,2,2,102074,97926
2:1:2,2,2,102072,97928
3:6:2,1,1,102071,97929
2:4:5,1,1,102070,97930
6:1:3,0,-1,102071,97929
2:1:5,1,1,102070,97930
3:2:5,1,1,102069,97931
6:6:3,0,-1,102070,97930
6:3:5,0,-1,102071,97929
2:1:2,2,2,102069,97931
3:5:4,0,-1,102070,97930
4:4:1,0,-1,102071,97929
6:5:6,0,-1,102072,97928
1:4:5,0,-1,102073,97927
6:2:1,1,1,102072,97928
6:6:3,0,-1,102073,97927
1:3:3,0,-1,102074,97926
1:5:2,1,1,102073,97927
3:3:3,0,-1,102074,97926
5:6:2,1,1,102073,97927
2:5:3,1,1,102072,97928
2:4:2,2,2,102070,97930
1:5:6,0,-1,102071,97929
3:6:6,0,-1,102072,97928
5:6:3,0,-1,102073,97927
4:5:5,0,-1,102074,97926
2:4:4,1,1,102073,97927
4:4:5,0,-1,102074,97926
3:4:5,0,-1,102075,97925
2:5:5,1,1,102074,97926
6:6:2,1,1,102073,97927
2:2:5,2,2,102071,97929
5:3:3,0,-1,102072,97928
4:2:4,1,1,102071,97929
6:4:5,0,-1,102072,97928
1:3:5,0,-1,102073,97927
4:6:3,0,-1,102074,97926
4:4:3,0,-1,102075,97925
6:2:4,1,1,102074,97926
1:3:3,0,-1,102075,97925
3:5:5,0,-1,102076,97924
5:5:5,0,-1,102077,97923
6:5:1,0,-1,102078,97922
2:4:1,1,1,102077,97923
2:1:5,1,1,102076,97924
2:2:2,3,3,102073,97927
5:5:3,0,-1,102074,97926
1:4:4,0,-1,102075,97925
6:5:5,0,-1,102076,97924
4:6:2,1,1,102075,97925
1:2:3,1,1,102074,97926
1:6:5,0,-1,102075,97925
2:3:6,1,1,102074,97926
5:3:4,0,-1,102075,97925
1:4:2,1,1,102074,97926
1:2:1,1,1,102073,97927
1:3:1,0,-1,102074,97926
6:5:1,0,-1,102075,97925
1:3:3,0,-1,102076,97924
1:1:5,0,-1,102077,97923
2:4:6,1,1,102076,97924
1:5:4,0,-1,102077,97923
3:6:3,0,-1,102078,97922
5:1:3,0,-1,102079,97921
1:4:6,0,-1,102080,97920
6:2:1,1,1,102079,97921
5:6:5,0,-1,102080,97920
1:3:1,0,-1,102081,97919
3:4:1,0,-1,102082,97918
6:2:2,2,2,102080,97920
5:1:4,0,-1,102081,97919
6:1:3,0,-1,102082,97918
6:3:2,1,1,102081,97919
1:3:6,0,-1,102082,97918
5:1:5,0,-1,102083,97917
3:4:4,0,-1,102084,97916
6:2:5,1,1,102083,97917
5:6:6,0,-1,102084,97916
3:2:4,1,1,102083,97917
3:5:3,0,-1,102084,97916
2:5:2,2,2,102082,97918
6:1:1,0,-1,102083,97917
1:2:6,1,1,102082,97918
6:6:6,0,-1,102083,97917
4:3:1,0,-1,102084,97916
2:2:6,2,2,102082,97918
2:2:3,2,2,102080,97920
2:3:3,1,1,102079,97921
2:6:2,2,2,102077,97923
5:1:3,0,-1,102078,97922
1:4:1,0,-1,102079,97921
6:1:6,0,-1,102080,97920
3:5:6,0,-1,102081,97919
1:3:3,0,-1,102082,97918
1:3:3,0,-1,102083,97917
5:5:1,0,-1,102084,97916
6:6:6,0,-1,102085,97915
2:6:4,1,1,102084,97916
1:1:5,0,-1,102085,97915
3:1:2,1,1,102084,97916
2:2:2,3,3,102081,97919
6:1:1,0,-1,102082,97918
5:4:5,0,-1,102083,97917
4:3:2,1,1,102082,97918
5:3:3,0,-1,102083,97917
2:4:1,1,1,102082,97918
6:6:6,0,-1,102083,97917
6:1:6,0,-1,102084,97916
4:3:4,0,-1,102085,97915
2:4:1,1,1,102084,97916
1:6:5,0,-1,102085,97915
2:1:2,2,2,102083,97917
6:4:6,0,-1,102084,97916
2:5:6,1,1,102083,97917
5:4:3,0,-1,102084,97916
1:5:5,0,-1,102085,97915
3:6:1,0,-1,102086,97914
2:1:1,1,1,102085,97915
5:5:3,0,-1,102086,97914
6:1:1,0,-1,102087,97913
3:6:3,0,-1,102088,97912
4:3:2,1,1,102087,97913
5:2:6,1,1,102086,97914
6:2:2,2,2,102084,97916
2:4:6,1,1,102083,97917
3:1:6,0,-1,102084,97916
1:3:6,0,-1,102085,97915
6:5:3,0,-1,102086,97914
1:1:2,1,1,102085,97915
6:1:1,0,-1,102086,97914
4:6:6,0,-1,102087,97913
2:6:2,2,2,102085,97915
3:1:2,1,1,102084,97916
4:5:4,0,-1,102085,97915
1:2:5,1,1,102084,97916
6:5:5,0,-1,102085,97915
1:2:6,1,1,102084,97916
1:4:4,0,-1,102085,97915
3:4:4,0,-1,102086,97914
2:1:5,1,1,102085,97915
5:1:1,0,-1,102086,97914
4:4:4,0,-1,102087,97913
4:6:1,0,-1,102088,97912
6:5:4,0,-1,102089,97911
3:4:6,0,-1,102090,97910
6:4:4,0,-1,102091,97909
5:3:4,0,-1,102092,97908
3:6:6,0,-1,102093,97907
5:3:1,0,-1,102094,97906
2:4:3,1,1,102093,97907
1:1:4,0,-1,102094,97906
6:2:1,1,1,102093,97907
4:3:5,0,-1,102094,97906
2:2:6,2,2,102092,97908
6:1:3,0,-1,102093,97907
4:1:5,0,-1,102094,97906
4:3:6,0,-1,102095,97905
6:3:2,1,1,102094,97906
6:6:6,0,-1,102095,97905
4:5:5,0,-1,102096,97904
1:3:6,0,-1,102097,97903
3:4:6,0,-1,102098,97902
6:2:2,2,2,102096,97904
2:4:3,1,1,102095,97905
6:4:5,0,-1,102096,97904
1:6:3,0,-1,102097,97903
5:1:6,0,-1,102098,97902
2:6:1,1,1,102097,97903
6:6:1,0,-1,102098,97902
3:6:6,0,-1,102099,97901
4:6:3,0,-1,102100,97900
1:3:2,1,1,102099,97901
4:5:3,0,-1,102100,97900
5:6:4,0,-1,102101,97899
2:2:3,2,2,102099,97901
1:2:2,2,2,102097,97903
5:6:4,0,-1,102098,97902
4:2:1,1,1,102097,97903
5:1:2,1,1,102096,97904
2:6:2,2,2,102094,97906
5:4:2,1,1,102093,97907
6:4:6,0,-1,102094,97906
4:4:2,1,1,102093,97907
3:2:6,1,1,102092,97908
3:2:6,1,1,102091,97909
3:3:5,0,-1,102092,97908
1:5:1,0,-1,102093,97907
4:1:2,1,1,102092,97908
1:6:3,0,-1,102093,97907
1:4:1,0,-1,102094,97906
3:3:2,1,1,102093,97907
5:1:4,0,-1,102094,97906
5:5:3,0,-1,102095,97905
4:1:5,0,-1,102096,97904
6:3:2,1,1,102095,97905
4:6:5,0,-1,102096,97904
4:3:6,0,-1,102097,97903
3:3:6,0,-1,102098,97902
5:4:6,0,-1,102099,97901
1:6:2,1,1,102098,97902
3:5:6,0,-1,102099,97901
6:2:4,1,1,102098,97902
6:3:3,0,-1,102099,97901
3:3:1,0,-1,102100,97900
5:3:1,0,-1,102101,97899
3:4:2,1,1,102100,97900
4:1:3,0,-1,102101,97899
6:1:4,0,-1,102102,97898
6:4:4,0,-1,102103,97897
4:6:2,1,1,102102,97898
5:2:5,1,1,102101,97899
5:3:1,0,-1,102102,97898
4:2:4,1,1,102101,97899
1:5:4,0,-1,102102,97898
2:6:4,1,1,102101,97899
6:5:3,0,-1,102102,97898
5:4:6,0,-1,102103,97897
1:2:4,1,1,102102,97898
5:4:3,0,-1,102103,97897
2:1:4,1,1,102102,97898
5:1:6,0,-1,102103,97897
6:3:5,0,-1,102104,97896
3:1:1,0,-1,102105,97895
6:4:4,0,-1,102106,97894
5:2:2,2,2,102104,97896
3:1:2,1,1,102103,97897
1:3:2,1,1,102102,97898
1:5:3,0,-1,102103,97897
4:2:1,1,1,102102,97898
5:6:6,0,-1,102103,97897
4:2:2,2,2,102101,97899
4:3:6,0,-1,102102,97898
1:2:5,1,1,102101,97899
2:4:6,1,1,102100,97900
5:3:4,0,-1,102101,97899
1:5:6,0,-1,102102,97898
3:4:4,0,-1,102103,97897
4:6:6,0,-1,102104,97896
5:4:6,0,-1,102105,97895
6:1:1,0,-1,102106,97894
6:3:4,0,-1,102107,97893
2:4:6,1,1,102106,97894
3:5:2,1,1,102105,97895
6:5:2,1,1,102104,97896
4:3:4,0,-1,102105,97895
3:5:1,0,-1,102106,97894
1:1:5,0,-1,102107,97893
6:2:2,2,2,102105,97895
3:6:2,1,1,102104,97896
4:5:6,0,-1,102105,97895
6:2:6,1,1,102104,97896
4:6:4,0,-1,102105,97895
4:1:1,0,-1,102106,97894
1:2:1,1,1,102105,97895
3:2:3,1,1,102104,97896
4:3:1,0,-1,102105,97895
3:2:5,1,1,102104,97896
2:3:2,2,2,102102,97898
6:3:5,0,-1,102103,97897
4:4:2,1,1,102102,97898
2:1:4,1,1,102101,97899
5:2:3,1,1,102100,97900
4:4:5,0,-1,102101,97899
3:3:1,0,-1,102102,97898
1:2:3,1,1,102101,97899
3:4:6,0,-1,102102,97898
1:5:4,0,-1,102103,97897
3:5:2,1,1,102102,97898
3:3:4,0,-1,102103,97897
2:6:1,1,1,102102,97898
4:4:3,0,-1,102103,97897
2:3:4,1,1,102102,97898
4:4:4,0,-1,102103,97897
6:2:1,1,1,102102,97898
3:5:3,0,-1,102103,97897
4:1:1,0,-1,102104,97896
6:5:5,0,-1,102105,97895
1:4:2,1,1,102104,97896
6:4:6,0,-1,102105,97895
1:5:3,0,-1,102106,97894
4:5:3,0,-1,102107,97893
2:1:3,1,1,102106,97894
3:4:4,0,-1,102107,97893
4:5:2,1,1,102106,97894
5:6:4,0,-1,102107,97893
2:3:5,1,1,102106,97894
6:1:1,0,-1,102107,97893
2:4:4,1,1,102106,97894
1:4:1,0,-1,102107,97893
3:6:5,0,-1,102108,97892
4:5:1,0,-1,102109,97891
3:1:4,0,-1,102110,97890
5:1:6,0,-1,102111,97889
2:5:6,1,1,102110,97890
4:5:5,0,-1,102111,97889
6:1:1,0,-1,102112,97888
6:1:5,0,-1,102113,97887
3:3:1,0,-1,102114,97886
2:3:2,2,2,102112,97888
6:2:6,1,1,102111,97889
5:3:6,0,-1,102112,97888
2:6:1,1,1,102111,97889
4:5:5,0,-1,102112,97888
6:6:3,0,-1,102113,97887
3:4:2,1,1,102112,97888
4:1:3,0,-1,102113,97887
3:6:2,1,1,102112,97888
5:4:2,1,1,102111,97889
6:2:5,1,1,102110,97890
1:4:4,0,-1,102111,97889
4:1:4,0,-1,102112,97888
3:4:2,1,1,102111,97889
5:1:6,0,-1,102112,97888
6:2:3,1,1,102111,97889
2:5:1,1,1,102110,97890
3:6:5,0,-1,102111,97889
6:6:3,0,-1,102112,97888
6:6:1,0,-1,102113,97887
3:2:3,1,1,102112,97888
4:4:1,0,-1,102113,97887
2:5:1,1,1,102112,97888
2:2:2,3,3,102109,97891
4:6:6,0,-1,102110,97890
5:3:4,0,-1,102111,97889
3:1:2,1,1,102110,97890
4:4:6,0,-1,102111,97889
4:5:1,0,-1,102112,97888
6:1:5,0,-1,102113,97887
1:3:2,1,1,102112,97888
5:3:2,1,1,102111,97889
3:2:5,1,1,102110,97890
3:3:1,0,-1,102111,97889
3:4:4,0,-1,102112,97888
5:3:4,0,-1,102113,97887
1:5:3,0,-1,102114,97886
2:5:3,1,1,102113,97887
2:5:3,1,1,102112,97888
6:6:6,0,-1,102113,97887
6:2:3,1,1,102112,97888
5:4:1,0,-1,102113,97887
4:5:1,0,-1,102114,97886
6:4:6,0,-1,102115,97885
4:4:3,0,-1,102116,97884
5:6:3,0,-1,102117,97883
2:2:4,2,2,102115,97885
6:6:2,1,1,102114,97886
6:4:3,0,-1,102115,97885
1:1:2,1,1,102114,97886
6:5:4,0,-1,102115,97885
5:1:6,0,-1,102116,97884
5:3:4,0,-1,102117,97883
6:6:4,0,-1,102118,97882
2:3:5,1,1,102117,97883
3:6:3,0,-1,102118,97882
5:6:6,0,-1,102119,97881
5:4:2,1,1,102118,97882
5:1:3,0,-1,102119,97881
5:2:1,1,1,102118,97882
4:6:4,0,-1,102119,97881
6:3:4,0,-1,102120,97880
4:4:6,0,-1,102121,97879
1:5:1,0,-1,102122,97878
5:6:5,0,-1,102123,97877
5:5:5,0,-1,102124,97876
5:1:4,0,-1,102125,97875
4:5:6,0,-1,102126,97874
1:3:4,0,-1,102127,97873
6:6:2,1,1,102126,97874
3:3:2,1,1,102125,97875
2:6:3,1,1,102124,97876
3:1:3,0,-1,102125,97875
6:5:5,0,-1,102126,97874
6:6:1,0,-1,102127,97873
6:5:5,0,-1,102128,97872
2:3:6,1,1,102127,97873
4:6:2,1,1,102126,97874
5:3:5,0,-1,102127,97873
1:1:4,0,-1,102128,97872
2:4:6,1,1,102127,97873
2:1:6,1,1,102126,97874
6:3:3,0,-1,102127,97873
3:1:6,0,-1,102128,97872
4:5:3,0,-1,102129,97871
6:2:1,1,1,102128,97872
3:5:6,0,-1,102129,97871
2:5:6,1,1,102128,97872
1:4:5,0,-1,102129,97871
1:1:5,0,-1,102130,97870
2:6:4,1,1,102129,97871
1:5:1,0,-1,102130,97870
4:2:5,1,1,102129,97871
5:2:6,1,1,102128,97872
5:6:2,1,1,102127,97873
6:1:4,0,-1,102128,97872
2:4:2,2,2,102126,97874
4:4:1,0,-1,102127,97873
5:2:3,1,1,102126,97874
3:6:4,0,-1,102127,97873
6:2:5,1,1,102126,97874
1:4:6,0,-1,102127,97873
6:2:4,1,1,102126,97874
6:3:4,0,-1,102127,97873
3:6:3,0,-1,102128,97872
5:6:6,0,-1,102129,97871
6:2:6,1,1,102128,97872
6:6:4,0,-1,102129,97871
2:6:4,1,1,102128,97872
1:5:3,0,-1,102129,97871
5:3:2,1,1,102128,97872
2:3:1,1,1,102127,97873
1:1:5,0,-1,102128,97872
5:2:5,1,1,102127,97873
2:3:3,1,1,102126,97874
6:6:5,0,-1,102127,97873
3:2:3,1,1,102126,97874
3:2:1,1,1,102125,97875
2:2:4,2,2,102123,97877
2:6:2,2,2,102121,97879
2:5:5,1,1,102120,97880
1:4:6,0,-1,102121,97879
1:1:6,0,-1,102122,97878
4:4:1,0,-1,102123,97877
6:5:6,0,-1,102124,97876
5:3:3,0,-1,102125,97875
5:3:3,0,-1,102126,97874
2:4:2,2,2,102124,97876
6:4:1,0,-1,102125,97875
1:6:1,0,-1,102126,97874
3:4:4,0,-1,102127,97873
2:1:3,1,1,102126,97874
1:3:6,0,-1,102127,97873
2:1:1,1,1,102126,97874
2:1:3,1,1,102125,97875
2:3:2,2,2,102123,97877
5:3:6,0,-1,102124,97876
1:1:6,0,-1,102125,97875
3:2:4,1,1,102124,97876
4:5:6,0,-1,102125,97875
4:4:5,0,-1,102126,97874
6:5:2,1,1,102125,97875
5:3:5,0,-1,102126,97874
3:4:5,0,-1,102127,97873
1:2:6,1,1,102126,97874
5:6:6,0,-1,102127,97873
6:3:2,1,1,102126,97874
1:4:6,0,-1,102127,97873
3:4:6,0,-1,102128,97872
1:3:6,0,-1,102129,97871
3:6:6,0,-1,102130,97870
6:2:3,1,1,102129,97871
5:3:5,0,-1,102130,97870
6:6:1,0,-1,102131,97869
2:4:4,1,1,102130,97870
4:3:3,0,-1,102131,97869
3:2:6,1,1,102130,97870
3:2:2,2,2,102128,97872
4:2:2,2,2,102126,97874
5:4:3,0,-1,102127,97873
6:5:3,0,-1,102128,97872
2:5:6,1,1,102127,97873
6:1:6,0,-1,102128,97872
2:6:5,1,1,102127,97873
6:5:4,0,-1,102128,97872
4:4:6,0,-1,102129,97871
2:5:6,1,1,102128,97872
3:6:6,0,-1,102129,97871
3:5:5,0,-1,102130,97870
1:6:2,1,1,102129,97871
4:5:3,0,-1,102130,97870
4:4:6,0,-1,102131,97869
3:4:3,0,-1,102132,97868
1:4:3,0,-1,102133,97867
5:6:2,1,1,102132,97868
3:6:2,1,1,102131,97869
4:6:4,0,-1,102132,97868
6:1:6,0,-1,102133,97867
2:6:4,1,1,102132,97868
6:3:4,0,-1,102133,97867
1:2:4,1,1,102132,97868
2:1:2,2,2,102130,97870
2:2:2,3,3,102127,97873
2:2:2,3,3,102124,97876
2:2:6,2,2,102122,97878
5:6:6,0,-1,102123,97877
6:1:2,1,1,102122,97878
2:2:6,2,2,102120,97880
5:1:5,0,-1,102121,97879
2:1:4,1,1,102120,97880
6:5:4,0,-1,102121,97879
3:4:5,0,-1,102122,97878
3:3:4,0,-1,102123,97877
2:1:5,1,1,102122,97878
2:2:3,2,2,102120,97880
5:5:1,0,-1,102121,97879
2:4:5,1,1,102120,97880
1:3:3,0,-1,102121,97879
3:4:2,1,1,102120,97880
4:6:2,1,1,102119,97881
1:1:3,0,-1,102120,97880
5:1:5,0,-1,102121,97879
1:2:3,1,1,102120,97880
4:4:6,0,-1,102121,97879
5:2:4,1,1,102120,97880
1:5:6,0,-1,102121,97879
5:3:2,1,1,102120,97880
4:5:6,0,-1,102121,97879
5:4:1,0,-1,102122,97878
5:1:1,0,-1,102123,97877
6:5:4,0,-1,102124,97876
4:2:5,1,1,102123,97877
4:4:2,1,1,102122,97878
2:3:4,1,1,102121,97879
3:3:3,0,-1,102122,97878
5:2:6,1,1,102121,97879
4:1:1,0,-1,102122,97878
6:6:6,0,-1,102123,97877
6:5:5,0,-1,102124,97876
4:6:5,0,-1,102125,97875
2:5:2,2,2,102123,97877
5:4:2,1,1,102122,97878
1:1:5,0,-1,102123,97877
4:2:1,1,1,102122,97878
5:4:1,0,-1,102123,97877
3:4:2,1,1,102122,97878
4:2:3,1,1,102121,97879
2:2:1,2,2,102119,97881
3:3:5,0,-1,102120,97880
5:3:4,0,-1,102121,97879
1:3:1,0,-1,102122,97878
2:6:6,1,1,102121,97879
4:5:3,0,-1,102122,97878
5:1:4,0,-1,102123,97877
5:3:6,0,-1,102124,97876
6:2:5,1,1,102123,97877
1:5:3,0,-1,102124,97876
4:3:5,0,-1,102125,97875
4:3:6,0,-1,102126,97874
4:1:2,1,1,102125,97875
3:3:1,0,-1,102126,97874
5:1:4,0,-1,102127,97873
4:3:1,0,-1,102128,97872
2:3:5,1,1,102127,97873
4:3:5,0,-1,102128,97872
5:6:3,0,-1,102129,97871
4:4:2,1,1,102128,97872
3:1:5,0,-1,102129,97871
2:2:3,2,2,102127,97873
4:6:1,0,-1,102128,97872
5:5:3,0,-1,102129,97871
5:6:5,0,-1,102130,97870
2:1:2,2,2,102128,97872
1:6:1,0,-1,102129,97871
1:3:3,0,-1,102130,97870
1:4:3,0,-1,102131,97869
2:1:3,1,1,102130,97870
6:2:4,1,1,102129,97871
1:5:1,0,-1,102130,97870
3:1:2,1,1,102129,97871
4:4:2,1,1,102128,97872
2:4:3,1,1,102127,97873
4:4:6,0,-1,102128,97872
3:1:4,0,-1,102129,97871
5:1:1,0,-1,102130,97870
6:1:6,0,-1,102131,97869
6:6:2,1,1,102130,97870
5:5:6,0,-1,102131,97869
4:3:3,0,-1,102132,97868
1:2:6,1,1,102131,97869
1:1:2,1,1,102130,97870
5:1:2,1,1,102129,97871
3:6:2,1,1,102128,97872
3:2:6,1,1,102127,97873
3:4:2,1,1,102126,97874
4:6:6,0,-1,102127,97873
6:6:1,0,-1,102128,97872
2:2:6,2,2,102126,97874
1:5:3,0,-1,102127,97873
5:1:3,0,-1,102128,97872
4:2:4,1,1,102127,97873
4:6:3,0,-1,102128,97872
6:6:5,0,-1,102129,97871
6:6:6,0,-1,102130,97870
1:5:1,0,-1,102131,97869
2:5:6,1,1,102130,97870
4:1:2,1,1,102129,97871
5:4:4,0,-1,102130,97870
5:6:6,0,-1,102131,97869
4:1:3,0,-1,102132,97868
6:2:2,2,2,102130,97870
1:2:5,1,1,102129,97871
5:6:5,0,-1,102130,97870
1:1:1,0,-1,102131,97869
5:4:3,0,-1,102132,97868
6:6:5,0,-1,102133,97867
4:2:3,1,1,102132,97868
3:1:4,0,-1,102133,97867
4:3:5,0,-1,102134,97866
1:6:4,0,-1,102135,97865
4:3:2,1,1,102134,97866
5:4:1,0,-1,102135,97865
3:2:3,1,1,102134,97866
1:1:4,0,-1,102135,97865
2:4:6,1,1,102134,97866
2:2:2,3,3,102131,97869
6:4:3,0,-1,102132,97868
1:1:2,1,1,102131,97869
3:3:4,0,-1,102132,97868
2:2:6,2,2,102130,97870
5:1:6,0,-1,102131,97869
1:3:5,0,-1,102132,97868
5:5:1,0,-1,102133,97867
3:5:6,0,-1,102134,97866
1:1:1,0,-1,102135,97865
4:3:2,1,1,102134,97866
3:4:3,0,-1,102135,97865
6:4:6,0,-1,102136,97864
3:5:6,0,-1,102137,97863
4:5:5,0,-1,102138,97862
2:3:6,1,1,102137,97863
5:1:6,0,-1,102138,97862
4:1:6,0,-1,102139,97861
1:3:6,0,-1,102140,97860
1:5:1,0,-1,102141,97859
5:5:6,0,-1,102142,97858
2:6:4,1,1,102141,97859
1:6:5,0,-1,102142,97858
3:4:5,0,-1,102143,97857
5:2:1,1,1,102142,97858
5:1:4,0,-1,102143,97857
4:6:3,0,-1,102144,97856
3:2:1,1,1,102143,97857
5:1:5,0,-1,102144,97856
1:1:4,0,-1,102145,97855
4:2:4,1,1,102144,97856
1:6:6,0,-1,102145,97855
1:2:6,1,1,102144,97856
6:5:4,0,-1,102145,97855
1:1:1,0,-1,102146,97854
3:3:4,0,-1,102147,97853
6:5:4,0,-1,102148,97852
5:1:1,0,-1,102149,97851
6:3:2,1,1,102148,97852
2:5:5,1,1,102147,97853
2:5:3,1,1,102146,97854
2:4:6,1,1,102145,97855
2:2:3,2,2,102143,97857
1:5:4,0,-1,102144,97856
6:3:3,0,-1,102145,97855
5:3:6,0,-1,102146,97854
5:2:5,1,1,102145,97855
3:4:5,0,-1,102146,97854
1:3:6,0,-1,102147,97853
6:1:3,0,-1,102148,97852
2:1:3,1,1,102147,97853
1:4:3,0,-1,102148,97852
1:4:6,0,-1,102149,97851
2:2:3,2,2,102147,97853
2:3:4,1,1,102146,97854
3:5:6,0,-1,102147,97853
3:4:6,0,-1,102148,97852
3:2:5,1,1,102147,97853
5:5:1,0,-1,102148,97852
3:5:2,1,1,102147,97853
3:3:6,0,-1,102148,97852
2:4:4,1,1,102147,97853
5:1:4,0,-1,102148,97852
6:6:2,1,1,102147,97853
6:5:4,0,-1,102148,97852
5:6:1,0,-1,102149,97851
4:2:6,1,1,102148,97852
2:1:1,1,1,102147,97853
5:3:2,1,1,102146,97854
5:4:3,0,-1,102147,97853
6:3:5,0,-1,102148,97852
2:3:6,1,1,102147,97853
4:6:5,0,-1,102148,97852
2:6:6,1,1,102147,97853
5:3:5,0,-1,102148,97852
3:2:4,1,1,102147,97853
2:3:5,1,1,102146,97854
4:2:3,1,1,102145,97855
2:4:4,1,1,102144,97856
3:3:4,0,-1,102145,97855
1:4:4,0,-1,102146,97854
2:2:5,2,2,102144,97856
4:3:3,0,-1,102145,97855
1:6:4,0,-1,102146,97854
2:3:5,1,1,102145,97855
2:4:3,1,1,102144,97856
6:5:5,0,-1,102145,97855
2:6:3,1,1,102144,97856
1:1:2,1,1,102143,97857
5:4:3,0,-1,102144,97856
3:3:1,0,-1,102145,97855
6:6:6,0,-1,102146,97854
4:3:3,0,-1,102147,97853
6:5:3,0,-1,102148,97852
3:5:3,0,-1,102149,97851
3:5:2,1,1,102148,97852
1:2:2,2,2,102146,97854
4:6:1,0,-1,102147,97853
3:4:3,0,-1,102148,97852
4:1:5,0,-1,102149,97851
6:5:4,0,-1,102150,97850
3:5:3,0,-1,102151,97849
5:4:2,1,1,102150,97850
6:4:6,0,-1,102151,97849
4:4:2,1,1,102150,97850
5:2:3,1,1,102149,97851
3:3:1,0,-1,102150,97850
1:4:2,1,1,102149,97851
3:4:1,0,-1,102150,97850
1:3:2,1,1,102149,97851
1:5:6,0,-1,102150,97850
1:4:6,0,-1,102151,97849
4:3:5,0,-1,102152,97848
6:3:1,0,-1,102153,97847
1:2:6,1,1,102152,97848
5:1:2,1,1,102151,97849
6:3:3,0,-1,102152,97848
5:2:3,1,1,102151,97849
4:6:2,1,1,102150,97850
6:5:6,0,-1,102151,97849
3:4:2,1,1,102150,97850
5:5:6,0,-1,102151,97849
3:3:3,0,-1,102152,97848
3:6:1,0,-1,102153,97847
5:6:6,0,-1,102154,97846
1:3:4,0,-1,102155,97845
6:1:1,0,-1,102156,97844
4:1:4,0,-1,102157,97843
4:4:6,0,-1,102158,97842
4:6:3,0,-1,102159,97841
4:2:5,1,1,102158,97842
2:5:4,1,1,102157,97843
6:3:2,1,1,102156,97844
2:3:1,1,1,102155,97845
6:4:2,1,1,102154,97846
3:5:4,0,-1,102155,97845
2:4:6,1,1,102154,97846
1:6:2,1,1,102153,97847
5:4:2,1,1,102152,97848
6:2:5,1,1,102151,97849
4:4:2,1,1,102150,97850
1:4:3,0,-1,102151,97849
4:4:5,0,-1,102152,97848
2:3:2,2,2,102150,97850
4:4:3,0,-1,102151,97849
4:2:1,1,1,102150,97850
5:5:3,0,-1,102151,97849
4:2:6,1,1,102150,97850
6:3:6,0,-1,102151,97849
3:3:3,0,-1,102152,97848
3:6:1,0,-1,102153,97847
2:3:2,2,2,102151,97849
5:5:2,1,1,102150,97850
4:3:1,0,-1,102151,97849
6:4:2,1,1,102150,97850
6:4:3,0,-1,102151,97849
2:4:5,1,1,102150,97850
6:2:1,1,1,102149,97851
3:2:1,1,1,102148,97852
4:5:4,0,-1,102149,97851
5:3:4,0,-1,102150,97850
4:3:6,0,-1,102151,97849
3:4:5,0,-1,102152,97848
1:5:2,1,1,102151,97849
1:5:4,0,-1,102152,97848
5:1:1,0,-1,102153,97847
5:3:5,0,-1,102154,97846
3:3:1,0,-1,102155,97845
3:2:2,2,2,102153,97847
6:2:2,2,2,102151,97849
5:1:6,0,-1,102152,97848
6:1:1,0,-1,102153,97847
1:3:4,0,-1,102154,97846
1:5:5,0,-1,102155,97845
1:3:5,0,-1,102156,97844
5:3:6,0,-1,102157,97843
5:3:6,0,-1,102158,97842
5:4:3,0,-1,102159,97841
1:2:4,1,1,102158,97842
2:2:6,2,2,102156,97844
6:6:4,0,-1,102157,97843
2:5:4,1,1,102156,97844
5:4:6,0,-1,102157,97843
1:2:2,2,2,102155,97845
6:5:2,1,1,102154,97846
4:3:4,0,-1,102155,97845
5:1:6,0,-1,102156,97844
2:5:2,2,2,102154,97846
6:1:6,0,-1,102155,97845
5:5:1,0,-1,102156,97844
6:1:6,0,-1,102157,97843
6:1:3,0,-1,102158,97842
1:6:3,0,-1,102159,97841
6:1:5,0,-1,102160,97840
3:1:1,0,-1,102161,97839
1:4:5,0,-1,102162,97838
5:4:5,0,-1,102163,97837
4:5:1,0,-1,102164,97836
3:6:5,0,-1,102165,97835
6:5:5,0,-1,102166,97834
6:4:5,0,-1,102167,97833
6:5:2,1,1,102166,97834
1:2:4,1,1,102165,97835
2:6:3,1,1,102164,97836
1:2:3,1,1,102163,97837
5:5:2,1,1,102162,97838
5:5:5,0,-1,102163,97837
1:1:3,0,-1,102164,97836
3:4:5,0,-1,102165,97835
3:2:2,2,2,102163,97837
1:5:4,0,-1,102164,97836
1:4:1,0,-1,102165,97835
6:5:4,0,-1,102166,97834
3:3:1,0,-1,102167,97833
3:3:2,1,1,102166,97834
3:2:3,1,1,102165,97835
3:6:1,0,-1,102166,97834
4:5:5,0,-1,102167,97833
1:6:1,0,-1,102168,97832
4:3:3,0,-1,102169,97831
1:5:1,0,-1,102170,97830
4:5:6,0,-1,102171,97829
5:4:2,1,1,102170,97830
1:1:4,0,-1,102171,97829
2:2:2,3,3,102168,97832
5:3:4,0,-1,102169,97831
2:5:3,1,1,102168,97832
5:5:6,0,-1,102169,97831
3:6:5,0,-1,102170,97830
3:2:6,1,1,102169,97831
2:4:3,1,1,102168,97832
6:5:5,0,-1,102169,97831
5:1:1,0,-1,102170,97830
5:3:1,0,-1,102171,97829
5:2:5,1,1,102170,97830
4:3:6,0,-1,102171,97829
5:6:6,0,-1,102172,97828
3:1:5,0,-1,102173,97827
3:5:6,0,-1,102174,97826
5:5:6,0,-1,102175,97825
2:6:4,1,1,102174,97826
6:2:2,2,2,102172,97828
2:3:1,1,1,102171,97829
1:3:1,0,-1,102172,97828
3:2:2,2,2,102170,97830
3:3:4,0,-1,102171,97829
6:1:5,0,-1,102172,97828
3:2:4,1,1,102171,97829
6:2:6,1,1,102170,97830
1:6:5,0,-1,102171,97829
6:1:5,0,-1,102172,97828
4:2:6,1,1,102171,97829
1:3:4,0,-1,102172,97828
5:5:4,0,-1,102173,97827
1:2:3,1,1,102172,97828
6:4:4,0,-1,102173,97827
4:5:6,0,-1,102174,97826
6:2:1,1,1,102173,97827
1:3:2,1,1,102172,97828
6:3:2,1,1,102171,97829
3:2:1,1,1,102170,97830
6:2:5,1,1,102169,97831
3:1:6,0,-1,102170,97830
6:5:5,0,-1,102171,97829
4:1:6,0,-1,102172,97828
4:1:3,0,-1,102173,97827
5:4:2,1,1,102172,97828
1:4:4,0,-1,102173,97827
2:1:2,2,2,102171,97829
6:2:1,1,1,102170,97830
4:1:3,0,-1,102171,97829
3:5:5,0,-1,102172,97828
3:3:6,0,-1,102173,97827
5:5:3,0,-1,102174,97826
1:3:4,0,-1,102175,97825
2:5:4,1,1,102174,97826
1:3:1,0,-1,102175,97825
5:3:4,0,-1,102176,97824
6:3:5,0,-1,102177,97823
4:6:2,1,1,102176,97824
5:3:3,0,-1,102177,97823
6:2:2,2,2,102175,97825
2:6:5,1,1,102174,97826
2:4:1,1,1,102173,97827
4:5:4,0,-1,102174,97826
1:1:5,0,-1,102175,97825
2:1:3,1,1,102174,97826
2:4:2,2,2,102172,97828
4:1:2,1,1,102171,97829
3:6:2,1,1,102170,97830
4:6:2,1,1,102169,97831
1:2:5,1,1,102168,97832
5:1:1,0,-1,102169,97831
1:4:1,0,-1,102170,97830
3:2:1,1,1,102169,97831
3:1:2,1,1,102168,97832
1:1:3,0,-1,102169,97831
2:6:1,1,1,102168,97832
4:6:4,0,-1,102169,97831
3:4:5,0,-1,102170,97830
3:6:5,0,-1,102171,97829
4:1:2,1,1,102170,97830
5:4:5,0,-1,102171,97829
1:4:4,0,-1,102172,97828
6:1:4,0,-1,102173,97827
5:2:4,1,1,102172,97828
5:2:3,1,1,102171,97829
3:3:2,1,1,102170,97830
3:4:2,1,1,102169,97831
6:1:1,0,-1,102170,97830
4:4:6,0,-1,102171,97829
6:4:1,0,-1,102172,97828
2:5:5,1,1,102171,97829
4:5:4,0,-1,102172,97828
4:6:1,0,-1,102173,97827
3:4:1,0,-1,102174,97826
3:6:2,1,1,102173,97827
1:4:5,0,-1,102174,97826
3:1:1,0,-1,102175,97825
4:3:3,0,-1,102176,97824
6:1:6,0,-1,102177,97823
5:6:4,0,-1,102178,97822
6:4:5,0,-1,102179,97821
3:3:1,0,-1,102180,97820
5:4:4,0,-1,102181,97819
6:6:6,0,-1,102182,97818
3:5:6,0,-1,102183,97817
6:4:4,0,-1,102184,97816
1:6:2,1,1,102183,97817
6:1:2,1,1,102182,97818
4:4:3,0,-1,102183,97817
4:6:1,0,-1,102184,97816
1:4:1,0,-1,102185,97815
3:2:4,1,1,102184,97816
1:4:6,0,-1,102185,97815
5:4:4,0,-1,102186,97814
4:6:4,0,-1,102187,97813
5:1:6,0,-1,102188,97812
2:4:2,2,2,102186,97814
5:2:2,2,2,102184,97816
1:3:2,1,1,102183,97817
1:3:1,0,-1,102184,97816
4:4:6,0,-1,102185,97815
4:5:1,0,-1,102186,97814
3:5:4,0,-1,102187,97813
3:4:5,0,-1,102188,97812
5:1:6,0,-1,102189,97811
5:3:3,0,-1,102190,97810
4:6:3,0,-1,102191,97809
5:2:4,1,1,102190,97810
6:4:5,0,-1,102191,97809
5:4:5,0,-1,102192,97808
1:5:1,0,-1,102193,97807
5:2:4,1,1,102192,97808
4:3:3,0,-1,102193,97807
3:4:3,0,-1,102194,97806
5:6:4,0,-1,102195,97805
3:4:6,0,-1,102196,97804
4:1:3,0,-1,102197,97803
5:1:3,0,-1,102198,97802
1:6:6,0,-1,102199,97801
2:4:1,1,1,102198,97802
6:4:6,0,-1,102199,97801
3:5:5,0,-1,102200,97800
6:3:2,1,1,102199,97801
5:6:2,1,1,102198,97802
2:5:1,1,1,102197,97803
5:4:5,0,-1,102198,97802
3:6:4,0,-1,102199,97801
5:3:6,0,-1,102200,97800
3:6:6,0,-1,102201,97799
5:4:3,0,-1,102202,97798
3:5:5,0,-1,102203,97797
2:6:6,1,1,102202,97798
2:3:5,1,1,102201,97799
6:5:3,0,-1,102202,97798
3:1:3,0,-1,102203,97797
4:5:6,0,-1,102204,97796
3:2:6,1,1,102203,97797
5:5:3,0,-1,102204,97796
4:2:6,1,1,102203,97797
4:5:5,0,-1,102204,97796
1:1:5,0,-1,102205,97795
6:4:2,1,1,102204,97796
5:2:2,2,2,102202,97798
5:6:1,0,-1,102203,97797
4:1:6,0,-1,102204,97796
1:4:2,1,1,102203,97797
2:1:6,1,1,102202,97798
3:1:5,0,-1,102203,97797
3:5:6,0,-1,102204,97796
6:2:2,2,2,102202,97798
5:1:2,1,1,102201,97799
3:3:5,0,-1,102202,97798
1:1:1,0,-1,102203,97797
5:5:2,1,1,102202,97798
4:2:1,1,1,102201,97799
5:1:4,0,-1,102202,97798
5:6:5,0,-1,102203,97797
1:5:2,1,1,102202,97798
6:1:4,0,-1,102203,97797
2:3:4,1,1,102202,97798
5:4:1,0,-1,102203,97797
6:1:6,0,-1,102204,97796
4:6:1,0,-1,102205,97795
2:4:1,1,1,102204,97796
5:1:5,0,-1,102205,97795
5:3:4,0,-1,102206,97794
5:4:4,0,-1,102207,97793
3:1:6,0,-1,102208,97792
3:2:4,1,1,102207,97793
4:3:4,0,-1,102208,97792
1:3:6,0,-1,102209,97791
2:1:3,1,1,102208,97792
1:2:1,1,1,102207,97793
2:1:6,1,1,102206,97794
5:6:2,1,1,102205,97795
6:6:2,1,1,102204,97796
6:6:6,0,-1,102205,97795
1:2:4,1,1,102204,97796
4:6:5,0,-1,102205,97795
1:1:6,0,-1,102206,97794
4:1:2,1,1,102205,97795
5:1:1,0,-1,102206,97794
3:6:5,0,-1,102207,97793
2:1:6,1,1,102206,97794
6:1:3,0,-1,102207,97793
1:3:5,0,-1,102208,97792
2:2:3,2,2,102206,97794
6:6:3,0,-1,102207,97793
1:3:5,0,-1,102208,97792
3:5:2,1,1,102207,97793
5:3:3,0,-1,102208,97792
3:4:6,0,-1,102209,97791
6:1:1,0,-1,102210,97790
1:1:6,0,-1,102211,97789
1:4:2,1,1,102210,97790
1:6:4,0,-1,102211,97789
6:6:1,0,-1,102212,97788
4:4:5,0,-1,102213,97787
5:3:1,0,-1,102214,97786
6:2:5,1,1,102213,97787
6:1:1,0,-1,102214,97786
2:4:1,1,1,102213,97787
5:1:2,1,1,102212,97788
5:2:6,1,1,102211,97789
5:5:3,0,-1,102212,97788
2:1:3,1,1,102211,97789
6:3:1,0,-1,102212,97788
2:5:1,1,1,102211,97789
5:3:5,0,-1,102212,97788
1:2:4,1,1,102211,97789
3:3:3,0,-1,102212,97788
4:5:3,0,-1,102213,97787
6:5:5,0,-1,102214,97786
5:5:2,1,1,102213,97787
4:6:1,0,-1,102214,97786
6:2:1,1,1,102213,97787
5:3:4,0,-1,102214,97786
2:1:1,1,1,102213,97787
6:4:6,0,-1,102214,97786
4:5:4,0,-1,102215,97785
2:3:3,1,1,102214,97786
1:2:6,1,1,102213,97787
6:5:5,0,-1,102214,97786
6:2:5,1,1,102213,97787
3:4:6,0,-1,102214,97786
6:5:4,0,-1,102215,97785
4:3:1,0,-1,102216,97784
2:1:6,1,1,102215,97785
3:3:3,0,-1,102216,97784
4:2:1,1,1,102215,97785
5:6:6,0,-1,102216,97784
4:5:5,0,-1,102217,97783
4:3:2,1,1,102216,97784
5:1:1,0,-1,102217,97783
5:6:5,0,-1,102218,97782
3:4:2,1,1,102217,97783
3:5:6,0,-1,102218,97782
6:4:1,0,-1,102219,97781
3:6:5,0,-1,102220,97780
2:5:3,1,1,102219,97781
5:6:6,0,-1,102220,97780
4:6:6,0,-1,102221,97779
3:6:6,0,-1,102222,97778
3:5:4,0,-1,102223,97777
1:5:3,0,-1,102224,97776
1:5:1,0,-1,102225,97775
5:3:5,0,-1,102226,97774
6:3:3,0,-1,102227,97773
1:5:2,1,1,102226,97774
1:1:3,0,-1,102227,97773
3:1:2,1,1,102226,97774
6:2:1,1,1,102225,97775
1:3:4,0,-1,102226,97774
5:5:1,0,-1,102227,97773
1:4:6,0,-1,102228,97772
4:4:3,0,-1,102229,97771
2:1:3,1,1,102228,97772
1:6:6,0,-1,102229,97771
6:2:2,2,2,102227,97773
2:3:5,1,1,102226,97774
1:5:1,0,-1,102227,97773
4:1:4,0,-1,102228,97772
6:3:5,0,-1,102229,97771
3:2:5,1,1,102228,97772
1:1:5,0,-1,102229,97771
4:4:3,0,-1,102230,97770
3:2:3,1,1,102229,97771
6:4:3,0,-1,102230,97770
4:3:1,0,-1,102231,97769
4:4:4,0,-1,102232,97768
1:6:5,0,-1,102233,97767
4:2:4,1,1,102232,97768
4:3:6,0,-1,102233,97767
2:1:1,1,1,102232,97768
1:4:3,0,-1,102233,97767
5:5:2,1,1,102232,97768
5:1:4,0,-1,102233,97767
4:5:6,0,-1,102234,97766
5:2:4,1,1,102233,97767
2:2:3,2,2,102231,97769
4:3:3,0,-1,102232,97768
5:4:4,0,-1,102233,97767
6:4:5,0,-1,102234,97766
2:1:5,1,1,102233,97767
5:4:6,0,-1,102234,97766
5:4:3,0,-1,102235,97765
4:2:1,1,1,102234,97766
3:4:1,0,-1,102235,97765
6:3:2,1,1,102234,97766
5:2:4,1,1,102233,97767
5:4:1,0,-1,102234,97766
6:4:5,0,-1,102235,97765
2:2:5,2,2,102233,97767
4:2:3,1,1,102232,97768
2:1:6,1,1,102231,97769
2:5:5,1,1,102230,97770
6:3:1,0,-1,102231,97769
3:6:1,0,-1,102232,97768
6:6:6,0,-1,102233,97767
3:5:1,0,-1,102234,97766
5:3:1,0,-1,102235,97765
3:5:6,0,-1,102236,97764
6:2:3,1,1,102235,97765
5:1:4,0,-1,102236,97764
4:2:6,1,1,102235,97765
5:2:4,1,1,102234,97766
1:3:6,0,-1,102235,97765
6:6:3,0,-1,102236,97764
3:4:2,1,1,102235,97765
1:4:5,0,-1,102236,97764
3:5:2,1,1,102235,97765
4:1:2,1,1,102234,97766
4:2:5,1,1,102233,97767
4:5:5,0,-1,102234,97766
4:2:6,1,1,102233,97767
5:4:5,0,-1,102234,97766
1:1:3,0,-1,102235,97765
1:3:6,0,-1,102236,97764
2:5:1,1,1,102235,97765
2:2:6,2,2,102233,97767
3:4:4,0,-1,102234,97766
4:6:6,0,-1,102235,97765
1:4:1,0,-1,102236,97764
5:1:6,0,-1,102237,97763
4:1:5,0,-1,102238,97762
1:3:5,0,-1,102239,97761
6:4:1,0,-1,102240,97760
5:1:6,0,-1,102241,97759
1:2:2,2,2,102239,97761
2:5:2,2,2,102237,97763
3:1:6,0,-1,102238,97762
4:3:2,1,1,102237,97763
3:5:4,0,-1,102238,97762
4:2:6,1,1,102237,97763
4:1:6,0,-1,102238,97762
1:1:6,0,-1,102239,97761
1:1:1,0,-1,102240,97760
2:2:6,2,2,102238,97762
1:6:6,0,-1,102239,97761
1:2:1,1,1,102238,97762
1:6:4,0,-1,102239,97761
6:3:4,0,-1,102240,97760
1:5:1,0,-1,102241,97759
6:3:3,0,-1,102242,97758
2:1:3,1,1,102241,97759
2:2:5,2,2,102239,97761
4:3:6,0,-1,102240,97760
5:1:2,1,1,102239,97761
6:2:5,1,1,102238,97762
4:3:3,0,-1,102239,97761
3:4:1,0,-1,102240,97760
3:3:1,0,-1,102241,97759
5:6:6,0,-1,102242,97758
1:3:2,1,1,102241,97759
3:3:2,1,1,102240,97760
3:3:6,0,-1,102241,97759
4:5:1,0,-1,102242,97758
3:3:6,0,-1,102243,97757
4:6:3,0,-1,102244,97756
6:6:2,1,1,102243,97757
6:4:5,0,-1,102244,97756
4:5:6,0,-1,102245,97755
3:3:5,0,-1,102246,97754
5:2:2,2,2,102244,97756
2:1:2,2,2,102242,97758
5:5:1,0,-1,102243,97757
1:3:1,0,-1,102244,97756
6:3:2,1,1,102243,97757
2:5:5,1,1,102242,97758
3:4:2,1,1,102241,97759
2:6:1,1,1,102240,97760
6:3:3,0,-1,102241,97759
3:4:5,0,-1,102242,97758
2:1:5,1,1,102241,97759
5:5:6,0,-1,102242,97758
3:5:6,0,-1,102243,97757
4:5:5,0,-1,102244,97756
2:3:1,1,1,102243,97757
2:1:2,2,2,102241,97759
2:1:6,1,1,102240,97760
3:4:1,0,-1,102241,97759
2:1:5,1,1,102240,97760
6:5:4,0,-1,102241,97759
2:1:6,1,1,102240,97760
4:4:2,1,1,102239,97761
4:4:2,1,1,102238,97762
1:6:6,0,-1,102239,97761
6:2:1,1,1,102238,97762
6:2:2,2,2,102236,97764
2:4:4,1,1,102235,97765
3:4:4,0,-1,102236,97764
3:6:3,0,-1,102237,97763
5:5:2,1,1,102236,97764
1:4:1,0,-1,102237,97763
5:2:4,1,1,102236,97764
5:2:6,1,1,102235,97765
6:1:4,0,-1,102236,97764
6:4:1,0,-1,102237,97763
3:5:2,1,1,102236,97764
3:6:1,0,-1,102237,97763
1:4:5,0,-1,102238,97762
5:5:1,0,-1,102239,97761
2:1:6,1,1,102238,97762
2:4:5,1,1,102237,97763
6:2:1,1,1,102236,97764
5:3:4,0,-1,102237,97763
6:2:2,2,2,102235,97765
3:1:6,0,-1,102236,97764
2:5:3,1,1,102235,97765
4:3:6,0,-1,102236,97764
2:3:4,1,1,102235,97765
2:1:5,1,1,102234,97766
3:1:5,0,-1,102235,97765
3:1:2,1,1,102234,97766
5:3:3,0,-1,102235,97765
3:6:4,0,-1,102236,97764
2:1:2,2,2,102234,97766
6:2:3,1,1,102233,97767
4:4:1,0,-1,102234,97766
1:2:1,1,1,102233,97767
3:6:5,0,-1,102234,97766
1:2:2,2,2,102232,97768
5:1:4,0,-1,102233,97767
3:3:1,0,-1,102234,97766
3:5:4,0,-1,102235,97765
6:2:1,1,1,102234,97766
5:5:3,0,-1,102235,97765
1:3:1,0,-1,102236,97764
1:6:5,0,-1,102237,97763
1:2:3,1,1,102236,97764
5:1:2,1,1,102235,97765
5:2:2,2,2,102233,97767
3:3:1,0,-1,102234,97766
4:2:4,1,1,102233,97767
3:2:5,1,1,102232,97768
2:2:5,2,2,102230,97770
1:1:6,0,-1,102231,97769
4:4:2,1,1,102230,97770
3:4:5,0,-1,102231,97769
3:3:2,1,1,102230,97770
2:5:3,1,1,102229,97771
1:6:6,0,-1,102230,97770
1:1:6,0,-1,102231,97769
1:3:2,1,1,102230,97770
6:6:5,0,-1,102231,97769
4:3:6,0,-1,102232,97768
3:3:5,0,-1,102233,97767
3:5:4,0,-1,102234,97766
3:5:3,0,-1,102235,97765
1:3:2,1,1,102234,97766
4:2:1,1,1,102233,97767
3:2:2,2,2,102231,97769
2:6:4,1,1,102230,97770
3:1:5,0,-1,102231,97769
1:2:2,2,2,102229,97771
3:2:4,1,1,102228,97772
5:4:5,0,-1,102229,97771
6:4:5,0,-1,102230,97770
4:4:2,1,1,102229,97771
4:2:4,1,1,102228,97772
5:1:3,0,-1,102229,97771
3:2:5,1,1,102228,97772
6:2:3,1,1,102227,97773
6:3:4,0,-1,102228,97772
4:3:3,0,-1,102229,97771
4:4:5,0,-1,102230,97770
1:1:4,0,-1,102231,97769
5:6:1,0,-1,102232,97768
1:1:6,0,-1,102233,97767
4:1:1,0,-1,102234,97766
5:1:6,0,-1,102235,97765
5:1:2,1,1,102234,97766
4:2:6,1,1,102233,97767
1:5:6,0,-1,102234,97766
2:2:4,2,2,102232,97768
1:6:6,0,-1,102233,97767
3:3:5,0,-1,102234,97766
1:3:3,0,-1,102235,97765
4:3:2,1,1,102234,97766
5:4:1,0,-1,102235,97765
1:4:5,0,-1,102236,97764
2:1:3,1,1,102235,97765
6:3:5,0,-1,102236,97764
2:4:4,1,1,102235,97765
5:2:5,1,1,102234,97766
3:6:3,0,-1,102235,97765
3:6:5,0,-1,102236,97764
3:4:2,1,1,102235,97765
3:4:5,0,-1,102236,97764
1:4:3,0,-1,102237,97763
4:3:5,0,-1,102238,97762
3:4:3,0,-1,102239,97761
1:6:3,0,-1,102240,97760
2:1:2,2,2,102238,97762
5:3:4,0,-1,102239,97761
4:1:3,0,-1,102240,97760
4:6:6,0,-1,102241,97759
3:6:3,0,-1,102242,97758
6:2:4,1,1,102241,97759
4:2:4,1,1,102240,97760
5:5:4,0,-1,102241,97759
2:3:6,1,1,102240,97760
5:1:2,1,1,102239,97761
3:6:1,0,-1,102240,97760
5:2:6,1,1,102239,97761
3:2:3,1,1,102238,97762
6:3:4,0,-1,102239,97761
2:1:2,2,2,102237,97763
2:6:6,1,1,102236,97764
1:6:5,0,-1,102237,97763
6:5:3,0,-1,102238,97762
2:5:2,2,2,102236,97764
6:1:2,1,1,102235,97765
3:6:3,0,-1,102236,97764
2:6:6,1,1,102235,97765
4:5:1,0,-1,102236,97764
3:1:6,0,-1,102237,97763
3:2:3,1,1,102236,97764
1:5:4,0,-1,102237,97763
1:2:5,1,1,102236,97764
4:1:4,0,-1,102237,97763
2:2:5,2,2,102235,97765
5:1:3,0,-1,102236,97764
3:4:3,0,-1,102237,97763
1:1:4,0,-1,102238,97762
4:2:2,2,2,102236,97764
1:5:2,1,1,102235,97765
4:1:5,0,-1,102236,97764
5:6:1,0,-1,102237,97763
3:6:1,0,-1,102238,97762
2:4:4,1,1,102237,97763
1:5:1,0,-1,102238,97762
4:2:1,1,1,102237,97763
4:3:3,0,-1,102238,97762
1:5:3,0,-1,102239,97761
5:4:4,0,-1,102240,97760
5:4:2,1,1,102239,97761
6:1:5,0,-1,102240,97760
3:6:5,0,-1,102241,97759
5:1:4,0,-1,102242,97758
4:5:1,0,-1,102243,97757
1:1:6,0,-1,102244,97756
2:1:5,1,1,102243,97757
4:2:3,1,1,102242,97758
5:4:5,0,-1,102243,97757
1:3:6,0,-1,102244,97756
2:1:3,1,1,102243,97757
2:6:3,1,1,102242,97758
4:3:4,0,-1,102243,97757
3:5:2,1,1,102242,97758
3:1:5,0,-1,102243,97757
1:2:5,1,1,102242,97758
2:2:5,2,2,102240,97760
6:4:6,0,-1,102241,97759
6:1:2,1,1,102240,97760
6:1:3,0,-1,102241,97759
1:3:2,1,1,102240,97760
1:2:6,1,1,102239,97761
1:6:5,0,-1,102240,97760
3:6:5,0,-1,102241,97759
4:6:1,0,-1,102242,97758
5:2:2,2,2,102240,97760
3:3:2,1,1,102239,97761
1:4:1,0,-1,102240,97760
5:1:4,0,-1,102241,97759
1:5:1,0,-1,102242,97758
3:5:6,0,-1,102243,97757
6:5:6,0,-1,102244,97756
2:4:2,2,2,102242,97758
2:3:5,1,1,102241,97759
5:2:1,1,1,102240,97760
6:3:2,1,1,102239,97761
5:3:4,0,-1,102240,97760
4:4:5,0,-1,102241,97759
6:6:4,0,-1,102242,97758
4:6:5,0,-1,102243,97757
6:6:4,0,-1,102244,97756
3:5:2,1,1,102243,97757
3:6:3,0,-1,102244,97756
6:6:3,0,-1,102245,97755
6:3:2,1,1,102244,97756
3:1:3,0,-1,102245,97755
3:1:4,0,-1,102246,97754
6:1:5,0,-1,102247,97753
2:3:3,1,1,102246,97754
2:5:3,1,1,102245,97755
4:1:2,1,1,102244,97756
1:1:3,0,-1,102245,97755
4:4:3,0,-1,102246,97754
6:3:6,0,-1,102247,97753
1:1:4,0,-1,102248,97752
6:2:6,1,1,102247,97753
4:2:4,1,1,102246,97754
4:1:2,1,1,102245,97755
2:1:3,1,1,102244,97756
3:5:2,1,1,102243,97757
2:3:4,1,1,102242,97758
6:3:6,0,-1,102243,97757
3:3:2,1,1,102242,97758
3:2:1,1,1,102241,97759
3:1:6,0,-1,102242,97758
5:3:6,0,-1,102243,97757
3:5:2,1,1,102242,97758
2:1:3,1,1,102241,97759
1:3:1,0,-1,102242,97758
2:6:3,1,1,102241,97759
1:3:4,0,-1,102242,97758
4:6:2,1,1,102241,97759
6:5:6,0,-1,102242,97758
2:1:5,1,1,102241,97759
6:3:2,1,1,102240,97760
6:4:3,0,-1,102241,97759
2:5:1,1,1,102240,97760
4:5:4,0,-1,102241,97759
5:3:2,1,1,102240,97760
3:6:6,0,-1,102241,97759
3:6:6,0,-1,102242,97758
5:6:1,0,-1,102243,97757
6:6:3,0,-1,102244,97756
6:4:6,0,-1,102245,97755
4:6:3,0,-1,102246,97754
5:1:5,0,-1,102247,97753
4:4:2,1,1,102246,97754
6:6:4,0,-1,102247,97753
2:2:2,3,3,102244,97756
1:2:4,1,1,102243,97757
1:4:4,0,-1,102244,97756
5:1:2,1,1,102243,97757
2:3:1,1,1,102242,97758
2:1:2,2,2,102240,97760
6:5:5,0,-1,102241,97759
3:2:2,2,2,102239,97761
6:4:2,1,1,102238,97762
5:3:1,0,-1,102239,97761
4:5:4,0,-1,102240,97760
2:6:4,1,1,102239,97761
6:4:1,0,-1,102240,97760
5:5:3,0,-1,102241,97759
3:4:2,1,1,102240,97760
5:2:3,1,1,102239,97761
6:3:4,0,-1,102240,97760
5:6:1,0,-1,102241,97759
5:2:1,1,1,102240,97760
1:2:3,1,1,102239,97761
4:1:5,0,-1,102240,97760
2:2:6,2,2,102238,97762
4:2:3,1,1,102237,97763
1:3:1,0,-1,102238,97762
4:5:5,0,-1,102239,97761
3:2:2,2,2,102237,97763
5:3:2,1,1,102236,97764
3:3:3,0,-1,102237,97763
6:3:6,0,-1,102238,97762
5:2:5,1,1,102237,97763
3:1:4,0,-1,102238,97762
3:1:2,1,1,102237,97763
4:6:4,0,-1,102238,97762
3:5:2,1,1,102237,97763
2:3:1,1,1,102236,97764
6:5:4,0,-1,102237,97763
3:5:5,0,-1,102238,97762
4:3:1,0,-1,102239,97761
4:4:2,1,1,102238,97762
2:1:1,1,1,102237,97763
2:1:3,1,1,102236,97764
5:2:5,1,1,102235,97765
5:2:6,1,1,102234,97766
4:4:6,0,-1,102235,97765
4:5:1,0,-1,102236,97764
1:6:1,0,-1,102237,97763
4:3:3,0,-1,102238,97762
3:5:4,0,-1,102239,97761
6:3:3,0,-1,102240,97760
3:4:3,0,-1,102241,97759
4:1:6,0,-1,102242,97758
4:6:3,0,-1,102243,97757
4:6:5,0,-1,102244,97756
3:5:1,0,-1,102245,97755
5:5:4,0,-1,102246,97754
2:1:3,1,1,102245,97755
3:5:2,1,1,102244,97756
1:4:4,0,-1,102245,97755
6:2:3,1,1,102244,97756
6:5:5,0,-1,102245,97755
4:3:1,0,-1,102246,97754
5:5:1,0,-1,102247,97753
6:4:6,0,-1,102248,97752
1:4:1,0,-1,102249,97751
6:3:1,0,-1,102250,97750
6:4:2,1,1,102249,97751
5:2:5,1,1,102248,97752
2:3:6,1,1,102247,97753
6:3:4,0,-1,102248,97752
4:5:2,1,1,102247,97753
4:6:6,0,-1,102248,97752
2:2:1,2,2,102246,97754
6:1:4,0,-1,102247,97753
3:5:2,1,1,102246,97754
3:4:1,0,-1,102247,97753
6:1:3,0,-1,102248,97752
1:1:6,0,-1,102249,97751
5:1:6,0,-1,102250,97750
2:5:6,1,1,102249,97751
2:6:3,1,1,102248,97752
2:2:4,2,2,102246,97754
4:4:4,0,-1,102247,97753
5:2:6,1,1,102246,97754
2:4:1,1,1,102245,97755
2:3:2,2,2,102243,97757
5:4:4,0,-1,102244,97756
3:2:1,1,1,102243,97757
6:1:2,1,1,102242,97758
1:2:2,2,2,102240,97760
4:3:3,0,-1,102241,97759
2:6:6,1,1,102240,97760
1:4:2,1,1,102239,97761
6:5:5,0,-1,102240,97760
4:1:6,0,-1,102241,97759
5:2:6,1,1,102240,97760
1:3:2,1,1,102239,97761
2:3:2,2,2,102237,97763
1:3:4,0,-1,102238,97762
4:3:2,1,1,102237,97763
1:4:3,0,-1,102238,97762
6:2:5,1,1,102237,97763
6:2:5,1,1,102236,97764
1:4:1,0,-1,102237,97763
5:3:3,0,-1,102238,97762
5:6:2,1,1,102237,97763
6:6:5,0,-1,102238,97762
6:4:5,0,-1,102239,97761
3:5:5,0,-1,102240,97760
4:1:5,0,-1,102241,97759
2:4:4,1,1,102240,97760
4:5:4,0,-1,102241,97759
3:4:3,0,-1,102242,97758
4:3:5,0,-1,102243,97757
1:2:6,1,1,102242,97758
3:3:3,0,-1,102243,97757
5:2:2,2,2,102241,97759
5:2:3,1,1,102240,97760
1:5:4,0,-1,102241,97759
1:1:1,0,-1,102242,97758
6:4:4,0,-1,102243,97757
6:3:4,0,-1,102244,97756
5:1:3,0,-1,102245,97755
6:5:6,0,-1,102246,97754
6:1:4,0,-1,102247,97753
3:2:2,2,2,102245,97755
4:2:4,1,1,102244,97756
1:6:2,1,1,102243,97757
4:5:2,1,1,102242,97758
4:5:1,0,-1,102243,97757
6:3:1,0,-1,102244,97756
6:2:6,1,1,102243,97757
4:6:1,0,-1,102244,97756
1:1:3,0,-1,102245,97755
5:3:6,0,-1,102246,97754
3:4:5,0,-1,102247,97753
3:2:1,1,1,102246,97754
4:5:2,1,1,102245,97755
3:1:5,0,-1,102246,97754
5:3:6,0,-1,102247,97753
1:2:3,1,1,102246,97754
3:1:6,0,-1,102247,97753
5:2:4,1,1,102246,97754
1:4:5,0,-1,102247,97753
3:3:5,0,-1,102248,97752
5:6:2,1,1,102247,97753
2:5:6,1,1,102246,97754
3:5:5,0,-1,102247,97753
1:6:4,0,-1,102248,97752
6:4:5,0,-1,102249,97751
3:6:6,0,-1,102250,97750
3:4:4,0,-1,102251,97749
2:5:2,2,2,102249,97751
4:5:4,0,-1,102250,97750
6:1:3,0,-1,102251,97749
4:4:4,0,-1,102252,97748
4:4:2,1,1,102251,97749
6:4:1,0,-1,102252,97748
6:3:5,0,-1,102253,97747
1:2:5,1,1,102252,97748
2:5:1,1,1,102251,97749
3:2:4,1,1,102250,97750
4:4:5,0,-1,102251,97749
4:5:6,0,-1,102252,97748
2:4:4,1,1,102251,97749
6:6:4,0,-1,102252,97748
6:3:4,0,-1,102253,97747
5:2:1,1,1,102252,97748
4:4:1,0,-1,102253,97747
1:4:5,0,-1,102254,97746
4:5:3,0,-1,102255,97745
5:5:3,0,-1,102256,97744
1:6:3,0,-1,102257,97743
2:5:4,1,1,102256,97744
4:2:6,1,1,102255,97745
3:4:5,0,-1,102256,97744
4:2:1,1,1,102255,97745
3:1:6,0,-1,102256,97744
2:5:6,1,1,102255,97745
1:1:3,0,-1,102256,97744
4:6:3,0,-1,102257,97743
6:2:6,1,1,102256,97744
3:2:1,1,1,102255,97745
3:6:1,0,-1,102256,97744
2:6:4,1,1,102255,97745
6:3:6,0,-1,102256,97744
2:1:6,1,1,102255,97745
6:1:5,0,-1,102256,97744
2:1:5,1,1,102255,97745
4:5:6,0,-1,102256,97744
5:5:2,1,1,102255,97745
1:5:6,0,-1,102256,97744
6:5:5,0,-1,102257,97743
4:4:1,0,-1,102258,97742
6:3:1,0,-1,102259,97741
3:6:4,0,-1,102260,97740
4:2:6,1,1,102259,97741
3:4:4,0,-1,102260,97740
1:3:2,1,1,102259,97741
4:6:2,1,1,102258,97742
2:1:6,1,1,102257,97743
4:6:3,0,-1,102258,97742
5:1:6,0,-1,102259,97741
2:5:2,2,2,102257,97743
1:3:2,1,1,102256,97744
3:3:6,0,-1,102257,97743
5:5:4,0,-1,102258,97742
3:3:5,0,-1,102259,97741
6:5:3,0,-1,102260,97740
3:5:5,0,-1,102261,97739
2:6:4,1,1,102260,97740
2:3:2,2,2,102258,97742
5:1:2,1,1,102257,97743
6:6:4,0,-1,102258,97742
5:1:5,0,-1,102259,97741
5:2:3,1,1,102258,97742
3:5:2,1,1,102257,97743
3:1:6,0,-1,102258,97742
6:1:5,0,-1,102259,97741
2:1:6,1,1,102258,97742
2:1:4,1,1,102257,97743
3:1:3,0,-1,102258,97742
6:5:4,0,-1,102259,97741
5:4:6,0,-1,102260,97740
6:4:2,1,1,102259,97741
4:5:5,0,-1,102260,97740
6:6:3,0,-1,102261,97739
1:2:6,1,1,102260,97740
2:6:4,1,1,102259,97741
6:3:6,0,-1,102260,97740
6:1:6,0,-1,102261,97739
4:2:5,1,1,102260,97740
3:4:3,0,-1,102261,97739
1:5:6,0,-1,102262,97738
6:5:4,0,-1,102263,97737
3:6:4,0,-1,102264,97736
5:3:5,0,-1,102265,97735
4:3:1,0,-1,102266,97734
1:3:6,0,-1,102267,97733
4:6:6,0,-1,102268,97732
4:3:5,0,-1,102269,97731
5:6:2,1,1,102268,97732
3:5:5,0,-1,102269,97731
3:4:5,0,-1,102270,97730
1:5:1,0,-1,102271,97729
1:4:3,0,-1,102272,97728
2:3:5,1,1,102271,97729
5:3:4,0,-1,102272,97728
1:5:2,1,1,102271,97729
1:6:5,0,-1,102272,97728
6:4:5,0,-1,102273,97727
1:5:2,1,1,102272,97728
1:4:6,0,-1,102273,97727
5:2:3,1,1,102272,97728
5:5:4,0,-1,102273,97727
2:6:1,1,1,102272,97728
4:4:6,0,-1,102273,97727
6:4:1,0,-1,102274,97726
3:1:6,0,-1,102275,97725
6:6:4,0,-1,102276,97724
3:5:2,1,1,102275,97725
2:2:2,3,3,102272,97728
5:6:5,0,-1,102273,97727
5:5:4,0,-1,102274,97726
4:3:5,0,-1,102275,97725
6:2:4,1,1,102274,97726
6:3:3,0,-1,102275,97725
5:3:2,1,1,102274,97726
2:5:1,1,1,102273,97727
4:4:4,0,-1,102274,97726
4:6:6,0,-1,102275,97725
6:6:4,0,-1,102276,97724
3:3:4,0,-1,102277,97723
6:1:3,0,-1,102278,97722
5:6:4,0,-1,102279,97721
2:4:2,2,2,102277,97723
5:3:1,0,-1,102278,97722
4:4:2,1,1,102277,97723
1:3:1,0,-1,102278,97722
1:5:1,0,-1,102279,97721
5:5:1,0,-1,102280,97720
6:4:6,0,-1,102281,97719
1:3:2,1,1,102280,97720
6:2:6,1,1,102279,97721
1:2:6,1,1,102278,97722
5:6:4,0,-1,102279,97721
2:5:1,1,1,102278,97722
2:1:6,1,1,102277,97723
6:1:5,0,-1,102278,97722
5:1:6,0,-1,102279,97721
4:4:3,0,-1,102280,97720
1:1:4,0,-1,102281,97719
6:6:1,0,-1,102282,97718
5:4:1,0,-1,102283,97717
5:1:1,0,-1,102284,97716
3:4:6,0,-1,102285,97715
6:4:4,0,-1,102286,97714
6:4:5,0,-1,102287,97713
1:6:3,0,-1,102288,97712
4:5:2,1,1,102287,97713
6:3:6,0,-1,102288,97712
3:3:2,1,1,102287,97713
5:5:4,0,-1,102288,97712
5:1:6,0,-1,102289,97711
3:3:4,0,-1,102290,97710
5:4:5,0,-1,102291,97709
1:3:3,0,-1,102292,97708
1:4:2,1,1,102291,97709
5:5:3,0,-1,102292,97708
2:6:2,2,2,102290,97710
2:6:3,1,1,102289,97711
1:3:5,0,-1,102290,97710
6:6:4,0,-1,102291,97709
1:5:2,1,1,102290,97710
4:4:3,0,-1,102291,97709
3:3:5,0,-1,102292,97708
3:5:6,0,-1,102293,97707
3:3:2,1,1,102292,97708
5:1:5,0,-1,102293,97707
4:3:1,0,-1,102294,97706
4:6:2,1,1,102293,97707
4:6:5,0,-1,102294,97706
3:4:2,1,1,102293,97707
1:6:5,0,-1,102294,97706
3:4:6,0,-1,102295,97705
3:4:3,0,-1,102296,97704
5:4:4,0,-1,102297,97703
1:5:1,0,-1,102298,97702
1:5:1,0,-1,102299,97701
5:5:3,0,-1,102300,97700
1:4:1,0,-1,102301,97699
1:2:6,1,1,102300,97700
4:2:3,1,1,102299,97701
2:2:6,2,2,102297,97703
2:1:4,1,1,102296,97704
5:5:6,0,-1,102297,97703
2:1:6,1,1,102296,97704
2:6:5,1,1,102295,97705
6:3:4,0,-1,102296,97704
6:4:5,0,-1,102297,97703
6:2:5,1,1,102296,97704
2:5:5,1,1,102295,97705
5:6:2,1,1,102294,97706
4:3:1,0,-1,102295,97705
5:2:5,1,1,102294,97706
5:3:6,0,-1,102295,97705
3:5:3,0,-1,102296,97704
3:2:5,1,1,102295,97705
3:2:1,1,1,102294,97706
2:6:2,2,2,102292,97708
2:3:2,2,2,102290,97710
1:6:4,0,-1,102291,97709
2:2:3,2,2,102289,97711
3:4:1,0,-1,102290,97710
2:4:2,2,2,102288,97712
2:4:5,1,1,102287,97713
4:2:6,1,1,102286,97714
1:4:3,0,-1,102287,97713
2:1:2,2,2,102285,97715
2:5:3,1,1,102284,97716
5:4:4,0,-1,102285,97715
4:6:1,0,-1,102286,97714
3:4:5,0,-1,102287,97713
2:6:1,1,1,102286,97714
1:6:3,0,-1,102287,97713
3:6:2,1,1,102286,97714
2:5:3,1,1,102285,97715
5:6:2,1,1,102284,97716
6:2:1,1,1,102283,97717
4:5:1,0,-1,102284,97716
5:6:4,0,-1,102285,97715
3:1:3,0,-1,102286,97714
5:3:5,0,-1,102287,97713
3:3:4,0,-1,102288,97712
5:1:2,1,1,102287,97713
5:4:1,0,-1,102288,97712
3:6:5,0,-1,102289,97711
5:6:2,1,1,102288,97712
2:1:4,1,1,102287,97713
1:2:3,1,1,102286,97714
4:3:1,0,-1,102287,97713
6:3:5,0,-1,102288,97712
3:5:1,0,-1,102289,97711
5:2:4,1,1,102288,97712
3:1:6,0,-1,102289,97711
4:4:5,0,-1,102290,97710
6:5:2,1,1,102289,97711
4:2:3,1,1,102288,97712
3:3:1,0,-1,102289,97711
2:5:4,1,1,102288,97712
5:1:5,0,-1,102289,97711
1:5:3,0,-1,102290,97710
6:2:6,1,1,102289,97711
5:6:2,1,1,102288,97712
6:6:1,0,-1,102289,97711
3:1:1,0,-1,102290,97710
2:1:4,1,1,102289,97711
3:4:4,0,-1,102290,97710
3:5:1,0,-1,102291,97709
3:6:3,0,-1,102292,97708
6:6:1,0,-1,102293,97707
6:6:1,0,-1,102294,97706
4:3:1,0,-1,102295,97705
4:3:5,0,-1,102296,97704
1:1:1,0,-1,102297,97703
1:5:3,0,-1,102298,97702
2:3:1,1,1,102297,97703
4:5:3,0,-1,102298,97702
3:5:5,0,-1,102299,97701
6:5:2,1,1,102298,97702
5:5:2,1,1,102297,97703
2:2:4,2,2,102295,97705
1:3:2,1,1,102294,97706
2:3:2,2,2,102292,97708
3:3:6,0,-1,102293,97707
4:2:5,1,1,102292,97708
1:5:4,0,-1,102293,97707
5:6:2,1,1,102292,97708
2:5:1,1,1,102291,97709
6:2:2,2,2,102289,97711
1:1:3,0,-1,102290,97710
1:5:1,0,-1,102291,97709
2:3:4,1,1,102290,97710
4:1:5,0,-1,102291,97709
1:6:5,0,-1,102292,97708
4:5:5,0,-1,102293,97707
5:4:1,0,-1,102294,97706
6:6:1,0,-1,102295,97705
1:4:3,0,-1,102296,97704
3:2:2,2,2,102294,97706
4:6:2,1,1,102293,97707
4:6:1,0,-1,102294,97706
6:5:3,0,-1,102295,97705
5:5:2,1,1,102294,97706
6:5:3,0,-1,102295,97705
2:5:2,2,2,102293,97707
6:1:2,1,1,102292,97708
3:1:3,0,-1,102293,97707
2:6:3,1,1,102292,97708
1:6:5,0,-1,102293,97707
4:6:6,0,-1,102294,97706
2:6:4,1,1,102293,97707
1:4:5,0,-1,102294,97706
5:4:6,0,-1,102295,97705
3:1:5,0,-1,102296,97704
4:5:5,0,-1,102297,97703
4:1:1,0,-1,102298,97702
4:3:6,0,-1,102299,97701
6:5:6,0,-1,102300,97700
5:5:2,1,1,102299,97701
3:6:1,0,-1,102300,97700
3:3:5,0,-1,102301,97699
1:4:6,0,-1,102302,97698
5:5:6,0,-1,102303,97697
2:3:4,1,1,102302,97698
4:4:1,0,-1,102303,97697
4:5:4,0,-1,102304,97696
3:1:5,0,-1,102305,97695
6:5:2,1,1,102304,97696
6:3:6,0,-1,102305,97695
2:4:3,1,1,102304,97696
4:5:6,0,-1,102305,97695
5:2:3,1,1,102304,97696
1:3:1,0,-1,102305,97695
2:5:5,1,1,102304,97696
3:6:2,1,1,102303,97697
1:6:3,0,-1,102304,97696
2:1:4,1,1,102303,97697
1:3:5,0,-1,102304,97696
4:1:1,0,-1,102305,97695
1:3:4,0,-1,102306,97694
5:1:5,0,-1,102307,97693
3:2:2,2,2,102305,97695
2:4:5,1,1,102304,97696
5:6:6,0,-1,102305,97695
3:5:4,0,-1,102306,97694
6:6:1,0,-1,102307,97693
1:6:6,0,-1,102308,97692
1:4:5,0,-1,102309,97691
1:3:5,0,-1,102310,97690
3:5:2,1,1,102309,97691
3:6:1,0,-1,102310,97690
4:1:1,0,-1,102311,97689
5:1:6,0,-1,102312,97688
4:2:5,1,1,102311,97689
2:6:2,2,2,102309,97691
3:2:5,1,1,102308,97692
3:1:1,0,-1,102309,97691
2:4:1,1,1,102308,97692
4:3:2,1,1,102307,97693
4:5:5,0,-1,102308,97692
4:3:4,0,-1,102309,97691
2:6:4,1,1,102308,97692
2:3:5,1,1,102307,97693
3:3:5,0,-1,102308,97692
5:2:1,1,1,102307,97693
6:4:3,0,-1,102308,97692
3:5:4,0,-1,102309,97691
6:5:2,1,1,102308,97692
4:4:2,1,1,102307,97693
6:2:6,1,1,102306,97694
4:2:5,1,1,102305,97695
6:2:2,2,2,102303,97697
5:4:6,0,-1,102304,97696
5:5:5,0,-1,102305,97695
1:3:3,0,-1,102306,97694
6:1:1,0,-1,102307,97693
5:2:2,2,2,102305,97695
1:5:6,0,-1,102306,97694
4:3:1,0,-1,102307,97693
2:2:5,2,2,102305,97695
1:4:5,0,-1,102306,97694
3:6:3,0,-1,102307,97693
2:2:6,2,2,102305,97695
1:1:5,0,-1,102306,97694
4:4:5,0,-1,102307,97693
1:4:4,0,-1,102308,97692
1:2:3,1,1,102307,97693
6:1:3,0,-1,102308,97692
2:1:2,2,2,102306,97694
4:2:1,1,1,102305,97695
3:1:1,0,-1,102306,97694
2:5:2,2,2,102304,97696
1:1:1,0,-1,102305,97695
4:4:2,1,1,102304,97696
5:4:3,0,-1,102305,97695
2:5:2,2,2,102303,97697
1:3:6,0,-1,102304,97696
4:1:6,0,-1,102305,97695
5:3:1,0,-1,102306,97694
2:3:2,2,2,102304,97696
3:3:1,0,-1,102305,97695
6:3:4,0,-1,102306,97694
4:3:5,0,-1,102307,97693
5:3:1,0,-1,102308,97692
2:6:2,2,2,102306,97694
3:5:1,0,-1,102307,97693
5:1:4,0,-1,102308,97692
4:2:5,1,1,102307,97693
1:1:1,0,-1,102308,97692
5:3:3,0,-1,102309,97691
5:2:4,1,1,102308,97692
2:4:5,1,1,102307,97693
6:3:1,0,-1,102308,97692
6:4:6,0,-1,102309,97691
4:3:6,0,-1,102310,97690
6:2:6,1,1,102309,97691
6:6:6,0,-1,102310,97690
4:1:1,0,-1,102311,97689
3:1:4,0,-1,102312,97688
3:2:1,1,1,102311,97689
5:3:5,0,-1,102312,97688
6:2:5,1,1,102311,97689
5:1:5,0,-1,102312,97688
1:2:2,2,2,102310,97690
4:6:2,1,1,102309,97691
4:1:5,0,-1,102310,97690
6:5:2,1,1,102309,97691
6:2:6,1,1,102308,97692
6:4:6,0,-1,102309,97691
2:6:4,1,1,102308,97692
4:1:5,0,-1,102309,97691
6:6:5,0,-1,102310,97690
4:3:4,0,-1,102311,97689
5:4:6,0,-1,102312,97688
2:1:5,1,1,102311,97689
4:2:1,1,1,102310,97690
4:5:4,0,-1,102311,97689
3:5:3,0,-1,102312,97688
6:6:6,0,-1,102313,97687
6:5:6,0,-1,102314,97686
5:3:2,1,1,102313,97687
6:4:1,0,-1,102314,97686
6:5:6,0,-1,102315,97685
5:5:4,0,-1,102316,97684
5:4:2,1,1,102315,97685
1:6:1,0,-1,102316,97684
5:4:2,1,1,102315,97685
3:6:3,0,-1,102316,97684
4:6:5,0,-1,102317,97683
5:4:1,0,-1,102318,97682
2:3:3,1,1,102317,97683
4:4:3,0,-1,102318,97682
4:2:5,1,1,102317,97683
4:6:5,0,-1,102318,97682
1:4:3,0,-1,102319,97681
6:3:2,1,1,102318,97682
6:2:4,1,1,102317,97683
2:3:3,1,1,102316,97684
6:6:5,0,-1,102317,97683
2:3:3,1,1,102316,97684
3:2:3,1,1,102315,97685
5:6:4,0,-1,102316,97684
6:3:1,0,-1,102317,97683
6:6:2,1,1,102316,97684
2:5:3,1,1,102315,97685
6:5:4,0,-1,102316,97684
1:4:1,0,-1,102317,97683
2:1:3,1,1,102316,97684
2:3:4,1,1,102315,97685
1:6:5,0,-1,102316,97684
6:5:2,1,1,102315,97685
1:6:2,1,1,102314,97686
3:6:1,0,-1,102315,97685
5:3:3,0,-1,102316,97684
2:6:4,1,1,102315,97685
5:1:6,0,-1,102316,97684
4:1:2,1,1,102315,97685
5:1:4,0,-1,102316,97684
5:1:1,0,-1,102317,97683
6:5:6,0,-1,102318,97682
5:1:2,1,1,102317,97683
6:2:5,1,1,102316,97684
2:6:1,1,1,102315,97685
5:6:4,0,-1,102316,97684
1:1:4,0,-1,102317,97683
1:4:1,0,-1,102318,97682
5:6:3,0,-1,102319,97681
1:4:1,0,-1,102320,97680
1:5:3,0,-1,102321,97679
1:4:3,0,-1,102322,97678
6:6:6,0,-1,102323,97677
2:1:2,2,2,102321,97679
6:6:6,0,-1,102322,97678
5:1:6,0,-1,102323,97677
6:3:3,0,-1,102324,97676
1:3:5,0,-1,102325,97675
4:4:2,1,1,102324,97676
3:4:3,0,-1,102325,97675
6:6:5,0,-1,102326,97674
1:4:5,0,-1,102327,97673
4:3:6,0,-1,102328,97672
3:5:3,0,-1,102329,97671
1:4:4,0,-1,102330,97670
5:4:4,0,-1,102331,97669
4:4:2,1,1,102330,97670
2:1:1,1,1,102329,97671
3:2:1,1,1,102328,97672
4:6:6,0,-1,102329,97671
3:1:5,0,-1,102330,97670
3:2:4,1,1,102329,97671
6:2:6,1,1,102328,97672
5:1:6,0,-1,102329,97671
3:3:4,0,-1,102330,97670
6:6:1,0,-1,102331,97669
1:3:6,0,-1,102332,97668
1:5:5,0,-1,102333,97667
5:6:5,0,-1,102334,97666
1:5:5,0,-1,102335,97665
2:5:6,1,1,102334,97666
3:1:4,0,-1,102335,97665
1:6:5,0,-1,102336,97664
3:3:5,0,-1,102337,97663
1:1:5,0,-1,102338,97662
2:2:3,2,2,102336,97664
1:4:4,0,-1,102337,97663
1:3:5,0,-1,102338,97662
3:5:5,0,-1,102339,97661
3:3:5,0,-1,102340,97660
3:1:5,0,-1,102341,97659
1:6:1,0,-1,102342,97658
4:2:2,2,2,102340,97660
6:5:5,0,-1,102341,97659
3:2:1,1,1,102340,97660
4:6:5,0,-1,102341,97659
4:5:3,0,-1,102342,97658
4:4:4,0,-1,102343,97657
5:2:5,1,1,102342,97658
5:5:3,0,-1,102343,97657
3:4:5,0,-1,102344,97656
5:4:1,0,-1,102345,97655
5:3:4,0,-1,102346,97654
4:2:6,1,1,102345,97655
5:6:3,0,-1,102346,97654
5:2:5,1,1,102345,97655
1:4:6,0,-1,102346,97654
5:5:6,0,-1,102347,97653
6:1:4,0,-1,102348,97652
5:5:2,1,1,102347,97653
3:2:4,1,1,102346,97654
5:4:3,0,-1,102347,97653
1:5:3,0,-1,102348,97652
3:1:2,1,1,102347,97653
2:2:6,2,2,102345,97655
5:1:3,0,-1,102346,97654
4:1:3,0,-1,102347,97653
4:4:2,1,1,102346,97654
3:2:1,1,1,102345,97655
2:2:1,2,2,102343,97657
2:3:6,1,1,102342,97658
4:5:6,0,-1,102343,97657
1:6:5,0,-1,102344,97656
1:1:1,0,-1,102345,97655
1:3:1,0,-1,102346,97654
3:5:1,0,-1,102347,97653
1:6:3,0,-1,102348,97652
2:6:5,1,1,102347,97653
3:3:1,0,-1,102348,97652
5:5:2,1,1,102347,97653
1:1:6,0,-1,102348,97652
5:3:3,0,-1,102349,97651
5:6:3,0,-1,102350,97650
4:4:3,0,-1,102351,97649
4:5:6,0,-1,102352,97648
4:3:5,0,-1,102353,97647
3:1:6,0,-1,102354,97646
2:3:2,2,2,102352,97648
4:5:1,0,-1,102353,97647
1:5:5,0,-1,102354,97646
2:5:5,1,1,102353,97647
5:4:3,0,-1,102354,97646
1:5:4,0,-1,102355,97645
5:5:3,0,-1,102356,97644
6:1:2,1,1,102355,97645
4:1:1,0,-1,102356,97644
2:5:6,1,1,102355,97645
6:4:5,0,-1,102356,97644
5:6:3,0,-1,102357,97643
2:5:5,1,1,102356,97644
6:1:3,0,-1,102357,97643
6:1:3,0,-1,102358,97642
2:5:6,1,1,102357,97643
1:5:1,0,-1,102358,97642
6:1:1,0,-1,102359,97641
6:4:1,0,-1,102360,97640
2:5:5,1,1,102359,97641
2:2:3,2,2,102357,97643
6:4:3,0,-1,102358,97642
2:3:2,2,2,102356,97644
6:4:6,0,-1,102357,97643
2:5:4,1,1,102356,97644
3:3:3,0,-1,102357,97643
1:6:4,0,-1,102358,97642
6:6:5,0,-1,102359,97641
5:1:3,0,-1,102360,97640
6:5:4,0,-1,102361,97639
2:6:6,1,1,102360,97640
5:3:5,0,-1,102361,97639
2:3:5,1,1,102360,97640
3:1:2,1,1,102359,97641
6:4:6,0,-1,102360,97640
5:4:2,1,1,102359,97641
5:1:2,1,1,102358,97642
5:4:6,0,-1,102359,97641
6:1:5,0,-1,102360,97640
4:5:1,0,-1,102361,97639
5:6:5,0,-1,102362,97638
5:4:5,0,-1,102363,97637
2:2:2,3,3,102360,97640
2:4:2,2,2,102358,97642
1:3:3,0,-1,102359,97641
1:5:5,0,-1,102360,97640
3:3:2,1,1,102359,97641
1:3:1,0,-1,102360,97640
4:6:3,0,-1,102361,97639
3:3:2,1,1,102360,97640
2:4:6,1,1,102359,97641
3:6:2,1,1,102358,97642
3:5:1,0,-1,102359,97641
1:2:2,2,2,102357,97643
2:6:4,1,1,102356,97644
4:6:2,1,1,102355,97645
2:1:2,2,2,102353,97647
1:2:6,1,1,102352,97648
3:3:1,0,-1,102353,97647
3:2:5,1,1,102352,97648
3:2:2,2,2,102350,97650
5:4:5,0,-1,102351,97649
3:6:5,0,-1,102352,97648
1:3:2,1,1,102351,97649
4:5:3,0,-1,102352,97648
6:1:1,0,-1,102353,97647
5:2:2,2,2,102351,97649
4:5:6,0,-1,102352,97648
3:3:4,0,-1,102353,97647
3:5:1,0,-1,102354,97646
4:5:6,0,-1,102355,97645
5:6:3,0,-1,102356,97644
1:6:4,0,-1,102357,97643
2:4:6,1,1,102356,97644
5:3:2,1,1,102355,97645
2:2:6,2,2,102353,97647
1:2:5,1,1,102352,97648
3:2:5,1,1,102351,97649
3:4:3,0,-1,102352,97648
2:3:2,2,2,102350,97650
3:3:6,0,-1,102351,97649
5:5:4,0,-1,102352,97648
2:6:6,1,1,102351,97649
3:3:3,0,-1,102352,97648
5:2:1,1,1,102351,97649
5:3:4,0,-1,102352,97648
3:5:3,0,-1,102353,97647
4:5:5,0,-1,102354,97646
4:6:6,0,-1,102355,97645
2:6:1,1,1,102354,97646
1:3:3,0,-1,102355,97645
4:4:2,1,1,102354,97646
5:3:2,1,1,102353,97647
3:1:5,0,-1,102354,97646
5:1:1,0,-1,102355,97645
3:2:6,1,1,102354,97646
6:3:3,0,-1,102355,97645
4:2:1,1,1,102354,97646
2:6:1,1,1,102353,97647
3:6:4,0,-1,102354,97646
2:5:6,1,1,102353,97647
6:5:4,0,-1,102354,97646
6:2:2,2,2,102352,97648
2:6:2,2,2,102350,97650
5:3:2,1,1,102349,97651
4:5:1,0,-1,102350,97650
3:5:4,0,-1,102351,97649
6:2:3,1,1,102350,97650
6:6:4,0,-1,102351,97649
6:6:2,1,1,102350,97650
6:4:2,1,1,102349,97651
6:5:2,1,1,102348,97652
5:5:1,0,-1,102349,97651
6:1:6,0,-1,102350,97650
5:1:4,0,-1,102351,97649
5:5:4,0,-1,102352,97648
6:3:3,0,-1,102353,97647
2:2:4,2,2,102351,97649
6:2:1,1,1,102350,97650
2:3:4,1,1,102349,97651
3:3:1,0,-1,102350,97650
6:1:5,0,-1,102351,97649
6:5:1,0,-1,102352,97648
6:3:5,0,-1,102353,97647
5:3:2,1,1,102352,97648
5:6:5,0,-1,102353,97647
1:1:1,0,-1,102354,97646
6:2:4,1,1,102353,97647
4:6:1,0,-1,102354,97646
2:1:2,2,2,102352,97648
2:4:4,1,1,102351,97649
5:5:6,0,-1,102352,97648
6:1:1,0,-1,102353,97647
2:6:2,2,2,102351,97649
6:6:2,1,1,102350,97650
4:2:5,1,1,102349,97651
4:5:1,0,-1,102350,97650
6:1:1,0,-1,102351,97649
2:3:4,1,1,102350,97650
1:6:6,0,-1,102351,97649
1:6:1,0,-1,102352,97648
1:3:4,0,-1,102353,97647
4:5:4,0,-1,102354,97646
5:2:5,1,1,102353,97647
6:4:2,1,1,102352,97648
6:4:6,0,-1,102353,97647
1:2:6,1,1,102352,97648
2:4:5,1,1,102351,97649
5:6:3,0,-1,102352,97648
2:3:1,1,1,102351,97649
4:3:5,0,-1,102352,97648
5:4:3,0,-1,102353,97647
2:6:1,1,1,102352,97648
3:2:4,1,1,102351,97649
6:6:6,0,-1,102352,97648
3:2:6,1,1,102351,97649
3:4:4,0,-1,102352,97648
3:5:5,0,-1,102353,97647
4:4:2,1,1,102352,97648
4:4:5,0,-1,102353,97647
2:6:2,2,2,102351,97649
6:2:3,1,1,102350,97650
3:4:1,0,-1,102351,97649
2:3:4,1,1,102350,97650
1:3:2,1,1,102349,97651
1:5:6,0,-1,102350,97650
4:2:4,1,1,102349,97651
1:2:2,2,2,102347,97653
3:6:4,0,-1,102348,97652
5:2:5,1,1,102347,97653
5:3:4,0,-1,102348,97652
5:3:1,0,-1,102349,97651
3:3:6,0,-1,102350,97650
4:2:6,1,1,102349,97651
6:1:6,0,-1,102350,97650
2:5:4,1,1,102349,97651
6:2:6,1,1,102348,97652
5:4:1,0,-1,102349,97651
6:1:4,0,-1,102350,97650
1:4:4,0,-1,102351,97649
3:4:3,0,-1,102352,97648
3:3:5,0,-1,102353,97647
4:5:5,0,-1,102354,97646
1:2:5,1,1,102353,97647
5:4:4,0,-1,102354,97646
6:1:4,0,-1,102355,97645
4:2:1,1,1,102354,97646
4:3:1,0,-1,102355,97645
1:1:2,1,1,102354,97646
4:5:1,0,-1,102355,97645
2:4:5,1,1,102354,97646
5:5:2,1,1,102353,97647
1:1:2,1,1,102352,97648
3:6:1,0,-1,102353,97647
4:3:6,0,-1,102354,97646
2:4:2,2,2,102352,97648
6:1:4,0,-1,102353,97647
3:6:5,0,-1,102354,97646
4:6:3,0,-1,102355,97645
5:6:5,0,-1,102356,97644
1:2:1,1,1,102355,97645
2:6:6,1,1,102354,97646
2:3:2,2,2,102352,97648
6:6:3,0,-1,102353,97647
4:1:5,0,-1,102354,97646
6:2:5,1,1,102353,97647
4:1:6,0,-1,102354,97646
2:3:6,1,1,102353,97647
4:1:1,0,-1,102354,97646
5:4:3,0,-1,102355,97645
4:6:4,0,-1,102356,97644
1:2:6,1,1,102355,97645
4:5:5,0,-1,102356,97644
6:4:3,0,-1,102357,97643
1:5:5,0,-1,102358,97642
6:2:3,1,1,102357,97643
4:2:1,1,1,102356,97644
6:6:1,0,-1,102357,97643
5:1:6,0,-1,102358,97642
3:1:3,0,-1,102359,97641
6:6:3,0,-1,102360,97640
3:3:1,0,-1,102361,97639
1:3:6,0,-1,102362,97638
2:3:6,1,1,102361,97639
5:4:3,0,-1,102362,97638
2:6:4,1,1,102361,97639
1:5:3,0,-1,102362,97638
3:6:3,0,-1,102363,97637
4:5:2,1,1,102362,97638
5:4:5,0,-1,102363,97637
4:1:5,0,-1,102364,97636
4:5:4,0,-1,102365,97635
3:2:3,1,1,102364,97636
4:5:4,0,-1,102365,97635
3:2:3,1,1,102364,97636
5:4:3,0,-1,102365,97635
1:6:1,0,-1,102366,97634
5:4:6,0,-1,102367,97633
5:6:3,0,-1,102368,97632
3:6:6,0,-1,102369,97631
4:3:2,1,1,102368,97632
3:4:5,0,-1,102369,97631
6:5:2,1,1,102368,97632
1:6:1,0,-1,102369,97631
4:2:4,1,1,102368,97632
5:1:4,0,-1,102369,97631
5:3:6,0,-1,102370,97630
6:1:2,1,1,102369,97631
6:1:6,0,-1,102370,97630
6:2:2,2,2,102368,97632
2:5:1,1,1,102367,97633
2:5:6,1,1,102366,97634
5:2:1,1,1,102365,97635
3:1:3,0,-1,102366,97634
2:5:3,1,1,102365,97635
6:5:3,0,-1,102366,97634
6:5:1,0,-1,102367,97633
1:5:4,0,-1,102368,97632
3:2:5,1,1,102367,97633
1:3:4,0,-1,102368,97632
2:6:3,1,1,102367,97633
3:4:5,0,-1,102368,97632
3:6:2,1,1,102367,97633
5:2:5,1,1,102366,97634
3:2:6,1,1,102365,97635
6:6:3,0,-1,102366,97634
5:2:3,1,1,102365,97635
5:4:2,1,1,102364,97636
3:2:1,1,1,102363,97637
5:5:4,0,-1,102364,97636
6:4:2,1,1,102363,97637
2:2:6,2,2,102361,97639
4:1:3,0,-1,102362,97638
4:3:5,0,-1,102363,97637
6:5:5,0,-1,102364,97636
1:2:1,1,1,102363,97637
6:2:6,1,1,102362,97638
5:3:4,0,-1,102363,97637
1:1:3,0,-1,102364,97636
4:1:5,0,-1,102365,97635
6:3:5,0,-1,102366,97634
4:3:2,1,1,102365,97635
3:4:1,0,-1,102366,97634
4:2:4,1,1,102365,97635
3:3:1,0,-1,102366,97634
5:1:2,1,1,102365,97635
2:5:5,1,1,102364,97636
1:1:1,0,-1,102365,97635
3:1:1,0,-1,102366,97634
6:4:3,0,-1,102367,97633
2:1:5,1,1,102366,97634
4:3:4,0,-1,102367,97633
4:5:2,1,1,102366,97634
4:6:6,0,-1,102367,97633
2:1:6,1,1,102366,97634
1:3:6,0,-1,102367,97633
2:6:2,2,2,102365,97635
1:4:3,0,-1,102366,97634
4:1:1,0,-1,102367,97633
1:1:4,0,-1,102368,97632
4:4:5,0,-1,102369,97631
5:2:1,1,1,102368,97632
3:6:3,0,-1,102369,97631
6:4:6,0,-1,102370,97630
2:1:6,1,1,102369,97631
3:6:3,0,-1,102370,97630
3:6:3,0,-1,102371,97629
3:4:5,0,-1,102372,97628
1:3:5,0,-1,102373,97627
6:4:5,0,-1,102374,97626
2:2:3,2,2,102372,97628
5:1:5,0,-1,102373,97627
1:2:4,1,1,102372,97628
5:4:5,0,-1,102373,97627
4:1:4,0,-1,102374,97626
3:5:2,1,1,102373,97627
2:6:1,1,1,102372,97628
2:4:4,1,1,102371,97629
6:3:3,0,-1,102372,97628
2:2:5,2,2,102370,97630
6:3:3,0,-1,102371,97629
4:4:4,0,-1,102372,97628
1:3:5,0,-1,102373,97627
3:2:5,1,1,102372,97628
6:6:3,0,-1,102373,97627
4:3:1,0,-1,102374,97626
4:4:1,0,-1,102375,97625
1:3:4,0,-1,102376,97624
5:1:6,0,-1,102377,97623
3:2:3,1,1,102376,97624
4:2:3,1,1,102375,97625
4:1:3,0,-1,102376,97624
3:2:6,1,1,102375,97625
3:5:3,0,-1,102376,97624
1:5:1,0,-1,102377,97623
5:1:2,1,1,102376,97624
3:5:2,1,1,102375,97625
5:1:6,0,-1,102376,97624
1:6:3,0,-1,102377,97623
3:2:1,1,1,102376,97624
6:3:6,0,-1,102377,97623
5:2:4,1,1,102376,97624
4:4:6,0,-1,102377,97623
6:5:1,0,-1,102378,97622
5:6:5,0,-1,102379,97621
1:6:6,0,-1,102380,97620
5:2:1,1,1,102379,97621
2:5:2,2,2,102377,97623
2:3:6,1,1,102376,97624
3:5:2,1,1,102375,97625
3:3:3,0,-1,102376,97624
6:1:3,0,-1,102377,97623
2:1:3,1,1,102376,97624
5:2:2,2,2,102374,97626
4:1:3,0,-1,102375,97625
2:2:6,2,2,102373,97627
3:3:6,0,-1,102374,97626
6:6:3,0,-1,102375,97625
6:2:5,1,1,102374,97626
4:2:4,1,1,102373,97627
2:4:1,1,1,102372,97628
6:5:5,0,-1,102373,97627
2:2:4,2,2,102371,97629
4:3:5,0,-1,102372,97628
2:5:5,1,1,102371,97629
6:5:2,1,1,102370,97630
6:1:3,0,-1,102371,97629
1:2:1,1,1,102370,97630
6:6:5,0,-1,102371,97629
4:5:5,0,-1,102372,97628
2:5:6,1,1,102371,97629
1:4:4,0,-1,102372,97628
1:6:4,0,-1,102373,97627
5:6:2,1,1,102372,97628
2:6:5,1,1,102371,97629
4:5:5,0,-1,102372,97628
4:4:6,0,-1,102373,97627
6:2:6,1,1,102372,97628
1:5:4,0,-1,102373,97627
4:6:4,0,-1,102374,97626
2:1:3,1,1,102373,97627
5:5:2,1,1,102372,97628
5:4:4,0,-1,102373,97627
3:4:3,0,-1,102374,97626
2:1:6,1,1,102373,97627
2:5:6,1,1,102372,97628
5:1:2,1,1,102371,97629
3:4:1,0,-1,102372,97628
1:6:6,0,-1,102373,97627
4:1:1,0,-1,102374,97626
1:5:6,0,-1,102375,97625
2:1:5,1,1,102374,97626
3:2:6,1,1,102373,97627
5:6:1,0,-1,102374,97626
4:5:1,0,-1,102375,97625
2:4:5,1,1,102374,97626
5:6:6,0,-1,102375,97625
3:1:2,1,1,102374,97626
6:3:5,0,-1,102375,97625
5:5:1,0,-1,102376,97624
6:3:3,0,-1,102377,97623
6:6:3,0,-1,102378,97622
1:5:4,0,-1,102379,97621
1:6:1,0,-1,102380,97620
6:1:2,1,1,102379,97621
2:1:6,1,1,102378,97622
4:4:5,0,-1,102379,97621
3:5:6,0,-1,102380,97620
3:2:6,1,1,102379,97621
1:6:4,0,-1,102380,97620
1:2:2,2,2,102378,97622
6:2:1,1,1,102377,97623
5:6:5,0,-1,102378,97622
2:3:3,1,1,102377,97623
6:6:3,0,-1,102378,97622
5:5:6,0,-1,102379,97621
6:2:2,2,2,102377,97623
1:3:2,1,1,102376,97624
3:1:3,0,-1,102377,97623
5:2:3,1,1,102376,97624
2:6:5,1,1,102375,97625
5:6:1,0,-1,102376,97624
3:5:5,0,-1,102377,97623
6:4:6,0,-1,102378,97622
1:3:6,0,-1,102379,97621
5:4:1,0,-1,102380,97620
5:5:3,0,-1,102381,97619
5:6:1,0,-1,102382,97618
6:5:2,1,1,102381,97619
1:6:2,1,1,102380,97620
5:6:5,0,-1,102381,97619
3:3:6,0,-1,102382,97618
4:2:5,1,1,102381,97619
6:5:5,0,-1,102382,97618
5:3:3,0,-1,102383,97617
2:6:2,2,2,102381,97619
6:6:6,0,-1,102382,97618
5:5:1,0,-1,102383,97617
5:3:5,0,-1,102384,97616
1:4:5,0,-1,102385,97615
2:3:1,1,1,102384,97616
1:1:1,0,-1,102385,97615
5:5:6,0,-1,102386,97614
6:4:4,0,-1,102387,97613
2:1:3,1,1,102386,97614
4:3:1,0,-1,102387,97613
6:1:4,0,-1,102388,97612
2:6:3,1,1,102387,97613
3:5:1,0,-1,102388,97612
5:2:1,1,1,102387,97613
5:6:3,0,-1,102388,97612
4:4:6,0,-1,102389,97611
1:3:6,0,-1,102390,97610
2:1:5,1,1,102389,97611
4:5:6,0,-1,102390,97610
2:3:6,1,1,102389,97611
5:4:1,0,-1,102390,97610
6:3:6,0,-1,102391,97609
2:1:1,1,1,102390,97610
3:4:4,0,-1,102391,97609
4:4:5,0,-1,102392,97608
5:5:5,0,-1,102393,97607
1:2:2,2,2,102391,97609
2:6:4,1,1,102390,97610
2:6:1,1,1,102389,97611
2:5:6,1,1,102388,97612
4:2:6,1,1,102387,97613
2:4:1,1,1,102386,97614
1:3:3,0,-1,102387,97613
2:6:1,1,1,102386,97614
6:2:3,1,1,102385,97615
4:6:3,0,-1,102386,97614
4:5:1,0,-1,102387,97613
3:4:5,0,-1,102388,97612
4:3:1,0,-1,102389,97611
4:1:2,1,1,102388,97612
6:3:6,0,-1,102389,97611
6:4:2,1,1,102388,97612
2:4:4,1,1,102387,97613
6:3:1,0,-1,102388,97612
1:2:6,1,1,102387,97613
5:1:3,0,-1,102388,97612
5:4:2,1,1,102387,97613
4:5:1,0,-1,102388,97612
3:6:1,0,-1,102389,97611
3:2:2,2,2,102387,97613
5:1:6,0,-1,102388,97612
5:1:3,0,-1,102389,97611
3:5:2,1,1,102388,97612
2:5:3,1,1,102387,97613
3:2:3,1,1,102386,97614
1:3:1,0,-1,102387,97613
5:4:3,0,-1,102388,97612
1:3:6,0,-1,102389,97611
6:6:4,0,-1,102390,97610
4:3:2,1,1,102389,97611
6:1:3,0,-1,102390,97610
3:6:1,0,-1,102391,97609
2:3:1,1,1,102390,97610
3:3:6,0,-1,102391,97609
1:5:1,0,-1,102392,97608
5:1:3,0,-1,102393,97607
3:1:4,0,-1,102394,97606
6:4:3,0,-1,102395,97605
5:1:3,0,-1,102396,97604
6:5:5,0,-1,102397,97603
5:1:3,0,-1,102398,97602
3:1:1,0,-1,102399,97601
4:4:4,0,-1,102400,97600
4:1:6,0,-1,102401,97599
1:5:6,0,-1,102402,97598
5:2:5,1,1,102401,97599
5:4:4,0,-1,102402,97598
2:3:1,1,1,102401,97599
2:4:5,1,1,102400,97600
2:1:5,1,1,102399,97601
5:4:1,0,-1,102400,97600
5:2:4,1,1,102399,97601
1:6:6,0,-1,102400,97600
5:2:3,1,1,102399,97601
5:3:1,0,-1,102400,97600
5:1:2,1,1,102399,97601
1:5:4,0,-1,102400,97600
4:4:4,0,-1,102401,97599
6:2:3,1,1,102400,97600
4:3:3,0,-1,102401,97599
1:6:3,0,-1,102402,97598
3:4:1,0,-1,102403,97597
5:4:5,0,-1,102404,97596
2:4:4,1,1,102403,97597
6:6:3,0,-1,102404,97596
3:5:4,0,-1,102405,97595
1:2:4,1,1,102404,97596
3:3:1,0,-1,102405,97595
4:3:1,0,-1,102406,97594
3:6:2,1,1,102405,97595
1:6:3,0,-1,102406,97594
1:3:5,0,-1,102407,97593
2:1:3,1,1,102406,97594
1:6:4,0,-1,102407,97593
2:1:2,2,2,102405,97595
5:6:5,0,-1,102406,97594
6:6:2,1,1,102405,97595
1:1:6,0,-1,102406,97594
2:4:2,2,2,102404,97596
1:4:5,0,-1,102405,97595
3:5:2,1,1,102404,97596
4:4:2,1,1,102403,97597
3:3:6,0,-1,102404,97596
4:2:5,1,1,102403,97597
5:6:1,0,-1,102404,97596
1:5:6,0,-1,102405,97595
4:3:6,0,-1,102406,97594
1:3:1,0,-1,102407,97593
5:1:4,0,-1,102408,97592
6:1:6,0,-1,102409,97591
2:3:4,1,1,102408,97592
6:2:1,1,1,102407,97593
5:6:5,0,-1,102408,97592
4:5:1,0,-1,102409,97591
5:4:4,0,-1,102410,97590
6:6:2,1,1,102409,97591
5:3:6,0,-1,102410,97590
1:3:6,0,-1,102411,97589
5:5:4,0,-1,102412,97588
2:5:1,1,1,102411,97589
5:5:4,0,-1,102412,97588
3:3:5,0,-1,102413,97587
3:2:2,2,2,102411,97589
3:3:4,0,-1,102412,97588
5:2:3,1,1,102411,97589
3:4:1,0,-1,102412,97588
5:4:6,0,-1,102413,97587
3:2:4,1,1,102412,97588
3:1:2,1,1,102411,97589
4:1:2,1,1,102410,97590
2:1:3,1,1,102409,97591
2:3:2,2,2,102407,97593
2:3:6,1,1,102406,97594
6:1:5,0,-1,102407,97593
4:1:1,0,-1,102408,97592
5:6:6,0,-1,102409,97591
4:2:5,1,1,102408,97592
6:4:4,0,-1,102409,97591
2:1:3,1,1,102408,97592
3:6:5,0,-1,102409,97591
4:1:5,0,-1,102410,97590
4:2:1,1,1,102409,97591
5:5:1,0,-1,102410,97590
5:4:1,0,-1,102411,97589
4:6:4,0,-1,102412,97588
1:5:1,0,-1,102413,97587
3:6:4,0,-1,102414,97586
6:1:2,1,1,102413,97587
3:2:6,1,1,102412,97588
6:6:3,0,-1,102413,97587
5:3:5,0,-1,102414,97586
4:2:5,1,1,102413,97587
4:1:2,1,1,102412,97588
6:4:6,0,-1,102413,97587
6:1:1,0,-1,102414,97586
6:5:6,0,-1,102415,97585
1:3:3,0,-1,102416,97584
2:5:1,1,1,102415,97585
1:6:6,0,-1,102416,97584
6:4:3,0,-1,102417,97583
6:1:5,0,-1,102418,97582
4:6:1,0,-1,102419,97581
6:6:4,0,-1,102420,97580
6:6:2,1,1,102419,97581
2:2:4,2,2,102417,97583
6:4:5,0,-1,102418,97582
3:5:6,0,-1,102419,97581
2:1:6,1,1,102418,97582
1:2:1,1,1,102417,97583
1:4:6,0,-1,102418,97582
4:5:3,0,-1,102419,97581
1:1:3,0,-1,102420,97580
5:2:4,1,1,102419,97581
2:2:2,3,3,102416,97584
4:6:2,1,1,102415,97585
2:2:4,2,2,102413,97587
5:4:5,0,-1,102414,97586
3:5:5,0,-1,102415,97585
1:6:4,0,-1,102416,97584
1:5:5,0,-1,102417,97583
4:1:5,0,-1,102418,97582
4:4:5,0,-1,102419,97581
5:4:4,0,-1,102420,97580
2:2:3,2,2,102418,97582
5:2:1,1,1,102417,97583
1:2:4,1,1,102416,97584
5:5:5,0,-1,102417,97583
1:2:5,1,1,102416,97584
4:6:6,0,-1,102417,97583
4:5:2,1,1,102416,97584
5:2:5,1,1,102415,97585
2:3:6,1,1,102414,97586
3:3:1,0,-1,102415,97585
1:1:6,0,-1,102416,97584
3:3:6,0,-1,102417,97583
1:2:2,2,2,102415,97585
4:5:5,0,-1,102416,97584
3:3:5,0,-1,102417,97583
1:4:1,0,-1,102418,97582
4:2:1,1,1,102417,97583
4:2:1,1,1,102416,97584
3:6:3,0,-1,102417,97583
3:6:5,0,-1,102418,97582
1:4:4,0,-1,102419,97581
2:3:3,1,1,102418,97582
3:2:5,1,1,102417,97583
3:6:5,0,-1,102418,97582
2:1:4,1,1,102417,97583
5:4:3,0,-1,102418,97582
5:2:5,1,1,102417,97583
4:6:4,0,-1,102418,97582
5:2:2,2,2,102416,97584
4:3:2,1,1,102415,97585
3:5:2,1,1,102414,97586
2:1:3,1,1,102413,97587
5:4:4,0,-1,102414,97586
1:6:4,0,-1,102415,97585
6:4:5,0,-1,102416,97584
5:1:6,0,-1,102417,97583
6:3:5,0,-1,102418,97582
2:4:4,1,1,102417,97583
5:3:5,0,-1,102418,97582
3:5:4,0,-1,102419,97581
4:5:5,0,-1,102420,97580
4:1:1,0,-1,102421,97579
1:4:2,1,1,102420,97580
5:4:2,1,1,102419,97581
4:2:4,1,1,102418,97582
1:5:1,0,-1,102419,97581
6:5:1,0,-1,102420,97580
3:4:3,0,-1,102421,97579
1:6:2,1,1,102420,97580
5:6:3,0,-1,102421,97579
5:6:3,0,-1,102422,97578
1:4:4,0,-1,102423,97577
3:5:2,1,1,102422,97578
1:6:6,0,-1,102423,97577
2:4:5,1,1,102422,97578
2:1:2,2,2,102420,97580
6:3:1,0,-1,102421,97579
6:6:6,0,-1,102422,97578
3:4:4,0,-1,102423,97577
6:5:6,0,-1,102424,97576
4:1:6,0,-1,102425,97575
5:6:6,0,-1,102426,97574
1:6:5,0,-1,102427,97573
3:1:4,0,-1,102428,97572
1:3:1,0,-1,102429,97571
4:6:1,0,-1,102430,97570
2:1:2,2,2,102428,97572
5:6:5,0,-1,102429,97571
4:1:5,0,-1,102430,97570
5:3:1,0,-1,102431,97569
3:2:2,2,2,102429,97571
3:1:4,0,-1,102430,97570
6:5:3,0,-1,102431,97569
6:2:5,1,1,102430,97570
1:2:4,1,1,102429,97571
1:6:3,0,-1,102430,97570
1:3:4,0,-1,102431,97569
1:2:3,1,1,102430,97570
2:1:3,1,1,102429,97571
5:3:2,1,1,102428,97572
5:2:3,1,1,102427,97573
6:5:3,0,-1,102428,97572
6:5:3,0,-1,102429,97571
3:1:1,0,-1,102430,97570
4:5:1,0,-1,102431,97569
1:1:5,0,-1,102432,97568
3:3:2,1,1,102431,97569
3:3:3,0,-1,102432,97568
3:2:1,1,1,102431,97569
4:6:5,0,-1,102432,97568
5:5:6,0,-1,102433,97567
3:4:6,0,-1,102434,97566
2:5:5,1,1,102433,97567
1:2:2,2,2,102431,97569
6:3:2,1,1,102430,97570
5:6:3,0,-1,102431,97569
4:2:4,1,1,102430,97570
6:1:1,0,-1,102431,97569
6:4:6,0,-1,102432,97568
2:5:1,1,1,102431,97569
4:3:1,0,-1,102432,97568
3:6:4,0,-1,102433,97567
3:5:3,0,-1,102434,97566
4:6:2,1,1,102433,97567
4:5:3,0,-1,102434,97566
5:6:1,0,-1,102435,97565
1:4:6,0,-1,102436,97564
4:5:5,0,-1,102437,97563
3:1:1,0,-1,102438,97562
6:2:2,2,2,102436,97564
3:4:4,0,-1,102437,97563
5:1:2,1,1,102436,97564
6:1:3,0,-1,102437,97563
5:4:5,0,-1,102438,97562
3:4:2,1,1,102437,97563
3:5:6,0,-1,102438,97562
5:4:2,1,1,102437,97563
1:2:5,1,1,102436,97564
3:3:4,0,-1,102437,97563
5:1:3,0,-1,102438,97562
3:2:1,1,1,102437,97563
6:3:6,0,-1,102438,97562
3:4:1,0,-1,102439,97561
5:6:4,0,-1,102440,97560
5:3:1,0,-1,102441,97559
1:4:5,0,-1,102442,97558
4:5:3,0,-1,102443,97557
3:6:1,0,-1,102444,97556
3:4:2,1,1,102443,97557
6:6:1,0,-1,102444,97556
2:4:1,1,1,102443,97557
1:4:4,0,-1,102444,97556
4:5:2,1,1,102443,97557
1:1:6,0,-1,102444,97556
3:3:4,0,-1,102445,97555
3:5:3,0,-1,102446,97554
4:6:1,0,-1,102447,97553
2:3:6,1,1,102446,97554
5:4:4,0,-1,102447,97553
6:2:1,1,1,102446,97554
6:5:2,1,1,102445,97555
6:5:1,0,-1,102446,97554
3:6:1,0,-1,102447,97553
5:2:3,1,1,102446,97554
6:6:6,0,-1,102447,97553
3:6:2,1,1,102446,97554
2:3:2,2,2,102444,97556
1:1:3,0,-1,102445,97555
4:1:6,0,-1,102446,97554
2:3:2,2,2,102444,97556
5:5:6,0,-1,102445,97555
6:5:2,1,1,102444,97556
5:5:4,0,-1,102445,97555
6:1:5,0,-1,102446,97554
5:1:4,0,-1,102447,97553
4:6:2,1,1,102446,97554
4:4:2,1,1,102445,97555
4:4:6,0,-1,102446,97554
5:1:5,0,-1,102447,97553
1:3:2,1,1,102446,97554
4:1:1,0,-1,102447,97553
3:3:6,0,-1,102448,97552
6:4:3,0,-1,102449,97551
3:3:2,1,1,102448,97552
5:6:2,1,1,102447,97553
6:5:5,0,-1,102448,97552
2:5:3,1,1,102447,97553
3:3:5,0,-1,102448,97552
2:3:4,1,1,102447,97553
1:4:4,0,-1,102448,97552
2:1:3,1,1,102447,97553
6:6:1,0,-1,102448,97552
2:1:6,1,1,102447,97553
4:6:3,0,-1,102448,97552
2:6:4,1,1,102447,97553
3:5:6,0,-1,102448,97552
4:4:1,0,-1,102449,97551
4:3:1,0,-1,102450,97550
3:6:2,1,1,102449,97551
5:3:2,1,1,102448,97552
2:2:1,2,2,102446,97554
2:4:1,1,1,102445,97555
2:6:6,1,1,102444,97556
3:5:5,0,-1,102445,97555
6:4:2,1,1,102444,97556
3:2:1,1,1,102443,97557
6:3:4,0,-1,102444,97556
4:5:1,0,-1,102445,97555
4:1:5,0,-1,102446,97554
6:2:5,1,1,102445,97555
1:1:6,0,-1,102446,97554
2:2:6,2,2,102444,97556
3:4:1,0,-1,102445,97555
1:6:2,1,1,102444,97556
5:1:3,0,-1,102445,97555
4:2:4,1,1,102444,97556
6:4:6,0,-1,102445,97555
3:2:5,1,1,102444,97556
6:3:5,0,-1,102445,97555
6:4:1,0,-1,102446,97554
6:3:1,0,-1,102447,97553
2:6:5,1,1,102446,97554
5:2:2,2,2,102444,97556
3:4:1,0,-1,102445,97555
6:5:5,0,-1,102446,97554
3:4:1,0,-1,102447,97553
1:6:5,0,-1,102448,97552
5:5:6,0,-1,102449,97551
5:4:1,0,-1,102450,97550
1:6:6,0,-1,102451,97549
1:4:5,0,-1,102452,97548
6:6:6,0,-1,102453,97547
1:5:1,0,-1,102454,97546
5:5:6,0,-1,102455,97545
3:2:5,1,1,102454,97546
5:4:3,0,-1,102455,97545
1:1:5,0,-1,102456,97544
2:1:1,1,1,102455,97545
1:2:6,1,1,102454,97546
3:6:4,0,-1,102455,97545
4:6:1,0,-1,102456,97544
5:4:1,0,-1,102457,97543
4:5:4,0,-1,102458,97542
3:4:1,0,-1,102459,97541
5:6:1,0,-1,102460,97540
5:3:6,0,-1,102461,97539
2:3:3,1,1,102460,97540
1:1:2,1,1,102459,97541
3:3:6,0,-1,102460,97540
6:4:1,0,-1,102461,97539
3:3:1,0,-1,102462,97538
1:3:6,0,-1,102463,97537
5:3:2,1,1,102462,97538
2:5:4,1,1,102461,97539
1:4:1,0,-1,102462,97538
5:4:4,0,-1,102463,97537
5:3:2,1,1,102462,97538
3:5:1,0,-1,102463,97537
4:2:2,2,2,102461,97539
4:2:4,1,1,102460,97540
2:3:1,1,1,102459,97541
3:6:3,0,-1,102460,97540
4:2:3,1,1,102459,97541
6:2:4,1,1,102458,97542
2:1:5,1,1,102457,97543
2:6:1,1,1,102456,97544
4:3:2,1,1,102455,97545
5:4:3,0,-1,102456,97544
6:2:2,2,2,102454,97546
1:3:1,0,-1,102455,97545
6:5:3,0,-1,102456,97544
4:6:3,0,-1,102457,97543
1:3:6,0,-1,102458,97542
4:3:6,0,-1,102459,97541
5:3:2,1,1,102458,97542
2:3:2,2,2,102456,97544
1:6:3,0,-1,102457,97543
3:5:2,1,1,102456,97544
6:2:6,1,1,102455,97545
5:2:3,1,1,102454,97546
5:2:5,1,1,102453,97547
4:1:5,0,-1,102454,97546
3:1:5,0,-1,102455,97545
1:2:5,1,1,102454,97546
2:2:5,2,2,102452,97548
3:3:6,0,-1,102453,97547
2:5:4,1,1,102452,97548
5:2:1,1,1,102451,97549
4:6:2,1,1,102450,97550
4:1:3,0,-1,102451,97549
2:5:1,1,1,102450,97550
4:2:3,1,1,102449,97551
1:2:1,1,1,102448,97552
6:3:5,0,-1,102449,97551
6:3:6,0,-1,102450,97550
2:2:6,2,2,102448,97552
1:2:4,1,1,102447,97553
1:2:2,2,2,102445,97555
4:6:2,1,1,102444,97556
6:3:5,0,-1,102445,97555
3:3:1,0,-1,102446,97554
4:5:4,0,-1,102447,97553
1:6:3,0,-1,102448,97552
4:5:6,0,-1,102449,97551
2:1:6,1,1,102448,97552
3:3:4,0,-1,102449,97551
2:5:2,2,2,102447,97553
5:2:6,1,1,102446,97554
1:3:4,0,-1,102447,97553
4:1:2,1,1,102446,97554
4:5:6,0,-1,102447,97553
2:6:4,1,1,102446,97554
1:1:4,0,-1,102447,97553
2:4:1,1,1,102446,97554
3:6:6,0,-1,102447,97553
3:1:1,0,-1,102448,97552
2:6:6,1,1,102447,97553
2:5:6,1,1,102446,97554
2:2:3,2,2,102444,97556
6:1:1,0,-1,102445,97555
3:4:3,0,-1,102446,97554
5:5:4,0,-1,102447,97553
4:4:5,0,-1,102448,97552
5:1:6,0,-1,102449,97551
1:2:4,1,1,102448,97552
2:3:6,1,1,102447,97553
6:5:4,0,-1,102448,97552
1:5:5,0,-1,102449,97551
1:4:5,0,-1,102450,97550
5:4:4,0,-1,102451,97549
1:5:5,0,-1,102452,97548
6:5:4,0,-1,102453,97547
5:2:2,2,2,102451,97549
4:5:5,0,-1,102452,97548
5:2:6,1,1,102451,97549
6:3:2,1,1,102450,97550
1:6:3,0,-1,102451,97549
2:3:5,1,1,102450,97550
3:5:4,0,-1,102451,97549
5:2:6,1,1,102450,97550
4:2:2,2,2,102448,97552
5:1:6,0,-1,102449,97551
1:6:3,0,-1,102450,97550
1:6:3,0,-1,102451,97549
6:6:2,1,1,102450,97550
5:2:4,1,1,102449,97551
2:6:6,1,1,102448,97552
2:4:3,1,1,102447,97553
4:4:4,0,-1,102448,97552
5:6:2,1,1,102447,97553
2:3:2,2,2,102445,97555
1:6:1,0,-1,102446,97554
6:5:2,1,1,102445,97555
1:2:5,1,1,102444,97556
4:4:1,0,-1,102445,97555
2:6:6,1,1,102444,97556
3:1:3,0,-1,102445,97555
4:2:1,1,1,102444,97556
4:5:4,0,-1,102445,97555
5:6:6,0,-1,102446,97554
4:6:6,0,-1,102447,97553
2:5:2,2,2,102445,97555
5:6:3,0,-1,102446,97554
2:5:6,1,1,102445,97555
5:6:1,0,-1,102446,97554
6:5:2,1,1,102445,97555
5:5:1,0,-1,102446,97554
3:2:2,2,2,102444,97556
1:4:4,0,-1,102445,97555
5:3:1,0,-1,102446,97554
3:1:5,0,-1,102447,97553
2:6:5,1,1,102446,97554
5:5:4,0,-1,102447,97553
1:1:4,0,-1,102448,97552
6:5:3,0,-1,102449,97551
2:2:2,3,3,102446,97554
4:1:6,0,-1,102447,97553
6:4:3,0,-1,102448,97552
5:5:3,0,-1,102449,97551
5:6:1,0,-1,102450,97550
2:1:3,1,1,102449,97551
2:2:1,2,2,102447,97553
3:3:6,0,-1,102448,97552
4:5:3,0,-1,102449,97551
4:5:2,1,1,102448,97552
6:4:1,0,-1,102449,97551
1:1:3,0,-1,102450,97550
4:1:5,0,-1,102451,97549
4:6:3,0,-1,102452,97548
6:3:4,0,-1,102453,97547
1:4:4,0,-1,102454,97546
5:1:2,1,1,102453,97547
1:5:2,1,1,102452,97548
3:3:6,0,-1,102453,97547
6:5:2,1,1,102452,97548
2:4:5,1,1,102451,97549
5:6:5,0,-1,102452,97548
5:5:5,0,-1,102453,97547
3:5:1,0,-1,102454,97546
2:5:3,1,1,102453,97547
2:1:6,1,1,102452,97548
2:5:6,1,1,102451,97549
6:2:2,2,2,102449,97551
2:6:1,1,1,102448,97552
2:4:6,1,1,102447,97553
1:2:4,1,1,102446,97554
6:1:4,0,-1,102447,97553
4:1:3,0,-1,102448,97552
4:6:2,1,1,102447,97553
3:2:1,1,1,102446,97554
4:5:5,0,-1,102447,97553
5:3:4,0,-1,102448,97552
1:6:5,0,-1,102449,97551
3:6:6,0,-1,102450,97550
5:2:1,1,1,102449,97551
4:3:4,0,-1,102450,97550
2:6:4,1,1,102449,97551
6:5:1,0,-1,102450,97550
5:3:2,1,1,102449,97551
1:5:2,1,1,102448,97552
4:5:6,0,-1,102449,97551
1:1:1,0,-1,102450,97550
2:6:5,1,1,102449,97551
5:4:5,0,-1,102450,97550
1:6:5,0,-1,102451,97549
4:4:6,0,-1,102452,97548
4:2:6,1,1,102451,97549
4:5:1,0,-1,102452,97548
3:2:1,1,1,102451,97549
6:1:1,0,-1,102452,97548
4:6:1,0,-1,102453,97547
5:6:1,0,-1,102454,97546
2:5:2,2,2,102452,97548
1:3:2,1,1,102451,97549
1:3:1,0,-1,102452,97548
4:3:5,0,-1,102453,97547
4:1:2,1,1,102452,97548
4:4:2,1,1,102451,97549
2:6:6,1,1,102450,97550
4:2:5,1,1,102449,97551
5:1:2,1,1,102448,97552
3:3:6,0,-1,102449,97551
6:6:2,1,1,102448,97552
5:3:5,0,-1,102449,97551
5:3:5,0,-1,102450,97550
5:2:1,1,1,102449,97551
4:4:2,1,1,102448,97552
4:4:6,0,-1,102449,97551
1:1:2,1,1,102448,97552
6:5:2,1,1,102447,97553
5:3:2,1,1,102446,97554
2:6:5,1,1,102445,97555
4:5:2,1,1,102444,97556
2:1:6,1,1,102443,97557
1:3:5,0,-1,102444,97556
2:4:3,1,1,102443,97557
1:2:5,1,1,102442,97558
4:2:6,1,1,102441,97559
5:5:1,0,-1,102442,97558
4:1:2,1,1,102441,97559
4:1:4,0,-1,102442,97558
1:6:4,0,-1,102443,97557
2:1:5,1,1,102442,97558
4:3:1,0,-1,102443,97557
5:5:6,0,-1,102444,97556
5:2:5,1,1,102443,97557
1:4:2,1,1,102442,97558
6:5:4,0,-1,102443,97557
2:1:6,1,1,102442,97558
6:5:3,0,-1,102443,97557
6:5:4,0,-1,102444,97556
3:4:2,1,1,102443,97557
5:1:5,0,-1,102444,97556
4:6:2,1,1,102443,97557
6:2:6,1,1,102442,97558
1:3:5,0,-1,102443,97557
5:5:1,0,-1,102444,97556
1:4:3,0,-1,102445,97555
4:4:5,0,-1,102446,97554
5:1:3,0,-1,102447,97553
5:3:3,0,-1,102448,97552
6:1:1,0,-1,102449,97551
6:5:5,0,-1,102450,97550
5:3:2,1,1,102449,97551
1:4:5,0,-1,102450,97550
1:3:6,0,-1,102451,97549
5:2:3,1,1,102450,97550
5:2:5,1,1,102449,97551
1:4:4,0,-1,102450,97550
6:4:5,0,-1,102451,97549
6:5:6,0,-1,102452,97548
5:1:6,0,-1,102453,97547
1:3:3,0,-1,102454,97546
3:6:4,0,-1,102455,97545
1:4:5,0,-1,102456,97544
2:2:4,2,2,102454,97546
5:1:2,1,1,102453,97547
6:5:5,0,-1,102454,97546
3:4:6,0,-1,102455,97545
2:1:4,1,1,102454,97546
2:1:6,1,1,102453,97547
5:4:3,0,-1,102454,97546
3:4:1,0,-1,102455,97545
3:5:4,0,-1,102456,97544
1:5:1,0,-1,102457,97543
3:5:4,0,-1,102458,97542
2:4:3,1,1,102457,97543
4:1:3,0,-1,102458,97542
1:2:1,1,1,102457,97543
4:6:3,0,-1,102458,97542
1:2:4,1,1,102457,97543
5:1:5,0,-1,102458,97542
5:5:5,0,-1,102459,97541
1:3:4,0,-1,102460,97540
3:3:6,0,-1,102461,97539
3:6:2,1,1,102460,97540
6:5:2,1,1,102459,97541
3:1:1,0,-1,102460,97540
1:3:1,0,-1,102461,97539
6:2:4,1,1,102460,97540
5:1:5,0,-1,102461,97539
2:4:3,1,1,102460,97540
5:2:4,1,1,102459,97541
2:6:1,1,1,102458,97542
3:1:6,0,-1,102459,97541
6:5:6,0,-1,102460,97540
1:6:5,0,-1,102461,97539
4:4:2,1,1,102460,97540
1:2:3,1,1,102459,97541
2:2:6,2,2,102457,97543
1:5:5,0,-1,102458,97542
4:3:5,0,-1,102459,97541
3:1:1,0,-1,102460,97540
3:2:1,1,1,102459,97541
5:6:1,0,-1,102460,97540
4:1:4,0,-1,102461,97539
2:2:4,2,2,102459,97541
3:4:2,1,1,102458,97542
3:6:2,1,1,102457,97543
2:3:4,1,1,102456,97544
4:6:4,0,-1,102457,97543
5:6:6,0,-1,102458,97542
5:6:2,1,1,102457,97543
4:3:5,0,-1,102458,97542
3:5:2,1,1,102457,97543
4:6:5,0,-1,102458,97542
5:1:4,0,-1,102459,97541
1:6:1,0,-1,102460,97540
4:1:6,0,-1,102461,97539
5:3:6,0,-1,102462,97538
1:3:3,0,-1,102463,97537
3:6:3,0,-1,102464,97536
5:5:2,1,1,102463,97537
6:1:5,0,-1,102464,97536
5:5:1,0,-1,102465,97535
1:4:5,0,-1,102466,97534
3:2:2,2,2,102464,97536
3:2:5,1,1,102463,97537
5:5:4,0,-1,102464,97536
3:4:6,0,-1,102465,97535
2:5:3,1,1,102464,97536
3:5:4,0,-1,102465,97535
1:3:4,0,-1,102466,97534
4:2:4,1,1,102465,97535
4:1:3,0,-1,102466,97534
3:2:2,2,2,102464,97536
2:1:2,2,2,102462,97538
3:6:4,0,-1,102463,97537
4:5:6,0,-1,102464,97536
2:4:5,1,1,102463,97537
1:5:3,0,-1,102464,97536
3:6:4,0,-1,102465,97535
3:6:5,0,-1,102466,97534
4:6:6,0,-1,102467,97533
5:6:2,1,1,102466,97534
6:2:5,1,1,102465,97535
1:5:1,0,-1,102466,97534
6:5:6,0,-1,102467,97533
3:2:2,2,2,102465,97535
5:4:1,0,-1,102466,97534
1:2:3,1,1,102465,97535
3:2:3,1,1,102464,97536
5:1:1,0,-1,102465,97535
4:5:6,0,-1,102466,97534
6:6:3,0,-1,102467,97533
6:4:2,1,1,102466,97534
5:1:4,0,-1,102467,97533
3:2:2,2,2,102465,97535
3:4:6,0,-1,102466,97534
2:3:2,2,2,102464,97536
5:5:6,0,-1,102465,97535
1:1:2,1,1,102464,97536
5:5:5,0,-1,102465,97535
4:5:5,0,-1,102466,97534
3:4:1,0,-1,102467,97533
6:5:2,1,1,102466,97534
3:3:6,0,-1,102467,97533
5:4:5,0,-1,102468,97532
5:2:5,1,1,102467,97533
1:2:5,1,1,102466,97534
1:1:3,0,-1,102467,97533
6:5:3,0,-1,102468,97532
1:6:6,0,-1,102469,97531
4:1:2,1,1,102468,97532
6:6:1,0,-1,102469,97531
1:5:2,1,1,102468,97532
1:4:3,0,-1,102469,97531
5:5:1,0,-1,102470,97530
2:1:2,2,2,102468,97532
5:4:5,0,-1,102469,97531
3:6:1,0,-1,102470,97530
3:2:5,1,1,102469,97531
3:4:3,0,-1,102470,97530
5:4:5,0,-1,102471,97529
5:3:2,1,1,102470,97530
5:6:2,1,1,102469,97531
4:1:1,0,-1,102470,97530
4:5:3,0,-1,102471,97529
1:1:1,0,-1,102472,97528
5:2:2,2,2,102470,97530
4:6:4,0,-1,102471,97529
1:4:6,0,-1,102472,97528
2:3:5,1,1,102471,97529
3:1:4,0,-1,102472,97528
1:5:5,0,-1,102473,97527
6:5:2,1,1,102472,97528
2:2:3,2,2,102470,97530
1:4:2,1,1,102469,97531
4:6:6,0,-1,102470,97530
2:1:4,1,1,102469,97531
5:6:3,0,-1,102470,97530
4:2:6,1,1,102469,97531
3:6:4,0,-1,102470,97530
1:2:3,1,1,102469,97531
6:6:4,0,-1,102470,97530
3:3:4,0,-1,102471,97529
6:3:6,0,-1,102472,97528
2:5:4,1,1,102471,97529
2:4:2,2,2,102469,97531
1:5:5,0,-1,102470,97530
6:2:2,2,2,102468,97532
1:3:1,0,-1,102469,97531
3:2:2,2,2,102467,97533
4:5:6,0,-1,102468,97532
3:3:5,0,-1,102469,97531
4:6:6,0,-1,102470,97530
1:4:1,0,-1,102471,97529
1:3:1,0,-1,102472,97528
3:2:5,1,1,102471,97529
2:4:5,1,1,102470,97530
5:1:4,0,-1,102471,97529
6:4:2,1,1,102470,97530
2:2:5,2,2,102468,97532
4:6:2,1,1,102467,97533
1:5:4,0,-1,102468,97532
6:4:5,0,-1,102469,97531
4:5:1,0,-1,102470,97530
4:5:2,1,1,102469,97531
6:2:3,1,1,102468,97532
1:6:6,0,-1,102469,97531
2:5:1,1,1,102468,97532
1:3:2,1,1,102467,97533
2:6:5,1,1,102466,97534
5:4:4,0,-1,102467,97533
5:4:4,0,-1,102468,97532
5:6:2,1,1,102467,97533
6:3:6,0,-1,102468,97532
6:3:4,0,-1,102469,97531
4:1:2,1,1,102468,97532
1:5:4,0,-1,102469,97531
4:4:5,0,-1,102470,97530
6:3:4,0,-1,102471,97529
3:3:3,0,-1,102472,97528
6:1:1,0,-1,102473,97527
4:6:2,1,1,102472,97528
6:1:5,0,-1,102473,97527
1:1:6,0,-1,102474,97526
2:5:6,1,1,102473,97527
3:5:6,0,-1,102474,97526
5:1:1,0,-1,102475,97525
6:2:6,1,1,102474,97526
1:4:3,0,-1,102475,97525
3:1:6,0,-1,102476,97524
3:3:3,0,-1,102477,97523
1:4:1,0,-1,102478,97522
4:2:3,1,1,102477,97523
4:6:1,0,-1,102478,97522
3:1:1,0,-1,102479,97521
5:5:2,1,1,102478,97522
5:2:3,1,1,102477,97523
4:1:5,0,-1,102478,97522
1:2:4,1,1,102477,97523
4:3:1,0,-1,102478,97522
4:2:2,2,2,102476,97524
4:1:1,0,-1,102477,97523
4:1:4,0,-1,102478,97522
3:5:3,0,-1,102479,97521
1:5:4,0,-1,102480,97520
6:2:2,2,2,102478,97522
3:2:4,1,1,102477,97523
1:6:5,0,-1,102478,97522
2:3:3,1,1,102477,97523
5:4:5,0,-1,102478,97522
2:4:6,1,1,102477,97523
6:4:2,1,1,102476,97524
3:3:1,0,-1,102477,97523
6:5:3,0,-1,102478,97522
5:5:4,0,-1,102479,97521
5:2:3,1,1,102478,97522
5:6:1,0,-1,102479,97521
6:4:6,0,-1,102480,97520
3:5:5,0,-1,102481,97519
4:5:6,0,-1,102482,97518
4:1:2,1,1,102481,97519
1:4:4,0,-1,102482,97518
4:6:3,0,-1,102483,97517
4:4:3,0,-1,102484,97516
4:1:3,0,-1,102485,97515
5:1:6,0,-1,102486,97514
1:5:1,0,-1,102487,97513
2:2:5,2,2,102485,97515
4:6:6,0,-1,102486,97514
2:6:6,1,1,102485,97515
1:4:5,0,-1,102486,97514
5:5:5,0,-1,102487,97513
1:5:4,0,-1,102488,97512
6:6:4,0,-1,102489,97511
1:1:5,0,-1,102490,97510
3:6:1,0,-1,102491,97509
2:4:5,1,1,102490,97510
4:6:6,0,-1,102491,97509
6:1:1,0,-1,102492,97508
3:1:2,1,1,102491,97509
5:5:1,0,-1,102492,97508
2:3:6,1,1,102491,97509
4:2:4,1,1,102490,97510
6:3:1,0,-1,102491,97509
2:4:4,1,1,102490,97510
5:1:3,0,-1,102491,97509
3:6:3,0,-1,102492,97508
6:6:4,0,-1,102493,97507
4:2:6,1,1,102492,97508
4:2:6,1,1,102491,97509
1:6:2,1,1,102490,97510
6:2:6,1,1,102489,97511
2:2:1,2,2,102487,97513
6:1:5,0,-1,102488,97512
1:2:6,1,1,102487,97513
3:5:2,1,1,102486,97514
6:4:3,0,-1,102487,97513
1:4:4,0,-1,102488,97512
1:1:1,0,-1,102489,97511
4:6:2,1,1,102488,97512
6:3:4,0,-1,102489,97511
3:5:6,0,-1,102490,97510
5:3:5,0,-1,102491,97509
3:2:2,2,2,102489,97511
1:2:1,1,1,102488,97512
3:3:6,0,-1,102489,97511
5:3:1,0,-1,102490,97510
6:2:2,2,2,102488,97512
2:4:1,1,1,102487,97513
2:5:2,2,2,102485,97515
4:3:6,0,-1,102486,97514
1:5:4,0,-1,102487,97513
2:6:1,1,1,102486,97514
2:2:2,3,3,102483,97517
6:2:3,1,1,102482,97518
6:3:3,0,-1,102483,97517
1:6:4,0,-1,102484,97516
5:4:6,0,-1,102485,97515
3:5:2,1,1,102484,97516
1:3:6,0,-1,102485,97515
6:6:4,0,-1,102486,97514
1:4:2,1,1,102485,97515
3:1:3,0,-1,102486,97514
2:4:4,1,1,102485,97515
5:1:4,0,-1,102486,97514
2:3:5,1,1,102485,97515
4:4:6,0,-1,102486,97514
4:4:6,0,-1,102487,97513
5:2:3,1,1,102486,97514
1:1:3,0,-1,102487,97513
5:4:6,0,-1,102488,97512
5:6:6,0,-1,102489,97511
2:1:3,1,1,102488,97512
1:3:5,0,-1,102489,97511
1:5:3,0,-1,102490,97510
6:5:2,1,1,102489,97511
5:4:6,0,-1,102490,97510
5:5:3,0,-1,102491,97509
5:1:4,0,-1,102492,97508
5:6:5,0,-1,102493,97507
6:5:6,0,-1,102494,97506
3:3:2,1,1,102493,97507
6:4:6,0,-1,102494,97506
1:3:2,1,1,102493,97507
4:1:4,0,-1,102494,97506
3:4:6,0,-1,102495,97505
6:4:1,0,-1,102496,97504
6:3:1,0,-1,102497,97503
1:6:6,0,-1,102498,97502
3:4:1,0,-1,102499,97501
6:6:3,0,-1,102500,97500
6:5:6,0,-1,102501,97499
5:4:3,0,-1,102502,97498
6:3:1,0,-1,102503,97497
4:2:5,1,1,102502,97498
3:1:1,0,-1,102503,97497
4:3:4,0,-1,102504,97496
2:4:6,1,1,102503,97497
3:2:1,1,1,102502,97498
2:3:6,1,1,102501,97499
4:3:5,0,-1,102502,97498
1:1:6,0,-1,102503,97497
3:6:1,0,-1,102504,97496
6:6:6,0,-1,102505,97495
1:2:4,1,1,102504,97496
1:5:3,0,-1,102505,97495
1:6:2,1,1,102504,97496
3:1:1,0,-1,102505,97495
2:1:4,1,1,102504,97496
4:2:6,1,1,102503,97497
2:1:4,1,1,102502,97498
1:2:3,1,1,102501,97499
3:3:4,0,-1,102502,97498
5:6:2,1,1,102501,97499
2:6:6,1,1,102500,97500
4:6:5,0,-1,102501,97499
4:4:6,0,-1,102502,97498
2:1:1,1,1,102501,97499
5:4:4,0,-1,102502,97498
3:1:2,1,1,102501,97499
2:5:1,1,1,102500,97500
5:1:5,0,-1,102501,97499
2:3:5,1,1,102500,97500
2:2:4,2,2,102498,97502
3:4:2,1,1,102497,97503
6:2:1,1,1,102496,97504
4:6:3,0,-1,102497,97503
3:6:6,0,-1,102498,97502
2:2:6,2,2,102496,97504
4:4:2,1,1,102495,97505
5:6:4,0,-1,102496,97504
4:6:1,0,-1,102497,97503
6:2:5,1,1,102496,97504
2:5:2,2,2,102494,97506
4:1:3,0,-1,102495,97505
6:6:1,0,-1,102496,97504
4:5:4,0,-1,102497,97503
2:1:3,1,1,102496,97504
1:4:6,0,-1,102497,97503
1:1:6,0,-1,102498,97502
2:4:6,1,1,102497,97503
2:2:2,3,3,102494,97506
3:2:4,1,1,102493,97507
1:5:6,0,-1,102494,97506
2:6:3,1,1,102493,97507
3:3:6,0,-1,102494,97506
6:6:4,0,-1,102495,97505
3:6:4,0,-1,102496,97504
1:3:6,0,-1,102497,97503
1:3:4,0,-1,102498,97502
3:1:6,0,-1,102499,97501
2:1:5,1,1,102498,97502
6:5:1,0,-1,102499,97501
4:6:6,0,-1,102500,97500
5:1:5,0,-1,102501,97499
1:2:1,1,1,102500,97500
2:4:2,2,2,102498,97502
3:3:5,0,-1,102499,97501
4:6:5,0,-1,102500,97500
2:1:3,1,1,102499,97501
3:1:4,0,-1,102500,97500
2:6:6,1,1,102499,97501
1:3:6,0,-1,102500,97500
6:2:5,1,1,102499,97501
5:1:3,0,-1,102500,97500
5:3:6,0,-1,102501,97499
4:6:3,0,-1,102502,97498
4:6:5,0,-1,102503,97497
1:5:5,0,-1,102504,97496
4:1:3,0,-1,102505,97495
6:4:6,0,-1,102506,97494
3:2:1,1,1,102505,97495
5:1:3,0,-1,102506,97494
3:1:4,0,-1,102507,97493
5:3:3,0,-1,102508,97492
6:1:3,0,-1,102509,97491
4:1:4,0,-1,102510,97490
6:6:3,0,-1,102511,97489
2:4:5,1,1,102510,97490
5:3:4,0,-1,102511,97489
2:3:3,1,1,102510,97490
1:5:1,0,-1,102511,97489
1:1:1,0,-1,102512,97488
4:5:3,0,-1,102513,97487
6:2:5,1,1,102512,97488
5:4:3,0,-1,102513,97487
5:5:1,0,-1,102514,97486
4:1:3,0,-1,102515,97485
4:5:1,0,-1,102516,97484
2:3:3,1,1,102515,97485
5:3:3,0,-1,102516,97484
4:5:4,0,-1,102517,97483
4:2:3,1,1,102516,97484
2:1:4,1,1,102515,97485
2:4:1,1,1,102514,97486
6:6:5,0,-1,102515,97485
3:6:2,1,1,102514,97486
2:2:3,2,2,102512,97488
2:5:5,1,1,102511,97489
6:4:4,0,-1,102512,97488
6:1:1,0,-1,102513,97487
2:4:6,1,1,102512,97488
5:5:4,0,-1,102513,97487
4:5:3,0,-1,102514,97486
3:2:2,2,2,102512,97488
6:6:4,0,-1,102513,97487
4:5:6,0,-1,102514,97486
6:6:1,0,-1,102515,97485
1:4:2,1,1,102514,97486
6:2:5,1,1,102513,97487
4:4:4,0,-1,102514,97486
4:5:3,0,-1,102515,97485
3:1:2,1,1,102514,97486
1:4:3,0,-1,102515,97485
4:1:1,0,-1,102516,97484
3:2:3,1,1,102515,97485
1:1:2,1,1,102514,97486
1:4:4,0,-1,102515,97485
3:2:2,2,2,102513,97487
3:6:5,0,-1,102514,97486
2:5:3,1,1,102513,97487
3:5:3,0,-1,102514,97486
4:5:5,0,-1,102515,97485
4:6:4,0,-1,102516,97484
5:4:2,1,1,102515,97485
1:6:2,1,1,102514,97486
3:4:2,1,1,102513,97487
3:6:6,0,-1,102514,97486
1:5:1,0,-1,102515,97485
2:3:5,1,1,102514,97486
2:6:6,1,1,102513,97487
4:6:6,0,-1,102514,97486
4:4:4,0,-1,102515,97485
4:4:4,0,-1,102516,97484
3:3:2,1,1,102515,97485
5:5:1,0,-1,102516,97484
2:5:4,1,1,102515,97485
6:1:5,0,-1,102516,97484
4:1:3,0,-1,102517,97483
2:1:2,2,2,102515,97485
4:5:5,0,-1,102516,97484
2:4:5,1,1,102515,97485
2:3:1,1,1,102514,97486
1:6:4,0,-1,102515,97485
3:1:3,0,-1,102516,97484
2:5:1,1,1,102515,97485
1:4:5,0,-1,102516,97484
4:6:2,1,1,102515,97485
3:5:4,0,-1,102516,97484
3:6:5,0,-1,102517,97483
3:2:6,1,1,102516,97484
2:6:5,1,1,102515,97485
6:1:3,0,-1,102516,97484
5:1:5,0,-1,102517,97483
5:1:4,0,-1,102518,97482
3:4:3,0,-1,102519,97481
4:1:1,0,-1,102520,97480
4:5:1,0,-1,102521,97479
5:1:6,0,-1,102522,97478
5:2:2,2,2,102520,97480
1:1:2,1,1,102519,97481
2:2:1,2,2,102517,97483
4:3:3,0,-1,102518,97482
3:5:5,0,-1,102519,97481
3:3:1,0,-1,102520,97480
4:3:2,1,1,102519,97481
5:2:1,1,1,102518,97482
2:2:2,3,3,102515,97485
5:5:5,0,-1,102516,97484
6:6:1,0,-1,102517,97483
5:4:3,0,-1,102518,97482
4:3:2,1,1,102517,97483
6:5:4,0,-1,102518,97482
5:1:2,1,1,102517,97483
4:1:2,1,1,102516,97484
2:6:6,1,1,102515,97485
2:2:4,2,2,102513,97487
4:3:6,0,-1,102514,97486
6:3:6,0,-1,102515,97485
1:5:2,1,1,102514,97486
2:1:2,2,2,102512,97488
3:2:3,1,1,102511,97489
1:2:1,1,1,102510,97490
1:1:1,0,-1,102511,97489
1:2:5,1,1,102510,97490
4:2:4,1,1,102509,97491
2:5:6,1,1,102508,97492
1:6:5,0,-1,102509,97491
2:2:3,2,2,102507,97493
3:5:4,0,-1,102508,97492
6:4:2,1,1,102507,97493
1:3:4,0,-1,102508,97492
5:3:6,0,-1,102509,97491
5:1:4,0,-1,102510,97490
4:6:3,0,-1,102511,97489
3:6:5,0,-1,102512,97488
2:6:4,1,1,102511,97489
2:3:1,1,1,102510,97490
1:6:4,0,-1,102511,97489
3:1:4,0,-1,102512,97488
5:4:2,1,1,102511,97489
3:5:5,0,-1,102512,97488
4:4:2,1,1,102511,97489
1:6:6,0,-1,102512,97488
6:1:3,0,-1,102513,97487
5:4:5,0,-1,102514,97486
2:4:5,1,1,102513,97487
2:5:4,1,1,102512,97488
3:5:2,1,1,102511,97489
3:5:2,1,1,102510,97490
4:3:5,0,-1,102511,97489
6:3:3,0,-1,102512,97488
5:4:4,0,-1,102513,97487
4:3:6,0,-1,102514,97486
2:4:3,1,1,102513,97487
4:1:2,1,1,102512,97488
4:4:6,0,-1,102513,97487
4:3:5,0,-1,102514,97486
3:1:5,0,-1,102515,97485
6:3:4,0,-1,102516,97484
4:3:3,0,-1,102517,97483
5:1:4,0,-1,102518,97482
2:2:3,2,2,102516,97484
5:4:2,1,1,102515,97485
1:4:5,0,-1,102516,97484
2:2:3,2,2,102514,97486
2:6:5,1,1,102513,97487
2:2:1,2,2,102511,97489
5:6:6,0,-1,102512,97488
1:6:1,0,-1,102513,97487
2:1:3,1,1,102512,97488
1:5:4,0,-1,102513,97487
2:1:3,1,1,102512,97488
3:4:5,0,-1,102513,97487
2:4:2,2,2,102511,97489
3:5:1,0,-1,102512,97488
6:3:6,0,-1,102513,97487
1:6:4,0,-1,102514,97486
3:1:5,0,-1,102515,97485
4:3:1,0,-1,102516,97484
4:6:5,0,-1,102517,97483
5:2:5,1,1,102516,97484
5:5:5,0,-1,102517,97483
1:2:3,1,1,102516,97484
1:4:1,0,-1,102517,97483
1:4:3,0,-1,102518,97482
3:2:2,2,2,102516,97484
2:5:3,1,1,102515,97485
3:5:6,0,-1,102516,97484
4:5:1,0,-1,102517,97483
3:1:5,0,-1,102518,97482
4:6:5,0,-1,102519,97481
2:2:4,2,2,102517,97483
5:3:6,0,-1,102518,97482
3:5:4,0,-1,102519,97481
2:3:6,1,1,102518,97482
2:2:1,2,2,102516,97484
5:6:5,0,-1,102517,97483
2:4:3,1,1,102516,97484
3:6:2,1,1,102515,97485
2:3:2,2,2,102513,97487
4:2:6,1,1,102512,97488
4:2:5,1,1,102511,97489
5:3:3,0,-1,102512,97488
6:2:4,1,1,102511,97489
2:4:3,1,1,102510,97490
4:2:3,1,1,102509,97491
1:2:5,1,1,102508,97492
6:3:6,0,-1,102509,97491
2:4:6,1,1,102508,97492
4:4:4,0,-1,102509,97491
5:5:6,0,-1,102510,97490
6:2:2,2,2,102508,97492
4:5:4,0,-1,102509,97491
3:1:6,0,-1,102510,97490
1:5:1,0,-1,102511,97489
1:6:4,0,-1,102512,97488
6:4:1,0,-1,102513,97487
1:6:5,0,-1,102514,97486
6:5:4,0,-1,102515,97485
5:4:5,0,-1,102516,97484
6:6:1,0,-1,102517,97483
3:6:5,0,-1,102518,97482
3:1:6,0,-1,102519,97481
6:6:6,0,-1,102520,97480
3:4:2,1,1,102519,97481
4:4:1,0,-1,102520,97480
1:5:6,0,-1,102521,97479
4:2:5,1,1,102520,97480
3:3:4,0,-1,102521,97479
6:2:5,1,1,102520,97480
2:4:2,2,2,102518,97482
3:2:3,1,1,102517,97483
2:2:3,2,2,102515,97485
6:3:5,0,-1,102516,97484
6:1:1,0,-1,102517,97483
6:3:5,0,-1,102518,97482
6:2:6,1,1,102517,97483
2:6:4,1,1,102516,97484
2:2:3,2,2,102514,97486
4:2:4,1,1,102513,97487
3:1:1,0,-1,102514,97486
1:4:2,1,1,102513,97487
4:4:2,1,1,102512,97488
5:1:1,0,-1,102513,97487
4:5:2,1,1,102512,97488
3:2:4,1,1,102511,97489
1:3:2,1,1,102510,97490
5:1:2,1,1,102509,97491
2:4:3,1,1,102508,97492
1:6:4,0,-1,102509,97491
4:4:4,0,-1,102510,97490
6:5:4,0,-1,102511,97489
1:3:2,1,1,102510,97490
2:5:2,2,2,102508,97492
1:4:2,1,1,102507,97493
4:3:2,1,1,102506,97494
2:4:2,2,2,102504,97496
4:5:2,1,1,102503,97497
3:3:5,0,-1,102504,97496
4:6:3,0,-1,102505,97495
4:3:6,0,-1,102506,97494
2:3:2,2,2,102504,97496
3:1:3,0,-1,102505,97495
2:6:5,1,1,102504,97496
2:5:3,1,1,102503,97497
5:6:1,0,-1,102504,97496
5:5:4,0,-1,102505,97495
5:5:4,0,-1,102506,97494
2:1:4,1,1,102505,97495
2:3:6,1,1,102504,97496
6:1:5,0,-1,102505,97495
4:6:4,0,-1,102506,97494
5:1:5,0,-1,102507,97493
4:6:4,0,-1,102508,97492
2:4:4,1,1,102507,97493
1:4:3,0,-1,102508,97492
3:6:2,1,1,102507,97493
4:3:1,0,-1,102508,97492
1:6:3,0,-1,102509,97491
1:3:6,0,-1,102510,97490
6:1:4,0,-1,102511,97489
3:3:1,0,-1,102512,97488
6:6:5,0,-1,102513,97487
2:6:4,1,1,102512,97488
3:1:3,0,-1,102513,97487
3:1:4,0,-1,102514,97486
2:5:6,1,1,102513,97487
6:4:3,0,-1,102514,97486
5:3:1,0,-1,102515,97485
1:3:5,0,-1,102516,97484
1:5:3,0,-1,102517,97483
4:6:6,0,-1,102518,97482
6:6:5,0,-1,102519,97481
2:1:4,1,1,102518,97482
6:6:5,0,-1,102519,97481
2:3:4,1,1,102518,97482
2:4:6,1,1,102517,97483
1:3:3,0,-1,102518,97482
3:6:2,1,1,102517,97483
4:3:1,0,-1,102518,97482
5:2:2,2,2,102516,97484
2:4:4,1,1,102515,97485
5:3:6,0,-1,102516,97484
1:2:4,1,1,102515,97485
2:5:5,1,1,102514,97486
1:6:3,0,-1,102515,97485
6:2:2,2,2,102513,97487
1:4:3,0,-1,102514,97486
3:3:5,0,-1,102515,97485
3:4:5,0,-1,102516,97484
3:3:6,0,-1,102517,97483
3:1:5,0,-1,102518,97482
5:2:6,1,1,102517,97483
1:6:6,0,-1,102518,97482
6:3:4,0,-1,102519,97481
6:6:6,0,-1,102520,97480
2:5:2,2,2,102518,97482
6:4:3,0,-1,102519,97481
2:1:4,1,1,102518,97482
5:3:6,0,-1,102519,97481
5:1:4,0,-1,102520,97480
2:6:2,2,2,102518,97482
5:3:6,0,-1,102519,97481
4:2:3,1,1,102518,97482
6:4:1,0,-1,102519,97481
5:4:1,0,-1,102520,97480
3:2:3,1,1,102519,97481
2:6:3,1,1,102518,97482
3:6:5,0,-1,102519,97481
6:5:5,0,-1,102520,97480
3:1:4,0,-1,102521,97479
1:2:6,1,1,102520,97480
1:1:4,0,-1,102521,97479
6:6:4,0,-1,102522,97478
5:1:2,1,1,102521,97479
4:5:3,0,-1,102522,97478
5:6:4,0,-1,102523,97477
6:1:3,0,-1,102524,97476
5:4:1,0,-1,102525,97475
2:5:5,1,1,102524,97476
1:4:2,1,1,102523,97477
6:2:6,1,1,102522,97478
4:6:4,0,-1,102523,97477
4:3:1,0,-1,102524,97476
2:4:3,1,1,102523,97477
6:5:3,0,-1,102524,97476
5:5:5,0,-1,102525,97475
5:1:1,0,-1,102526,97474
6:5:5,0,-1,102527,97473
5:6:2,1,1,102526,97474
4:2:6,1,1,102525,97475
4:5:3,0,-1,102526,97474
2:1:6,1,1,102525,97475
1:5:2,1,1,102524,97476
5:3:6,0,-1,102525,97475
2:1:3,1,1,102524,97476
2:1:3,1,1,102523,97477
2:5:4,1,1,102522,97478
3:1:4,0,-1,102523,97477
1:3:3,0,-1,102524,97476
3:5:6,0,-1,102525,97475
3:4:3,0,-1,102526,97474
4:2:5,1,1,102525,97475
6:1:6,0,-1,102526,97474
4:4:3,0,-1,102527,97473
5:4:5,0,-1,102528,97472
1:2:5,1,1,102527,97473
4:4:6,0,-1,102528,97472
4:3:5,0,-1,102529,97471
2:2:1,2,2,102527,97473
1:1:2,1,1,102526,97474
5:4:1,0,-1,102527,97473
6:3:1,0,-1,102528,97472
5:4:1,0,-1,102529,97471
1:1:5,0,-1,102530,97470
3:2:1,1,1,102529,97471
2:1:6,1,1,102528,97472
3:1:4,0,-1,102529,97471
6:4:2,1,1,102528,97472
3:3:6,0,-1,102529,97471
6:1:1,0,-1,102530,97470
6:5:6,0,-1,102531,97469
1:3:4,0,-1,102532,97468
2:3:4,1,1,102531,97469
6:2:1,1,1,102530,97470
5:2:6,1,1,102529,97471
6:1:2,1,1,102528,97472
2:5:5,1,1,102527,97473
2:2:3,2,2,102525,97475
5:2:5,1,1,102524,97476
2:2:3,2,2,102522,97478
5:3:1,0,-1,102523,97477
6:6:4,0,-1,102524,97476
2:1:6,1,1,102523,97477
2:3:5,1,1,102522,97478
1:1:5,0,-1,102523,97477
5:4:2,1,1,102522,97478
1:1:3,0,-1,102523,97477
2:2:2,3,3,102520,97480
5:1:6,0,-1,102521,97479
6:4:6,0,-1,102522,97478
5:1:5,0,-1,102523,97477
4:3:4,0,-1,102524,97476
3:1:2,1,1,102523,97477
1:4:1,0,-1,102524,97476
6:4:2,1,1,102523,97477
1:5:1,0,-1,102524,97476
5:4:2,1,1,102523,97477
2:3:6,1,1,102522,97478
1:1:5,0,-1,102523,97477
4:5:5,0,-1,102524,97476
3:2:1,1,1,102523,97477
2:1:6,1,1,102522,97478
6:2:2,2,2,102520,97480
6:4:4,0,-1,102521,97479
4:4:2,1,1,102520,97480
1:5:2,1,1,102519,97481
2:1:1,1,1,102518,97482
6:6:4,0,-1,102519,97481
5:3:6,0,-1,102520,97480
4:4:1,0,-1,102521,97479
5:6:5,0,-1,102522,97478
6:2:2,2,2,102520,97480
3:6:2,1,1,102519,97481
6:1:1,0,-1,102520,97480
6:1:1,0,-1,102521,97479
2:2:3,2,2,102519,97481
3:1:6,0,-1,102520,97480
4:5:6,0,-1,102521,97479
3:2:5,1,1,102520,97480
1:1:2,1,1,102519,97481
1:1:1,0,-1,102520,97480
3:3:4,0,-1,102521,97479
1:4:2,1,1,102520,97480
3:4:3,0,-1,102521,97479
1:6:4,0,-1,102522,97478
3:5:2,1,1,102521,97479
1:4:6,0,-1,102522,97478
5:1:1,0,-1,102523,97477
6:2:6,1,1,102522,97478
4:1:6,0,-1,102523,97477
3:4:4,0,-1,102524,97476
2:5:2,2,2,102522,97478
5:4:2,1,1,102521,97479
5:6:4,0,-1,102522,97478
4:3:6,0,-1,102523,97477
2:2:2,3,3,102520,97480
3:4:6,0,-1,102521,97479
4:5:5,0,-1,102522,97478
4:2:5,1,1,102521,97479
5:3:3,0,-1,102522,97478
4:2:2,2,2,102520,97480
5:2:6,1,1,102519,97481
2:5:3,1,1,102518,97482
5:6:1,0,-1,102519,97481
4:1:3,0,-1,102520,97480
3:4:4,0,-1,102521,97479
4:4:3,0,-1,102522,97478
4:2:1,1,1,102521,97479
5:1:5,0,-1,102522,97478
6:2:4,1,1,102521,97479
6:4:5,0,-1,102522,97478
1:3:3,0,-1,102523,97477
2:6:2,2,2,102521,97479
6:4:1,0,-1,102522,97478
1:3:2,1,1,102521,97479
6:3:5,0,-1,102522,97478
1:1:5,0,-1,102523,97477
4:5:5,0,-1,102524,97476
1:6:2,1,1,102523,97477
5:4:4,0,-1,102524,97476
5:5:1,0,-1,102525,97475
1:2:3,1,1,102524,97476
6:2:5,1,1,102523,97477
3:5:4,0,-1,102524,97476
2:3:2,2,2,102522,97478
3:2:2,2,2,102520,97480
4:1:5,0,-1,102521,97479
4:1:5,0,-1,102522,97478
2:4:5,1,1,102521,97479
4:6:4,0,-1,102522,97478
2:2:2,3,3,102519,97481
4:4:1,0,-1,102520,97480
6:6:3,0,-1,102521,97479
3:6:5,0,-1,102522,97478
6:6:2,1,1,102521,97479
6:5:1,0,-1,102522,97478
2:5:3,1,1,102521,97479
5:6:1,0,-1,102522,97478
4:3:4,0,-1,102523,97477
5:4:6,0,-1,102524,97476
2:1:2,2,2,102522,97478
6:4:6,0,-1,102523,97477
6:3:6,0,-1,102524,97476
3:6:5,0,-1,102525,97475
4:6:1,0,-1,102526,97474
6:4:3,0,-1,102527,97473
4:4:4,0,-1,102528,97472
6:3:3,0,-1,102529,97471
4:6:2,1,1,102528,97472
1:3:3,0,-1,102529,97471
3:3:2,1,1,102528,97472
6:5:3,0,-1,102529,97471
5:5:4,0,-1,102530,97470
5:1:3,0,-1,102531,97469
2:2:5,2,2,102529,97471
6:4:5,0,-1,102530,97470
3:3:4,0,-1,102531,97469
4:3:4,0,-1,102532,97468
1:4:1,0,-1,102533,97467
5:6:2,1,1,102532,97468
2:1:4,1,1,102531,97469
5:3:4,0,-1,102532,97468
1:1:4,0,-1,102533,97467
1:2:3,1,1,102532,97468
6:4:2,1,1,102531,97469
1:2:4,1,1,102530,97470
3:6:6,0,-1,102531,97469
2:1:3,1,1,102530,97470
4:5:5,0,-1,102531,97469
3:1:5,0,-1,102532,97468
4:3:4,0,-1,102533,97467
3:4:2,1,1,102532,97468
1:1:6,0,-1,102533,97467
5:5:3,0,-1,102534,97466
1:1:2,1,1,102533,97467
6:4:3,0,-1,102534,97466
2:1:4,1,1,102533,97467
4:3:4,0,-1,102534,97466
1:6:6,0,-1,102535,97465
6:4:5,0,-1,102536,97464
6:2:3,1,1,102535,97465
5:3:5,0,-1,102536,97464
6:1:3,0,-1,102537,97463
1:3:4,0,-1,102538,97462
6:1:6,0,-1,102539,97461
4:3:4,0,-1,102540,97460
2:5:5,1,1,102539,97461
3:1:6,0,-1,102540,97460
2:4:6,1,1,102539,97461
1:5:3,0,-1,102540,97460
3:5:4,0,-1,102541,97459
3:1:1,0,-1,102542,97458
5:2:4,1,1,102541,97459
3:3:6,0,-1,102542,97458
1:1:5,0,-1,102543,97457
5:1:5,0,-1,102544,97456
6:5:4,0,-1,102545,97455
4:5:1,0,-1,102546,97454
6:2:3,1,1,102545,97455
1:4:6,0,-1,102546,97454
5:2:2,2,2,102544,97456
6:1:3,0,-1,102545,97455
2:1:3,1,1,102544,97456
6:1:4,0,-1,102545,97455
3:3:6,0,-1,102546,97454
2:5:4,1,1,102545,97455
6:5:2,1,1,102544,97456
3:3:6,0,-1,102545,97455
5:3:1,0,-1,102546,97454
1:2:1,1,1,102545,97455
2:6:1,1,1,102544,97456
6:2:2,2,2,102542,97458
6:3:2,1,1,102541,97459
2:3:3,1,1,102540,97460
1:5:2,1,1,102539,97461
5:2:4,1,1,102538,97462
6:4:2,1,1,102537,97463
5:5:3,0,-1,102538,97462
6:3:4,0,-1,102539,97461
1:4:3,0,-1,102540,97460
6:2:5,1,1,102539,97461
5:6:2,1,1,102538,97462
5:2:2,2,2,102536,97464
2:5:5,1,1,102535,97465
2:5:4,1,1,102534,97466
2:2:4,2,2,102532,97468
5:5:1,0,-1,102533,97467
5:4:2,1,1,102532,97468
3:1:6,0,-1,102533,97467
2:5:3,1,1,102532,97468
3:1:2,1,1,102531,97469
6:4:6,0,-1,102532,97468
3:5:5,0,-1,102533,97467
4:3:5,0,-1,102534,97466
5:3:5,0,-1,102535,97465
4:5:2,1,1,102534,97466
5:2:6,1,1,102533,97467
5:3:1,0,-1,102534,97466
2:2:6,2,2,102532,97468
6:3:3,0,-1,102533,97467
6:6:3,0,-1,102534,97466
4:2:3,1,1,102533,97467
3:1:4,0,-1,102534,97466
1:6:3,0,-1,102535,97465
1:3:3,0,-1,102536,97464
6:4:4,0,-1,102537,97463
5:4:4,0,-1,102538,97462
6:1:3,0,-1,102539,97461
1:5:6,0,-1,102540,97460
5:3:5,0,-1,102541,97459
1:3:6,0,-1,102542,97458
6:3:3,0,-1,102543,97457
5:6:5,0,-1,102544,97456
5:1:1,0,-1,102545,97455
1:2:2,2,2,102543,97457
6:5:4,0,-1,102544,97456
6:3:2,1,1,102543,97457
5:4:5,0,-1,102544,97456
2:1:6,1,1,102543,97457
6:6:3,0,-1,102544,97456
1:4:5,0,-1,102545,97455
5:3:6,0,-1,102546,97454
2:5:5,1,1,102545,97455
2:4:1,1,1,102544,97456
4:4:6,0,-1,102545,97455
2:6:1,1,1,102544,97456
1:6:1,0,-1,102545,97455
5:5:2,1,1,102544,97456
5:3:5,0,-1,102545,97455
3:4:5,0,-1,102546,97454
2:1:2,2,2,102544,97456
4:1:1,0,-1,102545,97455
4:5:4,0,-1,102546,97454
2:3:1,1,1,102545,97455
4:1:6,0,-1,102546,97454
2:2:2,3,3,102543,97457
5:6:1,0,-1,102544,97456
6:5:5,0,-1,102545,97455
2:6:2,2,2,102543,97457
1:1:5,0,-1,102544,97456
4:1:1,0,-1,102545,97455
2:6:2,2,2,102543,97457
4:3:5,0,-1,102544,97456
2:3:3,1,1,102543,97457
1:5:4,0,-1,102544,97456
3:1:2,1,1,102543,97457
6:1:5,0,-1,102544,97456
5:4:2,1,1,102543,97457
2:4:5,1,1,102542,97458
6:6:2,1,1,102541,97459
6:3:1,0,-1,102542,97458
5:2:4,1,1,102541,97459
5:3:3,0,-1,102542,97458
3:6:5,0,-1,102543,97457
2:6:5,1,1,102542,97458
5:3:1,0,-1,102543,97457
5:4:1,0,-1,102544,97456
2:2:5,2,2,102542,97458
5:6:3,0,-1,102543,97457
6:3:6,0,-1,102544,97456
1:5:3,0,-1,102545,97455
4:4:2,1,1,102544,97456
6:3:5,0,-1,102545,97455
1:4:5,0,-1,102546,97454
1:1:6,0,-1,102547,97453
5:4:1,0,-1,102548,97452
2:2:5,2,2,102546,97454
5:2:2,2,2,102544,97456
3:2:6,1,1,102543,97457
5:5:2,1,1,102542,97458
6:1:3,0,-1,102543,97457
5:2:1,1,1,102542,97458
5:5:1,0,-1,102543,97457
2:6:3,1,1,102542,97458
1:4:2,1,1,102541,97459
4:6:6,0,-1,102542,97458
3:2:2,2,2,102540,97460
1:2:5,1,1,102539,97461
3:6:3,0,-1,102540,97460
6:3:6,0,-1,102541,97459
1:6:3,0,-1,102542,97458
2:4:3,1,1,102541,97459
6:2:6,1,1,102540,97460
1:5:4,0,-1,102541,97459
1:4:2,1,1,102540,97460
5:5:4,0,-1,102541,97459
5:1:1,0,-1,102542,97458
3:2:4,1,1,102541,97459
1:1:2,1,1,102540,97460
6:6:6,0,-1,102541,97459
2:3:6,1,1,102540,97460
5:3:6,0,-1,102541,97459
2:6:2,2,2,102539,97461
2:4:6,1,1,102538,97462
1:4:4,0,-1,102539,97461
6:5:4,0,-1,102540,97460
3:4:6,0,-1,102541,97459
1:2:3,1,1,102540,97460
3:1:5,0,-1,102541,97459
5:4:2,1,1,102540,97460
6:3:1,0,-1,102541,97459
5:5:2,1,1,102540,97460
4:5:3,0,-1,102541,97459
4:5:6,0,-1,102542,97458
5:4:6,0,-1,102543,97457
1:4:2,1,1,102542,97458
6:2:5,1,1,102541,97459
1:3:4,0,-1,102542,97458
5:6:1,0,-1,102543,97457
1:1:2,1,1,102542,97458
3:5:5,0,-1,102543,97457
1:6:6,0,-1,102544,97456
2:5:5,1,1,102543,97457
6:3:2,1,1,102542,97458
1:2:2,2,2,102540,97460
6:3:2,1,1,102539,97461
4:6:1,0,-1,102540,97460
4:6:6,0,-1,102541,97459
2:5:1,1,1,102540,97460
4:2:6,1,1,102539,97461
6:4:1,0,-1,102540,97460
3:4:5,0,-1,102541,97459
6:3:4,0,-1,102542,97458
3:1:3,0,-1,102543,97457
6:4:4,0,-1,102544,97456
3:4:6,0,-1,102545,97455
5:2:1,1,1,102544,97456
2:6:4,1,1,102543,97457
3:1:6,0,-1,102544,97456
1:5:5,0,-1,102545,97455
3:3:4,0,-1,102546,97454
1:2:4,1,1,102545,97455
5:1:3,0,-1,102546,97454
3:4:6,0,-1,102547,97453
1:2:4,1,1,102546,97454
5:3:5,0,-1,102547,97453
1:2:1,1,1,102546,97454
5:4:6,0,-1,102547,97453
5:1:4,0,-1,102548,97452
6:2:2,2,2,102546,97454
5:6:6,0,-1,102547,97453
6:1:6,0,-1,102548,97452
4:3:2,1,1,102547,97453
4:3:1,0,-1,102548,97452
4:4:2,1,1,102547,97453
6:5:4,0,-1,102548,97452
4:5:5,0,-1,102549,97451
5:1:2,1,1,102548,97452
5:1:1,0,-1,102549,97451
6:6:6,0,-1,102550,97450
6:3:4,0,-1,102551,97449
3:4:3,0,-1,102552,97448
3:6:1,0,-1,102553,97447
6:5:1,0,-1,102554,97446
5:5:2,1,1,102553,97447
2:5:1,1,1,102552,97448
5:2:6,1,1,102551,97449
3:6:1,0,-1,102552,97448
2:3:1,1,1,102551,97449
1:5:5,0,-1,102552,97448
4:5:2,1,1,102551,97449
5:2:5,1,1,102550,97450
2:1:1,1,1,102549,97451
4:1:3,0,-1,102550,97450
3:1:4,0,-1,102551,97449
3:3:5,0,-1,102552,97448
6:2:4,1,1,102551,97449
2:5:4,1,1,102550,97450
3:5:5,0,-1,102551,97449
5:1:2,1,1,102550,97450
3:6:5,0,-1,102551,97449
4:1:5,0,-1,102552,97448
3:1:3,0,-1,102553,97447
4:1:5,0,-1,102554,97446
6:1:4,0,-1,102555,97445
3:5:1,0,-1,102556,97444
3:6:1,0,-1,102557,97443
4:2:2,2,2,102555,97445
1:3:2,1,1,102554,97446
5:5:6,0,-1,102555,97445
6:6:1,0,-1,102556,97444
3:1:4,0,-1,102557,97443
4:4:5,0,-1,102558,97442
2:4:1,1,1,102557,97443
3:5:2,1,1,102556,97444
5:2:5,1,1,102555,97445
3:2:4,1,1,102554,97446
4:1:1,0,-1,102555,97445
4:2:3,1,1,102554,97446
6:5:2,1,1,102553,97447
2:2:6,2,2,102551,97449
4:3:5,0,-1,102552,97448
6:4:2,1,1,102551,97449
3:6:1,0,-1,102552,97448
1:1:6,0,-1,102553,97447
6:6:6,0,-1,102554,97446
5:6:1,0,-1,102555,97445
6:2:5,1,1,102554,97446
2:1:1,1,1,102553,97447
5:1:1,0,-1,102554,97446
3:5:3,0,-1,102555,97445
5:6:2,1,1,102554,97446
2:3:4,1,1,102553,97447
6:2:6,1,1,102552,97448
3:1:3,0,-1,102553,97447
2:6:1,1,1,102552,97448
2:4:1,1,1,102551,97449
6:3:4,0,-1,102552,97448
3:5:4,0,-1,102553,97447
3:5:6,0,-1,102554,97446
6:2:3,1,1,102553,97447
4:5:6,0,-1,102554,97446
3:2:5,1,1,102553,97447
4:1:6,0,-1,102554,97446
1:2:6,1,1,102553,97447
2:3:4,1,1,102552,97448
5:6:3,0,-1,102553,97447
3:3:4,0,-1,102554,97446
1:1:3,0,-1,102555,97445
2:3:3,1,1,102554,97446
6:5:3,0,-1,102555,97445
2:2:5,2,2,102553,97447
3:3:1,0,-1,102554,97446
1:2:2,2,2,102552,97448
5:1:3,0,-1,102553,97447
2:5:6,1,1,102552,97448
3:1:5,0,-1,102553,97447
2:4:6,1,1,102552,97448
2:1:5,1,1,102551,97449
4:6:2,1,1,102550,97450
4:4:3,0,-1,102551,97449
6:6:3,0,-1,102552,97448
3:5:6,0,-1,102553,97447
6:1:5,0,-1,102554,97446
2:6:6,1,1,102553,97447
2:5:5,1,1,102552,97448
6:6:6,0,-1,102553,97447
6:1:4,0,-1,102554,97446
6:2:6,1,1,102553,97447
2:4:2,2,2,102551,97449
6:3:5,0,-1,102552,97448
1:4:5,0,-1,102553,97447
1:4:3,0,-1,102554,97446
5:1:5,0,-1,102555,97445
2:6:6,1,1,102554,97446
6:6:4,0,-1,102555,97445
5:4:6,0,-1,102556,97444
2:2:4,2,2,102554,97446
1:6:5,0,-1,102555,97445
1:5:6,0,-1,102556,97444
4:2:5,1,1,102555,97445
4:3:6,0,-1,102556,97444
6:1:1,0,-1,102557,97443
3:1:3,0,-1,102558,97442
4:6:3,0,-1,102559,97441
5:5:4,0,-1,102560,97440
4:5:1,0,-1,102561,97439
2:5:2,2,2,102559,97441
5:4:1,0,-1,102560,97440
4:6:3,0,-1,102561,97439
1:3:3,0,-1,102562,97438
2:2:5,2,2,102560,97440
2:3:5,1,1,102559,97441
1:5:6,0,-1,102560,97440
2:6:3,1,1,102559,97441
3:3:1,0,-1,102560,97440
6:3:1,0,-1,102561,97439
5:6:1,0,-1,102562,97438
4:3:6,0,-1,102563,97437
1:1:6,0,-1,102564,97436
5:5:5,0,-1,102565,97435
5:2:3,1,1,102564,97436
2:6:4,1,1,102563,97437
2:4:5,1,1,102562,97438
6:6:3,0,-1,102563,97437
2:5:4,1,1,102562,97438
3:3:2,1,1,102561,97439
4:3:1,0,-1,102562,97438
1:3:6,0,-1,102563,97437
3:1:4,0,-1,102564,97436
4:4:4,0,-1,102565,97435
4:1:6,0,-1,102566,97434
2:1:1,1,1,102565,97435
4:1:1,0,-1,102566,97434
1:2:4,1,1,102565,97435
2:5:3,1,1,102564,97436
5:6:5,0,-1,102565,97435
4:3:4,0,-1,102566,97434
6:3:5,0,-1,102567,97433
3:5:6,0,-1,102568,97432
5:5:4,0,-1,102569,97431
1:1:5,0,-1,102570,97430
2:2:5,2,2,102568,97432
1:2:1,1,1,102567,97433
3:3:6,0,-1,102568,97432
6:2:2,2,2,102566,97434
1:3:2,1,1,102565,97435
1:2:6,1,1,102564,97436
5:6:1,0,-1,102565,97435
1:2:6,1,1,102564,97436
1:4:6,0,-1,102565,97435
6:1:5,0,-1,102566,97434
6:2:6,1,1,102565,97435
6:6:5,0,-1,102566,97434
4:4:3,0,-1,102567,97433
6:4:6,0,-1,102568,97432
4:1:5,0,-1,102569,97431
4:6:1,0,-1,102570,97430
5:2:1,1,1,102569,97431
1:3:4,0,-1,102570,97430
3:1:1,0,-1,102571,97429
5:3:5,0,-1,102572,97428
3:4:2,1,1,102571,97429
2:3:6,1,1,102570,97430
2:3:1,1,1,102569,97431
3:1:5,0,-1,102570,97430
5:4:4,0,-1,102571,97429
6:1:1,0,-1,102572,97428
3:3:1,0,-1,102573,97427
6:2:4,1,1,102572,97428
6:6:3,0,-1,102573,97427
5:3:1,0,-1,102574,97426
3:6:3,0,-1,102575,97425
3:5:3,0,-1,102576,97424
5:3:1,0,-1,102577,97423
4:5:2,1,1,102576,97424
6:4:4,0,-1,102577,97423
5:4:4,0,-1,102578,97422
2:5:6,1,1,102577,97423
5:5:4,0,-1,102578,97422
1:2:2,2,2,102576,97424
5:2:6,1,1,102575,97425
1:6:2,1,1,102574,97426
6:3:4,0,-1,102575,97425
2:1:5,1,1,102574,97426
4:2:4,1,1,102573,97427
4:5:2,1,1,102572,97428
5:6:1,0,-1,102573,97427
1:4:5,0,-1,102574,97426
1:3:1,0,-1,102575,97425
3:5:1,0,-1,102576,97424
5:3:3,0,-1,102577,97423
2:6:5,1,1,102576,97424
6:1:1,0,-1,102577,97423
5:2:2,2,2,102575,97425
4:3:5,0,-1,102576,97424
4:4:1,0,-1,102577,97423
4:3:1,0,-1,102578,97422
5:3:2,1,1,102577,97423
3:6:6,0,-1,102578,97422
3:2:2,2,2,102576,97424
3:2:6,1,1,102575,97425
3:5:4,0,-1,102576,97424
3:2:6,1,1,102575,97425
1:6:5,0,-1,102576,97424
5:3:5,0,-1,102577,97423
1:1:5,0,-1,102578,97422
1:3:3,0,-1,102579,97421
5:2:3,1,1,102578,97422
4:1:2,1,1,102577,97423
5:1:2,1,1,102576,97424
5:4:2,1,1,102575,97425
1:5:2,1,1,102574,97426
1:6:3,0,-1,102575,97425
6:1:6,0,-1,102576,97424
2:2:2,3,3,102573,97427
5:2:3,1,1,102572,97428
2:5:1,1,1,102571,97429
5:6:2,1,1,102570,97430
5:6:2,1,1,102569,97431
4:1:3,0,-1,102570,97430
6:2:1,1,1,102569,97431
6:2:4,1,1,102568,97432
3:6:5,0,-1,102569,97431
2:1:2,2,2,102567,97433
6:1:2,1,1,102566,97434
5:6:3,0,-1,102567,97433
5:5:2,1,1,102566,97434
6:2:2,2,2,102564,97436
4:4:4,0,-1,102565,97435
3:3:2,1,1,102564,97436
1:3:1,0,-1,102565,97435
5:2:4,1,1,102564,97436
2:5:2,2,2,102562,97438
5:5:5,0,-1,102563,97437
2:4:1,1,1,102562,97438
3:3:6,0,-1,102563,97437
2:2:1,2,2,102561,97439
2:4:1,1,1,102560,97440
6:2:6,1,1,102559,97441
6:6:2,1,1,102558,97442
1:4:1,0,-1,102559,97441
1:6:5,0,-1,102560,97440
2:6:1,1,1,102559,97441
4:5:3,0,-1,102560,97440
5:1:4,0,-1,102561,97439
6:4:5,0,-1,102562,97438
4:5:2,1,1,102561,97439
4:5:6,0,-1,102562,97438
4:3:5,0,-1,102563,97437
1:2:4,1,1,102562,97438
4:4:5,0,-1,102563,97437
3:1:4,0,-1,102564,97436
2:2:2,3,3,102561,97439
4:6:3,0,-1,102562,97438
5:4:6,0,-1,102563,97437
5:4:3,0,-1,102564,97436
2:5:5,1,1,102563,97437
6:3:6,0,-1,102564,97436
5:5:3,0,-1,102565,97435
4:4:1,0,-1,102566,97434
1:5:3,0,-1,102567,97433
4:6:2,1,1,102566,97434
1:3:3,0,-1,102567,97433
5:6:6,0,-1,102568,97432
5:2:2,2,2,102566,97434
2:5:1,1,1,102565,97435
3:5:3,0,-1,102566,97434
3:6:4,0,-1,102567,97433
1:3:5,0,-1,102568,97432
6:2:1,1,1,102567,97433
6:4:2,1,1,102566,97434
1:1:4,0,-1,102567,97433
4:4:4,0,-1,102568,97432
1:1:5,0,-1,102569,97431
2:1:6,1,1,102568,97432
6:6:5,0,-1,102569,97431
5:5:1,0,-1,102570,97430
2:4:5,1,1,102569,97431
2:4:2,2,2,102567,97433
1:4:1,0,-1,102568,97432
2:6:4,1,1,102567,97433
6:4:4,0,-1,102568,97432
1:1:4,0,-1,102569,97431
6:3:1,0,-1,102570,97430
3:5:4,0,-1,102571,97429
1:6:4,0,-1,102572,97428
3:4:6,0,-1,102573,97427
2:4:4,1,1,102572,97428
4:4:5,0,-1,102573,97427
1:1:2,1,1,102572,97428
1:6:4,0,-1,102573,97427
4:5:1,0,-1,102574,97426
1:5:1,0,-1,102575,97425
5:6:6,0,-1,102576,97424
5:4:6,0,-1,102577,97423
1:4:6,0,-1,102578,97422
3:1:3,0,-1,102579,97421
3:3:6,0,-1,102580,97420
2:2:3,2,2,102578,97422
2:2:4,2,2,102576,97424
1:3:5,0,-1,102577,97423
1:3:1,0,-1,102578,97422
4:6:3,0,-1,102579,97421
5:4:6,0,-1,102580,97420
4:6:1,0,-1,102581,97419
4:4:2,1,1,102580,97420
6:4:2,1,1,102579,97421
6:4:2,1,1,102578,97422
3:1:3,0,-1,102579,97421
6:2:5,1,1,102578,97422
1:5:6,0,-1,102579,97421
3:5:3,0,-1,102580,97420
2:4:2,2,2,102578,97422
6:1:5,0,-1,102579,97421
1:4:5,0,-1,102580,97420
4:3:5,0,-1,102581,97419
4:2:3,1,1,102580,97420
1:1:5,0,-1,102581,97419
1:5:1,0,-1,102582,97418
6:2:4,1,1,102581,97419
1:1:5,0,-1,102582,97418
4:3:6,0,-1,102583,97417
5:1:5,0,-1,102584,97416
5:4:4,0,-1,102585,97415
3:4:2,1,1,102584,97416
4:6:3,0,-1,102585,97415
1:2:6,1,1,102584,97416
1:3:3,0,-1,102585,97415
4:1:1,0,-1,102586,97414
3:3:2,1,1,102585,97415
5:5:6,0,-1,102586,97414
6:5:2,1,1,102585,97415
5:3:3,0,-1,102586,97414
3:1:3,0,-1,102587,97413
6:2:4,1,1,102586,97414
4:2:5,1,1,102585,97415
1:1:3,0,-1,102586,97414
2:4:1,1,1,102585,97415
5:1:3,0,-1,102586,97414
3:6:3,0,-1,102587,97413
3:6:5,0,-1,102588,97412
1:6:4,0,-1,102589,97411
1:3:4,0,-1,102590,97410
6:2:2,2,2,102588,97412
2:1:6,1,1,102587,97413
5:3:1,0,-1,102588,97412
6:1:5,0,-1,102589,97411
5:3:3,0,-1,102590,97410
4:2:1,1,1,102589,97411
1:5:5,0,-1,102590,97410
2:5:2,2,2,102588,97412
5:5:1,0,-1,102589,97411
4:3:5,0,-1,102590,97410
5:5:2,1,1,102589,97411
2:6:3,1,1,102588,97412
3:6:3,0,-1,102589,97411
2:4:1,1,1,102588,97412
1:2:2,2,2,102586,97414
2:2:2,3,3,102583,97417
2:4:6,1,1,102582,97418
1:3:2,1,1,102581,97419
4:1:3,0,-1,102582,97418
5:4:1,0,-1,102583,97417
3:6:5,0,-1,102584,97416
2:1:2,2,2,102582,97418
3:1:3,0,-1,102583,97417
1:3:6,0,-1,102584,97416
5:5:4,0,-1,102585,97415
5:1:4,0,-1,102586,97414
1:6:2,1,1,102585,97415
6:3:3,0,-1,102586,97414
5:3:4,0,-1,102587,97413
1:2:1,1,1,102586,97414
3:2:5,1,1,102585,97415
2:1:1,1,1,102584,97416
6:3:2,1,1,102583,97417
4:1:5,0,-1,102584,97416
2:4:1,1,1,102583,97417
2:2:2,3,3,102580,97420
1:4:1,0,-1,102581,97419
1:6:1,0,-1,102582,97418
4:1:2,1,1,102581,97419
6:4:1,0,-1,102582,97418
4:5:2,1,1,102581,97419
2:4:3,1,1,102580,97420
4:4:1,0,-1,102581,97419
4:4:2,1,1,102580,97420
3:3:6,0,-1,102581,97419
4:2:2,2,2,102579,97421
1:3:1,0,-1,102580,97420
1:3:5,0,-1,102581,97419
1:1:3,0,-1,102582,97418
2:3:2,2,2,102580,97420
1:4:1,0,-1,102581,97419
2:5:3,1,1,102580,97420
6:4:5,0,-1,102581,97419
2:3:2,2,2,102579,97421
1:3:2,1,1,102578,97422
3:5:5,0,-1,102579,97421
1:2:5,1,1,102578,97422
4:4:2,1,1,102577,97423
1:6:4,0,-1,102578,97422
2:5:2,2,2,102576,97424
3:1:3,0,-1,102577,97423
2:3:2,2,2,102575,97425
5:3:6,0,-1,102576,97424
6:5:3,0,-1,102577,97423
3:1:4,0,-1,102578,97422
3:2:6,1,1,102577,97423
4:1:4,0,-1,102578,97422
5:6:1,0,-1,102579,97421
2:2:1,2,2,102577,97423
4:5:1,0,-1,102578,97422
6:1:3,0,-1,102579,97421
5:6:1,0,-1,102580,97420
6:2:2,2,2,102578,97422
3:5:3,0,-1,102579,97421
5:2:6,1,1,102578,97422
3:3:5,0,-1,102579,97421
2:5:1,1,1,102578,97422
2:2:4,2,2,102576,97424
1:6:2,1,1,102575,97425
6:2:1,1,1,102574,97426
3:5:4,0,-1,102575,97425
1:1:5,0,-1,102576,97424
3:5:4,0,-1,102577,97423
3:5:2,1,1,102576,97424
6:4:4,0,-1,102577,97423
4:3:6,0,-1,102578,97422
4:6:6,0,-1,102579,97421
6:6:2,1,1,102578,97422
2:4:5,1,1,102577,97423
6:4:1,0,-1,102578,97422
4:4:3,0,-1,102579,97421
3:2:2,2,2,102577,97423
1:1:1,0,-1,102578,97422
2:4:6,1,1,102577,97423
3:3:5,0,-1,102578,97422
3:6:1,0,-1,102579,97421
5:2:5,1,1,102578,97422
3:6:3,0,-1,102579,97421
3:2:6,1,1,102578,97422
2:5:6,1,1,102577,97423
5:6:4,0,-1,102578,97422
3:2:5,1,1,102577,97423
3:2:1,1,1,102576,97424
5:5:2,1,1,102575,97425
6:4:2,1,1,102574,97426
1:1:4,0,-1,102575,97425
2:5:6,1,1,102574,97426
6:4:4,0,-1,102575,97425
1:6:4,0,-1,102576,97424
3:4:5,0,-1,102577,97423
1:1:3,0,-1,102578,97422
2:1:4,1,1,102577,97423
2:5:6,1,1,102576,97424
2:6:1,1,1,102575,97425
2:1:3,1,1,102574,97426
5:1:2,1,1,102573,97427
1:3:4,0,-1,102574,97426
6:5:5,0,-1,102575,97425
3:4:4,0,-1,102576,97424
6:6:6,0,-1,102577,97423
2:3:5,1,1,102576,97424
5:3:5,0,-1,102577,97423
3:1:5,0,-1,102578,97422
2:6:5,1,1,102577,97423
3:1:1,0,-1,102578,97422
1:5:2,1,1,102577,97423
6:3:4,0,-1,102578,97422
4:1:2,1,1,102577,97423
6:6:1,0,-1,102578,97422
5:6:4,0,-1,102579,97421
4:1:4,0,-1,102580,97420
3:3:3,0,-1,102581,97419
1:1:2,1,1,102580,97420
6:4:5,0,-1,102581,97419
5:5:5,0,-1,102582,97418
1:5:4,0,-1,102583,97417
4:6:4,0,-1,102584,97416
6:1:4,0,-1,102585,97415
1:3:6,0,-1,102586,97414
5:4:4,0,-1,102587,97413
2:1:1,1,1,102586,97414
3:1:3,0,-1,102587,97413
5:5:2,1,1,102586,97414
5:6:1,0,-1,102587,97413
5:3:1,0,-1,102588,97412
3:2:1,1,1,102587,97413
4:5:5,0,-1,102588,97412
4:2:6,1,1,102587,97413
5:5:4,0,-1,102588,97412
2:4:1,1,1,102587,97413
6:3:2,1,1,102586,97414
2:6:1,1,1,102585,97415
1:3:1,0,-1,102586,97414
2:2:3,2,2,102584,97416
3:1:5,0,-1,102585,97415
3:1:4,0,-1,102586,97414
5:5:3,0,-1,102587,97413
6:4:4,0,-1,102588,97412
3:5:6,0,-1,102589,97411
4:4:4,0,-1,102590,97410
3:3:5,0,-1,102591,97409
2:5:5,1,1,102590,97410
4:4:3,0,-1,102591,97409
5:2:5,1,1,102590,97410
3:4:6,0,-1,102591,97409
6:5:3,0,-1,102592,97408
3:6:5,0,-1,102593,97407
6:1:6,0,-1,102594,97406
4:5:5,0,-1,102595,97405
5:2:1,1,1,102594,97406
2:4:1,1,1,102593,97407
6:6:4,0,-1,102594,97406
2:4:2,2,2,102592,97408
4:2:1,1,1,102591,97409
2:4:1,1,1,102590,97410
3:5:2,1,1,102589,97411
3:5:5,0,-1,102590,97410
5:4:3,0,-1,102591,97409
5:5:6,0,-1,102592,97408
3:6:2,1,1,102591,97409
4:4:3,0,-1,102592,97408
4:6:1,0,-1,102593,97407
6:4:1,0,-1,102594,97406
3:4:2,1,1,102593,97407
6:6:6,0,-1,102594,97406
4:4:1,0,-1,102595,97405
5:1:1,0,-1,102596,97404
4:4:6,0,-1,102597,97403
1:5:2,1,1,102596,97404
2:4:6,1,1,102595,97405
6:4:5,0,-1,102596,97404
4:1:3,0,-1,102597,97403
5:4:6,0,-1,102598,97402
4:5:4,0,-1,102599,97401
3:3:6,0,-1,102600,97400
2:2:1,2,2,102598,97402
3:3:4,0,-1,102599,97401
5:3:2,1,1,102598,97402
3:3:5,0,-1,102599,97401
2:1:3,1,1,102598,97402
5:3:1,0,-1,102599,97401
5:1:3,0,-1,102600,97400
1:2:5,1,1,102599,97401
1:6:6,0,-1,102600,97400
6:5:2,1,1,102599,97401
6:1:4,0,-1,102600,97400
4:5:3,0,-1,102601,97399
1:3:3,0,-1,102602,97398
2:5:2,2,2,102600,97400
5:1:3,0,-1,102601,97399
2:2:1,2,2,102599,97401
2:3:4,1,1,102598,97402
1:3:6,0,-1,102599,97401
3:2:4,1,1,102598,97402
2:6:5,1,1,102597,97403
5:4:2,1,1,102596,97404
4:1:4,0,-1,102597,97403
6:2:6,1,1,102596,97404
5:4:4,0,-1,102597,97403
3:4:1,0,-1,102598,97402
4:4:5,0,-1,102599,97401
5:5:6,0,-1,102600,97400
1:5:5,0,-1,102601,97399
5:4:6,0,-1,102602,97398
1:4:6,0,-1,102603,97397
1:4:1,0,-1,102604,97396
4:1:1,0,-1,102605,97395
6:4:6,0,-1,102606,97394
2:4:4,1,1,102605,97395
4:2:1,1,1,102604,97396
3:4:3,0,-1,102605,97395
5:3:4,0,-1,102606,97394
1:3:1,0,-1,102607,97393
1:3:6,0,-1,102608,97392
4:5:2,1,1,102607,97393
1:2:6,1,1,102606,97394
2:1:1,1,1,102605,97395
6:2:3,1,1,102604,97396
4:2:2,2,2,102602,97398
2:4:5,1,1,102601,97399
2:6:2,2,2,102599,97401
1:3:3,0,-1,102600,97400
4:2:3,1,1,102599,97401
3:1:2,1,1,102598,97402
5:6:2,1,1,102597,97403
1:1:1,0,-1,102598,97402
5:4:6,0,-1,102599,97401
3:2:3,1,1,102598,97402
3:3:3,0,-1,102599,97401
3:1:1,0,-1,102600,97400
2:1:1,1,1,102599,97401
5:3:6,0,-1,102600,97400
1:4:4,0,-1,102601,97399
5:2:2,2,2,102599,97401
3:6:6,0,-1,102600,97400
3:4:5,0,-1,102601,97399
1:3:1,0,-1,102602,97398
2:1:4,1,1,102601,97399
4:5:1,0,-1,102602,97398
2:5:6,1,1,102601,97399
4:2:4,1,1,102600,97400
1:4:3,0,-1,102601,97399
6:3:6,0,-1,102602,97398
5:3:1,0,-1,102603,97397
5:1:6,0,-1,102604,97396
4:4:4,0,-1,102605,97395
4:6:5,0,-1,102606,97394
6:6:4,0,-1,102607,97393
1:6:2,1,1,102606,97394
6:4:4,0,-1,102607,97393
3:1:2,1,1,102606,97394
4:1:5,0,-1,102607,97393
3:6:6,0,-1,102608,97392
4:2:4,1,1,102607,97393
4:4:1,0,-1,102608,97392
3:1:1,0,-1,102609,97391
6:6:4,0,-1,102610,97390
1:4:2,1,1,102609,97391
2:4:2,2,2,102607,97393
6:5:5,0,-1,102608,97392
1:5:1,0,-1,102609,97391
2:2:2,3,3,102606,97394
2:6:5,1,1,102605,97395
5:1:6,0,-1,102606,97394
5:5:5,0,-1,102607,97393
1:1:6,0,-1,102608,97392
3:1:3,0,-1,102609,97391
3:6:3,0,-1,102610,97390
2:1:6,1,1,102609,97391
2:5:2,2,2,102607,97393
2:3:4,1,1,102606,97394
6:4:1,0,-1,102607,97393
2:2:3,2,2,102605,97395
2:1:5,1,1,102604,97396
1:5:5,0,-1,102605,97395
1:3:3,0,-1,102606,97394
6:6:3,0,-1,102607,97393
1:3:3,0,-1,102608,97392
5:1:4,0,-1,102609,97391
3:2:3,1,1,102608,97392
6:3:4,0,-1,102609,97391
5:2:5,1,1,102608,97392
3:3:4,0,-1,102609,97391
4:1:1,0,-1,102610,97390
4:2:6,1,1,102609,97391
2:5:5,1,1,102608,97392
4:5:2,1,1,102607,97393
4:1:3,0,-1,102608,97392
1:4:1,0,-1,102609,97391
1:5:4,0,-1,102610,97390
2:3:6,1,1,102609,97391
5:2:4,1,1,102608,97392
2:6:6,1,1,102607,97393
6:5:5,0,-1,102608,97392
3:1:5,0,-1,102609,97391
6:5:2,1,1,102608,97392
3:6:4,0,-1,102609,97391
5:3:2,1,1,102608,97392
4:5:5,0,-1,102609,97391
5:4:1,0,-1,102610,97390
3:4:1,0,-1,102611,97389
1:4:5,0,-1,102612,97388
1:6:5,0,-1,102613,97387
1:1:3,0,-1,102614,97386
4:5:6,0,-1,102615,97385
3:4:4,0,-1,102616,97384
4:2:6,1,1,102615,97385
5:5:6,0,-1,102616,97384
4:5:1,0,-1,102617,97383
4:3:6,0,-1,102618,97382
3:3:3,0,-1,102619,97381
3:2:2,2,2,102617,97383
1:4:2,1,1,102616,97384
6:4:3,0,-1,102617,97383
6:2:1,1,1,102616,97384
3:6:4,0,-1,102617,97383
5:2:1,1,1,102616,97384
1:2:2,2,2,102614,97386
3:5:3,0,-1,102615,97385
2:2:1,2,2,102613,97387
4:2:5,1,1,102612,97388
3:6:5,0,-1,102613,97387
6:6:3,0,-1,102614,97386
6:3:1,0,-1,102615,97385
5:2:4,1,1,102614,97386
1:2:3,1,1,102613,97387
1:6:2,1,1,102612,97388
5:6:6,0,-1,102613,97387
6:1:1,0,-1,102614,97386
4:1:6,0,-1,102615,97385
1:6:2,1,1,102614,97386
6:3:5,0,-1,102615,97385
2:6:2,2,2,102613,97387
6:2:3,1,1,102612,97388
1:1:6,0,-1,102613,97387
3:5:4,0,-1,102614,97386
1:3:1,0,-1,102615,97385
6:4:1,0,-1,102616,97384
1:4:1,0,-1,102617,97383
2:5:5,1,1,102616,97384
6:3:3,0,-1,102617,97383
5:1:5,0,-1,102618,97382
1:2:2,2,2,102616,97384
4:6:1,0,-1,102617,97383
3:1:1,0,-1,102618,97382
2:3:2,2,2,102616,97384
3:6:2,1,1,102615,97385
3:1:5,0,-1,102616,97384
4:1:4,0,-1,102617,97383
1:3:1,0,-1,102618,97382
2:3:2,2,2,102616,97384
6:4:5,0,-1,102617,97383
1:2:5,1,1,102616,97384
4:4:6,0,-1,102617,97383
5:1:5,0,-1,102618,97382
5:1:1,0,-1,102619,97381
4:5:3,0,-1,102620,97380
6:6:5,0,-1,102621,97379
3:3:2,1,1,102620,97380
3:1:2,1,1,102619,97381
5:3:4,0,-1,102620,97380
3:5:3,0,-1,102621,97379
4:5:1,0,-1,102622,97378
5:3:1,0,-1,102623,97377
5:2:3,1,1,102622,97378
2:6:3,1,1,102621,97379
6:5:5,0,-1,102622,97378
1:2:2,2,2,102620,97380
4:4:4,0,-1,102621,97379
4:3:3,0,-1,102622,97378
3:3:5,0,-1,102623,97377
6:5:4,0,-1,102624,97376
4:2:2,2,2,102622,97378
6:3:1,0,-1,102623,97377
3:5:4,0,-1,102624,97376
1:6:2,1,1,102623,97377
5:6:5,0,-1,102624,97376
3:1:5,0,-1,102625,97375
3:6:5,0,-1,102626,97374
5:4:6,0,-1,102627,97373
3:6:5,0,-1,102628,97372
5:5:1,0,-1,102629,97371
3:5:3,0,-1,102630,97370
6:5:4,0,-1,102631,97369
4:1:1,0,-1,102632,97368
2:4:3,1,1,102631,97369
2:3:2,2,2,102629,97371
6:1:1,0,-1,102630,97370
1:1:6,0,-1,102631,97369
4:5:1,0,-1,102632,97368
4:1:3,0,-1,102633,97367
3:6:4,0,-1,102634,97366
2:3:4,1,1,102633,97367
4:2:4,1,1,102632,97368
3:2:6,1,1,102631,97369
3:6:6,0,-1,102632,97368
6:5:2,1,1,102631,97369
4:1:3,0,-1,102632,97368
3:1:3,0,-1,102633,97367
5:5:1,0,-1,102634,97366
3:3:5,0,-1,102635,97365
3:5:3,0,-1,102636,97364
3:1:5,0,-1,102637,97363
6:4:5,0,-1,102638,97362
2:2:1,2,2,102636,97364
3:4:6,0,-1,102637,97363
5:2:1,1,1,102636,97364
3:2:2,2,2,102634,97366
2:1:5,1,1,102633,97367
6:2:4,1,1,102632,97368
6:3:4,0,-1,102633,97367
6:6:6,0,-1,102634,97366
5:6:3,0,-1,102635,97365
6:3:4,0,-1,102636,97364
1:6:5,0,-1,102637,97363
1:6:4,0,-1,102638,97362
5:4:2,1,1,102637,97363
3:1:1,0,-1,102638,97362
1:4:5,0,-1,102639,97361
5:4:3,0,-1,102640,97360
3:4:5,0,-1,102641,97359
5:6:2,1,1,102640,97360
5:6:2,1,1,102639,97361
2:1:2,2,2,102637,97363
5:5:3,0,-1,102638,97362
1:3:3,0,-1,102639,97361
6:1:6,0,-1,102640,97360
1:1:1,0,-1,102641,97359
4:6:5,0,-1,102642,97358
6:4:5,0,-1,102643,97357
2:3:6,1,1,102642,97358
6:4:5,0,-1,102643,97357
1:4:1,0,-1,102644,97356
5:1:6,0,-1,102645,97355
3:6:1,0,-1,102646,97354
1:1:5,0,-1,102647,97353
5:6:2,1,1,102646,97354
5:4:6,0,-1,102647,97353
6:3:4,0,-1,102648,97352
5:2:5,1,1,102647,97353
3:5:1,0,-1,102648,97352
4:1:3,0,-1,102649,97351
2:1:4,1,1,102648,97352
5:6:2,1,1,102647,97353
2:5:1,1,1,102646,97354
2:4:4,1,1,102645,97355
1:1:5,0,-1,102646,97354
4:3:4,0,-1,102647,97353
5:2:4,1,1,102646,97354
2:5:5,1,1,102645,97355
1:2:1,1,1,102644,97356
3:4:6,0,-1,102645,97355
3:4:2,1,1,102644,97356
1:4:1,0,-1,102645,97355
4:4:5,0,-1,102646,97354
3:6:3,0,-1,102647,97353
4:2:1,1,1,102646,97354
1:5:6,0,-1,102647,97353
2:1:4,1,1,102646,97354
1:3:1,0,-1,102647,97353
1:6:6,0,-1,102648,97352
5:4:2,1,1,102647,97353
6:5:4,0,-1,102648,97352
1:2:1,1,1,102647,97353
6:2:5,1,1,102646,97354
1:2:1,1,1,102645,97355
6:1:4,0,-1,102646,97354
5:2:2,2,2,102644,97356
6:4:6,0,-1,102645,97355
3:3:1,0,-1,102646,97354
6:2:1,1,1,102645,97355
3:2:5,1,1,102644,97356
2:4:3,1,1,102643,97357
6:3:2,1,1,102642,97358
3:1:1,0,-1,102643,97357
1:5:4,0,-1,102644,97356
3:1:4,0,-1,102645,97355
3:6:1,0,-1,102646,97354
4:3:5,0,-1,102647,97353
5:2:3,1,1,102646,97354
1:6:1,0,-1,102647,97353
2:5:3,1,1,102646,97354
4:4:1,0,-1,102647,97353
2:1:6,1,1,102646,97354
3:6:2,1,1,102645,97355
1:4:3,0,-1,102646,97354
6:2:4,1,1,102645,97355
4:2:5,1,1,102644,97356
6:4:2,1,1,102643,97357
2:6:5,1,1,102642,97358
6:1:3,0,-1,102643,97357
1:5:5,0,-1,102644,97356
4:6:6,0,-1,102645,97355
3:4:3,0,-1,102646,97354
5:3:1,0,-1,102647,97353
1:1:4,0,-1,102648,97352
6:4:4,0,-1,102649,97351
4:4:2,1,1,102648,97352
4:1:4,0,-1,102649,97351
5:5:6,0,-1,102650,97350
2:3:5,1,1,102649,97351
4:2:3,1,1,102648,97352
3:2:2,2,2,102646,97354
1:1:6,0,-1,102647,97353
5:5:1,0,-1,102648,97352
1:3:4,0,-1,102649,97351
2:3:1,1,1,102648,97352
4:5:5,0,-1,102649,97351
2:1:3,1,1,102648,97352
4:6:1,0,-1,102649,97351
2:5:2,2,2,102647,97353
4:2:5,1,1,102646,97354
4:5:4,0,-1,102647,97353
6:1:5,0,-1,102648,97352
5:4:2,1,1,102647,97353
3:1:1,0,-1,102648,97352
4:6:4,0,-1,102649,97351
4:6:3,0,-1,102650,97350
5:3:3,0,-1,102651,97349
3:2:1,1,1,102650,97350
6:4:2,1,1,102649,97351
4:5:3,0,-1,102650,97350
6:1:4,0,-1,102651,97349
6:5:1,0,-1,102652,97348
1:1:2,1,1,102651,97349
5:6:3,0,-1,102652,97348
5:6:5,0,-1,102653,97347
1:3:4,0,-1,102654,97346
2:2:6,2,2,102652,97348
3:5:2,1,1,102651,97349
1:4:4,0,-1,102652,97348
2:1:5,1,1,102651,97349
6:4:5,0,-1,102652,97348
1:1:5,0,-1,102653,97347
5:1:5,0,-1,102654,97346
3:3:1,0,-1,102655,97345
1:3:1,0,-1,102656,97344
4:6:1,0,-1,102657,97343
4:1:1,0,-1,102658,97342
3:5:1,0,-1,102659,97341
3:2:3,1,1,102658,97342
5:1:6,0,-1,102659,97341
3:5:4,0,-1,102660,97340
2:4:3,1,1,102659,97341
4:4:6,0,-1,102660,97340
4:4:1,0,-1,102661,97339
3:6:2,1,1,102660,97340
2:1:2,2,2,102658,97342
1:1:2,1,1,102657,97343
1:6:4,0,-1,102658,97342
6:2:2,2,2,102656,97344
3:6:3,0,-1,102657,97343
4:6:6,0,-1,102658,97342
1:4:3,0,-1,102659,97341
6:3:2,1,1,102658,97342
5:5:1,0,-1,102659,97341
1:2:6,1,1,102658,97342
3:4:2,1,1,102657,97343
4:5:2,1,1,102656,97344
6:6:2,1,1,102655,97345
3:4:1,0,-1,102656,97344
3:1:1,0,-1,102657,97343
4:1:5,0,-1,102658,97342
3:5:3,0,-1,102659,97341
1:1:2,1,1,102658,97342
3:4:1,0,-1,102659,97341
2:3:6,1,1,102658,97342
4:6:4,0,-1,102659,97341
5:4:4,0,-1,102660,97340
3:1:4,0,-1,102661,97339
4:1:3,0,-1,102662,97338
2:2:2,3,3,102659,97341
1:6:3,0,-1,102660,97340
1:3:1,0,-1,102661,97339
3:4:6,0,-1,102662,97338
1:3:2,1,1,102661,97339
2:2:6,2,2,102659,97341
5:5:4,0,-1,102660,97340
2:4:6,1,1,102659,97341
2:6:6,1,1,102658,97342
1:3:5,0,-1,102659,97341
3:3:4,0,-1,102660,97340
1:4:3,0,-1,102661,97339
2:4:1,1,1,102660,97340
4:1:4,0,-1,102661,97339
6:2:5,1,1,102660,97340
1:1:1,0,-1,102661,97339
3:6:5,0,-1,102662,97338
6:6:5,0,-1,102663,97337
2:2:4,2,2,102661,97339
4:5:2,1,1,102660,97340
3:4:5,0,-1,102661,97339
2:1:3,1,1,102660,97340
4:4:4,0,-1,102661,97339
6:5:2,1,1,102660,97340
5:2:5,1,1,102659,97341
2:1:2,2,2,102657,97343
5:3:2,1,1,102656,97344
1:6:4,0,-1,102657,97343
2:5:1,1,1,102656,97344
3:1:2,1,1,102655,97345
4:6:6,0,-1,102656,97344
5:4:4,0,-1,102657,97343
4:3:6,0,-1,102658,97342
2:6:3,1,1,102657,97343
3:2:3,1,1,102656,97344
1:5:6,0,-1,102657,97343
5:4:1,0,-1,102658,97342
1:4:5,0,-1,102659,97341
5:5:6,0,-1,102660,97340
1:1:4,0,-1,102661,97339
4:5:2,1,1,102660,97340
4:6:2,1,1,102659,97341
3:1:6,0,-1,102660,97340
3:3:2,1,1,102659,97341
3:5:5,0,-1,102660,97340
6:2:1,1,1,102659,97341
4:3:4,0,-1,102660,97340
6:1:6,0,-1,102661,97339
1:4:4,0,-1,102662,97338
2:5:4,1,1,102661,97339
3:2:5,1,1,102660,97340
4:1:6,0,-1,102661,97339
3:5:3,0,-1,102662,97338
2:6:2,2,2,102660,97340
5:6:4,0,-1,102661,97339
6:1:2,1,1,102660,97340
1:6:3,0,-1,102661,97339
2:4:6,1,1,102660,97340
3:6:5,0,-1,102661,97339
2:3:1,1,1,102660,97340
1:6:3,0,-1,102661,97339
4:6:1,0,-1,102662,97338
6:5:3,0,-1,102663,97337
1:3:3,0,-1,102664,97336
6:3:4,0,-1,102665,97335
1:4:1,0,-1,102666,97334
1:3:2,1,1,102665,97335
1:2:5,1,1,102664,97336
3:1:2,1,1,102663,97337
4:4:3,0,-1,102664,97336
5:2:5,1,1,102663,97337
6:5:2,1,1,102662,97338
4:3:1,0,-1,102663,97337
3:2:2,2,2,102661,97339
1:3:1,0,-1,102662,97338
2:5:4,1,1,102661,97339
1:6:6,0,-1,102662,97338
3:5:4,0,-1,102663,97337
2:4:2,2,2,102661,97339
4:1:6,0,-1,102662,97338
6:4:5,0,-1,102663,97337
4:1:4,0,-1,102664,97336
3:2:3,1,1,102663,97337
2:2:5,2,2,102661,97339
5:3:4,0,-1,102662,97338
3:2:1,1,1,102661,97339
3:2:4,1,1,102660,97340
5:2:2,2,2,102658,97342
3:3:5,0,-1,102659,97341
1:2:6,1,1,102658,97342
6:4:2,1,1,102657,97343
1:1:3,0,-1,102658,97342
2:3:3,1,1,102657,97343
6:3:6,0,-1,102658,97342
4:1:1,0,-1,102659,97341
2:2:1,2,2,102657,97343
5:4:6,0,-1,102658,97342
6:3:2,1,1,102657,97343
4:4:1,0,-1,102658,97342
2:1:6,1,1,102657,97343
5:2:1,1,1,102656,97344
4:4:5,0,-1,102657,97343
3:1:2,1,1,102656,97344
5:2:2,2,2,102654,97346
4:1:5,0,-1,102655,97345
4:6:3,0,-1,102656,97344
1:5:5,0,-1,102657,97343
5:4:5,0,-1,102658,97342
4:5:5,0,-1,102659,97341
3:4:6,0,-1,102660,97340
4:3:1,0,-1,102661,97339
3:2:4,1,1,102660,97340
5:5:5,0,-1,102661,97339
1:5:5,0,-1,102662,97338
4:2:3,1,1,102661,97339
6:5:6,0,-1,102662,97338
4:6:4,0,-1,102663,97337
1:6:6,0,-1,102664,97336
3:2:1,1,1,102663,97337
5:5:4,0,-1,102664,97336
2:4:2,2,2,102662,97338
4:3:6,0,-1,102663,97337
2:3:6,1,1,102662,97338
2:4:2,2,2,102660,97340
1:4:1,0,-1,102661,97339
6:4:1,0,-1,102662,97338
3:4:5,0,-1,102663,97337
1:5:6,0,-1,102664,97336
6:1:3,0,-1,102665,97335
4:2:3,1,1,102664,97336
4:2:4,1,1,102663,97337
1:3:3,0,-1,102664,97336
6:3:2,1,1,102663,97337
4:4:2,1,1,102662,97338
3:3:2,1,1,102661,97339
1:5:1,0,-1,102662,97338
6:5:6,0,-1,102663,97337
2:2:1,2,2,102661,97339
1:5:6,0,-1,102662,97338
3:4:1,0,-1,102663,97337
5:1:2,1,1,102662,97338
5:5:3,0,-1,102663,97337
2:1:6,1,1,102662,97338
3:1:6,0,-1,102663,97337
4:6:2,1,1,102662,97338
4:1:4,0,-1,102663,97337
6:2:4,1,1,102662,97338
6:5:3,0,-1,102663,97337
3:4:1,0,-1,102664,97336
2:1:2,2,2,102662,97338
6:4:3,0,-1,102663,97337
2:4:1,1,1,102662,97338
3:3:5,0,-1,102663,97337
5:6:2,1,1,102662,97338
2:3:5,1,1,102661,97339
5:5:4,0,-1,102662,97338
5:1:1,0,-1,102663,97337
6:3:3,0,-1,102664,97336
2:5:2,2,2,102662,97338
6:3:5,0,-1,102663,97337
4:5:5,0,-1,102664,97336
2:2:3,2,2,102662,97338
2:2:1,2,2,102660,97340
1:2:2,2,2,102658,97342
2:6:3,1,1,102657,97343
1:5:4,0,-1,102658,97342
2:6:5,1,1,102657,97343
6:4:3,0,-1,102658,97342
4:5:3,0,-1,102659,97341
4:4:5,0,-1,102660,97340
3:5:3,0,-1,102661,97339
2:4:5,1,1,102660,97340
1:6:5,0,-1,102661,97339
5:5:1,0,-1,102662,97338
6:2:2,2,2,102660,97340
3:2:1,1,1,102659,97341
1:3:2,1,1,102658,97342
6:2:2,2,2,102656,97344
3:5:3,0,-1,102657,97343
6:6:4,0,-1,102658,97342
3:6:3,0,-1,102659,97341
1:2:6,1,1,102658,97342
5:4:4,0,-1,102659,97341
4:1:6,0,-1,102660,97340
6:6:6,0,-1,102661,97339
6:1:5,0,-1,102662,97338
4:3:6,0,-1,102663,97337
5:3:2,1,1,102662,97338
5:3:2,1,1,102661,97339
1:3:1,0,-1,102662,97338
1:2:5,1,1,102661,97339
5:3:5,0,-1,102662,97338
3:1:2,1,1,102661,97339
5:6:1,0,-1,102662,97338
1:6:4,0,-1,102663,97337
3:6:4,0,-1,102664,97336
2:2:6,2,2,102662,97338
5:2:1,1,1,102661,97339
5:1:3,0,-1,102662,97338
4:4:4,0,-1,102663,97337
6:2:2,2,2,102661,97339
2:2:2,3,3,102658,97342
1:5:4,0,-1,102659,97341
6:5:4,0,-1,102660,97340
2:5:5,1,1,102659,97341
2:5:4,1,1,102658,97342
4:4:3,0,-1,102659,97341
3:2:6,1,1,102658,97342
4:5:5,0,-1,102659,97341
1:3:4,0,-1,102660,97340
1:5:4,0,-1,102661,97339
3:1:4,0,-1,102662,97338
4:5:4,0,-1,102663,97337
2:2:5,2,2,102661,97339
1:6:6,0,-1,102662,97338
1:2:5,1,1,102661,97339
5:6:4,0,-1,102662,97338
5:5:1,0,-1,102663,97337
5:4:5,0,-1,102664,97336
1:3:3,0,-1,102665,97335
3:6:3,0,-1,102666,97334
5:5:4,0,-1,102667,97333
5:1:1,0,-1,102668,97332
4:3:3,0,-1,102669,97331
3:3:4,0,-1,102670,97330
4:5:5,0,-1,102671,97329
1:3:3,0,-1,102672,97328
6:4:2,1,1,102671,97329
4:6:4,0,-1,102672,97328
6:5:5,0,-1,102673,97327
5:1:5,0,-1,102674,97326
2:4:2,2,2,102672,97328
4:3:5,0,-1,102673,97327
3:1:6,0,-1,102674,97326
5:5:5,0,-1,102675,97325
2:4:5,1,1,102674,97326
3:1:3,0,-1,102675,97325
6:5:4,0,-1,102676,97324
1:3:6,0,-1,102677,97323
4:2:6,1,1,102676,97324
2:5:2,2,2,102674,97326
6:6:5,0,-1,102675,97325
5:1:1,0,-1,102676,97324
3:2:3,1,1,102675,97325
4:2:1,1,1,102674,97326
3:6:2,1,1,102673,97327
4:5:2,1,1,102672,97328
3:4:3,0,-1,102673,97327
4:5:6,0,-1,102674,97326
3:1:3,0,-1,102675,97325
6:6:6,0,-1,102676,97324
5:5:3,0,-1,102677,97323
1:1:5,0,-1,102678,97322
5:5:1,0,-1,102679,97321
5:6:5,0,-1,102680,97320
4:4:1,0,-1,102681,97319
6:1:6,0,-1,102682,97318
3:6:2,1,1,102681,97319
2:4:5,1,1,102680,97320
3:6:6,0,-1,102681,97319
1:1:6,0,-1,102682,97318
3:2:6,1,1,102681,97319
6:6:2,1,1,102680,97320
6:4:2,1,1,102679,97321
1:5:1,0,-1,102680,97320
5:1:2,1,1,102679,97321
4:6:6,0,-1,102680,97320
5:5:2,1,1,102679,97321
3:4:6,0,-1,102680,97320
6:1:4,0,-1,102681,97319
6:2:6,1,1,102680,97320
3:4:4,0,-1,102681,97319
3:5:5,0,-1,102682,97318
6:6:6,0,-1,102683,97317
5:5:4,0,-1,102684,97316
1:1:6,0,-1,102685,97315
2:5:5,1,1,102684,97316
2:1:6,1,1,102683,97317
6:5:6,0,-1,102684,97316
6:5:3,0,-1,102685,97315
4:1:6,0,-1,102686,97314
4:6:4,0,-1,102687,97313
1:5:3,0,-1,102688,97312
2:6:6,1,1,102687,97313
4:5:4,0,-1,102688,97312
4:2:1,1,1,102687,97313
3:3:2,1,1,102686,97314
5:4:2,1,1,102685,97315
1:4:6,0,-1,102686,97314
4:4:5,0,-1,102687,97313
3:1:3,0,-1,102688,97312
5:6:4,0,-1,102689,97311
5:4:1,0,-1,102690,97310
3:4:5,0,-1,102691,97309
1:6:2,1,1,102690,97310
5:6:5,0,-1,102691,97309
1:6:2,1,1,102690,97310
5:5:3,0,-1,102691,97309
1:1:3,0,-1,102692,97308
2:1:4,1,1,102691,97309
2:6:6,1,1,102690,97310
1:5:3,0,-1,102691,97309
6:1:4,0,-1,102692,97308
1:6:2,1,1,102691,97309
1:2:6,1,1,102690,97310
4:1:4,0,-1,102691,97309
3:3:6,0,-1,102692,97308
2:5:3,1,1,102691,97309
5:2:3,1,1,102690,97310
3:4:6,0,-1,102691,97309
6:4:6,0,-1,102692,97308
6:4:2,1,1,102691,97309
6:1:4,0,-1,102692,97308
6:6:6,0,-1,102693,97307
2:1:6,1,1,102692,97308
2:4:6,1,1,102691,97309
6:4:4,0,-1,102692,97308
3:4:1,0,-1,102693,97307
4:1:2,1,1,102692,97308
3:6:1,0,-1,102693,97307
3:1:6,0,-1,102694,97306
5:3:3,0,-1,102695,97305
6:3:5,0,-1,102696,97304
5:1:3,0,-1,102697,97303
2:4:2,2,2,102695,97305
4:3:3,0,-1,102696,97304
5:6:6,0,-1,102697,97303
6:3:3,0,-1,102698,97302
6:6:4,0,-1,102699,97301
4:4:5,0,-1,102700,97300
5:3:5,0,-1,102701,97299
6:2:2,2,2,102699,97301
4:2:1,1,1,102698,97302
4:1:3,0,-1,102699,97301
4:5:3,0,-1,102700,97300
3:6:1,0,-1,102701,97299
1:6:5,0,-1,102702,97298
1:2:4,1,1,102701,97299
4:6:4,0,-1,102702,97298
2:3:4,1,1,102701,97299
2:4:1,1,1,102700,97300
5:3:3,0,-1,102701,97299
4:3:3,0,-1,102702,97298
4:6:6,0,-1,102703,97297
4:1:5,0,-1,102704,97296
5:4:5,0,-1,102705,97295
3:4:5,0,-1,102706,97294
6:4:5,0,-1,102707,97293
5:6:2,1,1,102706,97294
6:4:1,0,-1,102707,97293
4:6:4,0,-1,102708,97292
1:2:1,1,1,102707,97293
5:5:3,0,-1,102708,97292
5:1:1,0,-1,102709,97291
4:3:3,0,-1,102710,97290
3:1:4,0,-1,102711,97289
1:2:2,2,2,102709,97291
5:6:5,0,-1,102710,97290
4:5:2,1,1,102709,97291
3:2:3,1,1,102708,97292
3:1:6,0,-1,102709,97291
4:4:1,0,-1,102710,97290
6:6:5,0,-1,102711,97289
3:4:2,1,1,102710,97290
2:4:3,1,1,102709,97291
6:2:3,1,1,102708,97292
1:6:1,0,-1,102709,97291
1:6:4,0,-1,102710,97290
2:2:3,2,2,102708,97292
6:3:4,0,-1,102709,97291
3:5:4,0,-1,102710,97290
3:1:1,0,-1,102711,97289
4:3:6,0,-1,102712,97288
6:6:2,1,1,102711,97289
2:4:4,1,1,102710,97290
4:6:1,0,-1,102711,97289
2:6:2,2,2,102709,97291
6:6:2,1,1,102708,97292
6:5:1,0,-1,102709,97291
4:4:1,0,-1,102710,97290
5:6:1,0,-1,102711,97289
6:1:5,0,-1,102712,97288
4:3:3,0,-1,102713,97287
1:1:1,0,-1,102714,97286
4:3:3,0,-1,102715,97285
3:3:3,0,-1,102716,97284
4:1:2,1,1,102715,97285
5:1:5,0,-1,102716,97284
5:6:3,0,-1,102717,97283
4:4:4,0,-1,102718,97282
5:5:4,0,-1,102719,97281
3:1:2,1,1,102718,97282
2:1:3,1,1,102717,97283
5:3:5,0,-1,102718,97282
1:2:1,1,1,102717,97283
4:1:1,0,-1,102718,97282
3:4:6,0,-1,102719,97281
1:6:5,0,-1,102720,97280
5:3:1,0,-1,102721,97279
2:5:2,2,2,102719,97281
3:6:5,0,-1,102720,97280
3:4:6,0,-1,102721,97279
2:4:1,1,1,102720,97280
2:3:5,1,1,102719,97281
1:6:1,0,-1,102720,97280
6:2:1,1,1,102719,97281
5:6:3,0,-1,102720,97280
5:2:3,1,1,102719,97281
4:4:6,0,-1,102720,97280
5:3:1,0,-1,102721,97279
4:5:4,0,-1,102722,97278
1:4:2,1,1,102721,97279
5:4:6,0,-1,102722,97278
4:6:1,0,-1,102723,97277
4:3:6,0,-1,102724,97276
6:4:2,1,1,102723,97277
3:4:5,0,-1,102724,97276
1:2:5,1,1,102723,97277
5:5:3,0,-1,102724,97276
2:6:4,1,1,102723,97277
5:6:3,0,-1,102724,97276
3:4:2,1,1,102723,97277
4:4:3,0,-1,102724,97276
5:4:4,0,-1,102725,97275
3:1:5,0,-1,102726,97274
2:3:1,1,1,102725,97275
4:3:3,0,-1,102726,97274
1:6:5,0,-1,102727,97273
1:4:1,0,-1,102728,97272
6:1:4,0,-1,102729,97271
5:4:4,0,-1,102730,97270
2:2:6,2,2,102728,97272
4:2:2,2,2,102726,97274
3:5:3,0,-1,102727,97273
5:3:1,0,-1,102728,97272
4:5:5,0,-1,102729,97271
3:2:3,1,1,102728,97272
6:4:5,0,-1,102729,97271
5:4:6,0,-1,102730,97270
3:1:1,0,-1,102731,97269
6:6:3,0,-1,102732,97268
3:4:1,0,-1,102733,97267
5:1:4,0,-1,102734,97266
2:3:3,1,1,102733,97267
1:3:5,0,-1,102734,97266
3:6:6,0,-1,102735,97265
4:2:6,1,1,102734,97266
1:5:6,0,-1,102735,97265
3:4:6,0,-1,102736,97264
3:2:6,1,1,102735,97265
3:5:4,0,-1,102736,97264
6:3:2,1,1,102735,97265
3:2:2,2,2,102733,97267
3:1:2,1,1,102732,97268
1:6:2,1,1,102731,97269
6:6:2,1,1,102730,97270
3:5:2,1,1,102729,97271
3:2:1,1,1,102728,97272
3:6:1,0,-1,102729,97271
6:4:2,1,1,102728,97272
3:5:1,0,-1,102729,97271
1:4:1,0,-1,102730,97270
2:5:6,1,1,102729,97271
2:1:3,1,1,102728,97272
4:2:2,2,2,102726,97274
3:1:2,1,1,102725,97275
4:5:2,1,1,102724,97276
1:3:4,0,-1,102725,97275
2:3:6,1,1,102724,97276
5:4:6,0,-1,102725,97275
6:6:5,0,-1,102726,97274
5:5:5,0,-1,102727,97273
6:5:2,1,1,102726,97274
6:6:2,1,1,102725,97275
3:2:5,1,1,102724,97276
3:3:4,0,-1,102725,97275
2:3:4,1,1,102724,97276
6:3:3,0,-1,102725,97275
2:2:3,2,2,102723,97277
6:6:2,1,1,102722,97278
1:2:3,1,1,102721,97279
1:5:4,0,-1,102722,97278
6:4:2,1,1,102721,97279
1:4:3,0,-1,102722,97278
2:5:5,1,1,102721,97279
3:6:4,0,-1,102722,97278
2:1:5,1,1,102721,97279
5:1:6,0,-1,102722,97278
1:5:1,0,-1,102723,97277
1:5:4,0,-1,102724,97276
2:5:1,1,1,102723,97277
4:3:6,0,-1,102724,97276
2:6:2,2,2,102722,97278
2:6:5,1,1,102721,97279
1:3:1,0,-1,102722,97278
4:3:1,0,-1,102723,97277
3:3:2,1,1,102722,97278
4:6:1,0,-1,102723,97277
6:2:3,1,1,102722,97278
1:3:1,0,-1,102723,97277
1:5:3,0,-1,102724,97276
1:2:2,2,2,102722,97278
1:2:3,1,1,102721,97279
1:3:2,1,1,102720,97280
4:6:6,0,-1,102721,97279
3:6:2,1,1,102720,97280
2:6:5,1,1,102719,97281
1:2:3,1,1,102718,97282
2:6:5,1,1,102717,97283
1:5:1,0,-1,102718,97282
5:2:2,2,2,102716,97284
4:6:3,0,-1,102717,97283
2:3:4,1,1,102716,97284
2:6:2,2,2,102714,97286
1:2:1,1,1,102713,97287
3:5:4,0,-1,102714,97286
6:4:3,0,-1,102715,97285
2:6:3,1,1,102714,97286
5:4:6,0,-1,102715,97285
2:2:3,2,2,102713,97287
4:4:2,1,1,102712,97288
2:3:3,1,1,102711,97289
6:4:2,1,1,102710,97290
3:4:5,0,-1,102711,97289
1:1:4,0,-1,102712,97288
6:4:1,0,-1,102713,97287
6:4:4,0,-1,102714,97286
3:5:1,0,-1,102715,97285
5:1:6,0,-1,102716,97284
6:6:3,0,-1,102717,97283
5:5:6,0,-1,102718,97282
6:3:3,0,-1,102719,97281
5:1:2,1,1,102718,97282
5:6:5,0,-1,102719,97281
6:3:4,0,-1,102720,97280
6:5:2,1,1,102719,97281
6:4:4,0,-1,102720,97280
3:5:6,0,-1,102721,97279
3:2:2,2,2,102719,97281
5:1:3,0,-1,102720,97280
6:5:2,1,1,102719,97281
2:6:6,1,1,102718,97282
1:6:1,0,-1,102719,97281
1:5:5,0,-1,102720,97280
2:6:6,1,1,102719,97281
2:4:6,1,1,102718,97282
3:5:6,0,-1,102719,97281
5:4:3,0,-1,102720,97280
3:2:5,1,1,102719,97281
6:3:6,0,-1,102720,97280
3:1:1,0,-1,102721,97279
5:4:3,0,-1,102722,97278
4:1:5,0,-1,102723,97277
4:3:2,1,1,102722,97278
5:3:4,0,-1,102723,97277
4:6:3,0,-1,102724,97276
1:2:6,1,1,102723,97277
4:4:4,0,-1,102724,97276
2:3:6,1,1,102723,97277
1:5:5,0,-1,102724,97276
5:4:6,0,-1,102725,97275
5:1:6,0,-1,102726,97274
5:3:4,0,-1,102727,97273
3:6:2,1,1,102726,97274
3:5:6,0,-1,102727,97273
3:5:1,0,-1,102728,97272
6:2:6,1,1,102727,97273
3:6:5,0,-1,102728,97272
2:3:6,1,1,102727,97273
1:1:1,0,-1,102728,97272
1:4:5,0,-1,102729,97271
6:5:1,0,-1,102730,97270
1:3:6,0,-1,102731,97269
4:1:6,0,-1,102732,97268
3:4:3,0,-1,102733,97267
3:6:4,0,-1,102734,97266
3:5:2,1,1,102733,97267
2:2:3,2,2,102731,97269
2:1:4,1,1,102730,97270
1:1:1,0,-1,102731,97269
3:3:4,0,-1,102732,97268
3:2:2,2,2,102730,97270
6:3:4,0,-1,102731,97269
5:2:4,1,1,102730,97270
4:5:3,0,-1,102731,97269
5:4:5,0,-1,102732,97268
4:2:4,1,1,102731,97269
1:6:1,0,-1,102732,97268
2:3:4,1,1,102731,97269
4:2:2,2,2,102729,97271
1:2:2,2,2,102727,97273
2:3:4,1,1,102726,97274
3:2:1,1,1,102725,97275
1:3:6,0,-1,102726,97274
4:3:2,1,1,102725,97275
6:2:6,1,1,102724,97276
6:2:5,1,1,102723,97277
3:2:6,1,1,102722,97278
6:1:3,0,-1,102723,97277
3:4:2,1,1,102722,97278
5:1:2,1,1,102721,97279
2:1:2,2,2,102719,97281
1:6:3,0,-1,102720,97280
6:3:2,1,1,102719,97281
4:1:6,0,-1,102720,97280
4:1:1,0,-1,102721,97279
1:6:4,0,-1,102722,97278
6:2:4,1,1,102721,97279
5:3:5,0,-1,102722,97278
5:1:1,0,-1,102723,97277
4:3:4,0,-1,102724,97276
6:2:2,2,2,102722,97278
6:1:5,0,-1,102723,97277
6:3:6,0,-1,102724,97276
6:4:6,0,-1,102725,97275
4:3:5,0,-1,102726,97274
3:1:4,0,-1,102727,97273
1:5:4,0,-1,102728,97272
6:2:6,1,1,102727,97273
1:3:4,0,-1,102728,97272
1:3:4,0,-1,102729,97271
1:2:1,1,1,102728,97272
2:1:6,1,1,102727,97273
2:3:4,1,1,102726,97274
4:6:4,0,-1,102727,97273
6:2:6,1,1,102726,97274
4:4:4,0,-1,102727,97273
6:1:3,0,-1,102728,97272
5:5:4,0,-1,102729,97271
5:2:5,1,1,102728,97272
4:6:6,0,-1,102729,97271
1:1:5,0,-1,102730,97270
1:4:1,0,-1,102731,97269
2:2:1,2,2,102729,97271
4:2:2,2,2,102727,97273
4:4:2,1,1,102726,97274
2:4:5,1,1,102725,97275
4:3:1,0,-1,102726,97274
3:3:1,0,-1,102727,97273
2:2:3,2,2,102725,97275
5:4:5,0,-1,102726,97274
4:2:6,1,1,102725,97275
1:2:6,1,1,102724,97276
5:3:5,0,-1,102725,97275
3:2:3,1,1,102724,97276
3:6:3,0,-1,102725,97275
2:2:3,2,2,102723,97277
2:5:4,1,1,102722,97278
5:2:3,1,1,102721,97279
3:3:2,1,1,102720,97280
1:2:2,2,2,102718,97282
1:4:3,0,-1,102719,97281
3:4:1,0,-1,102720,97280
6:5:1,0,-1,102721,97279
2:1:3,1,1,102720,97280
4:6:2,1,1,102719,97281
3:6:3,0,-1,102720,97280
6:1:2,1,1,102719,97281
5:5:3,0,-1,102720,97280
6:6:3,0,-1,102721,97279
1:4:5,0,-1,102722,97278
3:4:5,0,-1,102723,97277
3:1:2,1,1,102722,97278
3:4:3,0,-1,102723,97277
6:3:5,0,-1,102724,97276
3:5:5,0,-1,102725,97275
1:5:5,0,-1,102726,97274
2:1:3,1,1,102725,97275
4:2:6,1,1,102724,97276
2:4:5,1,1,102723,97277
5:4:5,0,-1,102724,97276
5:4:4,0,-1,102725,97275
3:1:6,0,-1,102726,97274
3:3:5,0,-1,102727,97273
6:6:2,1,1,102726,97274
2:4:3,1,1,102725,97275
1:5:4,0,-1,102726,97274
4:1:1,0,-1,102727,97273
2:5:2,2,2,102725,97275
2:1:6,1,1,102724,97276
3:1:5,0,-1,102725,97275
5:1:2,1,1,102724,97276
5:3:3,0,-1,102725,97275
2:3:4,1,1,102724,97276
5:6:5,0,-1,102725,97275
5:6:3,0,-1,102726,97274
2:5:1,1,1,102725,97275
2:4:3,1,1,102724,97276
5:2:4,1,1,102723,97277
6:1:4,0,-1,102724,97276
2:6:2,2,2,102722,97278
5:4:1,0,-1,102723,97277
5:4:2,1,1,102722,97278
4:2:1,1,1,102721,97279
6:3:4,0,-1,102722,97278
4:5:6,0,-1,102723,97277
1:6:5,0,-1,102724,97276
3:1:3,0,-1,102725,97275
3:6:3,0,-1,102726,97274
4:1:6,0,-1,102727,97273
5:5:6,0,-1,102728,97272
5:4:6,0,-1,102729,97271
2:4:6,1,1,102728,97272
6:2:4,1,1,102727,97273
1:5:6,0,-1,102728,97272
2:6:1,1,1,102727,97273
4:5:5,0,-1,102728,97272
5:5:5,0,-1,102729,97271
6:2:4,1,1,102728,97272
3:6:6,0,-1,102729,97271
1:3:6,0,-1,102730,97270
1:4:3,0,-1,102731,97269
6:6:6,0,-1,102732,97268
4:3:5,0,-1,102733,97267
2:2:4,2,2,102731,97269
6:6:3,0,-1,102732,97268
4:5:5,0,-1,102733,97267
3:6:1,0,-1,102734,97266
3:3:4,0,-1,102735,97265
3:6:5,0,-1,102736,97264
2:2:1,2,2,102734,97266
5:2:4,1,1,102733,97267
1:6:1,0,-1,102734,97266
1:1:1,0,-1,102735,97265
3:5:3,0,-1,102736,97264
5:6:2,1,1,102735,97265
2:1:6,1,1,102734,97266
5:5:1,0,-1,102735,97265
5:3:1,0,-1,102736,97264
2:5:1,1,1,102735,97265
5:2:1,1,1,102734,97266
6:6:4,0,-1,102735,97265
6:3:3,0,-1,102736,97264
2:2:3,2,2,102734,97266
5:2:1,1,1,102733,97267
6:1:5,0,-1,102734,97266
6:4:1,0,-1,102735,97265
4:6:3,0,-1,102736,97264
6:6:6,0,-1,102737,97263
4:3:2,1,1,102736,97264
1:1:3,0,-1,102737,97263
5:4:6,0,-1,102738,97262
5:4:4,0,-1,102739,97261
4:6:3,0,-1,102740,97260
3:5:1,0,-1,102741,97259
3:6:2,1,1,102740,97260
1:4:5,0,-1,102741,97259
6:2:2,2,2,102739,97261
2:3:2,2,2,102737,97263
4:5:5,0,-1,102738,97262
1:1:2,1,1,102737,97263
3:1:5,0,-1,102738,97262
1:3:2,1,1,102737,97263
5:4:5,0,-1,102738,97262
2:3:4,1,1,102737,97263
3:1:5,0,-1,102738,97262
5:1:4,0,-1,102739,97261
4:3:2,1,1,102738,97262
4:6:1,0,-1,102739,97261
5:3:2,1,1,102738,97262
6:4:6,0,-1,102739,97261
4:6:3,0,-1,102740,97260
1:6:3,0,-1,102741,97259
1:6:2,1,1,102740,97260
5:6:2,1,1,102739,97261
1:3:1,0,-1,102740,97260
3:1:6,0,-1,102741,97259
4:6:4,0,-1,102742,97258
1:2:3,1,1,102741,97259
1:3:5,0,-1,102742,97258
2:3:3,1,1,102741,97259
5:5:5,0,-1,102742,97258
3:1:1,0,-1,102743,97257
2:1:1,1,1,102742,97258
2:6:6,1,1,102741,97259
6:5:2,1,1,102740,97260
3:6:5,0,-1,102741,97259
2:3:5,1,1,102740,97260
5:1:1,0,-1,102741,97259
6:1:4,0,-1,102742,97258
3:3:2,1,1,102741,97259
1:5:3,0,-1,102742,97258
1:4:1,0,-1,102743,97257
1:2:4,1,1,102742,97258
5:3:1,0,-1,102743,97257
2:5:3,1,1,102742,97258
3:3:4,0,-1,102743,97257
5:2:6,1,1,102742,97258
6:4:1,0,-1,102743,97257
6:5:4,0,-1,102744,97256
1:5:4,0,-1,102745,97255
4:2:2,2,2,102743,97257
5:3:6,0,-1,102744,97256
1:4:5,0,-1,102745,97255
1:1:6,0,-1,102746,97254
3:5:1,0,-1,102747,97253
5:2:1,1,1,102746,97254
4:1:6,0,-1,102747,97253
5:6:4,0,-1,102748,97252
2:2:3,2,2,102746,97254
3:1:3,0,-1,102747,97253
2:3:2,2,2,102745,97255
3:6:1,0,-1,102746,97254
3:3:2,1,1,102745,97255
5:2:6,1,1,102744,97256
5:6:5,0,-1,102745,97255
5:6:1,0,-1,102746,97254
5:3:1,0,-1,102747,97253
1:2:4,1,1,102746,97254
4:4:4,0,-1,102747,97253
4:2:1,1,1,102746,97254
2:6:1,1,1,102745,97255
4:1:3,0,-1,102746,97254
5:4:3,0,-1,102747,97253
1:6:5,0,-1,102748,97252
4:3:4,0,-1,102749,97251
5:3:2,1,1,102748,97252
6:5:4,0,-1,102749,97251
2:6:3,1,1,102748,97252
1:5:6,0,-1,102749,97251
6:6:6,0,-1,102750,97250
4:2:2,2,2,102748,97252
4:4:6,0,-1,102749,97251
3:2:6,1,1,102748,97252
6:6:6,0,-1,102749,97251
2:4:5,1,1,102748,97252
1:5:2,1,1,102747,97253
5:1:1,0,-1,102748,97252
1:4:4,0,-1,102749,97251
4:2:1,1,1,102748,97252
5:1:3,0,-1,102749,97251
5:1:6,0,-1,102750,97250
1:5:4,0,-1,102751,97249
4:3:5,0,-1,102752,97248
5:2:3,1,1,102751,97249
4:6:5,0,-1,102752,97248
2:1:4,1,1,102751,97249
3:1:4,0,-1,102752,97248
3:4:6,0,-1,102753,97247
6:2:2,2,2,102751,97249
1:3:3,0,-1,102752,97248
6:6:3,0,-1,102753,97247
6:4:6,0,-1,102754,97246
4:5:3,0,-1,102755,97245
4:5:5,0,-1,102756,97244
5:2:2,2,2,102754,97246
5:3:3,0,-1,102755,97245
2:6:5,1,1,102754,97246
3:5:5,0,-1,102755,97245
4:2:3,1,1,102754,97246
1:4:1,0,-1,102755,97245
1:3:3,0,-1,102756,97244
4:4:2,1,1,102755,97245
3:5:4,0,-1,102756,97244
5:5:3,0,-1,102757,97243
1:2:2,2,2,102755,97245
6:6:3,0,-1,102756,97244
6:1:2,1,1,102755,97245
5:1:1,0,-1,102756,97244
1:1:5,0,-1,102757,97243
6:5:1,0,-1,102758,97242
6:2:2,2,2,102756,97244
3:4:3,0,-1,102757,97243
4:2:4,1,1,102756,97244
4:6:6,0,-1,102757,97243
2:4:3,1,1,102756,97244
4:6:5,0,-1,102757,97243
1:3:6,0,-1,102758,97242
3:2:5,1,1,102757,97243
6:1:5,0,-1,102758,97242
2:3:4,1,1,102757,97243
3:6:1,0,-1,102758,97242
2:3:5,1,1,102757,97243
2:6:2,2,2,102755,97245
2:3:1,1,1,102754,97246
1:2:2,2,2,102752,97248
3:1:4,0,-1,102753,97247
5:1:4,0,-1,102754,97246
5:5:6,0,-1,102755,97245
4:4:3,0,-1,102756,97244
2:2:6,2,2,102754,97246
6:2:4,1,1,102753,97247
2:3:3,1,1,102752,97248
5:1:4,0,-1,102753,97247
2:4:6,1,1,102752,97248
2:2:2,3,3,102749,97251
4:6:5,0,-1,102750,97250
4:6:1,0,-1,102751,97249
6:2:3,1,1,102750,97250
3:6:4,0,-1,102751,97249
6:2:5,1,1,102750,97250
1:4:2,1,1,102749,97251
6:1:6,0,-1,102750,97250
5:6:3,0,-1,102751,97249
4:3:5,0,-1,102752,97248
3:3:1,0,-1,102753,97247
6:4:1,0,-1,102754,97246
5:2:5,1,1,102753,97247
2:1:1,1,1,102752,97248
2:6:1,1,1,102751,97249
6:6:3,0,-1,102752,97248
6:2:5,1,1,102751,97249
3:5:5,0,-1,102752,97248
2:4:5,1,1,102751,97249
4:6:1,0,-1,102752,97248
2:3:6,1,1,102751,97249
5:3:2,1,1,102750,97250
5:1:2,1,1,102749,97251
5:3:4,0,-1,102750,97250
6:6:2,1,1,102749,97251
2:1:4,1,1,102748,97252
6:5:1,0,-1,102749,97251
5:3:1,0,-1,102750,97250
2:4:1,1,1,102749,97251
6:6:2,1,1,102748,97252
2:1:2,2,2,102746,97254
6:4:5,0,-1,102747,97253
4:2:4,1,1,102746,97254
6:6:2,1,1,102745,97255
6:4:2,1,1,102744,97256
1:1:4,0,-1,102745,97255
6:4:2,1,1,102744,97256
5:4:1,0,-1,102745,97255
2:1:3,1,1,102744,97256
6:3:1,0,-1,102745,97255
4:5:3,0,-1,102746,97254
6:6:2,1,1,102745,97255
6:2:2,2,2,102743,97257
1:1:1,0,-1,102744,97256
6:6:4,0,-1,102745,97255
1:2:4,1,1,102744,97256
3:5:6,0,-1,102745,97255
1:3:6,0,-1,102746,97254
3:5:3,0,-1,102747,97253
1:6:2,1,1,102746,97254
2:6:1,1,1,102745,97255
5:5:6,0,-1,102746,97254
5:4:6,0,-1,102747,97253
3:3:2,1,1,102746,97254
5:3:1,0,-1,102747,97253
6:1:2,1,1,102746,97254
5:2:4,1,1,102745,97255
1:3:6,0,-1,102746,97254
2:2:4,2,2,102744,97256
4:1:2,1,1,102743,97257
2:3:5,1,1,102742,97258
3:6:6,0,-1,102743,97257
3:5:6,0,-1,102744,97256
2:3:2,2,2,102742,97258
3:1:2,1,1,102741,97259
4:4:2,1,1,102740,97260
3:1:4,0,-1,102741,97259
3:3:6,0,-1,102742,97258
6:2:2,2,2,102740,97260
3:6:2,1,1,102739,97261
2:3:2,2,2,102737,97263
3:1:5,0,-1,102738,97262
3:6:6,0,-1,102739,97261
1:4:5,0,-1,102740,97260
3:2:1,1,1,102739,97261
5:3:3,0,-1,102740,97260
6:5:5,0,-1,102741,97259
1:2:5,1,1,102740,97260
3:2:4,1,1,102739,97261
5:3:4,0,-1,102740,97260
5:4:6,0,-1,102741,97259
4:4:3,0,-1,102742,97258
3:1:2,1,1,102741,97259
3:3:2,1,1,102740,97260
4:3:4,0,-1,102741,97259
6:3:1,0,-1,102742,97258
5:4:2,1,1,102741,97259
2:4:5,1,1,102740,97260
5:5:1,0,-1,102741,97259
6:5:4,0,-1,102742,97258
1:3:2,1,1,102741,97259
1:4:5,0,-1,102742,97258
2:6:3,1,1,102741,97259
2:5:1,1,1,102740,97260
3:3:6,0,-1,102741,97259
1:1:3,0,-1,102742,97258
1:3:6,0,-1,102743,97257
4:1:3,0,-1,102744,97256
4:1:5,0,-1,102745,97255
5:5:2,1,1,102744,97256
4:1:3,0,-1,102745,97255
1:3:3,0,-1,102746,97254
5:2:6,1,1,102745,97255
6:5:1,0,-1,102746,97254
1:4:4,0,-1,102747,97253
2:6:6,1,1,102746,97254
4:5:2,1,1,102745,97255
1:2:5,1,1,102744,97256
2:5:3,1,1,102743,97257
5:3:1,0,-1,102744,97256
1:4:6,0,-1,102745,97255
5:4:2,1,1,102744,97256
1:1:2,1,1,102743,97257
5:5:5,0,-1,102744,97256
4:6:1,0,-1,102745,97255
3:1:2,1,1,102744,97256
6:6:4,0,-1,102745,97255
3:2:4,1,1,102744,97256
3:5:4,0,-1,102745,97255
5:1:1,0,-1,102746,97254
3:1:3,0,-1,102747,97253
5:3:4,0,-1,102748,97252
5:3:6,0,-1,102749,97251
4:1:1,0,-1,102750,97250
5:5:4,0,-1,102751,97249
4:6:4,0,-1,102752,97248
3:2:2,2,2,102750,97250
3:3:1,0,-1,102751,97249
3:3:6,0,-1,102752,97248
3:4:1,0,-1,102753,97247
5:4:3,0,-1,102754,97246
6:3:5,0,-1,102755,97245
1:5:1,0,-1,102756,97244
6:4:4,0,-1,102757,97243
6:5:4,0,-1,102758,97242
4:1:5,0,-1,102759,97241
5:3:3,0,-1,102760,97240
5:5:3,0,-1,102761,97239
6:4:5,0,-1,102762,97238
5:6:1,0,-1,102763,97237
4:5:2,1,1,102762,97238
5:3:5,0,-1,102763,97237
2:2:3,2,2,102761,97239
4:5:4,0,-1,102762,97238
6:4:6,0,-1,102763,97237
6:1:5,0,-1,102764,97236
4:5:1,0,-1,102765,97235
3:3:1,0,-1,102766,97234
4:2:4,1,1,102765,97235
5:6:2,1,1,102764,97236
4:6:6,0,-1,102765,97235
5:4:2,1,1,102764,97236
3:5:2,1,1,102763,97237
2:1:6,1,1,102762,97238
4:5:2,1,1,102761,97239
2:4:1,1,1,102760,97240
3:5:5,0,-1,102761,97239
6:1:6,0,-1,102762,97238
5:6:4,0,-1,102763,97237
6:1:6,0,-1,102764,97236
1:5:1,0,-1,102765,97235
5:2:1,1,1,102764,97236
6:3:3,0,-1,102765,97235
3:6:6,0,-1,102766,97234
5:1:1,0,-1,102767,97233
2:3:1,1,1,102766,97234
3:6:2,1,1,102765,97235
3:4:6,0,-1,102766,97234
4:4:4,0,-1,102767,97233
1:5:1,0,-1,102768,97232
3:6:5,0,-1,102769,97231
3:1:3,0,-1,102770,97230
1:2:3,1,1,102769,97231
1:6:2,1,1,102768,97232
6:1:1,0,-1,102769,97231
5:1:6,0,-1,102770,97230
3:4:6,0,-1,102771,97229
6:3:6,0,-1,102772,97228
2:4:3,1,1,102771,97229
2:1:5,1,1,102770,97230
4:1:2,1,1,102769,97231
3:2:6,1,1,102768,97232
4:6:3,0,-1,102769,97231
1:2:1,1,1,102768,97232
5:1:3,0,-1,102769,97231
2:2:6,2,2,102767,97233
2:4:5,1,1,102766,97234
1:1:6,0,-1,102767,97233
5:2:5,1,1,102766,97234
1:4:2,1,1,102765,97235
4:6:5,0,-1,102766,97234
2:4:2,2,2,102764,97236
4:2:6,1,1,102763,97237
6:2:3,1,1,102762,97238
3:1:1,0,-1,102763,97237
3:2:2,2,2,102761,97239
3:6:1,0,-1,102762,97238
2:4:1,1,1,102761,97239
1:6:3,0,-1,102762,97238
1:3:6,0,-1,102763,97237
1:2:3,1,1,102762,97238
2:5:6,1,1,102761,97239
1:3:3,0,-1,102762,97238
2:4:5,1,1,102761,97239
3:1:3,0,-1,102762,97238
4:3:4,0,-1,102763,97237
6:3:5,0,-1,102764,97236
5:6:2,1,1,102763,97237
1:6:2,1,1,102762,97238
5:4:5,0,-1,102763,97237
4:4:2,1,1,102762,97238
1:1:5,0,-1,102763,97237
1:1:6,0,-1,102764,97236
6:2:6,1,1,102763,97237
5:5:5,0,-1,102764,97236
3:6:6,0,-1,102765,97235
2:3:5,1,1,102764,97236
1:1:4,0,-1,102765,97235
6:4:6,0,-1,102766,97234
5:3:6,0,-1,102767,97233
1:5:5,0,-1,102768,97232
4:2:4,1,1,102767,97233
1:6:3,0,-1,102768,97232
4:2:3,1,1,102767,97233
3:5:4,0,-1,102768,97232
6:2:6,1,1,102767,97233
1:5:3,0,-1,102768,97232
2:1:5,1,1,102767,97233
4:2:5,1,1,102766,97234
6:3:5,0,-1,102767,97233
2:2:6,2,2,102765,97235
1:5:6,0,-1,102766,97234
2:4:6,1,1,102765,97235
2:6:4,1,1,102764,97236
6:1:3,0,-1,102765,97235
6:4:4,0,-1,102766,97234
3:2:1,1,1,102765,97235
6:5:3,0,-1,102766,97234
3:3:2,1,1,102765,97235
5:1:2,1,1,102764,97236
2:1:3,1,1,102763,97237
3:2:5,1,1,102762,97238
1:6:2,1,1,102761,97239
4:6:1,0,-1,102762,97238
3:5:2,1,1,102761,97239
6:2:5,1,1,102760,97240
6:2:3,1,1,102759,97241
4:2:5,1,1,102758,97242
2:6:6,1,1,102757,97243
3:3:1,0,-1,102758,97242
3:1:4,0,-1,102759,97241
3:4:2,1,1,102758,97242
6:4:4,0,-1,102759,97241
3:2:2,2,2,102757,97243
4:2:6,1,1,102756,97244
5:3:6,0,-1,102757,97243
6:2:5,1,1,102756,97244
3:3:1,0,-1,102757,97243
6:6:1,0,-1,102758,97242
1:4:2,1,1,102757,97243
3:3:4,0,-1,102758,97242
1:4:3,0,-1,102759,97241
3:3:3,0,-1,102760,97240
3:1:5,0,-1,102761,97239
5:4:3,0,-1,102762,97238
1:6:3,0,-1,102763,97237
6:6:3,0,-1,102764,97236
5:4:1,0,-1,102765,97235
5:5:2,1,1,102764,97236
5:5:4,0,-1,102765,97235
1:4:2,1,1,102764,97236
1:3:5,0,-1,102765,97235
5:4:5,0,-1,102766,97234
6:3:6,0,-1,102767,97233
5:6:5,0,-1,102768,97232
3:1:4,0,-1,102769,97231
2:2:6,2,2,102767,97233
1:4:2,1,1,102766,97234
2:2:5,2,2,102764,97236
5:1:6,0,-1,102765,97235
5:3:4,0,-1,102766,97234
5:5:5,0,-1,102767,97233
1:5:5,0,-1,102768,97232
6:6:3,0,-1,102769,97231
6:1:1,0,-1,102770,97230
1:2:2,2,2,102768,97232
6:5:1,0,-1,102769,97231
4:2:2,2,2,102767,97233
1:2:6,1,1,102766,97234
2:1:4,1,1,102765,97235
6:2:1,1,1,102764,97236
6:2:5,1,1,102763,97237
1:5:2,1,1,102762,97238
4:3:3,0,-1,102763,97237
4:3:6,0,-1,102764,97236
1:5:1,0,-1,102765,97235
1:5:2,1,1,102764,97236
1:2:1,1,1,102763,97237
5:1:4,0,-1,102764,97236
4:4:3,0,-1,102765,97235
4:3:2,1,1,102764,97236
5:5:6,0,-1,102765,97235
4:5:2,1,1,102764,97236
3:2:3,1,1,102763,97237
2:2:2,3,3,102760,97240
2:2:1,2,2,102758,97242
4:3:1,0,-1,102759,97241
6:6:3,0,-1,102760,97240
6:2:1,1,1,102759,97241
2:5:1,1,1,102758,97242
5:1:1,0,-1,102759,97241
3:1:3,0,-1,102760,97240
1:5:3,0,-1,102761,97239
6:2:6,1,1,102760,97240
1:6:5,0,-1,102761,97239
5:5:1,0,-1,102762,97238
6:2:3,1,1,102761,97239
3:4:2,1,1,102760,97240
6:2:5,1,1,102759,97241
6:3:2,1,1,102758,97242
2:6:3,1,1,102757,97243
3:3:2,1,1,102756,97244
1:1:4,0,-1,102757,97243
4:1:2,1,1,102756,97244
6:4:5,0,-1,102757,97243
3:2:4,1,1,102756,97244
2:3:4,1,1,102755,97245
4:5:4,0,-1,102756,97244
3:2:6,1,1,102755,97245
2:4:2,2,2,102753,97247
6:4:1,0,-1,102754,97246
4:5:1,0,-1,102755,97245
2:3:2,2,2,102753,97247
4:3:6,0,-1,102754,97246
5:1:2,1,1,102753,97247
3:2:5,1,1,102752,97248
2:5:3,1,1,102751,97249
5:5:3,0,-1,102752,97248
1:4:2,1,1,102751,97249
5:5:6,0,-1,102752,97248
2:5:2,2,2,102750,97250
1:6:5,0,-1,102751,97249
5:6:6,0,-1,102752,97248
5:2:4,1,1,102751,97249
3:6:3,0,-1,102752,97248
5:1:4,0,-1,102753,97247
6:5:3,0,-1,102754,97246
6:4:3,0,-1,102755,97245
2:6:5,1,1,102754,97246
4:6:1,0,-1,102755,97245
5:4:3,0,-1,102756,97244
1:4:1,0,-1,102757,97243
1:3:2,1,1,102756,97244
1:4:4,0,-1,102757,97243
5:2:1,1,1,102756,97244
4:1:4,0,-1,102757,97243
1:1:3,0,-1,102758,97242
6:1:3,0,-1,102759,97241
2:5:1,1,1,102758,97242
3:6:3,0,-1,102759,97241
2:4:3,1,1,102758,97242
6:1:3,0,-1,102759,97241
2:6:2,2,2,102757,97243
5:3:4,0,-1,102758,97242
5:1:2,1,1,102757,97243
3:1:6,0,-1,102758,97242
3:1:4,0,-1,102759,97241
4:2:3,1,1,102758,97242
5:5:1,0,-1,102759,97241
5:4:6,0,-1,102760,97240
1:5:1,0,-1,102761,97239
4:6:5,0,-1,102762,97238
4:6:6,0,-1,102763,97237
1:4:5,0,-1,102764,97236
2:4:6,1,1,102763,97237
5:1:1,0,-1,102764,97236
6:2:5,1,1,102763,97237
2:3:2,2,2,102761,97239
6:1:5,0,-1,102762,97238
2:3:4,1,1,102761,97239
6:4:4,0,-1,102762,97238
4:2:4,1,1,102761,97239
2:3:1,1,1,102760,97240
2:2:3,2,2,102758,97242
2:3:5,1,1,102757,97243
4:4:1,0,-1,102758,97242
4:6:4,0,-1,102759,97241
6:2:6,1,1,102758,97242
6:5:3,0,-1,102759,97241
6:4:5,0,-1,102760,97240
1:3:3,0,-1,102761,97239
5:3:4,0,-1,102762,97238
1:4:1,0,-1,102763,97237
4:1:5,0,-1,102764,97236
3:6:6,0,-1,102765,97235
2:2:4,2,2,102763,97237
5:4:4,0,-1,102764,97236
1:3:4,0,-1,102765,97235
5:6:1,0,-1,102766,97234
4:4:4,0,-1,102767,97233
5:5:3,0,-1,102768,97232
5:4:6,0,-1,102769,97231
3:3:4,0,-1,102770,97230
2:2:4,2,2,102768,97232
3:3:2,1,1,102767,97233
5:2:4,1,1,102766,97234
4:5:3,0,-1,102767,97233
3:3:6,0,-1,102768,97232
3:6:1,0,-1,102769,97231
1:6:2,1,1,102768,97232
2:1:2,2,2,102766,97234
5:1:1,0,-1,102767,97233
3:3:1,0,-1,102768,97232
4:1:5,0,-1,102769,97231
2:3:5,1,1,102768,97232
5:4:2,1,1,102767,97233
5:4:4,0,-1,102768,97232
3:6:4,0,-1,102769,97231
3:4:2,1,1,102768,97232
2:3:4,1,1,102767,97233
2:1:2,2,2,102765,97235
4:2:3,1,1,102764,97236
4:2:3,1,1,102763,97237
1:5:2,1,1,102762,97238
1:5:6,0,-1,102763,97237
4:3:3,0,-1,102764,97236
3:1:3,0,-1,102765,97235
3:2:5,1,1,102764,97236
6:6:4,0,-1,102765,97235
5:1:2,1,1,102764,97236
1:4:6,0,-1,102765,97235
3:3:1,0,-1,102766,97234
4:4:3,0,-1,102767,97233
1:3:1,0,-1,102768,97232
1:5:6,0,-1,102769,97231
4:3:4,0,-1,102770,97230
3:3:2,1,1,102769,97231
3:2:3,1,1,102768,97232
6:1:2,1,1,102767,97233
2:4:4,1,1,102766,97234
3:6:4,0,-1,102767,97233
2:2:1,2,2,102765,97235
5:1:4,0,-1,102766,97234
3:1:2,1,1,102765,97235
6:4:4,0,-1,102766,97234
6:4:4,0,-1,102767,97233
5:6:1,0,-1,102768,97232
6:6:3,0,-1,102769,97231
5:4:2,1,1,102768,97232
3:3:3,0,-1,102769,97231
5:4:6,0,-1,102770,97230
6:4:1,0,-1,102771,97229
4:1:4,0,-1,102772,97228
4:3:2,1,1,102771,97229
5:1:6,0,-1,102772,97228
3:2:2,2,2,102770,97230
6:4:2,1,1,102769,97231
4:6:4,0,-1,102770,97230
5:1:2,1,1,102769,97231
3:2:6,1,1,102768,97232
2:2:2,3,3,102765,97235
2:1:5,1,1,102764,97236
6:1:6,0,-1,102765,97235
1:6:3,0,-1,102766,97234
2:3:5,1,1,102765,97235
1:4:5,0,-1,102766,97234
6:3:3,0,-1,102767,97233
4:6:1,0,-1,102768,97232
1:1:5,0,-1,102769,97231
1:4:6,0,-1,102770,97230
4:6:3,0,-1,102771,97229
1:1:5,0,-1,102772,97228
6:3:2,1,1,102771,97229
3:4:6,0,-1,102772,97228
1:1:2,1,1,102771,97229
6:1:5,0,-1,102772,97228
4:1:5,0,-1,102773,97227
1:2:5,1,1,102772,97228
5:6:6,0,-1,102773,97227
4:1:6,0,-1,102774,97226
1:6:6,0,-1,102775,97225
1:4:1,0,-1,102776,97224
3:1:5,0,-1,102777,97223
2:2:2,3,3,102774,97226
4:5:4,0,-1,102775,97225
2:6:5,1,1,102774,97226
3:4:6,0,-1,102775,97225
6:1:2,1,1,102774,97226
3:2:3,1,1,102773,97227
5:6:2,1,1,102772,97228
2:6:4,1,1,102771,97229
2:6:5,1,1,102770,97230
3:4:4,0,-1,102771,97229
2:4:3,1,1,102770,97230
4:2:5,1,1,102769,97231
2:3:6,1,1,102768,97232
3:1:1,0,-1,102769,97231
6:3:4,0,-1,102770,97230
1:6:2,1,1,102769,97231
6:2:4,1,1,102768,97232
1:4:6,0,-1,102769,97231
3:3:3,0,-1,102770,97230
5:1:5,0,-1,102771,97229
4:2:2,2,2,102769,97231
5:1:1,0,-1,102770,97230
1:5:3,0,-1,102771,97229
1:5:6,0,-1,102772,97228
4:4:1,0,-1,102773,97227
2:1:4,1,1,102772,97228
4:2:6,1,1,102771,97229
6:6:3,0,-1,102772,97228
5:3:2,1,1,102771,97229
3:5:5,0,-1,102772,97228
5:6:4,0,-1,102773,97227
1:3:6,0,-1,102774,97226
3:5:4,0,-1,102775,97225
2:2:1,2,2,102773,97227
6:2:5,1,1,102772,97228
4:2:3,1,1,102771,97229
5:2:5,1,1,102770,97230
3:6:5,0,-1,102771,97229
2:6:3,1,1,102770,97230
6:4:2,1,1,102769,97231
3:4:5,0,-1,102770,97230
2:2:5,2,2,102768,97232
4:6:1,0,-1,102769,97231
6:2:3,1,1,102768,97232
4:6:2,1,1,102767,97233
3:4:1,0,-1,102768,97232
6:1:3,0,-1,102769,97231
1:5:5,0,-1,102770,97230
6:4:3,0,-1,102771,97229
3:2:6,1,1,102770,97230
3:6:1,0,-1,102771,97229
4:5:3,0,-1,102772,97228
3:6:6,0,-1,102773,97227
6:4:2,1,1,102772,97228
6:5:6,0,-1,102773,97227
4:5:5,0,-1,102774,97226
6:1:1,0,-1,102775,97225
3:1:3,0,-1,102776,97224
6:4:6,0,-1,102777,97223
6:3:4,0,-1,102778,97222
1:4:1,0,-1,102779,97221
5:5:6,0,-1,102780,97220
2:3:1,1,1,102779,97221
3:1:1,0,-1,102780,97220
5:1:1,0,-1,102781,97219
3:1:4,0,-1,102782,97218
4:2:6,1,1,102781,97219
6:1:1,0,-1,102782,97218
5:3:1,0,-1,102783,97217
5:4:3,0,-1,102784,97216
1:6:2,1,1,102783,97217
1:1:1,0,-1,102784,97216
2:6:5,1,1,102783,97217
4:5:3,0,-1,102784,97216
6:5:6,0,-1,102785,97215
2:5:5,1,1,102784,97216
1:5:6,0,-1,102785,97215
4:3:2,1,1,102784,97216
4:1:1,0,-1,102785,97215
5:6:1,0,-1,102786,97214
2:5:4,1,1,102785,97215
2:6:2,2,2,102783,97217
1:3:6,0,-1,102784,97216
4:1:3,0,-1,102785,97215
1:1:5,0,-1,102786,97214
2:2:3,2,2,102784,97216
4:1:4,0,-1,102785,97215
2:1:5,1,1,102784,97216
1:6:3,0,-1,102785,97215
2:2:4,2,2,102783,97217
4:2:3,1,1,102782,97218
1:5:2,1,1,102781,97219
1:1:1,0,-1,102782,97218
2:3:3,1,1,102781,97219
5:4:3,0,-1,102782,97218
1:3:5,0,-1,102783,97217
4:5:5,0,-1,102784,97216
6:6:3,0,-1,102785,97215
6:6:4,0,-1,102786,97214
1:3:1,0,-1,102787,97213
3:1:2,1,1,102786,97214
1:3:1,0,-1,102787,97213
4:3:1,0,-1,102788,97212
3:6:1,0,-1,102789,97211
2:1:6,1,1,102788,97212
3:4:6,0,-1,102789,97211
2:3:6,1,1,102788,97212
4:6:5,0,-1,102789,97211
4:4:5,0,-1,102790,97210
4:5:4,0,-1,102791,97209
4:3:6,0,-1,102792,97208
6:6:5,0,-1,102793,97207
3:3:3,0,-1,102794,97206
5:4:4,0,-1,102795,97205
3:1:1,0,-1,102796,97204
6:1:4,0,-1,102797,97203
4:3:1,0,-1,102798,97202
4:2:6,1,1,102797,97203
1:3:4,0,-1,102798,97202
5:3:5,0,-1,102799,97201
4:6:2,1,1,102798,97202
4:2:6,1,1,102797,97203
6:6:2,1,1,102796,97204
4:6:1,0,-1,102797,97203
3:1:1,0,-1,102798,97202
3:2:2,2,2,102796,97204
6:5:4,0,-1,102797,97203
3:5:3,0,-1,102798,97202
6:3:6,0,-1,102799,97201
6:1:4,0,-1,102800,97200
1:3:1,0,-1,102801,97199
3:3:1,0,-1,102802,97198
6:5:1,0,-1,102803,97197
6:5:5,0,-1,102804,97196
1:5:6,0,-1,102805,97195
6:3:4,0,-1,102806,97194
6:6:5,0,-1,102807,97193
6:4:2,1,1,102806,97194
5:6:2,1,1,102805,97195
2:3:5,1,1,102804,97196
6:2:5,1,1,102803,97197
1:3:2,1,1,102802,97198
2:3:5,1,1,102801,97199
6:4:4,0,-1,102802,97198
4:2:3,1,1,102801,97199
2:2:6,2,2,102799,97201
3:6:3,0,-1,102800,97200
6:1:4,0,-1,102801,97199
6:5:5,0,-1,102802,97198
6:3:2,1,1,102801,97199
5:6:4,0,-1,102802,97198
4:6:3,0,-1,102803,97197
2:5:1,1,1,102802,97198
4:5:6,0,-1,102803,97197
6:6:5,0,-1,102804,97196
4:2:4,1,1,102803,97197
5:2:2,2,2,102801,97199
4:5:2,1,1,102800,97200
2:3:1,1,1,102799,97201
1:2:5,1,1,102798,97202
3:4:2,1,1,102797,97203
1:1:3,0,-1,102798,97202
3:5:4,0,-1,102799,97201
6:2:3,1,1,102798,97202
4:5:2,1,1,102797,97203
6:5:5,0,-1,102798,97202
5:2:6,1,1,102797,97203
5:4:4,0,-1,102798,97202
3:5:6,0,-1,102799,97201
1:2:4,1,1,102798,97202
3:1:3,0,-1,102799,97201
3:1:1,0,-1,102800,97200
4:6:5,0,-1,102801,97199
5:5:4,0,-1,102802,97198
2:5:5,1,1,102801,97199
5:1:2,1,1,102800,97200
6:3:6,0,-1,102801,97199
2:4:3,1,1,102800,97200
2:1:6,1,1,102799,97201
6:6:4,0,-1,102800,97200
4:4:4,0,-1,102801,97199
4:4:4,0,-1,102802,97198
6:6:5,0,-1,102803,97197
2:6:4,1,1,102802,97198
4:3:5,0,-1,102803,97197
1:5:3,0,-1,102804,97196
3:5:4,0,-1,102805,97195
3:6:2,1,1,102804,97196
1:5:3,0,-1,102805,97195
2:4:6,1,1,102804,97196
6:3:3,0,-1,102805,97195
1:4:2,1,1,102804,97196
4:2:3,1,1,102803,97197
4:6:4,0,-1,102804,97196
2:4:5,1,1,102803,97197
4:2:3,1,1,102802,97198
1:4:6,0,-1,102803,97197
2:4:2,2,2,102801,97199
6:4:6,0,-1,102802,97198
4:6:4,0,-1,102803,97197
3:1:2,1,1,102802,97198
4:4:1,0,-1,102803,97197
5:6:5,0,-1,102804,97196
2:4:6,1,1,102803,97197
4:3:4,0,-1,102804,97196
6:4:5,0,-1,102805,97195
1:5:3,0,-1,102806,97194
4:1:3,0,-1,102807,97193
3:2:6,1,1,102806,97194
3:5:3,0,-1,102807,97193
3:4:4,0,-1,102808,97192
1:5:3,0,-1,102809,97191
4:2:1,1,1,102808,97192
4:6:6,0,-1,102809,97191
2:3:3,1,1,102808,97192
1:5:6,0,-1,102809,97191
5:3:2,1,1,102808,97192
1:5:1,0,-1,102809,97191
6:2:2,2,2,102807,97193
1:2:4,1,1,102806,97194
4:3:3,0,-1,102807,97193
1:6:3,0,-1,102808,97192
1:5:3,0,-1,102809,97191
1:2:6,1,1,102808,97192
5:6:5,0,-1,102809,97191
1:2:2,2,2,102807,97193
3:3:2,1,1,102806,97194
6:1:6,0,-1,102807,97193
4:1:2,1,1,102806,97194
1:6:3,0,-1,102807,97193
6:3:5,0,-1,102808,97192
2:5:4,1,1,102807,97193
3:5:4,0,-1,102808,97192
5:2:2,2,2,102806,97194
2:3:3,1,1,102805,97195
3:1:6,0,-1,102806,97194
5:1:2,1,1,102805,97195
5:1:5,0,-1,102806,97194
2:2:2,3,3,102803,97197
4:3:1,0,-1,102804,97196
5:4:3,0,-1,102805,97195
5:3:4,0,-1,102806,97194
4:3:1,0,-1,102807,97193
2:5:4,1,1,102806,97194
3:5:2,1,1,102805,97195
5:1:2,1,1,102804,97196
2:4:3,1,1,102803,97197
1:1:5,0,-1,102804,97196
1:4:6,0,-1,102805,97195
2:6:1,1,1,102804,97196
2:6:2,2,2,102802,97198
4:3:3,0,-1,102803,97197
6:2:1,1,1,102802,97198
4:4:5,0,-1,102803,97197
5:5:2,1,1,102802,97198
4:2:6,1,1,102801,97199
4:1:2,1,1,102800,97200
5:3:1,0,-1,102801,97199
5:1:1,0,-1,102802,97198
4:2:2,2,2,102800,97200
3:3:4,0,-1,102801,97199
5:5:5,0,-1,102802,97198
6:6:5,0,-1,102803,97197
5:2:4,1,1,102802,97198
3:1:5,0,-1,102803,97197
6:4:3,0,-1,102804,97196
3:1:2,1,1,102803,97197
2:1:6,1,1,102802,97198
5:3:1,0,-1,102803,97197
3:5:3,0,-1,102804,97196
3:3:2,1,1,102803,97197
3:3:6,0,-1,102804,97196
1:6:6,0,-1,102805,97195
6:1:3,0,-1,102806,97194
6:1:3,0,-1,102807,97193
6:6:1,0,-1,102808,97192
6:6:1,0,-1,102809,97191
4:5:2,1,1,102808,97192
4:4:4,0,-1,102809,97191
3:3:5,0,-1,102810,97190
3:3:3,0,-1,102811,97189
3:3:5,0,-1,102812,97188
2:1:2,2,2,102810,97190
2:3:6,1,1,102809,97191
4:1:4,0,-1,102810,97190
3:2:4,1,1,102809,97191
5:5:5,0,-1,102810,97190
2:3:6,1,1,102809,97191
3:3:4,0,-1,102810,97190
4:3:3,0,-1,102811,97189
5:4:2,1,1,102810,97190
1:5:1,0,-1,102811,97189
1:5:1,0,-1,102812,97188
4:3:1,0,-1,102813,97187
2:1:3,1,1,102812,97188
1:5:4,0,-1,102813,97187
5:4:5,0,-1,102814,97186
3:6:1,0,-1,102815,97185
5:2:4,1,1,102814,97186
2:6:4,1,1,102813,97187
6:5:6,0,-1,102814,97186
5:1:3,0,-1,102815,97185
6:4:2,1,1,102814,97186
2:1:3,1,1,102813,97187
2:3:5,1,1,102812,97188
3:3:2,1,1,102811,97189
2:2:4,2,2,102809,97191
3:6:1,0,-1,102810,97190
5:5:2,1,1,102809,97191
3:5:5,0,-1,102810,97190
5:6:1,0,-1,102811,97189
2:3:3,1,1,102810,97190
5:5:5,0,-1,102811,97189
5:1:3,0,-1,102812,97188
2:4:1,1,1,102811,97189
6:3:5,0,-1,102812,97188
6:6:1,0,-1,102813,97187
6:4:4,0,-1,102814,97186
4:6:3,0,-1,102815,97185
6:6:5,0,-1,102816,97184
6:6:3,0,-1,102817,97183
6:6:1,0,-1,102818,97182
3:2:1,1,1,102817,97183
3:2:2,2,2,102815,97185
3:1:6,0,-1,102816,97184
2:2:3,2,2,102814,97186
3:5:4,0,-1,102815,97185
5:1:2,1,1,102814,97186
6:4:3,0,-1,102815,97185
5:6:6,0,-1,102816,97184
2:1:5,1,1,102815,97185
1:4:3,0,-1,102816,97184
2:3:6,1,1,102815,97185
2:6:2,2,2,102813,97187
1:5:3,0,-1,102814,97186
2:1:1,1,1,102813,97187
1:1:1,0,-1,102814,97186
6:4:2,1,1,102813,97187
5:1:6,0,-1,102814,97186
6:1:3,0,-1,102815,97185
4:4:1,0,-1,102816,97184
4:3:1,0,-1,102817,97183
3:4:2,1,1,102816,97184
4:1:1,0,-1,102817,97183
3:1:1,0,-1,102818,97182
5:3:5,0,-1,102819,97181
6:4:1,0,-1,102820,97180
6:1:1,0,-1,102821,97179
2:2:2,3,3,102818,97182
2:5:1,1,1,102817,97183
6:2:1,1,1,102816,97184
2:4:5,1,1,102815,97185
5:3:6,0,-1,102816,97184
4:3:4,0,-1,102817,97183
6:6:5,0,-1,102818,97182
5:5:4,0,-1,102819,97181
6:3:2,1,1,102818,97182
6:5:6,0,-1,102819,97181
6:2:1,1,1,102818,97182
4:3:1,0,-1,102819,97181
6:1:3,0,-1,102820,97180
5:3:1,0,-1,102821,97179
3:2:6,1,1,102820,97180
1:1:4,0,-1,102821,97179
5:1:4,0,-1,102822,97178
5:3:3,0,-1,102823,97177
5:4:2,1,1,102822,97178
3:4:3,0,-1,102823,97177
4:6:2,1,1,102822,97178
1:5:1,0,-1,102823,97177
4:3:4,0,-1,102824,97176
2:5:3,1,1,102823,97177
5:4:4,0,-1,102824,97176
4:5:5,0,-1,102825,97175
6:6:6,0,-1,102826,97174
2:2:4,2,2,102824,97176
3:3:2,1,1,102823,97177
4:1:6,0,-1,102824,97176
6:5:3,0,-1,102825,97175
4:1:2,1,1,102824,97176
6:3:2,1,1,102823,97177
3:4:2,1,1,102822,97178
6:5:2,1,1,102821,97179
6:6:5,0,-1,102822,97178
1:6:2,1,1,102821,97179
2:1:4,1,1,102820,97180
4:3:3,0,-1,102821,97179
4:1:6,0,-1,102822,97178
2:5:2,2,2,102820,97180
2:6:1,1,1,102819,97181
2:5:3,1,1,102818,97182
3:5:2,1,1,102817,97183
1:1:2,1,1,102816,97184
4:3:6,0,-1,102817,97183
5:2:1,1,1,102816,97184
1:2:4,1,1,102815,97185
6:3:1,0,-1,102816,97184
1:5:5,0,-1,102817,97183
5:4:6,0,-1,102818,97182
6:3:6,0,-1,102819,97181
1:4:6,0,-1,102820,97180
4:2:3,1,1,102819,97181
6:2:2,2,2,102817,97183
2:2:1,2,2,102815,97185
6:2:6,1,1,102814,97186
5:6:4,0,-1,102815,97185
6:1:6,0,-1,102816,97184
5:6:2,1,1,102815,97185
1:1:2,1,1,102814,97186
1:2:5,1,1,102813,97187
3:2:2,2,2,102811,97189
4:2:3,1,1,102810,97190
6:5:2,1,1,102809,97191
2:6:4,1,1,102808,97192
4:3:3,0,-1,102809,97191
3:5:3,0,-1,102810,97190
5:3:2,1,1,102809,97191
6:4:3,0,-1,102810,97190
4:4:5,0,-1,102811,97189
6:6:3,0,-1,102812,97188
3:2:1,1,1,102811,97189
1:1:6,0,-1,102812,97188
6:1:6,0,-1,102813,97187
2:3:6,1,1,102812,97188
5:1:6,0,-1,102813,97187
6:5:2,1,1,102812,97188
4:1:5,0,-1,102813,97187
3:5:2,1,1,102812,97188
2:2:2,3,3,102809,97191
5:5:2,1,1,102808,97192
1:1:2,1,1,102807,97193
3:3:3,0,-1,102808,97192
3:1:2,1,1,102807,97193
5:3:3,0,-1,102808,97192
3:5:1,0,-1,102809,97191
4:1:5,0,-1,102810,97190
4:1:4,0,-1,102811,97189
1:1:2,1,1,102810,97190
3:3:6,0,-1,102811,97189
4:2:5,1,1,102810,97190
4:1:2,1,1,102809,97191
4:3:3,0,-1,102810,97190
1:3:6,0,-1,102811,97189
3:1:6,0,-1,102812,97188
5:1:6,0,-1,102813,97187
3:3:6,0,-1,102814,97186
5:1:6,0,-1,102815,97185
5:3:3,0,-1,102816,97184
6:4:6,0,-1,102817,97183
4:3:6,0,-1,102818,97182
6:2:1,1,1,102817,97183
5:3:1,0,-1,102818,97182
3:4:1,0,-1,102819,97181
4:3:2,1,1,102818,97182
3:2:6,1,1,102817,97183
6:5:2,1,1,102816,97184
2:3:4,1,1,102815,97185
1:6:5,0,-1,102816,97184
2:2:5,2,2,102814,97186
5:1:2,1,1,102813,97187
1:2:4,1,1,102812,97188
1:1:4,0,-1,102813,97187
5:4:2,1,1,102812,97188
3:3:5,0,-1,102813,97187
5:5:3,0,-1,102814,97186
6:3:4,0,-1,102815,97185
1:4:1,0,-1,102816,97184
6:1:3,0,-1,102817,97183
5:4:4,0,-1,102818,97182
1:6:6,0,-1,102819,97181
5:3:4,0,-1,102820,97180
6:4:2,1,1,102819,97181
2:6:3,1,1,102818,97182
1:6:1,0,-1,102819,97181
1:5:4,0,-1,102820,97180
1:1:3,0,-1,102821,97179
3:2:3,1,1,102820,97180
1:2:6,1,1,102819,97181
5:2:1,1,1,102818,97182
5:4:5,0,-1,102819,97181
6:2:4,1,1,102818,97182
4:3:1,0,-1,102819,97181
4:3:5,0,-1,102820,97180
4:6:2,1,1,102819,97181
3:2:3,1,1,102818,97182
3:5:4,0,-1,102819,97181
5:2:4,1,1,102818,97182
5:6:2,1,1,102817,97183
1:5:6,0,-1,102818,97182
6:2:5,1,1,102817,97183
5:6:4,0,-1,102818,97182
5:3:2,1,1,102817,97183
5:5:5,0,-1,102818,97182
5:5:1,0,-1,102819,97181
2:4:2,2,2,102817,97183
2:2:5,2,2,102815,97185
6:6:2,1,1,102814,97186
1:5:1,0,-1,102815,97185
4:2:1,1,1,102814,97186
2:5:6,1,1,102813,97187
3:3:1,0,-1,102814,97186
5:4:3,0,-1,102815,97185
5:3:3,0,-1,102816,97184
5:1:4,0,-1,102817,97183
1:4:6,0,-1,102818,97182
6:4:4,0,-1,102819,97181
5:5:6,0,-1,102820,97180
3:3:5,0,-1,102821,97179
3:2:6,1,1,102820,97180
5:1:6,0,-1,102821,97179
6:2:4,1,1,102820,97180
3:5:3,0,-1,102821,97179
4:6:5,0,-1,102822,97178
5:5:6,0,-1,102823,97177
4:5:6,0,-1,102824,97176
2:3:6,1,1,102823,97177
5:4:4,0,-1,102824,97176
6:3:5,0,-1,102825,97175
2:3:6,1,1,102824,97176
3:5:1,0,-1,102825,97175
4:6:4,0,-1,102826,97174
3:2:4,1,1,102825,97175
1:6:2,1,1,102824,97176
4:1:3,0,-1,102825,97175
4:5:1,0,-1,102826,97174
5:1:1,0,-1,102827,97173
6:3:1,0,-1,102828,97172
6:4:2,1,1,102827,97173
1:1:5,0,-1,102828,97172
6:1:4,0,-1,102829,97171
4:3:1,0,-1,102830,97170
4:1:5,0,-1,102831,97169
5:5:2,1,1,102830,97170
2:4:2,2,2,102828,97172
4:6:1,0,-1,102829,97171
4:1:2,1,1,102828,97172
5:1:4,0,-1,102829,97171
3:4:4,0,-1,102830,97170
4:2:1,1,1,102829,97171
5:3:1,0,-1,102830,97170
3:1:2,1,1,102829,97171
6:3:4,0,-1,102830,97170
6:3:2,1,1,102829,97171
5:4:3,0,-1,102830,97170
2:3:2,2,2,102828,97172
6:3:4,0,-1,102829,97171
3:1:4,0,-1,102830,97170
6:1:6,0,-1,102831,97169
6:2:3,1,1,102830,97170
2:5:3,1,1,102829,97171
6:4:3,0,-1,102830,97170
5:3:3,0,-1,102831,97169
3:3:1,0,-1,102832,97168
6:6:6,0,-1,102833,97167
6:4:1,0,-1,102834,97166
2:5:6,1,1,102833,97167
4:3:3,0,-1,102834,97166
3:4:1,0,-1,102835,97165
3:1:5,0,-1,102836,97164
1:1:1,0,-1,102837,97163
2:6:2,2,2,102835,97165
3:1:6,0,-1,102836,97164
2:3:2,2,2,102834,97166
3:5:5,0,-1,102835,97165
3:6:5,0,-1,102836,97164
1:3:4,0,-1,102837,97163
4:5:4,0,-1,102838,97162
2:5:4,1,1,102837,97163
5:2:6,1,1,102836,97164
3:1:3,0,-1,102837,97163
2:2:4,2,2,102835,97165
4:6:2,1,1,102834,97166
3:6:4,0,-1,102835,97165
6:5:6,0,-1,102836,97164
1:2:6,1,1,102835,97165
3:4:1,0,-1,102836,97164
1:6:6,0,-1,102837,97163
4:3:1,0,-1,102838,97162
1:3:5,0,-1,102839,97161
6:1:1,0,-1,102840,97160
3:1:6,0,-1,102841,97159
4:3:3,0,-1,102842,97158
5:6:5,0,-1,102843,97157
6:5:1,0,-1,102844,97156
2:2:5,2,2,102842,97158
4:6:6,0,-1,102843,97157
1:2:1,1,1,102842,97158
1:2:5,1,1,102841,97159
3:4:6,0,-1,102842,97158
3:5:2,1,1,102841,97159
1:4:2,1,1,102840,97160
5:2:3,1,1,102839,97161
6:2:6,1,1,102838,97162
3:5:4,0,-1,102839,97161
2:5:3,1,1,102838,97162
6:3:6,0,-1,102839,97161
2:4:5,1,1,102838,97162
2:4:4,1,1,102837,97163
1:3:4,0,-1,102838,97162
1:1:6,0,-1,102839,97161
2:1:5,1,1,102838,97162
3:1:4,0,-1,102839,97161
2:3:2,2,2,102837,97163
4:2:1,1,1,102836,97164
3:6:5,0,-1,102837,97163
6:3:1,0,-1,102838,97162
5:6:3,0,-1,102839,97161
2:1:3,1,1,102838,97162
4:4:6,0,-1,102839,97161
4:5:6,0,-1,102840,97160
1:5:3,0,-1,102841,97159
3:2:5,1,1,102840,97160
3:4:2,1,1,102839,97161
4:4:3,0,-1,102840,97160
3:3:1,0,-1,102841,97159
6:2:6,1,1,102840,97160
5:4:2,1,1,102839,97161
1:6:1,0,-1,102840,97160
2:5:6,1,1,102839,97161
6:5:5,0,-1,102840,97160
3:3:2,1,1,102839,97161
3:2:3,1,1,102838,97162
2:4:1,1,1,102837,97163
2:6:3,1,1,102836,97164
3:2:2,2,2,102834,97166
1:3:2,1,1,102833,97167
6:3:1,0,-1,102834,97166
4:5:2,1,1,102833,97167
2:1:1,1,1,102832,97168
5:1:2,1,1,102831,97169
3:6:2,1,1,102830,97170
4:6:3,0,-1,102831,97169
3:4:1,0,-1,102832,97168
3:3:2,1,1,102831,97169
5:6:2,1,1,102830,97170
4:6:5,0,-1,102831,97169
2:6:2,2,2,102829,97171
2:6:2,2,2,102827,97173
1:1:5,0,-1,102828,97172
4:1:2,1,1,102827,97173
1:5:5,0,-1,102828,97172
4:6:1,0,-1,102829,97171
2:1:5,1,1,102828,97172
3:4:4,0,-1,102829,97171
6:4:6,0,-1,102830,97170
6:4:1,0,-1,102831,97169
4:2:3,1,1,102830,97170
5:5:1,0,-1,102831,97169
2:4:6,1,1,102830,97170
6:4:1,0,-1,102831,97169
3:4:2,1,1,102830,97170
2:5:3,1,1,102829,97171
5:4:1,0,-1,102830,97170
2:5:1,1,1,102829,97171
2:2:2,3,3,102826,97174
1:1:6,0,-1,102827,97173
1:6:3,0,-1,102828,97172
5:2:3,1,1,102827,97173
2:1:2,2,2,102825,97175
2:2:4,2,2,102823,97177
1:6:3,0,-1,102824,97176
6:5:4,0,-1,102825,97175
6:5:5,0,-1,102826,97174
3:6:5,0,-1,102827,97173
3:5:1,0,-1,102828,97172
2:3:2,2,2,102826,97174
6:4:1,0,-1,102827,97173
1:3:3,0,-1,102828,97172
3:1:5,0,-1,102829,97171
4:4:6,0,-1,102830,97170
5:6:5,0,-1,102831,97169
5:2:3,1,1,102830,97170
1:6:6,0,-1,102831,97169
2:2:3,2,2,102829,97171
3:1:3,0,-1,102830,97170
2:5:6,1,1,102829,97171
3:4:6,0,-1,102830,97170
3:3:4,0,-1,102831,97169
2:5:4,1,1,102830,97170
2:2:3,2,2,102828,97172
3:6:5,0,-1,102829,97171
1:1:3,0,-1,102830,97170
3:4:5,0,-1,102831,97169
3:1:2,1,1,102830,97170
2:1:5,1,1,102829,97171
4:5:2,1,1,102828,97172
6:4:4,0,-1,102829,97171
6:3:4,0,-1,102830,97170
3:3:1,0,-1,102831,97169
6:4:1,0,-1,102832,97168
1:4:5,0,-1,102833,97167
4:1:3,0,-1,102834,97166
1:4:3,0,-1,102835,97165
1:3:6,0,-1,102836,97164
2:4:5,1,1,102835,97165
5:6:3,0,-1,102836,97164
3:6:2,1,1,102835,97165
4:4:6,0,-1,102836,97164
3:1:1,0,-1,102837,97163
1:2:3,1,1,102836,97164
4:6:2,1,1,102835,97165
2:4:4,1,1,102834,97166
3:5:2,1,1,102833,97167
2:1:2,2,2,102831,97169
3:4:4,0,-1,102832,97168
1:4:2,1,1,102831,97169
6:5:6,0,-1,102832,97168
6:2:6,1,1,102831,97169
6:3:3,0,-1,102832,97168
1:5:1,0,-1,102833,97167
5:4:6,0,-1,102834,97166
3:3:6,0,-1,102835,97165
5:5:1,0,-1,102836,97164
4:5:5,0,-1,102837,97163
1:1:2,1,1,102836,97164
3:3:2,1,1,102835,97165
4:1:4,0,-1,102836,97164
2:2:6,2,2,102834,97166
2:1:1,1,1,102833,97167
4:2:5,1,1,102832,97168
3:6:1,0,-1,102833,97167
4:2:2,2,2,102831,97169
5:3:2,1,1,102830,97170
1:2:4,1,1,102829,97171
3:1:5,0,-1,102830,97170
4:1:1,0,-1,102831,97169
5:1:3,0,-1,102832,97168
6:3:4,0,-1,102833,97167
4:3:3,0,-1,102834,97166
4:5:3,0,-1,102835,97165
1:1:1,0,-1,102836,97164
2:6:1,1,1,102835,97165
1:4:1,0,-1,102836,97164
4:1:6,0,-1,102837,97163
6:6:6,0,-1,102838,97162
2:3:1,1,1,102837,97163
4:1:5,0,-1,102838,97162
6:1:6,0,-1,102839,97161
6:4:1,0,-1,102840,97160
6:3:1,0,-1,102841,97159
4:1:2,1,1,102840,97160
1:3:5,0,-1,102841,97159
1:2:6,1,1,102840,97160
1:4:1,0,-1,102841,97159
5:4:5,0,-1,102842,97158
1:2:6,1,1,102841,97159
5:6:1,0,-1,102842,97158
6:3:6,0,-1,102843,97157
3:1:2,1,1,102842,97158
2:3:4,1,1,102841,97159
3:1:6,0,-1,102842,97158
1:5:4,0,-1,102843,97157
6:5:6,0,-1,102844,97156
6:4:5,0,-1,102845,97155
2:5:1,1,1,102844,97156
3:4:4,0,-1,102845,97155
2:4:6,1,1,102844,97156
5:4:4,0,-1,102845,97155
4:1:3,0,-1,102846,97154
5:4:1,0,-1,102847,97153
5:3:6,0,-1,102848,97152
6:4:2,1,1,102847,97153
2:4:4,1,1,102846,97154
1:4:1,0,-1,102847,97153
5:2:5,1,1,102846,97154
3:4:4,0,-1,102847,97153
3:2:4,1,1,102846,97154
3:4:4,0,-1,102847,97153
6:3:5,0,-1,102848,97152
2:4:4,1,1,102847,97153
2:1:2,2,2,102845,97155
2:5:6,1,1,102844,97156
6:6:6,0,-1,102845,97155
1:4:6,0,-1,102846,97154
5:1:1,0,-1,102847,97153
3:1:3,0,-1,102848,97152
1:4:2,1,1,102847,97153
2:6:5,1,1,102846,97154
2:2:3,2,2,102844,97156
3:3:2,1,1,102843,97157
4:6:1,0,-1,102844,97156
2:5:4,1,1,102843,97157
4:2:5,1,1,102842,97158
3:5:6,0,-1,102843,97157
2:2:3,2,2,102841,97159
6:1:6,0,-1,102842,97158
1:1:4,0,-1,102843,97157
5:4:5,0,-1,102844,97156
1:2:3,1,1,102843,97157
1:2:5,1,1,102842,97158
3:3:2,1,1,102841,97159
2:4:2,2,2,102839,97161
4:4:5,0,-1,102840,97160
2:3:2,2,2,102838,97162
3:1:2,1,1,102837,97163
2:2:2,3,3,102834,97166
2:2:1,2,2,102832,97168
4:4:3,0,-1,102833,97167
1:2:3,1,1,102832,97168
4:3:2,1,1,102831,97169
3:5:2,1,1,102830,97170
6:2:3,1,1,102829,97171
5:1:3,0,-1,102830,97170
3:1:4,0,-1,102831,97169
1:3:4,0,-1,102832,97168
4:6:2,1,1,102831,97169
5:6:3,0,-1,102832,97168
3:2:6,1,1,102831,97169
4:5:6,0,-1,102832,97168
4:6:3,0,-1,102833,97167
2:1:5,1,1,102832,97168
2:6:4,1,1,102831,97169
2:2:1,2,2,102829,97171
2:1:3,1,1,102828,97172
1:3:5,0,-1,102829,97171
6:4:6,0,-1,102830,97170
6:6:2,1,1,102829,97171
1:2:6,1,1,102828,97172
1:3:4,0,-1,102829,97171
1:4:6,0,-1,102830,97170
3:4:4,0,-1,102831,97169
2:3:5,1,1,102830,97170
5:3:6,0,-1,102831,97169
1:4:4,0,-1,102832,97168
3:2:6,1,1,102831,97169
6:3:3,0,-1,102832,97168
6:5:4,0,-1,102833,97167
5:2:1,1,1,102832,97168
2:6:1,1,1,102831,97169
2:6:2,2,2,102829,97171
5:1:2,1,1,102828,97172
6:1:1,0,-1,102829,97171
3:1:5,0,-1,102830,97170
5:3:5,0,-1,102831,97169
3:4:4,0,-1,102832,97168
3:3:5,0,-1,102833,97167
3:1:4,0,-1,102834,97166
6:5:5,0,-1,102835,97165
2:6:1,1,1,102834,97166
1:5:2,1,1,102833,97167
3:4:5,0,-1,102834,97166
3:1:3,0,-1,102835,97165
2:6:1,1,1,102834,97166
3:4:4,0,-1,102835,97165
3:1:1,0,-1,102836,97164
5:6:5,0,-1,102837,97163
4:2:1,1,1,102836,97164
4:2:4,1,1,102835,97165
3:5:3,0,-1,102836,97164
1:4:4,0,-1,102837,97163
2:6:6,1,1,102836,97164
6:2:5,1,1,102835,97165
5:4:3,0,-1,102836,97164
2:1:2,2,2,102834,97166
5:1:5,0,-1,102835,97165
2:2:5,2,2,102833,97167
4:4:6,0,-1,102834,97166
6:1:5,0,-1,102835,97165
1:3:4,0,-1,102836,97164
3:4:5,0,-1,102837,97163
5:1:5,0,-1,102838,97162
1:1:4,0,-1,102839,97161
3:5:3,0,-1,102840,97160
6:4:5,0,-1,102841,97159
1:3:1,0,-1,102842,97158
5:1:4,0,-1,102843,97157
6:2:3,1,1,102842,97158
5:6:1,0,-1,102843,97157
3:5:1,0,-1,102844,97156
2:4:2,2,2,102842,97158
3:2:2,2,2,102840,97160
5:6:5,0,-1,102841,97159
1:4:2,1,1,102840,97160
3:3:2,1,1,102839,97161
6:5:1,0,-1,102840,97160
5:5:2,1,1,102839,97161
5:5:6,0,-1,102840,97160
6:2:6,1,1,102839,97161
3:2:4,1,1,102838,97162
1:4:3,0,-1,102839,97161
4:4:2,1,1,102838,97162
2:6:5,1,1,102837,97163
5:6:2,1,1,102836,97164
6:5:6,0,-1,102837,97163
6:2:6,1,1,102836,97164
2:3:6,1,1,102835,97165
1:5:1,0,-1,102836,97164
6:6:1,0,-1,102837,97163
1:3:5,0,-1,102838,97162
3:5:1,0,-1,102839,97161
1:3:2,1,1,102838,97162
5:1:3,0,-1,102839,97161
5:6:2,1,1,102838,97162
6:3:6,0,-1,102839,97161
3:3:3,0,-1,102840,97160
2:6:2,2,2,102838,97162
2:2:6,2,2,102836,97164
6:2:2,2,2,102834,97166
2:6:4,1,1,102833,97167
3:5:2,1,1,102832,97168
5:3:4,0,-1,102833,97167
5:1:1,0,-1,102834,97166
5:5:1,0,-1,102835,97165
5:1:2,1,1,102834,97166
3:6:3,0,-1,102835,97165
4:2:2,2,2,102833,97167
2:1:2,2,2,102831,97169
6:4:3,0,-1,102832,97168
6:1:4,0,-1,102833,97167
1:4:1,0,-1,102834,97166
1:1:5,0,-1,102835,97165
1:4:3,0,-1,102836,97164
3:2:1,1,1,102835,97165
5:3:6,0,-1,102836,97164
4:1:2,1,1,102835,97165
1:5:5,0,-1,102836,97164
1:6:1,0,-1,102837,97163
4:1:1,0,-1,102838,97162
3:6:5,0,-1,102839,97161
4:6:6,0,-1,102840,97160
2:1:5,1,1,102839,97161
2:5:6,1,1,102838,97162
5:6:1,0,-1,102839,97161
2:2:5,2,2,102837,97163
1:3:5,0,-1,102838,97162
3:2:5,1,1,102837,97163
4:5:3,0,-1,102838,97162
5:4:6,0,-1,102839,97161
6:6:2,1,1,102838,97162
3:6:5,0,-1,102839,97161
4:6:3,0,-1,102840,97160
1:1:6,0,-1,102841,97159
2:5:4,1,1,102840,97160
1:3:6,0,-1,102841,97159
4:1:6,0,-1,102842,97158
2:1:5,1,1,102841,97159
4:1:1,0,-1,102842,97158
1:4:3,0,-1,102843,97157
2:2:4,2,2,102841,97159
3:3:1,0,-1,102842,97158
1:5:1,0,-1,102843,97157
3:3:5,0,-1,102844,97156
4:5:4,0,-1,102845,97155
2:5:1,1,1,102844,97156
2:5:2,2,2,102842,97158
1:5:4,0,-1,102843,97157
5:1:3,0,-1,102844,97156
3:1:6,0,-1,102845,97155
1:5:2,1,1,102844,97156
1:1:3,0,-1,102845,97155
2:5:4,1,1,102844,97156
3:6:6,0,-1,102845,97155
1:1:4,0,-1,102846,97154
2:2:5,2,2,102844,97156
5:5:1,0,-1,102845,97155
5:1:1,0,-1,102846,97154
3:3:4,0,-1,102847,97153
4:4:2,1,1,102846,97154
1:4:1,0,-1,102847,97153
4:5:3,0,-1,102848,97152
4:6:4,0,-1,102849,97151
2:1:5,1,1,102848,97152
4:1:4,0,-1,102849,97151
6:4:6,0,-1,102850,97150
2:5:6,1,1,102849,97151
5:2:6,1,1,102848,97152
2:1:4,1,1,102847,97153
6:1:2,1,1,102846,97154
6:3:4,0,-1,102847,97153
5:4:4,0,-1,102848,97152
3:6:3,0,-1,102849,97151
6:1:1,0,-1,102850,97150
4:3:1,0,-1,102851,97149
4:3:2,1,1,102850,97150
4:6:5,0,-1,102851,97149
2:5:5,1,1,102850,97150
2:5:2,2,2,102848,97152
4:2:6,1,1,102847,97153
1:4:2,1,1,102846,97154
4:3:3,0,-1,102847,97153
2:6:6,1,1,102846,97154
5:2:6,1,1,102845,97155
2:1:6,1,1,102844,97156
6:6:5,0,-1,102845,97155
2:3:5,1,1,102844,97156
3:6:5,0,-1,102845,97155
5:4:1,0,-1,102846,97154
5:4:5,0,-1,102847,97153
1:6:5,0,-1,102848,97152
6:1:5,0,-1,102849,97151
3:1:3,0,-1,102850,97150
5:1:1,0,-1,102851,97149
4:1:1,0,-1,102852,97148
2:1:6,1,1,102851,97149
4:3:3,0,-1,102852,97148
1:2:3,1,1,102851,97149
4:3:5,0,-1,102852,97148
2:1:5,1,1,102851,97149
6:2:5,1,1,102850,97150
1:6:2,1,1,102849,97151
6:4:2,1,1,102848,97152
1:4:3,0,-1,102849,97151
1:3:3,0,-1,102850,97150
6:2:1,1,1,102849,97151
6:6:2,1,1,102848,97152
5:3:3,0,-1,102849,97151
6:6:2,1,1,102848,97152
6:5:6,0,-1,102849,97151
4:3:3,0,-1,102850,97150
5:5:2,1,1,102849,97151
5:5:6,0,-1,102850,97150
2:5:3,1,1,102849,97151
5:4:2,1,1,102848,97152
2:1:1,1,1,102847,97153
3:1:5,0,-1,102848,97152
3:1:2,1,1,102847,97153
1:3:1,0,-1,102848,97152
6:5:4,0,-1,102849,97151
1:6:4,0,-1,102850,97150
4:6:2,1,1,102849,97151
4:1:3,0,-1,102850,97150
2:2:6,2,2,102848,97152
6:4:2,1,1,102847,97153
1:5:2,1,1,102846,97154
5:5:3,0,-1,102847,97153
3:5:2,1,1,102846,97154
2:1:2,2,2,102844,97156
5:2:5,1,1,102843,97157
5:1:6,0,-1,102844,97156
3:5:1,0,-1,102845,97155
3:5:1,0,-1,102846,97154
2:5:6,1,1,102845,97155
1:5:5,0,-1,102846,97154
4:1:1,0,-1,102847,97153
4:1:3,0,-1,102848,97152
5:1:3,0,-1,102849,97151
1:5:6,0,-1,102850,97150
3:3:5,0,-1,102851,97149
3:2:1,1,1,102850,97150
6:3:6,0,-1,102851,97149
4:5:2,1,1,102850,97150
6:1:4,0,-1,102851,97149
4:2:1,1,1,102850,97150
2:2:1,2,2,102848,97152
2:2:3,2,2,102846,97154
5:1:5,0,-1,102847,97153
3:5:3,0,-1,102848,97152
2:5:6,1,1,102847,97153
4:2:5,1,1,102846,97154
5:6:5,0,-1,102847,97153
5:2:4,1,1,102846,97154
1:1:5,0,-1,102847,97153
3:6:2,1,1,102846,97154
2:6:2,2,2,102844,97156
3:2:4,1,1,102843,97157
1:6:6,0,-1,102844,97156
1:4:5,0,-1,102845,97155
4:4:1,0,-1,102846,97154
5:3:2,1,1,102845,97155
5:1:2,1,1,102844,97156
5:6:6,0,-1,102845,97155
5:2:2,2,2,102843,97157
5:3:1,0,-1,102844,97156
2:4:2,2,2,102842,97158
4:6:6,0,-1,102843,97157
2:4:2,2,2,102841,97159
2:1:1,1,1,102840,97160
1:5:1,0,-1,102841,97159
2:5:4,1,1,102840,97160
3:3:5,0,-1,102841,97159
2:5:6,1,1,102840,97160
1:4:2,1,1,102839,97161
6:3:6,0,-1,102840,97160
4:3:6,0,-1,102841,97159
6:6:3,0,-1,102842,97158
2:3:3,1,1,102841,97159
4:6:5,0,-1,102842,97158
4:5:2,1,1,102841,97159
3:1:5,0,-1,102842,97158
4:5:4,0,-1,102843,97157
3:3:6,0,-1,102844,97156
4:6:4,0,-1,102845,97155
5:4:2,1,1,102844,97156
4:5:2,1,1,102843,97157
3:1:2,1,1,102842,97158
5:2:2,2,2,102840,97160
1:3:1,0,-1,102841,97159
3:3:4,0,-1,102842,97158
4:4:4,0,-1,102843,97157
2:3:2,2,2,102841,97159
3:3:3,0,-1,102842,97158
1:2:2,2,2,102840,97160
4:2:1,1,1,102839,97161
2:1:5,1,1,102838,97162
4:4:2,1,1,102837,97163
1:5:5,0,-1,102838,97162
2:4:2,2,2,102836,97164
2:6:5,1,1,102835,97165
2:6:4,1,1,102834,97166
5:1:1,0,-1,102835,97165
5:5:5,0,-1,102836,97164
5:1:5,0,-1,102837,97163
1:4:2,1,1,102836,97164
3:2:3,1,1,102835,97165
1:5:4,0,-1,102836,97164
4:1:6,0,-1,102837,97163
1:6:3,0,-1,102838,97162
4:1:4,0,-1,102839,97161
5:1:5,0,-1,102840,97160
5:1:2,1,1,102839,97161
1:1:5,0,-1,102840,97160
4:4:5,0,-1,102841,97159
1:1:4,0,-1,102842,97158
3:1:3,0,-1,102843,97157
5:6:3,0,-1,102844,97156
4:5:1,0,-1,102845,97155
1:5:1,0,-1,102846,97154
2:4:5,1,1,102845,97155
3:1:4,0,-1,102846,97154
2:2:3,2,2,102844,97156
5:3:3,0,-1,102845,97155
1:4:1,0,-1,102846,97154
4:2:2,2,2,102844,97156
2:5:5,1,1,102843,97157
3:2:2,2,2,102841,97159
4:1:1,0,-1,102842,97158
4:4:3,0,-1,102843,97157
6:4:2,1,1,102842,97158
6:2:5,1,1,102841,97159
4:1:6,0,-1,102842,97158
3:3:5,0,-1,102843,97157
3:1:3,0,-1,102844,97156
2:2:5,2,2,102842,97158
5:2:6,1,1,102841,97159
1:2:4,1,1,102840,97160
3:5:4,0,-1,102841,97159
3:4:3,0,-1,102842,97158
2:2:5,2,2,102840,97160
3:3:1,0,-1,102841,97159
3:2:6,1,1,102840,97160
5:1:4,0,-1,102841,97159
6:5:6,0,-1,102842,97158
5:2:3,1,1,102841,97159
5:6:5,0,-1,102842,97158
2:4:5,1,1,102841,97159
4:3:3,0,-1,102842,97158
6:5:2,1,1,102841,97159
5:3:5,0,-1,102842,97158
2:1:4,1,1,102841,97159
4:5:3,0,-1,102842,97158
4:4:2,1,1,102841,97159
3:1:5,0,-1,102842,97158
5:3:2,1,1,102841,97159
2:1:2,2,2,102839,97161
1:3:4,0,-1,102840,97160
2:1:3,1,1,102839,97161
3:2:4,1,1,102838,97162
2:4:3,1,1,102837,97163
6:4:4,0,-1,102838,97162
5:6:6,0,-1,102839,97161
5:6:6,0,-1,102840,97160
1:6:2,1,1,102839,97161
1:5:3,0,-1,102840,97160
6:6:5,0,-1,102841,97159
3:4:3,0,-1,102842,97158
1:1:3,0,-1,102843,97157
2:2:6,2,2,102841,97159
6:2:2,2,2,102839,97161
1:2:1,1,1,102838,97162
6:4:1,0,-1,102839,97161
1:5:2,1,1,102838,97162
4:6:3,0,-1,102839,97161
2:1:1,1,1,102838,97162
3:3:6,0,-1,102839,97161
1:4:1,0,-1,102840,97160
6:1:1,0,-1,102841,97159
4:6:6,0,-1,102842,97158
4:5:6,0,-1,102843,97157
5:6:3,0,-1,102844,97156
4:3:1,0,-1,102845,97155
5:2:2,2,2,102843,97157
5:3:5,0,-1,102844,97156
3:5:5,0,-1,102845,97155
5:4:5,0,-1,102846,97154
6:1:4,0,-1,102847,97153
5:1:1,0,-1,102848,97152
1:3:1,0,-1,102849,97151
4:5:1,0,-1,102850,97150
4:1:4,0,-1,102851,97149
5:2:2,2,2,102849,97151
4:6:1,0,-1,102850,97150
3:6:6,0,-1,102851,97149
4:3:1,0,-1,102852,97148
1:3:2,1,1,102851,97149
6:3:5,0,-1,102852,97148
3:4:3,0,-1,102853,97147
5:2:4,1,1,102852,97148
1:1:3,0,-1,102853,97147
5:5:6,0,-1,102854,97146
1:2:5,1,1,102853,97147
1:3:6,0,-1,102854,97146
3:3:2,1,1,102853,97147
6:1:1,0,-1,102854,97146
6:1:5,0,-1,102855,97145
3:2:4,1,1,102854,97146
3:6:5,0,-1,102855,97145
4:1:5,0,-1,102856,97144
1:2:6,1,1,102855,97145
2:5:5,1,1,102854,97146
3:6:6,0,-1,102855,97145
3:2:4,1,1,102854,97146
2:2:1,2,2,102852,97148
1:2:1,1,1,102851,97149
4:1:3,0,-1,102852,97148
3:4:5,0,-1,102853,97147
1:2:1,1,1,102852,97148
6:4:2,1,1,102851,97149
2:6:4,1,1,102850,97150
3:4:5,0,-1,102851,97149
3:5:4,0,-1,102852,97148
1:4:4,0,-1,102853,97147
1:2:6,1,1,102852,97148
6:2:2,2,2,102850,97150
5:5:2,1,1,102849,97151
1:3:4,0,-1,102850,97150
3:5:2,1,1,102849,97151
1:2:2,2,2,102847,97153
3:5:4,0,-1,102848,97152
5:5:2,1,1,102847,97153
4:2:5,1,1,102846,97154
2:4:5,1,1,102845,97155
2:4:5,1,1,102844,97156
1:2:1,1,1,102843,97157
6:4:1,0,-1,102844,97156
6:4:5,0,-1,102845,97155
3:3:6,0,-1,102846,97154
6:5:6,0,-1,102847,97153
4:2:6,1,1,102846,97154
5:6:6,0,-1,102847,97153
4:3:5,0,-1,102848,97152
5:2:5,1,1,102847,97153
4:1:2,1,1,102846,97154
3:5:6,0,-1,102847,97153
2:2:3,2,2,102845,97155
2:3:6,1,1,102844,97156
5:3:1,0,-1,102845,97155
3:2:5,1,1,102844,97156
3:6:3,0,-1,102845,97155
3:3:6,0,-1,102846,97154
1:5:2,1,1,102845,97155
4:2:4,1,1,102844,97156
6:4:6,0,-1,102845,97155
3:4:3,0,-1,102846,97154
2:5:3,1,1,102845,97155
4:1:1,0,-1,102846,97154
3:3:2,1,1,102845,97155
5:6:2,1,1,102844,97156
2:2:2,3,3,102841,97159
3:4:5,0,-1,102842,97158
4:1:1,0,-1,102843,97157
1:3:5,0,-1,102844,97156
5:4:5,0,-1,102845,97155
2:3:3,1,1,102844,97156
2:3:6,1,1,102843,97157
1:1:6,0,-1,102844,97156
3:3:2,1,1,102843,97157
3:6:6,0,-1,102844,97156
5:4:3,0,-1,102845,97155
6:1:6,0,-1,102846,97154
5:5:2,1,1,102845,97155
1:1:4,0,-1,102846,97154
3:5:2,1,1,102845,97155
6:1:6,0,-1,102846,97154
5:3:2,1,1,102845,97155
6:3:2,1,1,102844,97156
5:2:3,1,1,102843,97157
4:4:2,1,1,102842,97158
4:6:6,0,-1,102843,97157
2:2:6,2,2,102841,97159
1:2:5,1,1,102840,97160
3:3:5,0,-1,102841,97159
4:3:2,1,1,102840,97160
5:1:1,0,-1,102841,97159
6:2:1,1,1,102840,97160
4:3:1,0,-1,102841,97159
5:4:6,0,-1,102842,97158
5:5:2,1,1,102841,97159
1:6:2,1,1,102840,97160
2:3:1,1,1,102839,97161
1:4:5,0,-1,102840,97160
6:3:3,0,-1,102841,97159
2:4:5,1,1,102840,97160
1:2:1,1,1,102839,97161
3:1:3,0,-1,102840,97160
1:4:1,0,-1,102841,97159
5:2:1,1,1,102840,97160
3:2:3,1,1,102839,97161
5:1:3,0,-1,102840,97160
5:4:2,1,1,102839,97161
3:5:2,1,1,102838,97162
3:5:6,0,-1,102839,97161
2:6:5,1,1,102838,97162
3:4:2,1,1,102837,97163
2:2:3,2,2,102835,97165
3:2:1,1,1,102834,97166
2:2:6,2,2,102832,97168
2:1:2,2,2,102830,97170
6:6:3,0,-1,102831,97169
5:6:4,0,-1,102832,97168
4:2:4,1,1,102831,97169
3:5:3,0,-1,102832,97168
3:4:3,0,-1,102833,97167
5:4:1,0,-1,102834,97166
6:1:4,0,-1,102835,97165
3:3:1,0,-1,102836,97164
4:5:1,0,-1,102837,97163
1:5:1,0,-1,102838,97162
5:5:5,0,-1,102839,97161
4:3:5,0,-1,102840,97160
6:5:4,0,-1,102841,97159
2:3:6,1,1,102840,97160
2:1:4,1,1,102839,97161
6:3:4,0,-1,102840,97160
6:3:6,0,-1,102841,97159
4:1:5,0,-1,102842,97158
6:2:2,2,2,102840,97160
4:4:4,0,-1,102841,97159
3:5:2,1,1,102840,97160
1:1:1,0,-1,102841,97159
1:1:2,1,1,102840,97160
2:1:5,1,1,102839,97161
4:2:1,1,1,102838,97162
1:6:6,0,-1,102839,97161
6:1:3,0,-1,102840,97160
3:2:5,1,1,102839,97161
2:6:6,1,1,102838,97162
3:6:3,0,-1,102839,97161
5:6:4,0,-1,102840,97160
3:4:4,0,-1,102841,97159
2:3:1,1,1,102840,97160
5:6:1,0,-1,102841,97159
2:3:1,1,1,102840,97160
2:5:4,1,1,102839,97161
5:1:6,0,-1,102840,97160
6:2:6,1,1,102839,97161
2:5:1,1,1,102838,97162
5:5:6,0,-1,102839,97161
2:5:5,1,1,102838,97162
4:4:6,0,-1,102839,97161
4:6:2,1,1,102838,97162
3:6:3,0,-1,102839,97161
6:2:2,2,2,102837,97163
1:4:4,0,-1,102838,97162
5:1:2,1,1,102837,97163
1:4:5,0,-1,102838,97162
6:6:5,0,-1,102839,97161
3:1:5,0,-1,102840,97160
6:3:4,0,-1,102841,97159
1:5:5,0,-1,102842,97158
6:4:4,0,-1,102843,97157
3:3:1,0,-1,102844,97156
2:1:1,1,1,102843,97157
5:3:4,0,-1,102844,97156
3:1:1,0,-1,102845,97155
4:5:6,0,-1,102846,97154
4:4:4,0,-1,102847,97153
1:5:6,0,-1,102848,97152
5:4:1,0,-1,102849,97151
5:5:5,0,-1,102850,97150
6:1:1,0,-1,102851,97149
4:1:2,1,1,102850,97150
6:3:1,0,-1,102851,97149
1:2:2,2,2,102849,97151
1:3:1,0,-1,102850,97150
2:5:3,1,1,102849,97151
4:4:1,0,-1,102850,97150
3:6:1,0,-1,102851,97149
4:5:6,0,-1,102852,97148
1:6:2,1,1,102851,97149
3:5:5,0,-1,102852,97148
1:4:3,0,-1,102853,97147
2:4:3,1,1,102852,97148
4:6:6,0,-1,102853,97147
4:3:2,1,1,102852,97148
6:6:1,0,-1,102853,97147
6:6:1,0,-1,102854,97146
2:3:4,1,1,102853,97147
1:6:4,0,-1,102854,97146
3:4:6,0,-1,102855,97145
5:5:1,0,-1,102856,97144
2:6:4,1,1,102855,97145
2:6:2,2,2,102853,97147
6:5:4,0,-1,102854,97146
1:4:6,0,-1,102855,97145
3:5:2,1,1,102854,97146
5:5:6,0,-1,102855,97145
4:1:3,0,-1,102856,97144
1:2:3,1,1,102855,97145
2:5:3,1,1,102854,97146
4:3:2,1,1,102853,97147
6:4:1,0,-1,102854,97146
1:6:5,0,-1,102855,97145
6:5:2,1,1,102854,97146
4:2:5,1,1,102853,97147
4:3:5,0,-1,102854,97146
3:1:4,0,-1,102855,97145
3:1:4,0,-1,102856,97144
1:2:4,1,1,102855,97145
4:1:6,0,-1,102856,97144
6:4:5,0,-1,102857,97143
4:4:1,0,-1,102858,97142
3:3:2,1,1,102857,97143
6:4:3,0,-1,102858,97142
3:1:4,0,-1,102859,97141
1:4:1,0,-1,102860,97140
6:6:1,0,-1,102861,97139
2:5:3,1,1,102860,97140
1:4:5,0,-1,102861,97139
3:6:2,1,1,102860,97140
3:5:1,0,-1,102861,97139
5:3:4,0,-1,102862,97138
4:1:4,0,-1,102863,97137
5:2:4,1,1,102862,97138
5:6:5,0,-1,102863,97137
5:3:4,0,-1,102864,97136
3:1:2,1,1,102863,97137
4:3:5,0,-1,102864,97136
3:1:2,1,1,102863,97137
3:2:1,1,1,102862,97138
5:1:2,1,1,102861,97139
4:4:1,0,-1,102862,97138
1:6:2,1,1,102861,97139
1:1:3,0,-1,102862,97138
5:2:1,1,1,102861,97139
3:6:6,0,-1,102862,97138
2:3:1,1,1,102861,97139
5:1:1,0,-1,102862,97138
1:4:2,1,1,102861,97139
5:6:3,0,-1,102862,97138
6:2:3,1,1,102861,97139
4:6:1,0,-1,102862,97138
1:1:3,0,-1,102863,97137
2:4:3,1,1,102862,97138
5:4:2,1,1,102861,97139
1:2:4,1,1,102860,97140
2:4:1,1,1,102859,97141
1:3:1,0,-1,102860,97140
2:1:2,2,2,102858,97142
4:5:3,0,-1,102859,97141
4:1:2,1,1,102858,97142
5:1:3,0,-1,102859,97141
1:6:1,0,-1,102860,97140
4:6:2,1,1,102859,97141
5:3:5,0,-1,102860,97140
1:5:4,0,-1,102861,97139
4:6:2,1,1,102860,97140
6:3:1,0,-1,102861,97139
4:6:4,0,-1,102862,97138
2:1:4,1,1,102861,97139
6:4:6,0,-1,102862,97138
6:2:4,1,1,102861,97139
2:2:1,2,2,102859,97141
1:2:3,1,1,102858,97142
2:3:6,1,1,102857,97143
5:2:1,1,1,102856,97144
6:1:6,0,-1,102857,97143
3:1:1,0,-1,102858,97142
1:5:2,1,1,102857,97143
1:1:6,0,-1,102858,97142
6:4:1,0,-1,102859,97141
5:2:2,2,2,102857,97143
1:3:6,0,-1,102858,97142
2:6:6,1,1,102857,97143
3:3:1,0,-1,102858,97142
5:3:2,1,1,102857,97143
6:6:6,0,-1,102858,97142
6:1:6,0,-1,102859,97141
1:2:4,1,1,102858,97142
2:1:5,1,1,102857,97143
1:1:6,0,-1,102858,97142
4:1:1,0,-1,102859,97141
1:6:5,0,-1,102860,97140
6:2:5,1,1,102859,97141
5:6:5,0,-1,102860,97140
5:3:1,0,-1,102861,97139
6:4:4,0,-1,102862,97138
4:5:1,0,-1,102863,97137
5:2:4,1,1,102862,97138
2:1:3,1,1,102861,97139
4:1:6,0,-1,102862,97138
3:4:2,1,1,102861,97139
6:4:2,1,1,102860,97140
4:5:2,1,1,102859,97141
3:1:6,0,-1,102860,97140
5:1:3,0,-1,102861,97139
6:2:3,1,1,102860,97140
3:3:3,0,-1,102861,97139
5:2:3,1,1,102860,97140
3:6:5,0,-1,102861,97139
1:3:2,1,1,102860,97140
1:3:4,0,-1,102861,97139
6:2:5,1,1,102860,97140
5:6:3,0,-1,102861,97139
4:1:3,0,-1,102862,97138
3:6:3,0,-1,102863,97137
4:4:4,0,-1,102864,97136
3:6:1,0,-1,102865,97135
2:6:6,1,1,102864,97136
2:5:4,1,1,102863,97137
4:5:3,0,-1,102864,97136
5:4:1,0,-1,102865,97135
5:5:4,0,-1,102866,97134
4:5:4,0,-1,102867,97133
3:2:4,1,1,102866,97134
3:3:6,0,-1,102867,97133
1:3:1,0,-1,102868,97132
6:4:6,0,-1,102869,97131
6:5:5,0,-1,102870,97130
4:3:1,0,-1,102871,97129
4:6:2,1,1,102870,97130
1:1:1,0,-1,102871,97129
5:1:3,0,-1,102872,97128
3:5:2,1,1,102871,97129
4:3:1,0,-1,102872,97128
2:6:4,1,1,102871,97129
2:1:5,1,1,102870,97130
3:4:6,0,-1,102871,97129
2:4:2,2,2,102869,97131
6:1:5,0,-1,102870,97130
4:3:2,1,1,102869,97131
3:2:1,1,1,102868,97132
1:1:1,0,-1,102869,97131
6:3:3,0,-1,102870,97130
4:3:5,0,-1,102871,97129
2:5:6,1,1,102870,97130
3:3:4,0,-1,102871,97129
3:4:4,0,-1,102872,97128
6:2:4,1,1,102871,97129
2:6:4,1,1,102870,97130
1:2:1,1,1,102869,97131
3:2:3,1,1,102868,97132
4:5:2,1,1,102867,97133
5:2:6,1,1,102866,97134
4:2:3,1,1,102865,97135
1:4:5,0,-1,102866,97134
5:1:6,0,-1,102867,97133
1:2:4,1,1,102866,97134
2:6:5,1,1,102865,97135
6:5:5,0,-1,102866,97134
5:6:6,0,-1,102867,97133
2:4:1,1,1,102866,97134
6:3:1,0,-1,102867,97133
1:1:5,0,-1,102868,97132
6:6:4,0,-1,102869,97131
1:3:3,0,-1,102870,97130
1:1:3,0,-1,102871,97129
1:1:2,1,1,102870,97130
6:3:5,0,-1,102871,97129
1:4:6,0,-1,102872,97128
3:2:1,1,1,102871,97129
3:4:3,0,-1,102872,97128
2:2:4,2,2,102870,97130
3:2:1,1,1,102869,97131
1:2:3,1,1,102868,97132
2:5:4,1,1,102867,97133
1:2:1,1,1,102866,97134
3:1:6,0,-1,102867,97133
1:5:4,0,-1,102868,97132
2:6:1,1,1,102867,97133
3:5:6,0,-1,102868,97132
1:3:5,0,-1,102869,97131
2:4:6,1,1,102868,97132
5:6:6,0,-1,102869,97131
4:4:3,0,-1,102870,97130
1:1:4,0,-1,102871,97129
1:5:1,0,-1,102872,97128
2:1:4,1,1,102871,97129
2:1:3,1,1,102870,97130
2:5:1,1,1,102869,97131
6:6:4,0,-1,102870,97130
2:1:2,2,2,102868,97132
4:1:4,0,-1,102869,97131
6:5:6,0,-1,102870,97130
6:3:6,0,-1,102871,97129
3:4:4,0,-1,102872,97128
5:4:4,0,-1,102873,97127
1:5:4,0,-1,102874,97126
3:6:1,0,-1,102875,97125
5:3:3,0,-1,102876,97124
3:6:4,0,-1,102877,97123
3:6:5,0,-1,102878,97122
6:1:4,0,-1,102879,97121
3:3:3,0,-1,102880,97120
2:5:5,1,1,102879,97121
6:2:5,1,1,102878,97122
2:5:6,1,1,102877,97123
6:5:2,1,1,102876,97124
1:1:4,0,-1,102877,97123
1:5:6,0,-1,102878,97122
4:5:3,0,-1,102879,97121
5:2:2,2,2,102877,97123
6:3:5,0,-1,102878,97122
4:3:4,0,-1,102879,97121
2:2:2,3,3,102876,97124
4:1:2,1,1,102875,97125
2:5:5,1,1,102874,97126
5:4:4,0,-1,102875,97125
3:6:6,0,-1,102876,97124
3:4:6,0,-1,102877,97123
5:5:6,0,-1,102878,97122
3:4:5,0,-1,102879,97121
5:1:2,1,1,102878,97122
2:1:4,1,1,102877,97123
2:5:2,2,2,102875,97125
2:3:5,1,1,102874,97126
4:5:1,0,-1,102875,97125
6:4:2,1,1,102874,97126
2:5:4,1,1,102873,97127
5:6:3,0,-1,102874,97126
1:6:6,0,-1,102875,97125
3:4:4,0,-1,102876,97124
1:5:1,0,-1,102877,97123
5:3:1,0,-1,102878,97122
6:1:4,0,-1,102879,97121
1:1:3,0,-1,102880,97120
6:6:3,0,-1,102881,97119
5:5:5,0,-1,102882,97118
6:3:5,0,-1,102883,97117
2:2:5,2,2,102881,97119
2:5:6,1,1,102880,97120
4:2:3,1,1,102879,97121
1:5:1,0,-1,102880,97120
3:1:2,1,1,102879,97121
4:3:3,0,-1,102880,97120
4:2:2,2,2,102878,97122
4:2:5,1,1,102877,97123
5:6:6,0,-1,102878,97122
4:2:1,1,1,102877,97123
3:6:5,0,-1,102878,97122
1:5:1,0,-1,102879,97121
1:1:1,0,-1,102880,97120
6:1:2,1,1,102879,97121
1:4:2,1,1,102878,97122
6:4:1,0,-1,102879,97121
5:5:5,0,-1,102880,97120
2:6:1,1,1,102879,97121
3:4:1,0,-1,102880,97120
1:5:2,1,1,102879,97121
6:5:4,0,-1,102880,97120
1:3:4,0,-1,102881,97119
6:1:4,0,-1,102882,97118
4:4:2,1,1,102881,97119
4:1:4,0,-1,102882,97118
1:4:2,1,1,102881,97119
5:3:5,0,-1,102882,97118
3:4:6,0,-1,102883,97117
4:6:1,0,-1,102884,97116
3:6:6,0,-1,102885,97115
2:2:3,2,2,102883,97117
2:2:2,3,3,102880,97120
1:3:1,0,-1,102881,97119
3:6:6,0,-1,102882,97118
5:6:6,0,-1,102883,97117
4:6:2,1,1,102882,97118
6:1:4,0,-1,102883,97117
1:3:5,0,-1,102884,97116
2:6:5,1,1,102883,97117
6:3:1,0,-1,102884,97116
5:1:1,0,-1,102885,97115
3:4:4,0,-1,102886,97114
3:4:4,0,-1,102887,97113
5:5:3,0,-1,102888,97112
4:5:1,0,-1,102889,97111
4:5:2,1,1,102888,97112
6:2:1,1,1,102887,97113
4:4:5,0,-1,102888,97112
4:6:2,1,1,102887,97113
3:2:6,1,1,102886,97114
5:1:6,0,-1,102887,97113
3:2:2,2,2,102885,97115
4:6:6,0,-1,102886,97114
6:6:4,0,-1,102887,97113
1:2:3,1,1,102886,97114
4:6:4,0,-1,102887,97113
2:6:3,1,1,102886,97114
3:6:1,0,-1,102887,97113
4:4:2,1,1,102886,97114
2:3:4,1,1,102885,97115
2:2:3,2,2,102883,97117
5:1:6,0,-1,102884,97116
6:2:3,1,1,102883,97117
6:6:1,0,-1,102884,97116
5:1:5,0,-1,102885,97115
4:6:2,1,1,102884,97116
5:4:6,0,-1,102885,97115
5:1:6,0,-1,102886,97114
6:4:1,0,-1,102887,97113
5:5:4,0,-1,102888,97112
1:1:4,0,-1,102889,97111
3:1:2,1,1,102888,97112
6:1:6,0,-1,102889,97111
4:5:3,0,-1,102890,97110
6:6:3,0,-1,102891,97109
6:1:3,0,-1,102892,97108
1:5:2,1,1,102891,97109
1:1:3,0,-1,102892,97108
6:4:4,0,-1,102893,97107
2:2:6,2,2,102891,97109
4:1:4,0,-1,102892,97108
4:6:6,0,-1,102893,97107
3:3:3,0,-1,102894,97106
5:2:2,2,2,102892,97108
6:5:1,0,-1,102893,97107
4:5:1,0,-1,102894,97106
6:1:6,0,-1,102895,97105
3:2:4,1,1,102894,97106
4:4:6,0,-1,102895,97105
2:4:3,1,1,102894,97106
3:5:2,1,1,102893,97107
4:6:1,0,-1,102894,97106
5:6:4,0,-1,102895,97105
1:5:4,0,-1,102896,97104
6:1:2,1,1,102895,97105
2:6:6,1,1,102894,97106
3:5:5,0,-1,102895,97105
2:6:1,1,1,102894,97106
2:3:5,1,1,102893,97107
3:1:5,0,-1,102894,97106
1:5:6,0,-1,102895,97105
5:3:5,0,-1,102896,97104
5:1:6,0,-1,102897,97103
3:3:1,0,-1,102898,97102
4:4:5,0,-1,102899,97101
2:3:5,1,1,102898,97102
5:1:2,1,1,102897,97103
5:5:4,0,-1,102898,97102
2:4:6,1,1,102897,97103
3:5:5,0,-1,102898,97102
6:4:2,1,1,102897,97103
3:2:1,1,1,102896,97104
4:5:6,0,-1,102897,97103
6:1:1,0,-1,102898,97102
6:1:2,1,1,102897,97103
4:5:5,0,-1,102898,97102
6:2:5,1,1,102897,97103
5:4:2,1,1,102896,97104
2:3:1,1,1,102895,97105
3:4:6,0,-1,102896,97104
6:3:2,1,1,102895,97105
4:4:5,0,-1,102896,97104
6:1:5,0,-1,102897,97103
3:1:5,0,-1,102898,97102
1:6:3,0,-1,102899,97101
6:6:4,0,-1,102900,97100
6:5:1,0,-1,102901,97099
2:6:4,1,1,102900,97100
3:4:2,1,1,102899,97101
2:3:2,2,2,102897,97103
2:2:2,3,3,102894,97106
1:5:2,1,1,102893,97107
6:4:1,0,-1,102894,97106
1:3:5,0,-1,102895,97105
5:3:5,0,-1,102896,97104
6:1:4,0,-1,102897,97103
6:6:4,0,-1,102898,97102
2:2:3,2,2,102896,97104
5:1:6,0,-1,102897,97103
1:4:1,0,-1,102898,97102
2:6:5,1,1,102897,97103
1:5:1,0,-1,102898,97102
3:6:4,0,-1,102899,97101
5:5:5,0,-1,102900,97100
3:2:4,1,1,102899,97101
2:1:4,1,1,102898,97102
6:4:5,0,-1,102899,97101
1:6:2,1,1,102898,97102
4:2:2,2,2,102896,97104
1:1:6,0,-1,102897,97103
6:3:3,0,-1,102898,97102
4:6:6,0,-1,102899,97101
5:2:5,1,1,102898,97102
6:1:1,0,-1,102899,97101
1:4:1,0,-1,102900,97100
1:6:4,0,-1,102901,97099
6:4:5,0,-1,102902,97098
3:4:5,0,-1,102903,97097
4:1:1,0,-1,102904,97096
6:3:5,0,-1,102905,97095
2:4:2,2,2,102903,97097
6:1:3,0,-1,102904,97096
6:6:4,0,-1,102905,97095
3:5:6,0,-1,102906,97094
5:5:5,0,-1,102907,97093
5:6:1,0,-1,102908,97092
3:5:1,0,-1,102909,97091
4:4:1,0,-1,102910,97090
2:4:3,1,1,102909,97091
3:6:6,0,-1,102910,97090
5:6:3,0,-1,102911,97089
5:3:2,1,1,102910,97090
4:2:3,1,1,102909,97091
6:5:4,0,-1,102910,97090
5:2:4,1,1,102909,97091
3:2:5,1,1,102908,97092
5:1:2,1,1,102907,97093
1:2:5,1,1,102906,97094
4:1:4,0,-1,102907,97093
5:5:6,0,-1,102908,97092
5:6:4,0,-1,102909,97091
1:5:6,0,-1,102910,97090
6:1:4,0,-1,102911,97089
4:4:2,1,1,102910,97090
3:2:5,1,1,102909,97091
2:1:1,1,1,102908,97092
2:3:1,1,1,102907,97093
6:5:3,0,-1,102908,97092
3:5:1,0,-1,102909,97091
5:6:5,0,-1,102910,97090
3:6:2,1,1,102909,97091
1:2:2,2,2,102907,97093
5:1:2,1,1,102906,97094
3:2:3,1,1,102905,97095
3:2:3,1,1,102904,97096
2:6:3,1,1,102903,97097
1:2:3,1,1,102902,97098
3:1:6,0,-1,102903,97097
2:6:3,1,1,102902,97098
4:2:3,1,1,102901,97099
6:4:2,1,1,102900,97100
6:3:6,0,-1,102901,97099
1:2:3,1,1,102900,97100
6:5:5,0,-1,102901,97099
5:2:3,1,1,102900,97100
4:3:5,0,-1,102901,97099
2:6:6,1,1,102900,97100
6:2:6,1,1,102899,97101
5:4:3,0,-1,102900,97100
4:6:3,0,-1,102901,97099
6:3:1,0,-1,102902,97098
3:3:2,1,1,102901,97099
2:6:1,1,1,102900,97100
1:4:2,1,1,102899,97101
1:5:5,0,-1,102900,97100
6:1:4,0,-1,102901,97099
2:3:3,1,1,102900,97100
1:5:2,1,1,102899,97101
1:6:1,0,-1,102900,97100
6:1:3,0,-1,102901,97099
1:5:2,1,1,102900,97100
2:1:6,1,1,102899,97101
6:6:2,1,1,102898,97102
1:1:3,0,-1,102899,97101
5:6:2,1,1,102898,97102
3:6:1,0,-1,102899,97101
4:3:1,0,-1,102900,97100
6:2:3,1,1,102899,97101
3:4:2,1,1,102898,97102
3:4:2,1,1,102897,97103
5:6:4,0,-1,102898,97102
3:4:3,0,-1,102899,97101
4:2:1,1,1,102898,97102
4:5:6,0,-1,102899,97101
1:3:6,0,-1,102900,97100
5:3:4,0,-1,102901,97099
3:6:2,1,1,102900,97100
1:3:2,1,1,102899,97101
6:4:6,0,-1,102900,97100
2:2:2,3,3,102897,97103
6:4:5,0,-1,102898,97102
2:5:3,1,1,102897,97103
2:2:4,2,2,102895,97105
1:2:6,1,1,102894,97106
4:5:4,0,-1,102895,97105
3:4:5,0,-1,102896,97104
4:1:5,0,-1,102897,97103
4:3:5,0,-1,102898,97102
4:1:2,1,1,102897,97103
2:2:3,2,2,102895,97105
4:5:3,0,-1,102896,97104
6:5:1,0,-1,102897,97103
5:3:4,0,-1,102898,97102
1:1:4,0,-1,102899,97101
4:6:4,0,-1,102900,97100
6:6:2,1,1,102899,97101
4:3:4,0,-1,102900,97100
4:1:3,0,-1,102901,97099
1:4:5,0,-1,102902,97098
1:3:4,0,-1,102903,97097
1:5:5,0,-1,102904,97096
4:6:5,0,-1,102905,97095
4:1:1,0,-1,102906,97094
5:6:6,0,-1,102907,97093
6:2:4,1,1,102906,97094
6:1:4,0,-1,102907,97093
3:6:4,0,-1,102908,97092
6:2:4,1,1,102907,97093
1:6:5,0,-1,102908,97092
6:5:3,0,-1,102909,97091
1:5:1,0,-1,102910,97090
1:1:4,0,-1,102911,97089
2:2:2,3,3,102908,97092
6:3:4,0,-1,102909,97091
1:2:1,1,1,102908,97092
6:3:1,0,-1,102909,97091
1:4:1,0,-1,102910,97090
4:5:3,0,-1,102911,97089
3:4:5,0,-1,102912,97088
1:4:3,0,-1,102913,97087
2:6:4,1,1,102912,97088
4:4:4,0,-1,102913,97087
2:2:1,2,2,102911,97089
5:6:2,1,1,102910,97090
5:3:2,1,1,102909,97091
5:3:2,1,1,102908,97092
5:1:1,0,-1,102909,97091
3:1:2,1,1,102908,97092
5:2:6,1,1,102907,97093
1:5:4,0,-1,102908,97092
3:4:1,0,-1,102909,97091
1:1:2,1,1,102908,97092
6:6:2,1,1,102907,97093
6:3:6,0,-1,102908,97092
3:1:2,1,1,102907,97093
5:2:5,1,1,102906,97094
6:4:6,0,-1,102907,97093
2:2:1,2,2,102905,97095
2:6:2,2,2,102903,97097
6:1:4,0,-1,102904,97096
6:5:1,0,-1,102905,97095
6:1:6,0,-1,102906,97094
4:3:5,0,-1,102907,97093
1:1:2,1,1,102906,97094
3:3:3,0,-1,102907,97093
2:3:5,1,1,102906,97094
2:3:1,1,1,102905,97095
6:1:2,1,1,102904,97096
4:6:3,0,-1,102905,97095
3:6:1,0,-1,102906,97094
1:6:6,0,-1,102907,97093
2:4:6,1,1,102906,97094
1:1:1,0,-1,102907,97093
1:6:1,0,-1,102908,97092
6:1:4,0,-1,102909,97091
6:3:2,1,1,102908,97092
1:5:6,0,-1,102909,97091
6:1:4,0,-1,102910,97090
6:4:6,0,-1,102911,97089
3:3:1,0,-1,102912,97088
6:5:2,1,1,102911,97089
3:5:1,0,-1,102912,97088
4:6:2,1,1,102911,97089
2:6:5,1,1,102910,97090
3:3:2,1,1,102909,97091
4:1:4,0,-1,102910,97090
2:1:6,1,1,102909,97091
2:6:1,1,1,102908,97092
2:2:5,2,2,102906,97094
6:6:2,1,1,102905,97095
3:3:4,0,-1,102906,97094
5:1:5,0,-1,102907,97093
4:4:6,0,-1,102908,97092
1:6:5,0,-1,102909,97091
4:3:6,0,-1,102910,97090
3:3:1,0,-1,102911,97089
3:4:6,0,-1,102912,97088
3:3:1,0,-1,102913,97087
5:5:1,0,-1,102914,97086
3:6:6,0,-1,102915,97085
5:2:3,1,1,102914,97086
4:1:5,0,-1,102915,97085
3:6:1,0,-1,102916,97084
5:1:5,0,-1,102917,97083
1:6:3,0,-1,102918,97082
5:1:3,0,-1,102919,97081
3:1:6,0,-1,102920,97080
6:4:6,0,-1,102921,97079
6:4:1,0,-1,102922,97078
6:6:2,1,1,102921,97079
3:6:4,0,-1,102922,97078
6:4:1,0,-1,102923,97077
1:3:1,0,-1,102924,97076
4:5:1,0,-1,102925,97075
6:2:4,1,1,102924,97076
5:5:2,1,1,102923,97077
5:2:6,1,1,102922,97078
5:1:4,0,-1,102923,97077
5:2:1,1,1,102922,97078
5:4:6,0,-1,102923,97077
3:4:5,0,-1,102924,97076
6:1:2,1,1,102923,97077
3:2:1,1,1,102922,97078
2:2:3,2,2,102920,97080
2:3:5,1,1,102919,97081
4:3:4,0,-1,102920,97080
3:3:4,0,-1,102921,97079
4:1:1,0,-1,102922,97078
6:6:1,0,-1,102923,97077
6:5:1,0,-1,102924,97076
4:4:4,0,-1,102925,97075
1:6:3,0,-1,102926,97074
4:2:4,1,1,102925,97075
2:1:4,1,1,102924,97076
4:1:1,0,-1,102925,97075
3:3:5,0,-1,102926,97074
1:5:2,1,1,102925,97075
6:5:5,0,-1,102926,97074
1:1:4,0,-1,102927,97073
5:2:3,1,1,102926,97074
6:6:2,1,1,102925,97075
3:4:2,1,1,102924,97076
1:4:2,1,1,102923,97077
6:1:4,0,-1,102924,97076
2:1:5,1,1,102923,97077
1:5:1,0,-1,102924,97076
6:2:1,1,1,102923,97077
1:3:3,0,-1,102924,97076
5:2:3,1,1,102923,97077
6:6:3,0,-1,102924,97076
4:1:1,0,-1,102925,97075
2:5:2,2,2,102923,97077
5:5:4,0,-1,102924,97076
4:4:3,0,-1,102925,97075
3:1:2,1,1,102924,97076
1:2:1,1,1,102923,97077
2:1:5,1,1,102922,97078
6:6:3,0,-1,102923,97077
2:5:1,1,1,102922,97078
2:5:5,1,1,102921,97079
2:2:6,2,2,102919,97081
5:4:2,1,1,102918,97082
5:3:6,0,-1,102919,97081
5:5:4,0,-1,102920,97080
2:2:2,3,3,102917,97083
4:5:2,1,1,102916,97084
2:5:1,1,1,102915,97085
4:6:5,0,-1,102916,97084
3:6:6,0,-1,102917,97083
1:2:4,1,1,102916,97084
3:3:4,0,-1,102917,97083
6:3:2,1,1,102916,97084
3:6:5,0,-1,102917,97083
4:3:2,1,1,102916,97084
4:2:2,2,2,102914,97086
3:3:1,0,-1,102915,97085
1:2:5,1,1,102914,97086
6:1:4,0,-1,102915,97085
1:2:3,1,1,102914,97086
1:5:6,0,-1,102915,97085
2:1:1,1,1,102914,97086
5:4:5,0,-1,102915,97085
2:5:2,2,2,102913,97087
6:5:3,0,-1,102914,97086
1:1:3,0,-1,102915,97085
1:3:6,0,-1,102916,97084
5:2:5,1,1,102915,97085
4:3:4,0,-1,102916,97084
5:2:4,1,1,102915,97085
1:5:2,1,1,102914,97086
5:5:6,0,-1,102915,97085
3:5:1,0,-1,102916,97084
3:3:2,1,1,102915,97085
3:5:2,1,1,102914,97086
1:6:4,0,-1,102915,97085
2:2:3,2,2,102913,97087
1:4:1,0,-1,102914,97086
1:5:6,0,-1,102915,97085
4:1:2,1,1,102914,97086
6:4:1,0,-1,102915,97085
3:5:6,0,-1,102916,97084
4:5:2,1,1,102915,97085
1:6:1,0,-1,102916,97084
1:2:4,1,1,102915,97085
4:5:5,0,-1,102916,97084
3:2:6,1,1,102915,97085
6:6:1,0,-1,102916,97084
4:6:1,0,-1,102917,97083
1:5:4,0,-1,102918,97082
3:5:5,0,-1,102919,97081
6:3:5,0,-1,102920,97080
1:2:1,1,1,102919,97081
2:2:3,2,2,102917,97083
6:5:1,0,-1,102918,97082
4:5:5,0,-1,102919,97081
2:5:2,2,2,102917,97083
6:4:5,0,-1,102918,97082
6:4:1,0,-1,102919,97081
5:6:3,0,-1,102920,97080
2:4:4,1,1,102919,97081
3:6:4,0,-1,102920,97080
5:6:3,0,-1,102921,97079
4:6:1,0,-1,102922,97078
4:4:5,0,-1,102923,97077
1:6:6,0,-1,102924,97076
4:3:4,0,-1,102925,97075
2:1:4,1,1,102924,97076
1:2:5,1,1,102923,97077
2:4:2,2,2,102921,97079
6:3:5,0,-1,102922,97078
2:3:4,1,1,102921,97079
1:5:5,0,-1,102922,97078
5:4:6,0,-1,102923,97077
6:4:3,0,-1,102924,97076
3:3:6,0,-1,102925,97075
1:3:6,0,-1,102926,97074
5:4:5,0,-1,102927,97073
5:6:3,0,-1,102928,97072
4:5:4,0,-1,102929,97071
3:6:1,0,-1,102930,97070
6:3:2,1,1,102929,97071
2:2:5,2,2,102927,97073
1:2:6,1,1,102926,97074
5:5:5,0,-1,102927,97073
6:5:2,1,1,102926,97074
1:3:6,0,-1,102927,97073
2:4:4,1,1,102926,97074
3:1:2,1,1,102925,97075
2:4:6,1,1,102924,97076
4:1:6,0,-1,102925,97075
3:4:5,0,-1,102926,97074
5:3:3,0,-1,102927,97073
3:3:4,0,-1,102928,97072
6:1:6,0,-1,102929,97071
6:4:3,0,-1,102930,97070
3:6:2,1,1,102929,97071
3:3:3,0,-1,102930,97070
1:5:3,0,-1,102931,97069
3:6:4,0,-1,102932,97068
3:1:1,0,-1,102933,97067
4:4:2,1,1,102932,97068
6:2:6,1,1,102931,97069
4:1:6,0,-1,102932,97068
2:3:6,1,1,102931,97069
5:3:3,0,-1,102932,97068
5:4:3,0,-1,102933,97067
2:5:6,1,1,102932,97068
1:3:1,0,-1,102933,97067
4:3:3,0,-1,102934,97066
6:4:3,0,-1,102935,97065
1:4:2,1,1,102934,97066
1:4:6,0,-1,102935,97065
2:4:6,1,1,102934,97066
3:1:4,0,-1,102935,97065
1:2:6,1,1,102934,97066
1:6:2,1,1,102933,97067
2:6:2,2,2,102931,97069
1:3:2,1,1,102930,97070
6:3:4,0,-1,102931,97069
6:3:1,0,-1,102932,97068
6:6:6,0,-1,102933,97067
1:1:1,0,-1,102934,97066
5:6:4,0,-1,102935,97065
6:3:5,0,-1,102936,97064
1:4:1,0,-1,102937,97063
4:4:4,0,-1,102938,97062
2:5:4,1,1,102937,97063
3:3:2,1,1,102936,97064
2:6:3,1,1,102935,97065
4:1:2,1,1,102934,97066
4:5:3,0,-1,102935,97065
3:1:2,1,1,102934,97066
3:5:3,0,-1,102935,97065
1:1:3,0,-1,102936,97064
5:2:5,1,1,102935,97065
1:2:2,2,2,102933,97067
4:5:4,0,-1,102934,97066
6:3:5,0,-1,102935,97065
3:2:6,1,1,102934,97066
3:2:2,2,2,102932,97068
6:6:4,0,-1,102933,97067
5:6:6,0,-1,102934,97066
2:4:5,1,1,102933,97067
4:6:5,0,-1,102934,97066
4:2:1,1,1,102933,97067
3:6:3,0,-1,102934,97066
1:1:2,1,1,102933,97067
5:4:5,0,-1,102934,97066
5:5:1,0,-1,102935,97065
1:6:2,1,1,102934,97066
4:2:4,1,1,102933,97067
5:3:5,0,-1,102934,97066
3:2:3,1,1,102933,97067
6:2:5,1,1,102932,97068
1:6:1,0,-1,102933,97067
3:6:4,0,-1,102934,97066
6:3:5,0,-1,102935,97065
3:3:4,0,-1,102936,97064
2:5:2,2,2,102934,97066
6:4:6,0,-1,102935,97065
1:5:3,0,-1,102936,97064
1:5:3,0,-1,102937,97063
4:3:2,1,1,102936,97064
1:4:5,0,-1,102937,97063
6:2:5,1,1,102936,97064
1:2:3,1,1,102935,97065
5:6:2,1,1,102934,97066
2:6:5,1,1,102933,97067
2:1:5,1,1,102932,97068
2:2:5,2,2,102930,97070
1:1:1,0,-1,102931,97069
1:2:2,2,2,102929,97071
2:2:2,3,3,102926,97074
6:5:1,0,-1,102927,97073
2:6:6,1,1,102926,97074
1:4:1,0,-1,102927,97073
5:4:5,0,-1,102928,97072
6:1:3,0,-1,102929,97071
4:4:6,0,-1,102930,97070
1:4:3,0,-1,102931,97069
3:3:3,0,-1,102932,97068
5:1:6,0,-1,102933,97067
5:3:2,1,1,102932,97068
5:5:5,0,-1,102933,97067
6:5:2,1,1,102932,97068
3:4:2,1,1,102931,97069
3:3:4,0,-1,102932,97068
4:3:5,0,-1,102933,97067
6:4:4,0,-1,102934,97066
6:2:1,1,1,102933,97067
6:2:6,1,1,102932,97068
5:5:6,0,-1,102933,97067
6:1:4,0,-1,102934,97066
1:4:6,0,-1,102935,97065
3:5:3,0,-1,102936,97064
6:2:2,2,2,102934,97066
2:2:1,2,2,102932,97068
6:3:6,0,-1,102933,97067
6:6:4,0,-1,102934,97066
5:3:2,1,1,102933,97067
2:4:6,1,1,102932,97068
2:1:3,1,1,102931,97069
3:4:3,0,-1,102932,97068
1:5:4,0,-1,102933,97067
4:5:5,0,-1,102934,97066
1:3:3,0,-1,102935,97065
3:5:1,0,-1,102936,97064
4:1:5,0,-1,102937,97063
3:5:1,0,-1,102938,97062
2:6:6,1,1,102937,97063
1:3:5,0,-1,102938,97062
4:4:2,1,1,102937,97063
1:6:3,0,-1,102938,97062
4:4:3,0,-1,102939,97061
6:3:3,0,-1,102940,97060
5:2:5,1,1,102939,97061
3:1:3,0,-1,102940,97060
4:2:3,1,1,102939,97061
4:2:1,1,1,102938,97062
4:3:3,0,-1,102939,97061
2:1:2,2,2,102937,97063
5:5:1,0,-1,102938,97062
1:2:1,1,1,102937,97063
1:1:5,0,-1,102938,97062
3:6:3,0,-1,102939,97061
1:4:2,1,1,102938,97062
4:1:3,0,-1,102939,97061
4:1:3,0,-1,102940,97060
3:2:1,1,1,102939,97061
5:3:5,0,-1,102940,97060
6:1:5,0,-1,102941,97059
2:1:3,1,1,102940,97060
3:5:2,1,1,102939,97061
5:6:1,0,-1,102940,97060
1:3:2,1,1,102939,97061
1:4:6,0,-1,102940,97060
1:5:6,0,-1,102941,97059
1:1:1,0,-1,102942,97058
4:4:5,0,-1,102943,97057
5:5:2,1,1,102942,97058
6:1:4,0,-1,102943,97057
1:1:3,0,-1,102944,97056
5:5:2,1,1,102943,97057
6:1:1,0,-1,102944,97056
5:4:5,0,-1,102945,97055
2:5:6,1,1,102944,97056
1:2:4,1,1,102943,97057
4:6:3,0,-1,102944,97056
1:6:2,1,1,102943,97057
6:1:3,0,-1,102944,97056
5:2:3,1,1,102943,97057
1:1:3,0,-1,102944,97056
6:6:1,0,-1,102945,97055
4:3:4,0,-1,102946,97054
3:5:6,0,-1,102947,97053
3:2:6,1,1,102946,97054
5:5:1,0,-1,102947,97053
3:5:6,0,-1,102948,97052
6:5:3,0,-1,102949,97051
6:3:3,0,-1,102950,97050
1:4:5,0,-1,102951,97049
3:3:6,0,-1,102952,97048
5:2:6,1,1,102951,97049
2:6:6,1,1,102950,97050
6:4:3,0,-1,102951,97049
5:2:4,1,1,102950,97050
6:1:6,0,-1,102951,97049
6:4:5,0,-1,102952,97048
5:1:1,0,-1,102953,97047
6:2:1,1,1,102952,97048
6:3:4,0,-1,102953,97047
3:1:4,0,-1,102954,97046
5:5:3,0,-1,102955,97045
6:5:6,0,-1,102956,97044
5:2:1,1,1,102955,97045
5:5:3,0,-1,102956,97044
6:3:4,0,-1,102957,97043
5:4:3,0,-1,102958,97042
2:4:3,1,1,102957,97043
2:3:2,2,2,102955,97045
1:3:3,0,-1,102956,97044
3:6:4,0,-1,102957,97043
1:1:2,1,1,102956,97044
3:2:3,1,1,102955,97045
5:3:4,0,-1,102956,97044
4:4:5,0,-1,102957,97043
5:5:5,0,-1,102958,97042
6:5:2,1,1,102957,97043
2:5:2,2,2,102955,97045
6:4:5,0,-1,102956,97044
3:3:6,0,-1,102957,97043
1:3:1,0,-1,102958,97042
2:6:5,1,1,102957,97043
3:5:3,0,-1,102958,97042
2:3:5,1,1,102957,97043
4:3:6,0,-1,102958,97042
6:3:5,0,-1,102959,97041
2:2:1,2,2,102957,97043
4:4:1,0,-1,102958,97042
6:1:5,0,-1,102959,97041
5:4:3,0,-1,102960,97040
1:3:1,0,-1,102961,97039
2:2:4,2,2,102959,97041
4:6:6,0,-1,102960,97040
4:4:6,0,-1,102961,97039
1:1:2,1,1,102960,97040
2:2:5,2,2,102958,97042
3:5:5,0,-1,102959,97041
2:4:2,2,2,102957,97043
1:3:2,1,1,102956,97044
1:3:6,0,-1,102957,97043
4:4:4,0,-1,102958,97042
5:4:3,0,-1,102959,97041
5:2:4,1,1,102958,97042
3:5:3,0,-1,102959,97041
3:6:4,0,-1,102960,97040
1:1:1,0,-1,102961,97039
2:3:3,1,1,102960,97040
4:2:3,1,1,102959,97041
5:4:3,0,-1,102960,97040
5:2:1,1,1,102959,97041
5:1:1,0,-1,102960,97040
3:3:5,0,-1,102961,97039
5:4:2,1,1,102960,97040
3:1:1,0,-1,102961,97039
1:1:3,0,-1,102962,97038
5:5:5,0,-1,102963,97037
2:5:4,1,1,102962,97038
5:1:5,0,-1,102963,97037
1:5:4,0,-1,102964,97036
6:4:1,0,-1,102965,97035
4:5:3,0,-1,102966,97034
2:2:5,2,2,102964,97036
3:6:2,1,1,102963,97037
3:5:4,0,-1,102964,97036
2:4:1,1,1,102963,97037
5:3:3,0,-1,102964,97036
6:1:4,0,-1,102965,97035
2:1:6,1,1,102964,97036
4:2:5,1,1,102963,97037
3:3:1,0,-1,102964,97036
4:6:1,0,-1,102965,97035
5:4:4,0,-1,102966,97034
6:3:4,0,-1,102967,97033
1:6:3,0,-1,102968,97032
5:4:4,0,-1,102969,97031
6:5:2,1,1,102968,97032
5:2:1,1,1,102967,97033
1:6:1,0,-1,102968,97032
4:3:3,0,-1,102969,97031
4:5:3,0,-1,102970,97030
3:2:6,1,1,102969,97031
1:6:1,0,-1,102970,97030
3:6:6,0,-1,102971,97029
1:3:1,0,-1,102972,97028
5:1:6,0,-1,102973,97027
5:5:6,0,-1,102974,97026
6:3:5,0,-1,102975,97025
2:2:5,2,2,102973,97027
3:3:1,0,-1,102974,97026
4:1:1,0,-1,102975,97025
4:4:6,0,-1,102976,97024
4:2:6,1,1,102975,97025
4:3:1,0,-1,102976,97024
6:1:5,0,-1,102977,97023
6:1:6,0,-1,102978,97022
1:2:3,1,1,102977,97023
3:4:1,0,-1,102978,97022
3:1:4,0,-1,102979,97021
6:5:6,0,-1,102980,97020
3:6:1,0,-1,102981,97019
2:5:2,2,2,102979,97021
3:6:5,0,-1,102980,97020
4:1:2,1,1,102979,97021
4:1:1,0,-1,102980,97020
4:4:6,0,-1,102981,97019
4:1:2,1,1,102980,97020
5:4:5,0,-1,102981,97019
4:5:6,0,-1,102982,97018
5:2:3,1,1,102981,97019
4:2:6,1,1,102980,97020
3:5:3,0,-1,102981,97019
2:3:1,1,1,102980,97020
6:3:6,0,-1,102981,97019
5:5:1,0,-1,102982,97018
2:6:3,1,1,102981,97019
2:3:4,1,1,102980,97020
3:6:5,0,-1,102981,97019
5:2:5,1,1,102980,97020
4:3:1,0,-1,102981,97019
5:2:1,1,1,102980,97020
6:4:4,0,-1,102981,97019
6:1:4,0,-1,102982,97018
5:5:1,0,-1,102983,97017
4:6:3,0,-1,102984,97016
5:3:5,0,-1,102985,97015
2:4:3,1,1,102984,97016
3:1:2,1,1,102983,97017
5:5:5,0,-1,102984,97016
3:1:1,0,-1,102985,97015
2:2:5,2,2,102983,97017
5:6:6,0,-1,102984,97016
5:5:2,1,1,102983,97017
2:2:2,3,3,102980,97020
5:2:2,2,2,102978,97022
4:5:1,0,-1,102979,97021
4:4:5,0,-1,102980,97020
5:1:4,0,-1,102981,97019
1:5:6,0,-1,102982,97018
2:5:1,1,1,102981,97019
5:2:4,1,1,102980,97020
5:3:4,0,-1,102981,97019
2:2:2,3,3,102978,97022
4:5:6,0,-1,102979,97021
5:3:5,0,-1,102980,97020
2:3:3,1,1,102979,97021
5:4:3,0,-1,102980,97020
2:5:3,1,1,102979,97021
2:4:3,1,1,102978,97022
6:2:6,1,1,102977,97023
3:1:5,0,-1,102978,97022
1:1:1,0,-1,102979,97021
4:4:6,0,-1,102980,97020
2:4:3,1,1,102979,97021
2:1:5,1,1,102978,97022
3:1:4,0,-1,102979,97021
6:6:5,0,-1,102980,97020
3:1:1,0,-1,102981,97019
3:5:4,0,-1,102982,97018
6:1:5,0,-1,102983,97017
1:4:1,0,-1,102984,97016
4:6:1,0,-1,102985,97015
2:1:4,1,1,102984,97016
2:5:5,1,1,102983,97017
1:3:5,0,-1,102984,97016
5:2:1,1,1,102983,97017
6:6:2,1,1,102982,97018
5:5:3,0,-1,102983,97017
6:6:1,0,-1,102984,97016
6:6:5,0,-1,102985,97015
2:3:2,2,2,102983,97017
1:4:1,0,-1,102984,97016
6:6:6,0,-1,102985,97015
1:2:6,1,1,102984,97016
3:5:3,0,-1,102985,97015
4:5:6,0,-1,102986,97014
2:5:1,1,1,102985,97015
6:4:5,0,-1,102986,97014
3:3:5,0,-1,102987,97013
4:6:6,0,-1,102988,97012
6:6:5,0,-1,102989,97011
1:5:3,0,-1,102990,97010
1:5:6,0,-1,102991,97009
5:2:1,1,1,102990,97010
2:2:6,2,2,102988,97012
3:1:2,1,1,102987,97013
6:1:2,1,1,102986,97014
3:5:2,1,1,102985,97015
6:6:2,1,1,102984,97016
6:6:1,0,-1,102985,97015
1:3:3,0,-1,102986,97014
2:2:4,2,2,102984,97016
5:2:6,1,1,102983,97017
3:5:6,0,-1,102984,97016
5:3:5,0,-1,102985,97015
1:3:1,0,-1,102986,97014
1:6:5,0,-1,102987,97013
5:6:2,1,1,102986,97014
5:5:3,0,-1,102987,97013
1:3:1,0,-1,102988,97012
4:5:3,0,-1,102989,97011
6:1:2,1,1,102988,97012
1:5:2,1,1,102987,97013
4:1:5,0,-1,102988,97012
3:4:3,0,-1,102989,97011
4:2:6,1,1,102988,97012
5:4:1,0,-1,102989,97011
6:5:3,0,-1,102990,97010
4:4:1,0,-1,102991,97009
1:2:4,1,1,102990,97010
1:6:4,0,-1,102991,97009
2:6:4,1,1,102990,97010
1:2:3,1,1,102989,97011
4:5:3,0,-1,102990,97010
2:2:6,2,2,102988,97012
3:2:6,1,1,102987,97013
6:1:3,0,-1,102988,97012
5:4:3,0,-1,102989,97011
6:6:5,0,-1,102990,97010
3:3:6,0,-1,102991,97009
1:2:2,2,2,102989,97011
3:4:3,0,-1,102990,97010
1:6:1,0,-1,102991,97009
4:4:6,0,-1,102992,97008
3:2:4,1,1,102991,97009
2:4:1,1,1,102990,97010
5:1:3,0,-1,102991,97009
4:1:3,0,-1,102992,97008
5:1:3,0,-1,102993,97007
2:6:2,2,2,102991,97009
3:2:6,1,1,102990,97010
3:1:6,0,-1,102991,97009
1:5:3,0,-1,102992,97008
1:5:2,1,1,102991,97009
6:2:5,1,1,102990,97010
4:4:6,0,-1,102991,97009
6:1:4,0,-1,102992,97008
3:6:1,0,-1,102993,97007
1:5:2,1,1,102992,97008
2:1:3,1,1,102991,97009
6:5:2,1,1,102990,97010
3:5:1,0,-1,102991,97009
4:3:5,0,-1,102992,97008
3:5:6,0,-1,102993,97007
1:2:4,1,1,102992,97008
4:1:6,0,-1,102993,97007
5:4:1,0,-1,102994,97006
1:2:6,1,1,102993,97007
2:2:5,2,2,102991,97009
2:3:5,1,1,102990,97010
2:2:6,2,2,102988,97012
3:5:2,1,1,102987,97013
3:6:6,0,-1,102988,97012
6:2:4,1,1,102987,97013
6:1:3,0,-1,102988,97012
1:5:5,0,-1,102989,97011
3:5:2,1,1,102988,97012
3:3:5,0,-1,102989,97011
4:4:3,0,-1,102990,97010
3:1:4,0,-1,102991,97009
4:1:3,0,-1,102992,97008
5:6:3,0,-1,102993,97007
3:2:3,1,1,102992,97008
2:4:3,1,1,102991,97009
6:1:4,0,-1,102992,97008
5:4:6,0,-1,102993,97007
1:6:6,0,-1,102994,97006
2:6:1,1,1,102993,97007
1:6:6,0,-1,102994,97006
1:2:6,1,1,102993,97007
5:2:2,2,2,102991,97009
6:3:5,0,-1,102992,97008
6:6:2,1,1,102991,97009
1:1:2,1,1,102990,97010
4:1:5,0,-1,102991,97009
2:3:3,1,1,102990,97010
3:6:5,0,-1,102991,97009
4:4:3,0,-1,102992,97008
1:6:1,0,-1,102993,97007
2:2:4,2,2,102991,97009
3:3:5,0,-1,102992,97008
2:2:5,2,2,102990,97010
3:6:3,0,-1,102991,97009
5:2:1,1,1,102990,97010
2:3:3,1,1,102989,97011
2:4:6,1,1,102988,97012
2:6:4,1,1,102987,97013
2:6:1,1,1,102986,97014
4:3:5,0,-1,102987,97013
4:2:6,1,1,102986,97014
4:5:1,0,-1,102987,97013
1:3:4,0,-1,102988,97012
5:3:2,1,1,102987,97013
5:2:1,1,1,102986,97014
3:4:4,0,-1,102987,97013
3:3:1,0,-1,102988,97012
6:2:4,1,1,102987,97013
1:6:5,0,-1,102988,97012
3:4:2,1,1,102987,97013
6:3:2,1,1,102986,97014
4:6:4,0,-1,102987,97013
3:6:1,0,-1,102988,97012
4:4:4,0,-1,102989,97011
1:1:2,1,1,102988,97012
1:1:5,0,-1,102989,97011
4:4:5,0,-1,102990,97010
6:1:2,1,1,102989,97011
6:2:1,1,1,102988,97012
1:5:2,1,1,102987,97013
3:5:6,0,-1,102988,97012
5:6:3,0,-1,102989,97011
6:2:3,1,1,102988,97012
2:4:3,1,1,102987,97013
2:2:5,2,2,102985,97015
1:6:4,0,-1,102986,97014
5:1:1,0,-1,102987,97013
3:5:5,0,-1,102988,97012
2:1:6,1,1,102987,97013
5:6:2,1,1,102986,97014
1:1:3,0,-1,102987,97013
5:5:1,0,-1,102988,97012
6:1:6,0,-1,102989,97011
6:3:4,0,-1,102990,97010
6:5:6,0,-1,102991,97009
5:4:5,0,-1,102992,97008
4:3:4,0,-1,102993,97007
6:4:6,0,-1,102994,97006
3:3:4,0,-1,102995,97005
4:1:6,0,-1,102996,97004
6:1:3,0,-1,102997,97003
2:5:6,1,1,102996,97004
4:2:3,1,1,102995,97005
6:1:1,0,-1,102996,97004
4:4:5,0,-1,102997,97003
1:3:5,0,-1,102998,97002
2:2:6,2,2,102996,97004
5:3:6,0,-1,102997,97003
1:2:1,1,1,102996,97004
3:6:5,0,-1,102997,97003
5:3:6,0,-1,102998,97002
2:6:3,1,1,102997,97003
4:1:1,0,-1,102998,97002
1:3:1,0,-1,102999,97001
6:2:6,1,1,102998,97002
3:1:1,0,-1,102999,97001
2:4:5,1,1,102998,97002
2:1:4,1,1,102997,97003
6:2:2,2,2,102995,97005
3:1:4,0,-1,102996,97004
6:4:6,0,-1,102997,97003
2:2:5,2,2,102995,97005
2:3:4,1,1,102994,97006
5:4:5,0,-1,102995,97005
4:6:4,0,-1,102996,97004
5:6:3,0,-1,102997,97003
4:4:2,1,1,102996,97004
2:2:5,2,2,102994,97006
5:3:2,1,1,102993,97007
3:4:3,0,-1,102994,97006
1:2:1,1,1,102993,97007
2:4:4,1,1,102992,97008
6:6:3,0,-1,102993,97007
4:3:1,0,-1,102994,97006
5:1:4,0,-1,102995,97005
3:5:4,0,-1,102996,97004
2:4:4,1,1,102995,97005
6:5:2,1,1,102994,97006
5:6:2,1,1,102993,97007
3:1:4,0,-1,102994,97006
1:6:3,0,-1,102995,97005
2:6:3,1,1,102994,97006
4:1:6,0,-1,102995,97005
4:4:2,1,1,102994,97006
6:6:3,0,-1,102995,97005
1:6:4,0,-1,102996,97004
5:2:2,2,2,102994,97006
5:1:5,0,-1,102995,97005
1:6:1,0,-1,102996,97004
4:6:4,0,-1,102997,97003
4:4:4,0,-1,102998,97002
3:4:6,0,-1,102999,97001
2:4:5,1,1,102998,97002
2:6:3,1,1,102997,97003
5:6:4,0,-1,102998,97002
6:6:2,1,1,102997,97003
5:5:1,0,-1,102998,97002
6:2:1,1,1,102997,97003
4:4:3,0,-1,102998,97002
5:3:6,0,-1,102999,97001
3:1:3,0,-1,103000,97000
4:6:6,0,-1,103001,96999
3:1:3,0,-1,103002,96998
4:6:1,0,-1,103003,96997
5:5:1,0,-1,103004,96996
2:5:3,1,1,103003,96997
6:5:2,1,1,103002,96998
4:4:5,0,-1,103003,96997
6:1:2,1,1,103002,96998
6:5:3,0,-1,103003,96997
5:6:5,0,-1,103004,96996
2:6:2,2,2,103002,96998
3:3:6,0,-1,103003,96997
1:2:3,1,1,103002,96998
4:5:6,0,-1,103003,96997
1:4:5,0,-1,103004,96996
3:1:4,0,-1,103005,96995
2:3:6,1,1,103004,96996
4:5:5,0,-1,103005,96995
3:1:4,0,-1,103006,96994
6:2:1,1,1,103005,96995
5:6:3,0,-1,103006,96994
6:1:6,0,-1,103007,96993
5:2:5,1,1,103006,96994
6:6:3,0,-1,103007,96993
2:1:4,1,1,103006,96994
1:2:4,1,1,103005,96995
4:2:4,1,1,103004,96996
1:2:6,1,1,103003,96997
3:1:5,0,-1,103004,96996
3:3:6,0,-1,103005,96995
3:4:3,0,-1,103006,96994
6:2:5,1,1,103005,96995
4:3:6,0,-1,103006,96994
5:5:4,0,-1,103007,96993
3:2:4,1,1,103006,96994
6:4:3,0,-1,103007,96993
2:6:6,1,1,103006,96994
2:6:2,2,2,103004,96996
5:6:2,1,1,103003,96997
5:5:3,0,-1,103004,96996
6:3:4,0,-1,103005,96995
2:2:6,2,2,103003,96997
1:1:3,0,-1,103004,96996
5:6:5,0,-1,103005,96995
2:1:5,1,1,103004,96996
3:5:1,0,-1,103005,96995
2:4:5,1,1,103004,96996
2:5:6,1,1,103003,96997
3:6:1,0,-1,103004,96996
2:3:5,1,1,103003,96997
1:3:6,0,-1,103004,96996
5:3:5,0,-1,103005,96995
3:3:3,0,-1,103006,96994
5:2:3,1,1,103005,96995
5:4:3,0,-1,103006,96994
1:2:3,1,1,103005,96995
5:3:2,1,1,103004,96996
2:5:1,1,1,103003,96997
6:6:1,0,-1,103004,96996
4:3:5,0,-1,103005,96995
2:2:4,2,2,103003,96997
2:1:4,1,1,103002,96998
3:4:5,0,-1,103003,96997
4:1:4,0,-1,103004,96996
1:2:4,1,1,103003,96997
6:2:5,1,1,103002,96998
2:5:5,1,1,103001,96999
1:1:5,0,-1,103002,96998
3:5:3,0,-1,103003,96997
2:1:5,1,1,103002,96998
6:2:1,1,1,103001,96999
6:5:1,0,-1,103002,96998
2:6:2,2,2,103000,97000
5:3:1,0,-1,103001,96999
2:1:5,1,1,103000,97000
2:2:4,2,2,102998,97002
4:2:4,1,1,102997,97003
3:5:1,0,-1,102998,97002
4:2:1,1,1,102997,97003
1:2:3,1,1,102996,97004
3:2:4,1,1,102995,97005
6:4:5,0,-1,102996,97004
3:4:4,0,-1,102997,97003
5:6:6,0,-1,102998,97002
1:1:3,0,-1,102999,97001
5:2:5,1,1,102998,97002
5:1:5,0,-1,102999,97001
2:6:3,1,1,102998,97002
1:1:4,0,-1,102999,97001
5:5:1,0,-1,103000,97000
4:1:1,0,-1,103001,96999
5:2:2,2,2,102999,97001
2:6:3,1,1,102998,97002
5:6:2,1,1,102997,97003
4:5:1,0,-1,102998,97002
1:4:6,0,-1,102999,97001
6:6:6,0,-1,103000,97000
2:2:4,2,2,102998,97002
2:1:5,1,1,102997,97003
3:5:6,0,-1,102998,97002
1:5:3,0,-1,102999,97001
5:2:2,2,2,102997,97003
3:3:2,1,1,102996,97004
5:3:3,0,-1,102997,97003
3:5:2,1,1,102996,97004
2:2:2,3,3,102993,97007
3:3:5,0,-1,102994,97006
3:1:4,0,-1,102995,97005
5:6:3,0,-1,102996,97004
6:5:1,0,-1,102997,97003
4:3:2,1,1,102996,97004
4:1:1,0,-1,102997,97003
4:4:3,0,-1,102998,97002
3:2:5,1,1,102997,97003
6:6:4,0,-1,102998,97002
5:1:4,0,-1,102999,97001
4:3:1,0,-1,103000,97000
4:3:3,0,-1,103001,96999
4:5:1,0,-1,103002,96998
3:2:1,1,1,103001,96999
1:3:2,1,1,103000,97000
2:2:4,2,2,102998,97002
2:1:3,1,1,102997,97003
3:4:6,0,-1,102998,97002
4:2:5,1,1,102997,97003
1:4:2,1,1,102996,97004
5:5:1,0,-1,102997,97003
3:4:1,0,-1,102998,97002
6:5:1,0,-1,102999,97001
4:6:4,0,-1,103000,97000
4:3:4,0,-1,103001,96999
5:6:4,0,-1,103002,96998
3:4:6,0,-1,103003,96997
6:6:5,0,-1,103004,96996
6:1:6,0,-1,103005,96995
4:3:5,0,-1,103006,96994
6:2:2,2,2,103004,96996
2:5:3,1,1,103003,96997
6:6:6,0,-1,103004,96996
1:5:6,0,-1,103005,96995
2:2:3,2,2,103003,96997
4:5:3,0,-1,103004,96996
2:1:3,1,1,103003,96997
2:3:1,1,1,103002,96998
5:6:3,0,-1,103003,96997
6:6:5,0,-1,103004,96996
1:1:2,1,1,103003,96997
4:2:3,1,1,103002,96998
5:1:1,0,-1,103003,96997
6:1:5,0,-1,103004,96996
4:2:5,1,1,103003,96997
3:6:5,0,-1,103004,96996
3:3:3,0,-1,103005,96995
6:2:2,2,2,103003,96997
4:5:2,1,1,103002,96998
1:2:1,1,1,103001,96999
5:4:2,1,1,103000,97000
3:3:4,0,-1,103001,96999
6:2:3,1,1,103000,97000
3:3:3,0,-1,103001,96999
4:3:2,1,1,103000,97000
2:2:1,2,2,102998,97002
6:5:5,0,-1,102999,97001
6:5:2,1,1,102998,97002
2:3:2,2,2,102996,97004
6:6:5,0,-1,102997,97003
1:6:2,1,1,102996,97004
2:6:6,1,1,102995,97005
4:1:4,0,-1,102996,97004
4:5:1,0,-1,102997,97003
5:3:4,0,-1,102998,97002
6:4:1,0,-1,102999,97001
3:2:3,1,1,102998,97002
5:3:4,0,-1,102999,97001
5:6:6,0,-1,103000,97000
2:4:2,2,2,102998,97002
6:2:6,1,1,102997,97003
2:6:3,1,1,102996,97004
5:1:3,0,-1,102997,97003
3:1:4,0,-1,102998,97002
4:6:1,0,-1,102999,97001
4:4:5,0,-1,103000,97000
4:6:3,0,-1,103001,96999
4:3:2,1,1,103000,97000
3:5:3,0,-1,103001,96999
3:5:3,0,-1,103002,96998
6:1:5,0,-1,103003,96997
2:5:6,1,1,103002,96998
5:5:1,0,-1,103003,96997
1:4:5,0,-1,103004,96996
5:2:3,1,1,103003,96997
4:6:6,0,-1,103004,96996
1:3:3,0,-1,103005,96995
2:1:4,1,1,103004,96996
1:5:5,0,-1,103005,96995
4:4:2,1,1,103004,96996
5:5:2,1,1,103003,96997
2:1:3,1,1,103002,96998
1:6:6,0,-1,103003,96997
3:1:1,0,-1,103004,96996
1:1:1,0,-1,103005,96995
5:1:2,1,1,103004,96996
3:5:5,0,-1,103005,96995
2:4:4,1,1,103004,96996
3:2:5,1,1,103003,96997
3:4:1,0,-1,103004,96996
6:3:5,0,-1,103005,96995
5:1:6,0,-1,103006,96994
2:2:5,2,2,103004,96996
5:5:2,1,1,103003,96997
6:3:2,1,1,103002,96998
6:3:3,0,-1,103003,96997
2:3:5,1,1,103002,96998
3:2:4,1,1,103001,96999
5:2:1,1,1,103000,97000
4:5:2,1,1,102999,97001
3:4:3,0,-1,103000,97000
5:1:1,0,-1,103001,96999
2:6:6,1,1,103000,97000
2:6:4,1,1,102999,97001
4:1:1,0,-1,103000,97000
1:2:5,1,1,102999,97001
5:3:5,0,-1,103000,97000
2:4:6,1,1,102999,97001
4:6:1,0,-1,103000,97000
6:5:5,0,-1,103001,96999
6:3:2,1,1,103000,97000
2:2:3,2,2,102998,97002
5:1:3,0,-1,102999,97001
4:3:1,0,-1,103000,97000
3:5:1,0,-1,103001,96999
4:1:3,0,-1,103002,96998
1:1:3,0,-1,103003,96997
3:2:2,2,2,103001,96999
6:3:3,0,-1,103002,96998
2:1:5,1,1,103001,96999
5:2:3,1,1,103000,97000
2:1:1,1,1,102999,97001
6:5:2,1,1,102998,97002
3:5:2,1,1,102997,97003
4:1:3,0,-1,102998,97002
4:6:4,0,-1,102999,97001
3:2:1,1,1,102998,97002
1:3:1,0,-1,102999,97001
3:2:3,1,1,102998,97002
3:4:5,0,-1,102999,97001
6:6:5,0,-1,103000,97000
4:5:4,0,-1,103001,96999
2:6:2,2,2,102999,97001
1:3:5,0,-1,103000,97000
4:6:5,0,-1,103001,96999
6:5:3,0,-1,103002,96998
4:1:2,1,1,103001,96999
1:6:4,0,-1,103002,96998
4:2:6,1,1,103001,96999
2:5:2,2,2,102999,97001
4:1:1,0,-1,103000,97000
4:1:2,1,1,102999,97001
5:3:6,0,-1,103000,97000
4:6:2,1,1,102999,97001
2:2:1,2,2,102997,97003
6:4:6,0,-1,102998,97002
1:5:6,0,-1,102999,97001
4:3:6,0,-1,103000,97000
3:2:4,1,1,102999,97001
3:2:6,1,1,102998,97002
1:3:5,0,-1,102999,97001
4:1:5,0,-1,103000,97000
4:6:4,0,-1,103001,96999
6:1:3,0,-1,103002,96998
2:6:2,2,2,103000,97000
3:1:2,1,1,102999,97001
2:6:6,1,1,102998,97002
2:4:2,2,2,102996,97004
4:6:4,0,-1,102997,97003
1:2:6,1,1,102996,97004
3:1:6,0,-1,102997,97003
4:3:5,0,-1,102998,97002
5:1:3,0,-1,102999,97001
2:2:1,2,2,102997,97003
1:3:3,0,-1,102998,97002
1:3:3,0,-1,102999,97001
5:6:1,0,-1,103000,97000
2:2:6,2,2,102998,97002
1:4:1,0,-1,102999,97001
2:6:6,1,1,102998,97002
5:1:2,1,1,102997,97003
6:6:3,0,-1,102998,97002
3:4:4,0,-1,102999,97001
1:1:1,0,-1,103000,97000
5:2:1,1,1,102999,97001
3:2:5,1,1,102998,97002
3:1:6,0,-1,102999,97001
3:3:1,0,-1,103000,97000
4:2:5,1,1,102999,97001
2:3:5,1,1,102998,97002
3:5:4,0,-1,102999,97001
3:5:3,0,-1,103000,97000
1:5:3,0,-1,103001,96999
5:6:5,0,-1,103002,96998
2:3:5,1,1,103001,96999
4:2:2,2,2,102999,97001
3:4:4,0,-1,103000,97000
4:5:6,0,-1,103001,96999
4:1:4,0,-1,103002,96998
3:6:3,0,-1,103003,96997
4:4:1,0,-1,103004,96996
6:6:4,0,-1,103005,96995
5:6:3,0,-1,103006,96994
6:2:6,1,1,103005,96995
4:1:6,0,-1,103006,96994
2:3:5,1,1,103005,96995
5:6:2,1,1,103004,96996
3:4:6,0,-1,103005,96995
3:4:4,0,-1,103006,96994
3:4:6,0,-1,103007,96993
3:1:4,0,-1,103008,96992
1:2:3,1,1,103007,96993
1:5:3,0,-1,103008,96992
4:6:1,0,-1,103009,96991
6:1:6,0,-1,103010,96990
3:1:1,0,-1,103011,96989
2:5:5,1,1,103010,96990
2:1:6,1,1,103009,96991
4:3:6,0,-1,103010,96990
1:1:5,0,-1,103011,96989
3:4:3,0,-1,103012,96988
4:3:6,0,-1,103013,96987
4:3:5,0,-1,103014,96986
3:5:2,1,1,103013,96987
4:4:2,1,1,103012,96988
2:4:5,1,1,103011,96989
4:2:6,1,1,103010,96990
3:6:2,1,1,103009,96991
6:4:5,0,-1,103010,96990
2:2:2,3,3,103007,96993
1:4:3,0,-1,103008,96992
2:4:6,1,1,103007,96993
5:6:4,0,-1,103008,96992
2:1:2,2,2,103006,96994
5:3:6,0,-1,103007,96993
6:6:4,0,-1,103008,96992
2:2:5,2,2,103006,96994
1:1:3,0,-1,103007,96993
6:5:6,0,-1,103008,96992
6:3:2,1,1,103007,96993
3:1:2,1,1,103006,96994
2:3:1,1,1,103005,96995
6:4:5,0,-1,103006,96994
4:3:5,0,-1,103007,96993
3:6:6,0,-1,103008,96992
4:3:2,1,1,103007,96993
5:2:5,1,1,103006,96994
3:6:6,0,-1,103007,96993
3:2:4,1,1,103006,96994
5:1:2,1,1,103005,96995
6:1:2,1,1,103004,96996
2:3:5,1,1,103003,96997
5:3:4,0,-1,103004,96996
3:1:4,0,-1,103005,96995
2:4:3,1,1,103004,96996
4:2:4,1,1,103003,96997
6:2:6,1,1,103002,96998
6:1:1,0,-1,103003,96997
4:2:5,1,1,103002,96998
6:5:4,0,-1,103003,96997
5:5:3,0,-1,103004,96996
1:3:1,0,-1,103005,96995
3:5:4,0,-1,103006,96994
2:5:3,1,1,103005,96995
6:2:1,1,1,103004,96996
2:4:2,2,2,103002,96998
4:4:3,0,-1,103003,96997
6:1:6,0,-1,103004,96996
3:1:5,0,-1,103005,96995
1:4:3,0,-1,103006,96994
2:2:6,2,2,103004,96996
3:3:6,0,-1,103005,96995
4:6:6,0,-1,103006,96994
1:5:6,0,-1,103007,96993
1:4:4,0,-1,103008,96992
6:5:3,0,-1,103009,96991
2:3:4,1,1,103008,96992
5:6:4,0,-1,103009,96991
6:2:4,1,1,103008,96992
4:6:6,0,-1,103009,96991
6:2:5,1,1,103008,96992
6:5:6,0,-1,103009,96991
2:1:5,1,1,103008,96992
5:3:3,0,-1,103009,96991
1:3:4,0,-1,103010,96990
5:5:6,0,-1,103011,96989
5:2:1,1,1,103010,96990
4:1:5,0,-1,103011,96989
3:6:2,1,1,103010,96990
2:1:3,1,1,103009,96991
1:5:3,0,-1,103010,96990
2:2:5,2,2,103008,96992
5:6:4,0,-1,103009,96991
6:3:1,0,-1,103010,96990
3:1:3,0,-1,103011,96989
3:3:3,0,-1,103012,96988
6:6:5,0,-1,103013,96987
4:5:1,0,-1,103014,96986
2:5:2,2,2,103012,96988
5:5:6,0,-1,103013,96987
5:6:2,1,1,103012,96988
5:2:5,1,1,103011,96989
5:3:2,1,1,103010,96990
2:5:3,1,1,103009,96991
6:2:6,1,1,103008,96992
4:4:4,0,-1,103009,96991
5:6:1,0,-1,103010,96990
4:2:3,1,1,103009,96991
2:4:1,1,1,103008,96992
2:3:5,1,1,103007,96993
4:6:1,0,-1,103008,96992
4:1:2,1,1,103007,96993
4:3:6,0,-1,103008,96992
6:3:6,0,-1,103009,96991
6:4:4,0,-1,103010,96990
5:2:3,1,1,103009,96991
2:3:6,1,1,103008,96992
2:5:1,1,1,103007,96993
6:3:5,0,-1,103008,96992
4:1:1,0,-1,103009,96991
5:6:1,0,-1,103010,96990
2:4:3,1,1,103009,96991
6:5:3,0,-1,103010,96990
6:1:3,0,-1,103011,96989
5:1:3,0,-1,103012,96988
4:5:3,0,-1,103013,96987
2:1:1,1,1,103012,96988
6:2:4,1,1,103011,96989
1:3:5,0,-1,103012,96988
3:3:6,0,-1,103013,96987
4:3:6,0,-1,103014,96986
5:5:3,0,-1,103015,96985
1:1:3,0,-1,103016,96984
1:3:3,0,-1,103017,96983
5:1:1,0,-1,103018,96982
3:4:1,0,-1,103019,96981
1:2:1,1,1,103018,96982
3:6:6,0,-1,103019,96981
1:3:3,0,-1,103020,96980
2:3:6,1,1,103019,96981
1:2:4,1,1,103018,96982
3:6:2,1,1,103017,96983
2:2:4,2,2,103015,96985
4:1:2,1,1,103014,96986
6:1:1,0,-1,103015,96985
6:2:4,1,1,103014,96986
5:3:6,0,-1,103015,96985
1:6:5,0,-1,103016,96984
3:1:2,1,1,103015,96985
5:6:1,0,-1,103016,96984
5:4:3,0,-1,103017,96983
2:5:3,1,1,103016,96984
2:4:5,1,1,103015,96985
2:1:6,1,1,103014,96986
6:3:5,0,-1,103015,96985
5:6:4,0,-1,103016,96984
5:6:3,0,-1,103017,96983
6:5:2,1,1,103016,96984
4:2:4,1,1,103015,96985
3:1:2,1,1,103014,96986
1:2:1,1,1,103013,96987
5:2:1,1,1,103012,96988
4:2:6,1,1,103011,96989
3:2:2,2,2,103009,96991
2:4:6,1,1,103008,96992
5:3:4,0,-1,103009,96991
3:6:1,0,-1,103010,96990
4:6:5,0,-1,103011,96989
3:4:3,0,-1,103012,96988
6:5:1,0,-1,103013,96987
2:1:1,1,1,103012,96988
3:5:5,0,-1,103013,96987
6:1:5,0,-1,103014,96986
3:3:5,0,-1,103015,96985
6:5:2,1,1,103014,96986
3:5:1,0,-1,103015,96985
3:1:3,0,-1,103016,96984
4:6:3,0,-1,103017,96983
4:1:4,0,-1,103018,96982
4:2:6,1,1,103017,96983
5:2:6,1,1,103016,96984
4:4:3,0,-1,103017,96983
4:1:6,0,-1,103018,96982
5:1:5,0,-1,103019,96981
6:1:1,0,-1,103020,96980
5:6:4,0,-1,103021,96979
2:1:4,1,1,103020,96980
1:2:1,1,1,103019,96981
2:4:1,1,1,103018,96982
6:1:4,0,-1,103019,96981
4:2:3,1,1,103018,96982
2:4:3,1,1,103017,96983
2:4:3,1,1,103016,96984
4:5:5,0,-1,103017,96983
3:4:5,0,-1,103018,96982
1:2:2,2,2,103016,96984
5:6:6,0,-1,103017,96983
4:4:3,0,-1,103018,96982
5:5:3,0,-1,103019,96981
1:4:6,0,-1,103020,96980
2:5:4,1,1,103019,96981
1:6:1,0,-1,103020,96980
6:4:6,0,-1,103021,96979
5:3:1,0,-1,103022,96978
5:2:4,1,1,103021,96979
5:6:4,0,-1,103022,96978
2:5:5,1,1,103021,96979
1:5:6,0,-1,103022,96978
2:5:3,1,1,103021,96979
1:2:3,1,1,103020,96980
1:5:6,0,-1,103021,96979
3:1:4,0,-1,103022,96978
6:1:4,0,-1,103023,96977
3:6:3,0,-1,103024,96976
3:2:2,2,2,103022,96978
2:6:5,1,1,103021,96979
1:6:2,1,1,103020,96980
5:5:4,0,-1,103021,96979
6:2:5,1,1,103020,96980
5:3:2,1,1,103019,96981
2:4:5,1,1,103018,96982
4:4:1,0,-1,103019,96981
4:4:4,0,-1,103020,96980
2:5:4,1,1,103019,96981
2:3:1,1,1,103018,96982
3:5:2,1,1,103017,96983
4:5:3,0,-1,103018,96982
6:4:3,0,-1,103019,96981
1:6:6,0,-1,103020,96980
6:5:3,0,-1,103021,96979
4:4:3,0,-1,103022,96978
1:5:5,0,-1,103023,96977
2:5:1,1,1,103022,96978
5:5:1,0,-1,103023,96977
6:2:6,1,1,103022,96978
5:4:5,0,-1,103023,96977
2:4:1,1,1,103022,96978
2:6:5,1,1,103021,96979
4:5:5,0,-1,103022,96978
2:4:6,1,1,103021,96979
1:2:1,1,1,103020,96980
3:4:2,1,1,103019,96981
1:4:1,0,-1,103020,96980
6:5:1,0,-1,103021,96979
5:4:3,0,-1,103022,96978
4:1:3,0,-1,103023,96977
5:1:3,0,-1,103024,96976
6:2:4,1,1,103023,96977
4:5:6,0,-1,103024,96976
6:6:2,1,1,103023,96977
1:3:3,0,-1,103024,96976
1:4:4,0,-1,103025,96975
6:4:2,1,1,103024,96976
4:6:1,0,-1,103025,96975
5:4:5,0,-1,103026,96974
5:1:6,0,-1,103027,96973
6:1:1,0,-1,103028,96972
1:3:3,0,-1,103029,96971
4:3:1,0,-1,103030,96970
4:5:4,0,-1,103031,96969
3:1:6,0,-1,103032,96968
5:5:1,0,-1,103033,96967
3:2:6,1,1,103032,96968
6:1:5,0,-1,103033,96967
4:3:6,0,-1,103034,96966
2:1:3,1,1,103033,96967
4:2:2,2,2,103031,96969
5:5:6,0,-1,103032,96968
5:2:3,1,1,103031,96969
2:4:6,1,1,103030,96970
2:6:1,1,1,103029,96971
2:1:6,1,1,103028,96972
2:6:5,1,1,103027,96973
4:1:1,0,-1,103028,96972
6:3:3,0,-1,103029,96971
3:3:1,0,-1,103030,96970
3:6:6,0,-1,103031,96969
6:2:6,1,1,103030,96970
5:3:1,0,-1,103031,96969
1:2:4,1,1,103030,96970
4:2:6,1,1,103029,96971
5:6:2,1,1,103028,96972
5:6:6,0,-1,103029,96971
6:1:5,0,-1,103030,96970
4:3:5,0,-1,103031,96969
1:5:5,0,-1,103032,96968
5:2:3,1,1,103031,96969
1:5:5,0,-1,103032,96968
1:6:5,0,-1,103033,96967
3:2:5,1,1,103032,96968
3:1:6,0,-1,103033,96967
5:2:4,1,1,103032,96968
3:4:5,0,-1,103033,96967
1:4:3,0,-1,103034,96966
4:6:3,0,-1,103035,96965
4:5:4,0,-1,103036,96964
2:6:5,1,1,103035,96965
2:5:5,1,1,103034,96966
5:1:6,0,-1,103035,96965
4:5:1,0,-1,103036,96964
4:4:3,0,-1,103037,96963
6:6:3,0,-1,103038,96962
3:5:1,0,-1,103039,96961
5:1:4,0,-1,103040,96960
2:4:6,1,1,103039,96961
1:2:3,1,1,103038,96962
3:1:3,0,-1,103039,96961
6:3:6,0,-1,103040,96960
1:3:4,0,-1,103041,96959
4:4:2,1,1,103040,96960
3:6:4,0,-1,103041,96959
1:1:5,0,-1,103042,96958
3:3:4,0,-1,103043,96957
6:1:5,0,-1,103044,96956
6:3:5,0,-1,103045,96955
1:4:3,0,-1,103046,96954
3:1:5,0,-1,103047,96953
4:5:3,0,-1,103048,96952
1:6:4,0,-1,103049,96951
5:2:5,1,1,103048,96952
1:4:1,0,-1,103049,96951
2:1:2,2,2,103047,96953
6:6:5,0,-1,103048,96952
1:6:4,0,-1,103049,96951
4:4:4,0,-1,103050,96950
2:6:5,1,1,103049,96951
6:5:4,0,-1,103050,96950
1:1:6,0,-1,103051,96949
3:3:6,0,-1,103052,96948
4:5:2,1,1,103051,96949
4:5:1,0,-1,103052,96948
5:6:5,0,-1,103053,96947
2:4:1,1,1,103052,96948
6:3:4,0,-1,103053,96947
2:5:4,1,1,103052,96948
5:2:1,1,1,103051,96949
5:5:5,0,-1,103052,96948
2:6:6,1,1,103051,96949
1:4:6,0,-1,103052,96948
3:1:5,0,-1,103053,96947
2:1:2,2,2,103051,96949
5:2:1,1,1,103050,96950
3:1:6,0,-1,103051,96949
4:5:2,1,1,103050,96950
1:2:6,1,1,103049,96951
3:6:2,1,1,103048,96952
1:4:3,0,-1,103049,96951
1:3:1,0,-1,103050,96950
2:2:4,2,2,103048,96952
6:3:6,0,-1,103049,96951
6:6:5,0,-1,103050,96950
5:1:5,0,-1,103051,96949
3:1:2,1,1,103050,96950
4:5:5,0,-1,103051,96949
3:5:5,0,-1,103052,96948
2:2:1,2,2,103050,96950
6:4:4,0,-1,103051,96949
2:5:4,1,1,103050,96950
5:6:5,0,-1,103051,96949
2:5:4,1,1,103050,96950
3:2:3,1,1,103049,96951
2:1:2,2,2,103047,96953
1:5:2,1,1,103046,96954
4:4:3,0,-1,103047,96953
1:6:6,0,-1,103048,96952
2:6:2,2,2,103046,96954
3:6:3,0,-1,103047,96953
5:1:1,0,-1,103048,96952
1:4:3,0,-1,103049,96951
3:5:2,1,1,103048,96952
5:3:4,0,-1,103049,96951
1:5:4,0,-1,103050,96950
4:1:1,0,-1,103051,96949
4:5:3,0,-1,103052,96948
6:4:1,0,-1,103053,96947
6:4:6,0,-1,103054,96946
6:3:5,0,-1,103055,96945
4:1:1,0,-1,103056,96944
2:1:3,1,1,103055,96945
2:4:5,1,1,103054,96946
4:3:6,0,-1,103055,96945
3:1:1,0,-1,103056,96944
3:6:4,0,-1,103057,96943
5:2:1,1,1,103056,96944
5:4:1,0,-1,103057,96943
3:5:3,0,-1,103058,96942
4:2:3,1,1,103057,96943
5:2:2,2,2,103055,96945
1:3:1,0,-1,103056,96944
5:1:5,0,-1,103057,96943
3:2:5,1,1,103056,96944
1:5:5,0,-1,103057,96943
3:4:1,0,-1,103058,96942
2:6:4,1,1,103057,96943
1:1:1,0,-1,103058,96942
2:5:2,2,2,103056,96944
6:5:1,0,-1,103057,96943
3:5:6,0,-1,103058,96942
3:3:1,0,-1,103059,96941
6:1:2,1,1,103058,96942
1:2:1,1,1,103057,96943
5:3:2,1,1,103056,96944
3:2:6,1,1,103055,96945
3:5:6,0,-1,103056,96944
1:6:1,0,-1,103057,96943
3:2:5,1,1,103056,96944
4:2:5,1,1,103055,96945
1:5:3,0,-1,103056,96944
2:5:1,1,1,103055,96945
3:5:4,0,-1,103056,96944
1:6:5,0,-1,103057,96943
6:6:4,0,-1,103058,96942
6:3:5,0,-1,103059,96941
5:4:2,1,1,103058,96942
6:3:5,0,-1,103059,96941
3:1:5,0,-1,103060,96940
3:4:2,1,1,103059,96941
3:1:1,0,-1,103060,96940
3:3:2,1,1,103059,96941
5:5:3,0,-1,103060,96940
6:6:2,1,1,103059,96941
4:2:3,1,1,103058,96942
3:3:4,0,-1,103059,96941
3:6:6,0,-1,103060,96940
2:6:1,1,1,103059,96941
4:1:6,0,-1,103060,96940
5:5:4,0,-1,103061,96939
5:6:2,1,1,103060,96940
3:2:5,1,1,103059,96941
6:2:3,1,1,103058,96942
4:2:2,2,2,103056,96944
2:3:5,1,1,103055,96945
3:3:4,0,-1,103056,96944
6:2:6,1,1,103055,96945
3:5:1,0,-1,103056,96944
5:3:2,1,1,103055,96945
2:3:3,1,1,103054,96946
5:6:1,0,-1,103055,96945
6:2:5,1,1,103054,96946
6:2:3,1,1,103053,96947
4:2:1,1,1,103052,96948
1:5:1,0,-1,103053,96947
5:2:4,1,1,103052,96948
5:5:6,0,-1,103053,96947
3:2:1,1,1,103052,96948
3:6:5,0,-1,103053,96947
1:6:1,0,-1,103054,96946
1:5:1,0,-1,103055,96945
2:5:5,1,1,103054,96946
2:3:6,1,1,103053,96947
4:1:1,0,-1,103054,96946
6:6:3,0,-1,103055,96945
6:5:4,0,-1,103056,96944
1:5:5,0,-1,103057,96943
2:2:4,2,2,103055,96945
6:6:3,0,-1,103056,96944
4:6:2,1,1,103055,96945
5:5:5,0,-1,103056,96944
3:6:5,0,-1,103057,96943
5:5:1,0,-1,103058,96942
3:5:6,0,-1,103059,96941
5:1:5,0,-1,103060,96940
2:2:2,3,3,103057,96943
2:3:2,2,2,103055,96945
4:3:6,0,-1,103056,96944
6:3:3,0,-1,103057,96943
5:1:2,1,1,103056,96944
4:3:1,0,-1,103057,96943
6:4:2,1,1,103056,96944
4:4:1,0,-1,103057,96943
3:1:2,1,1,103056,96944
2:6:2,2,2,103054,96946
6:6:5,0,-1,103055,96945
6:5:3,0,-1,103056,96944
5:4:1,0,-1,103057,96943
5:3:5,0,-1,103058,96942
6:3:5,0,-1,103059,96941
4:5:1,0,-1,103060,96940
5:3:2,1,1,103059,96941
3:2:4,1,1,103058,96942
6:4:2,1,1,103057,96943
4:6:2,1,1,103056,96944
2:4:4,1,1,103055,96945
2:4:3,1,1,103054,96946
1:2:2,2,2,103052,96948
1:1:3,0,-1,103053,96947
1:1:1,0,-1,103054,96946
4:3:2,1,1,103053,96947
2:2:4,2,2,103051,96949
6:2:6,1,1,103050,96950
2:6:1,1,1,103049,96951
4:2:4,1,1,103048,96952
3:5:4,0,-1,103049,96951
3:6:1,0,-1,103050,96950
1:5:3,0,-1,103051,96949
6:1:4,0,-1,103052,96948
4:6:4,0,-1,103053,96947
6:3:1,0,-1,103054,96946
4:5:2,1,1,103053,96947
3:6:5,0,-1,103054,96946
2:2:6,2,2,103052,96948
1:2:5,1,1,103051,96949
6:5:6,0,-1,103052,96948
1:3:5,0,-1,103053,96947
1:2:5,1,1,103052,96948
3:6:2,1,1,103051,96949
4:6:5,0,-1,103052,96948
5:6:3,0,-1,103053,96947
5:1:5,0,-1,103054,96946
3:6:2,1,1,103053,96947
6:6:4,0,-1,103054,96946
3:6:3,0,-1,103055,96945
5:1:5,0,-1,103056,96944
6:4:2,1,1,103055,96945
6:6:2,1,1,103054,96946
3:6:1,0,-1,103055,96945
5:2:1,1,1,103054,96946
2:2:4,2,2,103052,96948
1:4:2,1,1,103051,96949
6:1:2,1,1,103050,96950
2:5:4,1,1,103049,96951
6:2:1,1,1,103048,96952
6:4:5,0,-1,103049,96951
4:4:4,0,-1,103050,96950
3:5:3,0,-1,103051,96949
3:3:6,0,-1,103052,96948
4:6:5,0,-1,103053,96947
1:2:5,1,1,103052,96948
2:4:4,1,1,103051,96949
2:6:1,1,1,103050,96950
6:4:2,1,1,103049,96951
5:2:1,1,1,103048,96952
5:2:3,1,1,103047,96953
6:6:3,0,-1,103048,96952
3:5:1,0,-1,103049,96951
6:1:5,0,-1,103050,96950
3:4:3,0,-1,103051,96949
1:5:4,0,-1,103052,96948
2:1:1,1,1,103051,96949
6:5:5,0,-1,103052,96948
3:5:1,0,-1,103053,96947
4:4:3,0,-1,103054,96946
4:4:3,0,-1,103055,96945
2:6:6,1,1,103054,96946
5:6:3,0,-1,103055,96945
1:2:2,2,2,103053,96947
1:6:2,1,1,103052,96948
3:4:1,0,-1,103053,96947
3:2:3,1,1,103052,96948
5:2:6,1,1,103051,96949
4:2:4,1,1,103050,96950
5:2:6,1,1,103049,96951
4:5:3,0,-1,103050,96950
2:1:4,1,1,103049,96951
4:3:6,0,-1,103050,96950
1:3:6,0,-1,103051,96949
3:6:4,0,-1,103052,96948
3:1:4,0,-1,103053,96947
1:3:4,0,-1,103054,96946
6:1:6,0,-1,103055,96945
4:3:3,0,-1,103056,96944
3:3:6,0,-1,103057,96943
1:2:4,1,1,103056,96944
5:4:5,0,-1,103057,96943
5:1:1,0,-1,103058,96942
3:5:5,0,-1,103059,96941
4:3:3,0,-1,103060,96940
6:5:2,1,1,103059,96941
4:5:3,0,-1,103060,96940
5:5:6,0,-1,103061,96939
4:6:5,0,-1,103062,96938
2:1:4,1,1,103061,96939
1:5:6,0,-1,103062,96938
2:5:5,1,1,103061,96939
2:5:5,1,1,103060,96940
5:6:6,0,-1,103061,96939
5:1:2,1,1,103060,96940
4:6:3,0,-1,103061,96939
6:1:6,0,-1,103062,96938
1:3:5,0,-1,103063,96937
6:1:1,0,-1,103064,96936
5:4:5,0,-1,103065,96935
2:5:2,2,2,103063,96937
3:3:1,0,-1,103064,96936
4:6:1,0,-1,103065,96935
3:1:1,0,-1,103066,96934
6:3:2,1,1,103065,96935
1:4:2,1,1,103064,96936
5:1:5,0,-1,103065,96935
4:6:4,0,-1,103066,96934
5:2:6,1,1,103065,96935
2:2:5,2,2,103063,96937
3:5:4,0,-1,103064,96936
4:4:3,0,-1,103065,96935
6:4:6,0,-1,103066,96934
5:3:3,0,-1,103067,96933
3:5:4,0,-1,103068,96932
4:4:6,0,-1,103069,96931
1:1:5,0,-1,103070,96930
6:4:4,0,-1,103071,96929
2:3:2,2,2,103069,96931
5:6:1,0,-1,103070,96930
3:1:2,1,1,103069,96931
3:5:2,1,1,103068,96932
3:2:4,1,1,103067,96933
2:5:6,1,1,103066,96934
6:4:3,0,-1,103067,96933
3:6:1,0,-1,103068,96932
1:1:5,0,-1,103069,96931
3:3:5,0,-1,103070,96930
1:1:5,0,-1,103071,96929
5:3:2,1,1,103070,96930
6:4:2,1,1,103069,96931
2:4:1,1,1,103068,96932
6:3:1,0,-1,103069,96931
1:5:2,1,1,103068,96932
5:3:3,0,-1,103069,96931
3:3:4,0,-1,103070,96930
1:4:5,0,-1,103071,96929
6:6:2,1,1,103070,96930
1:2:4,1,1,103069,96931
3:1:3,0,-1,103070,96930
2:2:2,3,3,103067,96933
1:6:3,0,-1,103068,96932
6:4:5,0,-1,103069,96931
5:5:4,0,-1,103070,96930
3:3:2,1,1,103069,96931
5:1:4,0,-1,103070,96930
1:4:4,0,-1,103071,96929
1:6:2,1,1,103070,96930
6:3:6,0,-1,103071,96929
2:1:1,1,1,103070,96930
6:4:3,0,-1,103071,96929
5:1:2,1,1,103070,96930
6:5:2,1,1,103069,96931
2:3:5,1,1,103068,96932
1:4:4,0,-1,103069,96931
2:2:6,2,2,103067,96933
5:4:1,0,-1,103068,96932
4:2:4,1,1,103067,96933
6:1:6,0,-1,103068,96932
2:2:5,2,2,103066,96934
5:3:6,0,-1,103067,96933
5:6:1,0,-1,103068,96932
5:1:2,1,1,103067,96933
3:1:2,1,1,103066,96934
1:5:3,0,-1,103067,96933
1:3:6,0,-1,103068,96932
5:5:2,1,1,103067,96933
1:4:4,0,-1,103068,96932
2:1:6,1,1,103067,96933
1:4:1,0,-1,103068,96932
1:6:6,0,-1,103069,96931
4:3:3,0,-1,103070,96930
4:6:5,0,-1,103071,96929
5:5:1,0,-1,103072,96928
2:5:3,1,1,103071,96929
5:3:5,0,-1,103072,96928
2:3:4,1,1,103071,96929
1:4:3,0,-1,103072,96928
5:4:3,0,-1,103073,96927
5:1:2,1,1,103072,96928
3:2:2,2,2,103070,96930
6:4:3,0,-1,103071,96929
6:4:3,0,-1,103072,96928
4:2:2,2,2,103070,96930
6:4:6,0,-1,103071,96929
2:3:2,2,2,103069,96931
1:5:1,0,-1,103070,96930
5:5:3,0,-1,103071,96929
4:1:4,0,-1,103072,96928
2:1:5,1,1,103071,96929
4:2:3,1,1,103070,96930
6:1:6,0,-1,103071,96929
1:1:4,0,-1,103072,96928
4:5:5,0,-1,103073,96927
1:6:6,0,-1,103074,96926
6:6:4,0,-1,103075,96925
6:2:4,1,1,103074,96926
1:4:3,0,-1,103075,96925
2:1:2,2,2,103073,96927
6:1:4,0,-1,103074,96926
1:1:5,0,-1,103075,96925
6:4:2,1,1,103074,96926
4:5:5,0,-1,103075,96925
2:2:5,2,2,103073,96927
2:1:6,1,1,103072,96928
5:1:4,0,-1,103073,96927
1:2:2,2,2,103071,96929
5:4:3,0,-1,103072,96928
2:6:3,1,1,103071,96929
1:3:6,0,-1,103072,96928
2:6:2,2,2,103070,96930
5:6:3,0,-1,103071,96929
4:1:1,0,-1,103072,96928
6:4:1,0,-1,103073,96927
5:4:3,0,-1,103074,96926
2:6:1,1,1,103073,96927
1:3:4,0,-1,103074,96926
4:6:6,0,-1,103075,96925
1:6:2,1,1,103074,96926
1:5:1,0,-1,103075,96925
2:3:1,1,1,103074,96926
5:1:4,0,-1,103075,96925
6:2:2,2,2,103073,96927
2:4:6,1,1,103072,96928
5:1:4,0,-1,103073,96927
6:5:1,0,-1,103074,96926
5:2:2,2,2,103072,96928
6:2:6,1,1,103071,96929
4:3:2,1,1,103070,96930
1:3:4,0,-1,103071,96929
1:2:5,1,1,103070,96930
2:2:4,2,2,103068,96932
2:3:5,1,1,103067,96933
2:5:4,1,1,103066,96934
3:2:1,1,1,103065,96935
1:1:6,0,-1,103066,96934
4:3:2,1,1,103065,96935
2:1:1,1,1,103064,96936
2:2:1,2,2,103062,96938
2:2:6,2,2,103060,96940
2:3:1,1,1,103059,96941
3:2:5,1,1,103058,96942
2:3:4,1,1,103057,96943
3:2:6,1,1,103056,96944
6:3:4,0,-1,103057,96943
6:4:3,0,-1,103058,96942
1:5:6,0,-1,103059,96941
3:2:5,1,1,103058,96942
2:5:2,2,2,103056,96944
3:2:6,1,1,103055,96945
4:1:6,0,-1,103056,96944
2:2:6,2,2,103054,96946
1:1:4,0,-1,103055,96945
6:4:2,1,1,103054,96946
5:1:1,0,-1,103055,96945
3:6:5,0,-1,103056,96944
4:2:2,2,2,103054,96946
5:4:2,1,1,103053,96947
3:1:1,0,-1,103054,96946
1:3:3,0,-1,103055,96945
6:2:2,2,2,103053,96947
4:1:5,0,-1,103054,96946
6:5:2,1,1,103053,96947
2:1:5,1,1,103052,96948
4:5:2,1,1,103051,96949
6:3:3,0,-1,103052,96948
2:1:5,1,1,103051,96949
6:5:3,0,-1,103052,96948
1:3:3,0,-1,103053,96947
4:2:3,1,1,103052,96948
5:5:5,0,-1,103053,96947
2:5:6,1,1,103052,96948
2:6:3,1,1,103051,96949
1:3:5,0,-1,103052,96948
4:5:6,0,-1,103053,96947
4:2:4,1,1,103052,96948
2:1:3,1,1,103051,96949
6:5:5,0,-1,103052,96948
1:4:2,1,1,103051,96949
1:5:6,0,-1,103052,96948
6:5:6,0,-1,103053,96947
4:5:2,1,1,103052,96948
5:6:6,0,-1,103053,96947
6:2:3,1,1,103052,96948
5:6:5,0,-1,103053,96947
4:5:1,0,-1,103054,96946
4:6:6,0,-1,103055,96945
6:4:3,0,-1,103056,96944
3:4:1,0,-1,103057,96943
4:4:3,0,-1,103058,96942
2:4:5,1,1,103057,96943
6:2:3,1,1,103056,96944
2:2:6,2,2,103054,96946
5:4:4,0,-1,103055,96945
2:4:6,1,1,103054,96946
3:2:2,2,2,103052,96948
1:2:3,1,1,103051,96949
2:3:2,2,2,103049,96951
6:5:2,1,1,103048,96952
5:6:6,0,-1,103049,96951
5:5:2,1,1,103048,96952
3:6:1,0,-1,103049,96951
6:1:3,0,-1,103050,96950
3:3:6,0,-1,103051,96949
2:4:1,1,1,103050,96950
2:4:3,1,1,103049,96951
3:3:2,1,1,103048,96952
1:6:5,0,-1,103049,96951
5:5:6,0,-1,103050,96950
4:6:3,0,-1,103051,96949
1:3:2,1,1,103050,96950
5:4:3,0,-1,103051,96949
1:5:4,0,-1,103052,96948
2:6:3,1,1,103051,96949
6:2:6,1,1,103050,96950
1:1:1,0,-1,103051,96949
2:2:6,2,2,103049,96951
3:6:6,0,-1,103050,96950
2:2:1,2,2,103048,96952
2:1:5,1,1,103047,96953
6:6:1,0,-1,103048,96952
5:4:2,1,1,103047,96953
3:1:4,0,-1,103048,96952
3:3:4,0,-1,103049,96951
3:1:2,1,1,103048,96952
4:3:6,0,-1,103049,96951
2:2:6,2,2,103047,96953
3:6:4,0,-1,103048,96952
1:1:2,1,1,103047,96953
2:4:2,2,2,103045,96955
2:4:4,1,1,103044,96956
6:2:5,1,1,103043,96957
3:3:5,0,-1,103044,96956
3:6:3,0,-1,103045,96955
4:1:4,0,-1,103046,96954
1:1:6,0,-1,103047,96953
1:2:4,1,1,103046,96954
3:4:1,0,-1,103047,96953
1:4:2,1,1,103046,96954
1:5:1,0,-1,103047,96953
1:1:6,0,-1,103048,96952
1:4:2,1,1,103047,96953
1:6:3,0,-1,103048,96952
6:5:6,0,-1,103049,96951
3:3:3,0,-1,103050,96950
2:1:2,2,2,103048,96952
6:1:3,0,-1,103049,96951
6:2:5,1,1,103048,96952
4:5:2,1,1,103047,96953
4:5:1,0,-1,103048,96952
3:1:4,0,-1,103049,96951
1:4:6,0,-1,103050,96950
6:2:4,1,1,103049,96951
4:6:1,0,-1,103050,96950
1:4:3,0,-1,103051,96949
5:1:6,0,-1,103052,96948
5:3:4,0,-1,103053,96947
5:1:5,0,-1,103054,96946
4:3:4,0,-1,103055,96945
5:5:6,0,-1,103056,96944
1:3:4,0,-1,103057,96943
3:5:5,0,-1,103058,96942
1:4:2,1,1,103057,96943
2:2:4,2,2,103055,96945
4:6:6,0,-1,103056,96944
6:2:4,1,1,103055,96945
2:4:1,1,1,103054,96946
4:4:6,0,-1,103055,96945
2:4:2,2,2,103053,96947
4:6:6,0,-1,103054,96946
2:2:6,2,2,103052,96948
1:3:3,0,-1,103053,96947
6:5:6,0,-1,103054,96946
3:1:6,0,-1,103055,96945
1:1:2,1,1,103054,96946
4:5:4,0,-1,103055,96945
1:5:6,0,-1,103056,96944
6:6:4,0,-1,103057,96943
2:5:2,2,2,103055,96945
4:1:6,0,-1,103056,96944
4:6:2,1,1,103055,96945
1:3:6,0,-1,103056,96944
6:1:6,0,-1,103057,96943
5:3:2,1,1,103056,96944
6:6:4,0,-1,103057,96943
6:3:2,1,1,103056,96944
1:3:6,0,-1,103057,96943
6:4:1,0,-1,103058,96942
5:3:6,0,-1,103059,96941
3:4:6,0,-1,103060,96940
6:1:1,0,-1,103061,96939
6:3:6,0,-1,103062,96938
4:6:2,1,1,103061,96939
6:5:4,0,-1,103062,96938
3:6:1,0,-1,103063,96937
5:6:5,0,-1,103064,96936
6:2:6,1,1,103063,96937
5:6:2,1,1,103062,96938
5:6:2,1,1,103061,96939
1:1:5,0,-1,103062,96938
4:5:5,0,-1,103063,96937
4:1:3,0,-1,103064,96936
2:2:1,2,2,103062,96938
5:6:6,0,-1,103063,96937
4:6:2,1,1,103062,96938
4:6:1,0,-1,103063,96937
5:1:2,1,1,103062,96938
1:3:6,0,-1,103063,96937
1:4:3,0,-1,103064,96936
6:4:1,0,-1,103065,96935
4:1:1,0,-1,103066,96934
2:1:4,1,1,103065,96935
5:3:1,0,-1,103066,96934
3:6:5,0,-1,103067,96933
4:5:2,1,1,103066,96934
2:4:1,1,1,103065,96935
5:6:3,0,-1,103066,96934
5:4:5,0,-1,103067,96933
1:4:6,0,-1,103068,96932
4:4:1,0,-1,103069,96931
3:1:1,0,-1,103070,96930
6:2:4,1,1,103069,96931
6:6:5,0,-1,103070,96930
3:5:3,0,-1,103071,96929
5:4:1,0,-1,103072,96928
2:5:1,1,1,103071,96929
3:3:3,0,-1,103072,96928
1:5:2,1,1,103071,96929
6:5:4,0,-1,103072,96928
5:1:1,0,-1,103073,96927
6:6:3,0,-1,103074,96926
3:2:3,1,1,103073,96927
3:1:2,1,1,103072,96928
1:5:3,0,-1,103073,96927
5:1:3,0,-1,103074,96926
3:4:2,1,1,103073,96927
5:4:3,0,-1,103074,96926
1:5:3,0,-1,103075,96925
1:5:5,0,-1,103076,96924
1:6:4,0,-1,103077,96923
2:1:5,1,1,103076,96924
4:4:4,0,-1,103077,96923
3:5:4,0,-1,103078,96922
2:4:2,2,2,103076,96924
5:3:5,0,-1,103077,96923
3:5:4,0,-1,103078,96922
2:2:6,2,2,103076,96924
1:4:3,0,-1,103077,96923
3:5:6,0,-1,103078,96922
2:6:3,1,1,103077,96923
5:3:2,1,1,103076,96924
2:5:1,1,1,103075,96925
4:4:1,0,-1,103076,96924
5:4:3,0,-1,103077,96923
4:2:5,1,1,103076,96924
1:2:6,1,1,103075,96925
6:2:5,1,1,103074,96926
6:2:2,2,2,103072,96928
6:6:2,1,1,103071,96929
3:1:6,0,-1,103072,96928
6:2:5,1,1,103071,96929
2:5:1,1,1,103070,96930
1:2:3,1,1,103069,96931
5:1:2,1,1,103068,96932
6:1:5,0,-1,103069,96931
3:1:3,0,-1,103070,96930
1:4:2,1,1,103069,96931
6:6:5,0,-1,103070,96930
1:1:3,0,-1,103071,96929
6:5:4,0,-1,103072,96928
6:2:2,2,2,103070,96930
5:1:5,0,-1,103071,96929
4:2:2,2,2,103069,96931
5:6:5,0,-1,103070,96930
5:2:3,1,1,103069,96931
1:5:6,0,-1,103070,96930
1:1:1,0,-1,103071,96929
2:3:4,1,1,103070,96930
2:4:1,1,1,103069,96931
1:4:5,0,-1,103070,96930
1:1:1,0,-1,103071,96929
2:6:1,1,1,103070,96930
1:3:4,0,-1,103071,96929
6:4:5,0,-1,103072,96928
1:3:6,0,-1,103073,96927
5:4:5,0,-1,103074,96926
1:6:1,0,-1,103075,96925
2:5:4,1,1,103074,96926
5:4:1,0,-1,103075,96925
2:6:6,1,1,103074,96926
5:2:4,1,1,103073,96927
3:3:2,1,1,103072,96928
2:6:6,1,1,103071,96929
2:2:5,2,2,103069,96931
2:2:3,2,2,103067,96933
1:3:3,0,-1,103068,96932
3:6:3,0,-1,103069,96931
1:6:5,0,-1,103070,96930
2:3:5,1,1,103069,96931
2:1:1,1,1,103068,96932
2:1:1,1,1,103067,96933
2:3:2,2,2,103065,96935
6:6:1,0,-1,103066,96934
6:4:2,1,1,103065,96935
6:2:3,1,1,103064,96936
4:1:4,0,-1,103065,96935
1:3:4,0,-1,103066,96934
4:4:4,0,-1,103067,96933
2:6:6,1,1,103066,96934
3:4:2,1,1,103065,96935
6:3:3,0,-1,103066,96934
3:1:3,0,-1,103067,96933
2:4:2,2,2,103065,96935
2:6:1,1,1,103064,96936
2:1:2,2,2,103062,96938
1:1:3,0,-1,103063,96937
2:4:5,1,1,103062,96938
6:1:2,1,1,103061,96939
6:4:1,0,-1,103062,96938
3:3:2,1,1,103061,96939
1:5:2,1,1,103060,96940
6:1:2,1,1,103059,96941
3:3:4,0,-1,103060,96940
5:2:6,1,1,103059,96941
1:2:3,1,1,103058,96942
4:1:5,0,-1,103059,96941
1:3:2,1,1,103058,96942
4:2:2,2,2,103056,96944
5:4:5,0,-1,103057,96943
1:4:2,1,1,103056,96944
2:2:2,3,3,103053,96947
3:5:3,0,-1,103054,96946
5:5:4,0,-1,103055,96945
1:1:3,0,-1,103056,96944
4:3:2,1,1,103055,96945
5:4:1,0,-1,103056,96944
4:1:6,0,-1,103057,96943
1:5:4,0,-1,103058,96942
4:4:1,0,-1,103059,96941
1:6:6,0,-1,103060,96940
3:3:4,0,-1,103061,96939
4:6:1,0,-1,103062,96938
2:3:5,1,1,103061,96939
6:3:4,0,-1,103062,96938
4:5:2,1,1,103061,96939
5:3:1,0,-1,103062,96938
3:1:4,0,-1,103063,96937
6:5:6,0,-1,103064,96936
5:6:5,0,-1,103065,96935
1:6:4,0,-1,103066,96934
2:6:1,1,1,103065,96935
3:2:1,1,1,103064,96936
6:2:3,1,1,103063,96937
5:6:4,0,-1,103064,96936
4:3:5,0,-1,103065,96935
5:6:4,0,-1,103066,96934
1:2:2,2,2,103064,96936
2:1:1,1,1,103063,96937
5:2:4,1,1,103062,96938
6:3:2,1,1,103061,96939
2:6:2,2,2,103059,96941
3:1:5,0,-1,103060,96940
6:6:4,0,-1,103061,96939
1:6:5,0,-1,103062,96938
6:5:5,0,-1,103063,96937
2:1:1,1,1,103062,96938
3:2:6,1,1,103061,96939
2:2:1,2,2,103059,96941
5:4:3,0,-1,103060,96940
1:4:2,1,1,103059,96941
2:5:6,1,1,103058,96942
2:3:2,2,2,103056,96944
6:6:4,0,-1,103057,96943
2:4:1,1,1,103056,96944
6:2:6,1,1,103055,96945
1:3:4,0,-1,103056,96944
6:1:2,1,1,103055,96945
4:6:5,0,-1,103056,96944
5:4:4,0,-1,103057,96943
2:5:4,1,1,103056,96944
4:5:5,0,-1,103057,96943
3:3:5,0,-1,103058,96942
1:2:5,1,1,103057,96943
2:5:2,2,2,103055,96945
6:3:1,0,-1,103056,96944
6:2:4,1,1,103055,96945
5:5:6,0,-1,103056,96944
4:4:5,0,-1,103057,96943
6:1:3,0,-1,103058,96942
3:2:3,1,1,103057,96943
4:2:1,1,1,103056,96944
6:4:1,0,-1,103057,96943
4:6:2,1,1,103056,96944
6:3:5,0,-1,103057,96943
5:3:5,0,-1,103058,96942
6:5:3,0,-1,103059,96941
4:6:4,0,-1,103060,96940
2:4:6,1,1,103059,96941
2:2:2,3,3,103056,96944
2:2:3,2,2,103054,96946
1:4:6,0,-1,103055,96945
5:4:5,0,-1,103056,96944
1:5:4,0,-1,103057,96943
5:3:2,1,1,103056,96944
2:4:4,1,1,103055,96945
4:1:6,0,-1,103056,96944
2:1:3,1,1,103055,96945
5:2:1,1,1,103054,96946
6:5:5,0,-1,103055,96945
5:1:1,0,-1,103056,96944
3:4:1,0,-1,103057,96943
2:4:6,1,1,103056,96944
5:3:5,0,-1,103057,96943
3:1:3,0,-1,103058,96942
5:4:1,0,-1,103059,96941
3:4:5,0,-1,103060,96940
6:4:1,0,-1,103061,96939
3:3:3,0,-1,103062,96938
6:1:2,1,1,103061,96939
2:2:1,2,2,103059,96941
5:4:5,0,-1,103060,96940
1:2:3,1,1,103059,96941
1:4:3,0,-1,103060,96940
1:3:1,0,-1,103061,96939
6:6:1,0,-1,103062,96938
1:5:4,0,-1,103063,96937
5:5:1,0,-1,103064,96936
1:6:2,1,1,103063,96937
4:6:2,1,1,103062,96938
3:3:1,0,-1,103063,96937
2:1:1,1,1,103062,96938
1:5:1,0,-1,103063,96937
1:6:3,0,-1,103064,96936
4:3:3,0,-1,103065,96935
3:6:4,0,-1,103066,96934
6:1:2,1,1,103065,96935
2:1:4,1,1,103064,96936
6:5:2,1,1,103063,96937
1:5:1,0,-1,103064,96936
4:1:1,0,-1,103065,96935
3:1:6,0,-1,103066,96934
5:4:5,0,-1,103067,96933
4:5:6,0,-1,103068,96932
5:3:4,0,-1,103069,96931
3:6:3,0,-1,103070,96930
6:2:3,1,1,103069,96931
4:4:6,0,-1,103070,96930
3:6:6,0,-1,103071,96929
4:4:6,0,-1,103072,96928
4:1:3,0,-1,103073,96927
1:4:1,0,-1,103074,96926
1:4:3,0,-1,103075,96925
6:6:6,0,-1,103076,96924
6:4:2,1,1,103075,96925
2:6:6,1,1,103074,96926
6:2:1,1,1,103073,96927
5:4:4,0,-1,103074,96926
1:6:3,0,-1,103075,96925
2:6:4,1,1,103074,96926
3:6:4,0,-1,103075,96925
5:4:5,0,-1,103076,96924
5:1:6,0,-1,103077,96923
5:6:4,0,-1,103078,96922
2:3:5,1,1,103077,96923
5:4:1,0,-1,103078,96922
1:4:5,0,-1,103079,96921
3:3:2,1,1,103078,96922
4:3:4,0,-1,103079,96921
3:4:5,0,-1,103080,96920
4:6:1,0,-1,103081,96919
5:3:1,0,-1,103082,96918
4:4:2,1,1,103081,96919
1:6:5,0,-1,103082,96918
4:1:6,0,-1,103083,96917
2:5:5,1,1,103082,96918
6:3:6,0,-1,103083,96917
2:3:1,1,1,103082,96918
2:4:6,1,1,103081,96919
4:6:2,1,1,103080,96920
6:5:5,0,-1,103081,96919
3:1:3,0,-1,103082,96918
1:2:5,1,1,103081,96919
5:2:2,2,2,103079,96921
2:1:4,1,1,103078,96922
6:4:1,0,-1,103079,96921
3:1:4,0,-1,103080,96920
2:6:6,1,1,103079,96921
4:2:5,1,1,103078,96922
5:6:4,0,-1,103079,96921
3:3:3,0,-1,103080,96920
6:1:2,1,1,103079,96921
4:1:3,0,-1,103080,96920
4:6:4,0,-1,103081,96919
3:3:4,0,-1,103082,96918
1:1:2,1,1,103081,96919
5:6:3,0,-1,103082,96918
2:6:6,1,1,103081,96919
2:2:1,2,2,103079,96921
6:4:4,0,-1,103080,96920
3:1:1,0,-1,103081,96919
3:3:6,0,-1,103082,96918
1:5:1,0,-1,103083,96917
1:1:1,0,-1,103084,96916
3:2:6,1,1,103083,96917
5:6:5,0,-1,103084,96916
4:1:5,0,-1,103085,96915
5:2:4,1,1,103084,96916
4:2:6,1,1,103083,96917
6:6:6,0,-1,103084,96916
6:2:3,1,1,103083,96917
4:3:1,0,-1,103084,96916
2:2:4,2,2,103082,96918
5:1:5,0,-1,103083,96917
3:2:2,2,2,103081,96919
6:4:4,0,-1,103082,96918
2:2:6,2,2,103080,96920
6:6:3,0,-1,103081,96919
2:4:4,1,1,103080,96920
5:3:5,0,-1,103081,96919
3:6:6,0,-1,103082,96918
2:4:3,1,1,103081,96919
2:5:3,1,1,103080,96920
6:6:3,0,-1,103081,96919
5:1:2,1,1,103080,96920
4:2:1,1,1,103079,96921
1:3:1,0,-1,103080,96920
4:4:2,1,1,103079,96921
3:3:6,0,-1,103080,96920
3:6:4,0,-1,103081,96919
5:2:4,1,1,103080,96920
3:1:1,0,-1,103081,96919
3:6:1,0,-1,103082,96918
1:5:3,0,-1,103083,96917
6:6:5,0,-1,103084,96916
6:3:1,0,-1,103085,96915
2:4:5,1,1,103084,96916
2:1:5,1,1,103083,96917
3:5:1,0,-1,103084,96916
5:4:6,0,-1,103085,96915
4:3:4,0,-1,103086,96914
6:2:4,1,1,103085,96915
3:1:6,0,-1,103086,96914
2:6:2,2,2,103084,96916
5:1:4,0,-1,103085,96915
4:1:5,0,-1,103086,96914
3:1:3,0,-1,103087,96913
1:2:3,1,1,103086,96914
5:6:2,1,1,103085,96915
6:4:1,0,-1,103086,96914
6:6:5,0,-1,103087,96913
2:6:1,1,1,103086,96914
3:4:3,0,-1,103087,96913
2:3:6,1,1,103086,96914
1:2:4,1,1,103085,96915
3:3:4,0,-1,103086,96914
5:2:2,2,2,103084,96916
5:6:2,1,1,103083,96917
6:5:6,0,-1,103084,96916
4:4:4,0,-1,103085,96915
3:2:5,1,1,103084,96916
5:5:6,0,-1,103085,96915
5:1:2,1,1,103084,96916
5:4:4,0,-1,103085,96915
3:6:3,0,-1,103086,96914
6:6:6,0,-1,103087,96913
3:2:3,1,1,103086,96914
5:2:1,1,1,103085,96915
4:1:5,0,-1,103086,96914
3:3:6,0,-1,103087,96913
1:4:3,0,-1,103088,96912
3:6:3,0,-1,103089,96911
1:2:4,1,1,103088,96912
3:4:4,0,-1,103089,96911
5:6:2,1,1,103088,96912
3:1:3,0,-1,103089,96911
4:3:3,0,-1,103090,96910
5:4:3,0,-1,103091,96909
2:4:3,1,1,103090,96910
2:5:3,1,1,103089,96911
3:2:6,1,1,103088,96912
4:4:6,0,-1,103089,96911
1:5:5,0,-1,103090,96910
3:3:3,0,-1,103091,96909
6:1:5,0,-1,103092,96908
2:6:3,1,1,103091,96909
4:4:5,0,-1,103092,96908
4:6:5,0,-1,103093,96907
2:1:2,2,2,103091,96909
1:2:3,1,1,103090,96910
2:2:2,3,3,103087,96913
4:1:5,0,-1,103088,96912
3:2:5,1,1,103087,96913
6:4:5,0,-1,103088,96912
3:1:3,0,-1,103089,96911
2:6:3,1,1,103088,96912
2:4:1,1,1,103087,96913
6:1:5,0,-1,103088,96912
4:3:4,0,-1,103089,96911
4:2:5,1,1,103088,96912
4:5:5,0,-1,103089,96911
5:6:6,0,-1,103090,96910
1:6:5,0,-1,103091,96909
1:5:2,1,1,103090,96910
3:1:3,0,-1,103091,96909
6:5:3,0,-1,103092,96908
1:3:4,0,-1,103093,96907
6:5:1,0,-1,103094,96906
2:2:1,2,2,103092,96908
5:6:5,0,-1,103093,96907
3:1:4,0,-1,103094,96906
3:2:5,1,1,103093,96907
5:1:6,0,-1,103094,96906
3:3:6,0,-1,103095,96905
2:5:3,1,1,103094,96906
2:2:4,2,2,103092,96908
6:2:2,2,2,103090,96910
5:5:4,0,-1,103091,96909
5:3:1,0,-1,103092,96908
2:4:5,1,1,103091,96909
6:2:4,1,1,103090,96910
1:5:1,0,-1,103091,96909
4:2:6,1,1,103090,96910
4:1:5,0,-1,103091,96909
1:3:5,0,-1,103092,96908
6:3:4,0,-1,103093,96907
1:3:2,1,1,103092,96908
6:2:6,1,1,103091,96909
2:4:5,1,1,103090,96910
1:3:6,0,-1,103091,96909
2:4:1,1,1,103090,96910
1:4:3,0,-1,103091,96909
2:2:4,2,2,103089,96911
2:5:3,1,1,103088,96912
2:3:3,1,1,103087,96913
5:1:2,1,1,103086,96914
6:3:2,1,1,103085,96915
5:1:6,0,-1,103086,96914
1:3:1,0,-1,103087,96913
6:4:1,0,-1,103088,96912
5:5:5,0,-1,103089,96911
3:6:5,0,-1,103090,96910
1:2:2,2,2,103088,96912
5:1:3,0,-1,103089,96911
4:3:3,0,-1,103090,96910
4:3:6,0,-1,103091,96909
3:2:3,1,1,103090,96910
2:4:6,1,1,103089,96911
2:6:1,1,1,103088,96912
1:4:1,0,-1,103089,96911
4:3:4,0,-1,103090,96910
3:6:6,0,-1,103091,96909
4:2:2,2,2,103089,96911
3:6:2,1,1,103088,96912
2:5:5,1,1,103087,96913
6:1:3,0,-1,103088,96912
2:1:1,1,1,103087,96913
5:6:2,1,1,103086,96914
2:4:4,1,1,103085,96915
4:2:1,1,1,103084,96916
1:1:1,0,-1,103085,96915
5:3:2,1,1,103084,96916
4:5:3,0,-1,103085,96915
5:3:5,0,-1,103086,96914
1:5:5,0,-1,103087,96913
3:3:3,0,-1,103088,96912
3:2:2,2,2,103086,96914
1:6:5,0,-1,103087,96913
5:6:4,0,-1,103088,96912
1:5:6,0,-1,103089,96911
3:6:2,1,1,103088,96912
3:1:2,1,1,103087,96913
4:1:2,1,1,103086,96914
4:3:6,0,-1,103087,96913
3:5:2,1,1,103086,96914
4:4:4,0,-1,103087,96913
2:1:5,1,1,103086,96914
6:1:5,0,-1,103087,96913
1:6:2,1,1,103086,96914
1:1:5,0,-1,103087,96913
4:1:4,0,-1,103088,96912
5:2:6,1,1,103087,96913
2:6:1,1,1,103086,96914
3:1:1,0,-1,103087,96913
5:5:3,0,-1,103088,96912
4:3:3,0,-1,103089,96911
1:5:6,0,-1,103090,96910
1:4:6,0,-1,103091,96909
4:3:4,0,-1,103092,96908
4:1:2,1,1,103091,96909
4:6:2,1,1,103090,96910
5:4:1,0,-1,103091,96909
3:3:6,0,-1,103092,96908
1:6:2,1,1,103091,96909
3:4:6,0,-1,103092,96908
6:6:2,1,1,103091,96909
4:4:4,0,-1,103092,96908
1:6:2,1,1,103091,96909
2:4:3,1,1,103090,96910
1:5:1,0,-1,103091,96909
3:1:2,1,1,103090,96910
2:6:5,1,1,103089,96911
2:6:6,1,1,103088,96912
4:1:3,0,-1,103089,96911
2:6:5,1,1,103088,96912
2:5:4,1,1,103087,96913
3:5:1,0,-1,103088,96912
3:2:6,1,1,103087,96913
2:4:1,1,1,103086,96914
1:5:6,0,-1,103087,96913
2:4:4,1,1,103086,96914
3:3:4,0,-1,103087,96913
3:6:4,0,-1,103088,96912
2:5:2,2,2,103086,96914
4:1:3,0,-1,103087,96913
6:5:2,1,1,103086,96914
4:6:6,0,-1,103087,96913
5:3:5,0,-1,103088,96912
6:1:4,0,-1,103089,96911
5:2:1,1,1,103088,96912
6:2:5,1,1,103087,96913
1:4:3,0,-1,103088,96912
6:5:5,0,-1,103089,96911
4:2:6,1,1,103088,96912
3:1:2,1,1,103087,96913
4:6:2,1,1,103086,96914
1:1:2,1,1,103085,96915
1:2:4,1,1,103084,96916
3:5:1,0,-1,103085,96915
3:5:6,0,-1,103086,96914
3:2:3,1,1,103085,96915
4:2:6,1,1,103084,96916
6:4:1,0,-1,103085,96915
4:1:1,0,-1,103086,96914
2:1:2,2,2,103084,96916
1:5:2,1,1,103083,96917
2:5:1,1,1,103082,96918
4:6:4,0,-1,103083,96917
6:6:4,0,-1,103084,96916
3:1:3,0,-1,103085,96915
6:5:3,0,-1,103086,96914
1:4:1,0,-1,103087,96913
6:6:3,0,-1,103088,96912
3:6:5,0,-1,103089,96911
3:3:4,0,-1,103090,96910
6:3:2,1,1,103089,96911
3:6:1,0,-1,103090,96910
1:3:3,0,-1,103091,96909
3:3:4,0,-1,103092,96908
6:3:2,1,1,103091,96909
2:6:4,1,1,103090,96910
1:1:1,0,-1,103091,96909
2:3:5,1,1,103090,96910
1:5:6,0,-1,103091,96909
2:3:4,1,1,103090,96910
2:4:5,1,1,103089,96911
6:4:3,0,-1,103090,96910
4:3:5,0,-1,103091,96909
4:1:3,0,-1,103092,96908
2:5:5,1,1,103091,96909
4:4:1,0,-1,103092,96908
6:3:6,0,-1,103093,96907
6:2:5,1,1,103092,96908
6:5:3,0,-1,103093,96907
1:6:2,1,1,103092,96908
1:5:2,1,1,103091,96909
4:3:4,0,-1,103092,96908
5:2:5,1,1,103091,96909
5:2:2,2,2,103089,96911
4:3:2,1,1,103088,96912
2:4:3,1,1,103087,96913
6:2:3,1,1,103086,96914
2:5:5,1,1,103085,96915
3:5:3,0,-1,103086,96914
4:3:3,0,-1,103087,96913
3:4:5,0,-1,103088,96912
6:5:4,0,-1,103089,96911
2:3:2,2,2,103087,96913
3:1:4,0,-1,103088,96912
6:4:2,1,1,103087,96913
4:6:3,0,-1,103088,96912
5:6:3,0,-1,103089,96911
4:5:4,0,-1,103090,96910
1:3:6,0,-1,103091,96909
6:1:2,1,1,103090,96910
5:6:6,0,-1,103091,96909
4:5:5,0,-1,103092,96908
6:3:2,1,1,103091,96909
6:3:1,0,-1,103092,96908
5:1:4,0,-1,103093,96907
6:4:4,0,-1,103094,96906
5:5:4,0,-1,103095,96905
6:4:4,0,-1,103096,96904
4:2:4,1,1,103095,96905
3:2:1,1,1,103094,96906
1:5:4,0,-1,103095,96905
4:6:4,0,-1,103096,96904
5:6:2,1,1,103095,96905
5:5:1,0,-1,103096,96904
2:2:1,2,2,103094,96906
6:4:5,0,-1,103095,96905
4:3:5,0,-1,103096,96904
2:5:3,1,1,103095,96905
3:2:5,1,1,103094,96906
4:3:6,0,-1,103095,96905
6:4:5,0,-1,103096,96904
6:2:2,2,2,103094,96906
6:3:5,0,-1,103095,96905
3:4:4,0,-1,103096,96904
6:4:5,0,-1,103097,96903
6:5:2,1,1,103096,96904
5:5:4,0,-1,103097,96903
1:4:3,0,-1,103098,96902
4:4:4,0,-1,103099,96901
6:3:3,0,-1,103100,96900
5:4:6,0,-1,103101,96899
3:2:6,1,1,103100,96900
2:3:3,1,1,103099,96901
2:4:1,1,1,103098,96902
4:4:5,0,-1,103099,96901
5:2:3,1,1,103098,96902
6:3:4,0,-1,103099,96901
1:3:2,1,1,103098,96902
4:3:4,0,-1,103099,96901
3:3:6,0,-1,103100,96900
5:6:6,0,-1,103101,96899
5:1:4,0,-1,103102,96898
6:4:2,1,1,103101,96899
3:1:4,0,-1,103102,96898
6:4:2,1,1,103101,96899
1:3:4,0,-1,103102,96898
5:2:2,2,2,103100,96900
1:1:3,0,-1,103101,96899
1:1:5,0,-1,103102,96898
4:6:5,0,-1,103103,96897
2:5:6,1,1,103102,96898
3:3:3,0,-1,103103,96897
2:2:2,3,3,103100,96900
4:6:2,1,1,103099,96901
6:1:4,0,-1,103100,96900
4:4:1,0,-1,103101,96899
1:5:6,0,-1,103102,96898
2:5:2,2,2,103100,96900
6:1:4,0,-1,103101,96899
3:5:1,0,-1,103102,96898
2:4:1,1,1,103101,96899
5:1:4,0,-1,103102,96898
5:3:5,0,-1,103103,96897
5:1:2,1,1,103102,96898
1:5:3,0,-1,103103,96897
5:2:1,1,1,103102,96898
5:6:6,0,-1,103103,96897
2:5:2,2,2,103101,96899
6:6:3,0,-1,103102,96898
3:4:3,0,-1,103103,96897
4:4:6,0,-1,103104,96896
3:1:6,0,-1,103105,96895
6:2:4,1,1,103104,96896
1:2:6,1,1,103103,96897
3:4:1,0,-1,103104,96896
4:3:5,0,-1,103105,96895
4:1:3,0,-1,103106,96894
6:4:1,0,-1,103107,96893
5:6:5,0,-1,103108,96892
1:3:4,0,-1,103109,96891
2:4:4,1,1,103108,96892
1:5:6,0,-1,103109,96891
4:6:6,0,-1,103110,96890
1:2:4,1,1,103109,96891
4:6:2,1,1,103108,96892
1:2:4,1,1,103107,96893
2:3:4,1,1,103106,96894
2:4:5,1,1,103105,96895
2:2:5,2,2,103103,96897
5:2:5,1,1,103102,96898
6:3:2,1,1,103101,96899
5:5:1,0,-1,103102,96898
3:5:1,0,-1,103103,96897
2:4:5,1,1,103102,96898
5:1:2,1,1,103101,96899
4:2:4,1,1,103100,96900
3:1:3,0,-1,103101,96899
1:4:5,0,-1,103102,96898
6:5:6,0,-1,103103,96897
4:6:6,0,-1,103104,96896
1:3:3,0,-1,103105,96895
4:4:6,0,-1,103106,96894
5:3:6,0,-1,103107,96893
5:4:4,0,-1,103108,96892
3:5:3,0,-1,103109,96891
2:5:6,1,1,103108,96892
6:1:1,0,-1,103109,96891
6:2:5,1,1,103108,96892
2:1:6,1,1,103107,96893
3:4:5,0,-1,103108,96892
4:5:6,0,-1,103109,96891
5:4:3,0,-1,103110,96890
4:2:4,1,1,103109,96891
4:2:4,1,1,103108,96892
4:5:5,0,-1,103109,96891
6:6:1,0,-1,103110,96890
4:4:6,0,-1,103111,96889
6:6:1,0,-1,103112,96888
3:5:2,1,1,103111,96889
2:4:5,1,1,103110,96890
6:4:2,1,1,103109,96891
5:1:4,0,-1,103110,96890
4:1:5,0,-1,103111,96889
6:3:5,0,-1,103112,96888
6:3:1,0,-1,103113,96887
5:6:3,0,-1,103114,96886
5:6:6,0,-1,103115,96885
6:1:5,0,-1,103116,96884
4:3:5,0,-1,103117,96883
6:2:6,1,1,103116,96884
3:2:5,1,1,103115,96885
6:5:3,0,-1,103116,96884
2:3:2,2,2,103114,96886
6:3:3,0,-1,103115,96885
5:2:2,2,2,103113,96887
4:5:5,0,-1,103114,96886
3:3:4,0,-1,103115,96885
3:2:6,1,1,103114,96886
3:1:1,0,-1,103115,96885
3:3:2,1,1,103114,96886
5:4:1,0,-1,103115,96885
6:5:5,0,-1,103116,96884
2:6:6,1,1,103115,96885
5:2:5,1,1,103114,96886
5:2:2,2,2,103112,96888
6:6:3,0,-1,103113,96887
6:6:1,0,-1,103114,96886
1:2:3,1,1,103113,96887
3:3:5,0,-1,103114,96886
5:3:5,0,-1,103115,96885
3:1:4,0,-1,103116,96884
6:5:4,0,-1,103117,96883
3:1:5,0,-1,103118,96882
6:5:3,0,-1,103119,96881
6:5:4,0,-1,103120,96880
4:2:4,1,1,103119,96881
2:6:4,1,1,103118,96882
5:2:3,1,1,103117,96883
6:3:6,0,-1,103118,96882
4:3:3,0,-1,103119,96881
1:2:5,1,1,103118,96882
4:4:4,0,-1,103119,96881
4:3:5,0,-1,103120,96880
1:4:2,1,1,103119,96881
6:4:4,0,-1,103120,96880
2:6:6,1,1,103119,96881
4:2:6,1,1,103118,96882
1:5:6,0,-1,103119,96881
1:2:2,2,2,103117,96883
6:5:6,0,-1,103118,96882
2:3:4,1,1,103117,96883
5:6:6,0,-1,103118,96882
3:3:5,0,-1,103119,96881
3:4:6,0,-1,103120,96880
3:1:2,1,1,103119,96881
3:2:4,1,1,103118,96882
3:6:4,0,-1,103119,96881
6:6:3,0,-1,103120,96880
5:4:5,0,-1,103121,96879
2:5:1,1,1,103120,96880
6:2:3,1,1,103119,96881
3:6:1,0,-1,103120,96880
1:6:4,0,-1,103121,96879
2:6:5,1,1,103120,96880
1:6:4,0,-1,103121,96879
2:2:3,2,2,103119,96881
6:1:3,0,-1,103120,96880
3:4:4,0,-1,103121,96879
3:4:6,0,-1,103122,96878
1:3:1,0,-1,103123,96877
6:5:6,0,-1,103124,96876
2:4:1,1,1,103123,96877
1:1:2,1,1,103122,96878
2:5:5,1,1,103121,96879
4:6:6,0,-1,103122,96878
6:3:1,0,-1,103123,96877
5:4:3,0,-1,103124,96876
1:6:6,0,-1,103125,96875
1:4:3,0,-1,103126,96874
2:6:6,1,1,103125,96875
3:2:3,1,1,103124,96876
6:4:5,0,-1,103125,96875
5:1:5,0,-1,103126,96874
6:6:3,0,-1,103127,96873
3:6:1,0,-1,103128,96872
5:5:1,0,-1,103129,96871
4:5:6,0,-1,103130,96870
2:4:2,2,2,103128,96872
3:5:1,0,-1,103129,96871
5:5:1,0,-1,103130,96870
1:1:1,0,-1,103131,96869
4:1:1,0,-1,103132,96868
3:4:5,0,-1,103133,96867
5:3:3,0,-1,103134,96866
1:5:5,0,-1,103135,96865
1:6:4,0,-1,103136,96864
5:4:3,0,-1,103137,96863
6:1:1,0,-1,103138,96862
4:2:5,1,1,103137,96863
2:4:3,1,1,103136,96864
3:5:5,0,-1,103137,96863
6:3:3,0,-1,103138,96862
5:6:5,0,-1,103139,96861
6:5:5,0,-1,103140,96860
4:3:1,0,-1,103141,96859
3:4:5,0,-1,103142,96858
6:1:2,1,1,103141,96859
6:5:5,0,-1,103142,96858
6:1:4,0,-1,103143,96857
5:6:5,0,-1,103144,96856
5:1:3,0,-1,103145,96855
5:3:4,0,-1,103146,96854
6:4:6,0,-1,103147,96853
3:5:4,0,-1,103148,96852
6:4:6,0,-1,103149,96851
2:3:1,1,1,103148,96852
2:1:2,2,2,103146,96854
4:6:1,0,-1,103147,96853
1:3:3,0,-1,103148,96852
4:5:5,0,-1,103149,96851
3:6:6,0,-1,103150,96850
6:3:3,0,-1,103151,96849
5:6:3,0,-1,103152,96848
4:1:6,0,-1,103153,96847
6:2:2,2,2,103151,96849
1:2:3,1,1,103150,96850
5:2:4,1,1,103149,96851
4:5:1,0,-1,103150,96850
6:4:2,1,1,103149,96851
1:6:4,0,-1,103150,96850
6:6:5,0,-1,103151,96849
6:4:3,0,-1,103152,96848
3:2:5,1,1,103151,96849
5:6:6,0,-1,103152,96848
2:3:4,1,1,103151,96849
1:3:1,0,-1,103152,96848
2:6:5,1,1,103151,96849
5:4:1,0,-1,103152,96848
1:4:1,0,-1,103153,96847
4:5:2,1,1,103152,96848
1:5:2,1,1,103151,96849
5:5:2,1,1,103150,96850
2:4:4,1,1,103149,96851
2:3:3,1,1,103148,96852
2:4:4,1,1,103147,96853
3:1:5,0,-1,103148,96852
2:3:2,2,2,103146,96854
1:3:5,0,-1,103147,96853
6:3:3,0,-1,103148,96852
5:3:2,1,1,103147,96853
2:5:5,1,1,103146,96854
6:4:2,1,1,103145,96855
1:4:1,0,-1,103146,96854
4:3:5,0,-1,103147,96853
6:4:4,0,-1,103148,96852
1:4:5,0,-1,103149,96851
6:1:6,0,-1,103150,96850
4:5:1,0,-1,103151,96849
2:3:1,1,1,103150,96850
2:2:1,2,2,103148,96852
5:2:5,1,1,103147,96853
5:5:3,0,-1,103148,96852
6:6:1,0,-1,103149,96851
4:3:1,0,-1,103150,96850
1:6:3,0,-1,103151,96849
1:5:3,0,-1,103152,96848
4:2:6,1,1,103151,96849
1:6:1,0,-1,103152,96848
6:4:3,0,-1,103153,96847
5:4:1,0,-1,103154,96846
1:5:5,0,-1,103155,96845
1:5:5,0,-1,103156,96844
1:5:1,0,-1,103157,96843
1:4:6,0,-1,103158,96842
4:2:3,1,1,103157,96843
1:5:5,0,-1,103158,96842
4:2:4,1,1,103157,96843
1:5:6,0,-1,103158,96842
2:2:1,2,2,103156,96844
2:3:2,2,2,103154,96846
6:5:6,0,-1,103155,96845
4:3:4,0,-1,103156,96844
4:4:4,0,-1,103157,96843
4:2:5,1,1,103156,96844
1:3:5,0,-1,103157,96843
2:6:3,1,1,103156,96844
3:2:1,1,1,103155,96845
5:3:6,0,-1,103156,96844
6:4:2,1,1,103155,96845
3:5:3,0,-1,103156,96844
4:2:3,1,1,103155,96845
4:2:1,1,1,103154,96846
5:3:3,0,-1,103155,96845
1:4:5,0,-1,103156,96844
6:2:2,2,2,103154,96846
1:1:3,0,-1,103155,96845
3:5:3,0,-1,103156,96844
3:1:5,0,-1,103157,96843
4:4:3,0,-1,103158,96842
6:4:4,0,-1,103159,96841
1:3:5,0,-1,103160,96840
2:5:6,1,1,103159,96841
4:3:6,0,-1,103160,96840
5:4:4,0,-1,103161,96839
4:4:1,0,-1,103162,96838
2:6:2,2,2,103160,96840
5:1:3,0,-1,103161,96839
1:6:4,0,-1,103162,96838
4:2:6,1,1,103161,96839
5:3:5,0,-1,103162,96838
6:3:5,0,-1,103163,96837
3:4:3,0,-1,103164,96836
6:6:1,0,-1,103165,96835
4:2:1,1,1,103164,96836
5:5:6,0,-1,103165,96835
6:3:3,0,-1,103166,96834
6:4:5,0,-1,103167,96833
4:3:3,0,-1,103168,96832
3:5:3,0,-1,103169,96831
5:2:2,2,2,103167,96833
1:5:3,0,-1,103168,96832
6:1:6,0,-1,103169,96831
2:2:2,3,3,103166,96834
4:3:5,0,-1,103167,96833
5:5:6,0,-1,103168,96832
3:4:6,0,-1,103169,96831
5:4:6,0,-1,103170,96830
5:3:1,0,-1,103171,96829
6:5:1,0,-1,103172,96828
6:2:1,1,1,103171,96829
4:6:1,0,-1,103172,96828
5:6:4,0,-1,103173,96827
4:4:3,0,-1,103174,96826
4:2:6,1,1,103173,96827
1:1:3,0,-1,103174,96826
5:4:2,1,1,103173,96827
2:6:5,1,1,103172,96828
6:2:3,1,1,103171,96829
2:4:5,1,1,103170,96830
4:5:5,0,-1,103171,96829
4:2:2,2,2,103169,96831
5:2:6,1,1,103168,96832
2:3:1,1,1,103167,96833
1:4:3,0,-1,103168,96832
4:5:2,1,1,103167,96833
3:4:3,0,-1,103168,96832
4:1:2,1,1,103167,96833
1:4:2,1,1,103166,96834
1:6:4,0,-1,103167,96833
2:4:3,1,1,103166,96834
1:2:4,1,1,103165,96835
5:5:1,0,-1,103166,96834
3:3:5,0,-1,103167,96833
6:1:2,1,1,103166,96834
4:1:3,0,-1,103167,96833
3:4:6,0,-1,103168,96832
4:3:4,0,-1,103169,96831
4:1:4,0,-1,103170,96830
1:2:5,1,1,103169,96831
1:4:2,1,1,103168,96832
2:4:6,1,1,103167,96833
5:1:4,0,-1,103168,96832
1:3:3,0,-1,103169,96831
2:6:2,2,2,103167,96833
6:6:4,0,-1,103168,96832
6:3:5,0,-1,103169,96831
4:6:1,0,-1,103170,96830
5:3:1,0,-1,103171,96829
4:2:4,1,1,103170,96830
3:3:3,0,-1,103171,96829
4:5:2,1,1,103170,96830
3:1:5,0,-1,103171,96829
1:5:3,0,-1,103172,96828
4:6:5,0,-1,103173,96827
5:5:6,0,-1,103174,96826
2:5:2,2,2,103172,96828
4:4:2,1,1,103171,96829
3:1:5,0,-1,103172,96828
4:4:5,0,-1,103173,96827
5:6:1,0,-1,103174,96826
2:3:5,1,1,103173,96827
6:6:1,0,-1,103174,96826
6:6:6,0,-1,103175,96825
2:6:3,1,1,103174,96826
5:6:3,0,-1,103175,96825
5:6:5,0,-1,103176,96824
2:6:4,1,1,103175,96825
6:6:3,0,-1,103176,96824
5:4:3,0,-1,103177,96823
2:1:3,1,1,103176,96824
5:2:3,1,1,103175,96825
2:4:1,1,1,103174,96826
5:2:2,2,2,103172,96828
2:4:1,1,1,103171,96829
3:1:6,0,-1,103172,96828
5:6:3,0,-1,103173,96827
2:6:4,1,1,103172,96828
1:2:3,1,1,103171,96829
6:6:4,0,-1,103172,96828
4:5:2,1,1,103171,96829
2:5:2,2,2,103169,96831
2:2:6,2,2,103167,96833
2:4:3,1,1,103166,96834
3:6:3,0,-1,103167,96833
3:1:5,0,-1,103168,96832
6:1:5,0,-1,103169,96831
6:1:5,0,-1,103170,96830
6:1:1,0,-1,103171,96829
3:4:5,0,-1,103172,96828
4:6:3,0,-1,103173,96827
6:1:1,0,-1,103174,96826
3:6:6,0,-1,103175,96825
2:5:2,2,2,103173,96827
2:2:3,2,2,103171,96829
4:5:5,0,-1,103172,96828
2:2:2,3,3,103169,96831
5:3:4,0,-1,103170,96830
5:5:6,0,-1,103171,96829
2:2:6,2,2,103169,96831
2:6:6,1,1,103168,96832
5:1:1,0,-1,103169,96831
6:6:4,0,-1,103170,96830
3:5:5,0,-1,103171,96829
1:4:2,1,1,103170,96830
3:6:2,1,1,103169,96831
3:1:3,0,-1,103170,96830
4:3:3,0,-1,103171,96829
4:2:5,1,1,103170,96830
2:1:5,1,1,103169,96831
4:5:4,0,-1,103170,96830
4:2:5,1,1,103169,96831
4:4:4,0,-1,103170,96830
1:4:5,0,-1,103171,96829
2:3:4,1,1,103170,96830
6:4:2,1,1,103169,96831
5:4:1,0,-1,103170,96830
5:2:5,1,1,103169,96831
5:3:1,0,-1,103170,96830
2:1:5,1,1,103169,96831
4:5:2,1,1,103168,96832
3:2:5,1,1,103167,96833
6:1:2,1,1,103166,96834
1:5:6,0,-1,103167,96833
5:2:3,1,1,103166,96834
1:6:3,0,-1,103167,96833
3:6:2,1,1,103166,96834
4:3:6,0,-1,103167,96833
2:2:6,2,2,103165,96835
6:4:3,0,-1,103166,96834
3:6:5,0,-1,103167,96833
6:4:3,0,-1,103168,96832
1:6:2,1,1,103167,96833
3:6:4,0,-1,103168,96832
3:3:4,0,-1,103169,96831
2:1:6,1,1,103168,96832
1:2:4,1,1,103167,96833
3:6:2,1,1,103166,96834
4:5:5,0,-1,103167,96833
1:5:1,0,-1,103168,96832
5:2:5,1,1,103167,96833
1:2:5,1,1,103166,96834
2:4:3,1,1,103165,96835
3:4:3,0,-1,103166,96834
2:2:5,2,2,103164,96836
2:1:2,2,2,103162,96838
6:2:3,1,1,103161,96839
4:4:3,0,-1,103162,96838
3:3:3,0,-1,103163,96837
5:2:1,1,1,103162,96838
2:3:5,1,1,103161,96839
4:3:3,0,-1,103162,96838
6:5:3,0,-1,103163,96837
3:6:6,0,-1,103164,96836
2:1:3,1,1,103163,96837
3:2:2,2,2,103161,96839
6:6:2,1,1,103160,96840
1:5:4,0,-1,103161,96839
3:2:5,1,1,103160,96840
6:4:3,0,-1,103161,96839
6:1:4,0,-1,103162,96838
6:3:3,0,-1,103163,96837
4:6:2,1,1,103162,96838
4:2:5,1,1,103161,96839
2:6:3,1,1,103160,96840
1:5:2,1,1,103159,96841
3:3:1,0,-1,103160,96840
1:6:1,0,-1,103161,96839
6:2:6,1,1,103160,96840
4:3:3,0,-1,103161,96839
5:4:5,0,-1,103162,96838
5:2:1,1,1,103161,96839
4:3:5,0,-1,103162,96838
5:4:4,0,-1,103163,96837
1:5:1,0,-1,103164,96836
2:5:2,2,2,103162,96838
2:1:5,1,1,103161,96839
2:6:5,1,1,103160,96840
3:5:4,0,-1,103161,96839
4:2:2,2,2,103159,96841
2:2:5,2,2,103157,96843
3:1:5,0,-1,103158,96842
2:4:4,1,1,103157,96843
4:2:4,1,1,103156,96844
3:4:4,0,-1,103157,96843
1:4:6,0,-1,103158,96842
1:4:6,0,-1,103159,96841
4:5:5,0,-1,103160,96840
1:3:5,0,-1,103161,96839
4:3:1,0,-1,103162,96838
4:6:1,0,-1,103163,96837
6:1:4,0,-1,103164,96836
2:3:5,1,1,103163,96837
6:3:3,0,-1,103164,96836
5:1:5,0,-1,103165,96835
4:3:1,0,-1,103166,96834
1:1:4,0,-1,103167,96833
1:2:3,1,1,103166,96834
2:1:4,1,1,103165,96835
1:6:6,0,-1,103166,96834
1:2:4,1,1,103165,96835
6:1:2,1,1,103164,96836
4:1:1,0,-1,103165,96835
3:2:6,1,1,103164,96836
2:2:6,2,2,103162,96838
6:6:4,0,-1,103163,96837
3:5:5,0,-1,103164,96836
3:5:5,0,-1,103165,96835
6:5:4,0,-1,103166,96834
6:3:1,0,-1,103167,96833
3:1:3,0,-1,103168,96832
1:3:2,1,1,103167,96833
6:1:4,0,-1,103168,96832
1:4:2,1,1,103167,96833
4:1:4,0,-1,103168,96832
6:3:1,0,-1,103169,96831
5:3:5,0,-1,103170,96830
3:4:5,0,-1,103171,96829
3:6:1,0,-1,103172,96828
1:5:3,0,-1,103173,96827
5:6:1,0,-1,103174,96826
5:2:6,1,1,103173,96827
6:3:1,0,-1,103174,96826
1:5:1,0,-1,103175,96825
4:5:3,0,-1,103176,96824
2:4:2,2,2,103174,96826
1:1:6,0,-1,103175,96825
5:4:5,0,-1,103176,96824
3:4:1,0,-1,103177,96823
4:5:5,0,-1,103178,96822
5:6:4,0,-1,103179,96821
1:3:5,0,-1,103180,96820
6:2:6,1,1,103179,96821
2:1:2,2,2,103177,96823
3:3:3,0,-1,103178,96822
5:2:5,1,1,103177,96823
6:5:2,1,1,103176,96824
1:4:3,0,-1,103177,96823
1:1:5,0,-1,103178,96822
3:1:2,1,1,103177,96823
1:4:1,0,-1,103178,96822
3:1:1,0,-1,103179,96821
5:3:1,0,-1,103180,96820
5:1:2,1,1,103179,96821
1:3:6,0,-1,103180,96820
6:1:1,0,-1,103181,96819
6:2:2,2,2,103179,96821
6:3:2,1,1,103178,96822
2:3:1,1,1,103177,96823
3:6:2,1,1,103176,96824
6:3:4,0,-1,103177,96823
5:4:2,1,1,103176,96824
4:3:3,0,-1,103177,96823
5:2:6,1,1,103176,96824
4:2:1,1,1,103175,96825
6:2:4,1,1,103174,96826
6:6:6,0,-1,103175,96825
3:3:1,0,-1,103176,96824
4:2:5,1,1,103175,96825
4:2:2,2,2,103173,96827
4:2:3,1,1,103172,96828
5:4:6,0,-1,103173,96827
3:5:3,0,-1,103174,96826
2:4:5,1,1,103173,96827
6:2:3,1,1,103172,96828
5:4:2,1,1,103171,96829
5:5:6,0,-1,103172,96828
4:2:6,1,1,103171,96829
5:2:5,1,1,103170,96830
2:2:6,2,2,103168,96832
4:2:6,1,1,103167,96833
2:4:1,1,1,103166,96834
5:1:2,1,1,103165,96835
5:3:1,0,-1,103166,96834
3:2:5,1,1,103165,96835
6:4:6,0,-1,103166,96834
2:4:2,2,2,103164,96836
6:1:6,0,-1,103165,96835
2:1:5,1,1,103164,96836
3:6:5,0,-1,103165,96835
6:6:5,0,-1,103166,96834
1:3:4,0,-1,103167,96833
2:2:5,2,2,103165,96835
2:4:4,1,1,103164,96836
6:4:6,0,-1,103165,96835
6:4:5,0,-1,103166,96834
4:3:6,0,-1,103167,96833
4:1:2,1,1,103166,96834
5:5:3,0,-1,103167,96833
4:3:2,1,1,103166,96834
6:4:4,0,-1,103167,96833
2:5:6,1,1,103166,96834
6:6:4,0,-1,103167,96833
2:5:4,1,1,103166,96834
2:3:4,1,1,103165,96835
3:5:5,0,-1,103166,96834
5:5:5,0,-1,103167,96833
4:4:5,0,-1,103168,96832
5:6:2,1,1,103167,96833
4:3:6,0,-1,103168,96832
5:3:6,0,-1,103169,96831
2:1:4,1,1,103168,96832
5:4:2,1,1,103167,96833
6:1:5,0,-1,103168,96832
3:4:1,0,-1,103169,96831
6:4:6,0,-1,103170,96830
3:2:6,1,1,103169,96831
3:6:6,0,-1,103170,96830
3:2:2,2,2,103168,96832
2:5:6,1,1,103167,96833
6:1:3,0,-1,103168,96832
5:6:1,0,-1,103169,96831
5:3:1,0,-1,103170,96830
2:4:4,1,1,103169,96831
6:5:4,0,-1,103170,96830
4:5:1,0,-1,103171,96829
4:2:2,2,2,103169,96831
3:6:3,0,-1,103170,96830
3:2:5,1,1,103169,96831
5:1:3,0,-1,103170,96830
3:2:6,1,1,103169,96831
1:2:2,2,2,103167,96833
4:4:1,0,-1,103168,96832
4:6:5,0,-1,103169,96831
3:4:3,0,-1,103170,96830
2:6:6,1,1,103169,96831
5:5:6,0,-1,103170,96830
2:4:3,1,1,103169,96831
6:2:1,1,1,103168,96832
3:4:5,0,-1,103169,96831
5:6:6,0,-1,103170,96830
2:2:1,2,2,103168,96832
6:3:4,0,-1,103169,96831
2:2:3,2,2,103167,96833
6:5:2,1,1,103166,96834
4:6:5,0,-1,103167,96833
2:3:1,1,1,103166,96834
5:2:2,2,2,103164,96836
5:3:5,0,-1,103165,96835
4:6:5,0,-1,103166,96834
5:1:2,1,1,103165,96835
3:4:2,1,1,103164,96836
3:2:5,1,1,103163,96837
4:6:4,0,-1,103164,96836
4:2:1,1,1,103163,96837
5:3:5,0,-1,103164,96836
5:2:3,1,1,103163,96837
3:2:3,1,1,103162,96838
6:5:2,1,1,103161,96839
6:1:4,0,-1,103162,96838
5:6:3,0,-1,103163,96837
6:2:3,1,1,103162,96838
6:3:2,1,1,103161,96839
3:4:1,0,-1,103162,96838
1:2:2,2,2,103160,96840
1:4:4,0,-1,103161,96839
2:5:5,1,1,103160,96840
5:5:5,0,-1,103161,96839
5:1:6,0,-1,103162,96838
1:2:6,1,1,103161,96839
6:2:4,1,1,103160,96840
5:5:4,0,-1,103161,96839
6:2:5,1,1,103160,96840
5:3:5,0,-1,103161,96839
6:2:1,1,1,103160,96840
1:4:1,0,-1,103161,96839
6:6:3,0,-1,103162,96838
2:4:6,1,1,103161,96839
3:6:4,0,-1,103162,96838
3:6:2,1,1,103161,96839
6:2:3,1,1,103160,96840
2:2:3,2,2,103158,96842
6:1:2,1,1,103157,96843
6:1:6,0,-1,103158,96842
4:1:5,0,-1,103159,96841
2:6:1,1,1,103158,96842
1:6:5,0,-1,103159,96841
4:5:5,0,-1,103160,96840
1:4:1,0,-1,103161,96839
3:4:2,1,1,103160,96840
5:5:3,0,-1,103161,96839
2:2:4,2,2,103159,96841
1:6:4,0,-1,103160,96840
5:3:6,0,-1,103161,96839
6:1:4,0,-1,103162,96838
6:2:5,1,1,103161,96839
1:1:1,0,-1,103162,96838
5:6:4,0,-1,103163,96837
4:2:3,1,1,103162,96838
3:5:4,0,-1,103163,96837
4:1:6,0,-1,103164,96836
3:1:6,0,-1,103165,96835
5:1:6,0,-1,103166,96834
1:3:4,0,-1,103167,96833
1:5:1,0,-1,103168,96832
6:4:4,0,-1,103169,96831
2:5:4,1,1,103168,96832
1:3:1,0,-1,103169,96831
2:1:1,1,1,103168,96832
2:6:2,2,2,103166,96834
2:4:2,2,2,103164,96836
6:3:1,0,-1,103165,96835
1:1:1,0,-1,103166,96834
1:2:1,1,1,103165,96835
1:3:6,0,-1,103166,96834
1:2:4,1,1,103165,96835
1:6:2,1,1,103164,96836
1:5:3,0,-1,103165,96835
6:4:6,0,-1,103166,96834
6:6:4,0,-1,103167,96833
4:5:2,1,1,103166,96834
3:6:5,0,-1,103167,96833
1:2:3,1,1,103166,96834
6:1:6,0,-1,103167,96833
2:6:3,1,1,103166,96834
4:4:5,0,-1,103167,96833
6:4:6,0,-1,103168,96832
5:4:6,0,-1,103169,96831
5:2:4,1,1,103168,96832
2:3:6,1,1,103167,96833
6:3:6,0,-1,103168,96832
4:4:2,1,1,103167,96833
2:2:2,3,3,103164,96836
4:2:3,1,1,103163,96837
5:3:2,1,1,103162,96838
4:4:6,0,-1,103163,96837
5:6:5,0,-1,103164,96836
5:4:4,0,-1,103165,96835
2:5:1,1,1,103164,96836
1:4:4,0,-1,103165,96835
3:4:3,0,-1,103166,96834
6:1:2,1,1,103165,96835
3:6:6,0,-1,103166,96834
6:3:6,0,-1,103167,96833
5:3:5,0,-1,103168,96832
4:6:2,1,1,103167,96833
6:1:5,0,-1,103168,96832
3:4:1,0,-1,103169,96831
6:3:2,1,1,103168,96832
4:1:6,0,-1,103169,96831
6:2:3,1,1,103168,96832
1:4:4,0,-1,103169,96831
1:2:4,1,1,103168,96832
1:4:2,1,1,103167,96833
5:4:6,0,-1,103168,96832
5:2:3,1,1,103167,96833
1:6:2,1,1,103166,96834
2:6:4,1,1,103165,96835
3:5:6,0,-1,103166,96834
5:5:3,0,-1,103167,96833
5:3:5,0,-1,103168,96832
4:5:6,0,-1,103169,96831
6:6:2,1,1,103168,96832
6:4:2,1,1,103167,96833
1:3:4,0,-1,103168,96832
1:3:3,0,-1,103169,96831
3:6:4,0,-1,103170,96830
3:2:6,1,1,103169,96831
3:5:6,0,-1,103170,96830
5:1:5,0,-1,103171,96829
1:3:5,0,-1,103172,96828
3:3:5,0,-1,103173,96827
6:3:1,0,-1,103174,96826
1:2:5,1,1,103173,96827
5:5:3,0,-1,103174,96826
5:6:1,0,-1,103175,96825
1:2:2,2,2,103173,96827
5:6:2,1,1,103172,96828
3:3:6,0,-1,103173,96827
5:6:6,0,-1,103174,96826
2:6:4,1,1,103173,96827
6:3:6,0,-1,103174,96826
4:4:1,0,-1,103175,96825
1:4:3,0,-1,103176,96824
2:1:5,1,1,103175,96825
3:6:3,0,-1,103176,96824
1:6:2,1,1,103175,96825
2:5:4,1,1,103174,96826
4:5:5,0,-1,103175,96825
1:5:2,1,1,103174,96826
2:1:6,1,1,103173,96827
4:5:3,0,-1,103174,96826
2:4:5,1,1,103173,96827
2:6:4,1,1,103172,96828
6:5:2,1,1,103171,96829
3:5:2,1,1,103170,96830
3:4:6,0,-1,103171,96829
6:4:3,0,-1,103172,96828
5:6:3,0,-1,103173,96827
6:4:1,0,-1,103174,96826
3:6:2,1,1,103173,96827
2:6:2,2,2,103171,96829
3:1:2,1,1,103170,96830
4:5:3,0,-1,103171,96829
5:5:6,0,-1,103172,96828
5:6:6,0,-1,103173,96827
5:6:4,0,-1,103174,96826
6:4:6,0,-1,103175,96825
3:5:5,0,-1,103176,96824
5:5:4,0,-1,103177,96823
4:5:4,0,-1,103178,96822
3:3:3,0,-1,103179,96821
2:1:5,1,1,103178,96822
3:2:5,1,1,103177,96823
6:3:2,1,1,103176,96824
3:3:6,0,-1,103177,96823
5:6:5,0,-1,103178,96822
5:3:6,0,-1,103179,96821
5:3:3,0,-1,103180,96820
6:2:6,1,1,103179,96821
4:5:6,0,-1,103180,96820
3:1:1,0,-1,103181,96819
1:5:6,0,-1,103182,96818
6:2:6,1,1,103181,96819
3:1:4,0,-1,103182,96818
5:2:6,1,1,103181,96819
1:6:5,0,-1,103182,96818
1:1:3,0,-1,103183,96817
2:1:3,1,1,103182,96818
4:2:5,1,1,103181,96819
3:2:2,2,2,103179,96821
1:6:2,1,1,103178,96822
4:2:3,1,1,103177,96823
1:6:6,0,-1,103178,96822
5:1:4,0,-1,103179,96821
1:4:2,1,1,103178,96822
5:6:4,0,-1,103179,96821
1:1:2,1,1,103178,96822
4:3:5,0,-1,103179,96821
2:5:6,1,1,103178,96822
6:6:6,0,-1,103179,96821
1:3:4,0,-1,103180,96820
4:6:5,0,-1,103181,96819
2:1:1,1,1,103180,96820
5:2:5,1,1,103179,96821
6:1:1,0,-1,103180,96820
2:4:4,1,1,103179,96821
3:6:2,1,1,103178,96822
2:1:2,2,2,103176,96824
5:6:2,1,1,103175,96825
5:6:4,0,-1,103176,96824
1:2:3,1,1,103175,96825
1:2:3,1,1,103174,96826
4:5:1,0,-1,103175,96825
5:3:2,1,1,103174,96826
3:1:3,0,-1,103175,96825
3:5:5,0,-1,103176,96824
6:5:5,0,-1,103177,96823
1:2:2,2,2,103175,96825
1:2:2,2,2,103173,96827
1:1:4,0,-1,103174,96826
4:6:1,0,-1,103175,96825
3:4:4,0,-1,103176,96824
1:5:3,0,-1,103177,96823
5:5:1,0,-1,103178,96822
1:6:2,1,1,103177,96823
2:6:4,1,1,103176,96824
6:1:6,0,-1,103177,96823
4:3:1,0,-1,103178,96822
2:4:5,1,1,103177,96823
6:1:6,0,-1,103178,96822
6:4:4,0,-1,103179,96821
3:4:4,0,-1,103180,96820
5:3:3,0,-1,103181,96819
5:3:6,0,-1,103182,96818
5:6:1,0,-1,103183,96817
2:3:3,1,1,103182,96818
3:3:6,0,-1,103183,96817
5:3:4,0,-1,103184,96816
2:5:2,2,2,103182,96818
3:1:6,0,-1,103183,96817
6:2:1,1,1,103182,96818
2:1:2,2,2,103180,96820
2:3:5,1,1,103179,96821
1:2:4,1,1,103178,96822
4:2:2,2,2,103176,96824
6:5:2,1,1,103175,96825
6:3:1,0,-1,103176,96824
2:6:3,1,1,103175,96825
5:4:3,0,-1,103176,96824
1:4:5,0,-1,103177,96823
5:6:4,0,-1,103178,96822
4:4:3,0,-1,103179,96821
4:5:6,0,-1,103180,96820
1:3:2,1,1,103179,96821
5:6:6,0,-1,103180,96820
1:3:4,0,-1,103181,96819
6:2:4,1,1,103180,96820
4:4:6,0,-1,103181,96819
6:5:5,0,-1,103182,96818
2:3:1,1,1,103181,96819
2:1:4,1,1,103180,96820
4:4:5,0,-1,103181,96819
5:6:6,0,-1,103182,96818
1:6:6,0,-1,103183,96817
5:4:2,1,1,103182,96818
4:2:1,1,1,103181,96819
5:5:2,1,1,103180,96820
6:1:3,0,-1,103181,96819
5:2:1,1,1,103180,96820
5:5:3,0,-1,103181,96819
3:2:5,1,1,103180,96820
4:2:3,1,1,103179,96821
3:2:6,1,1,103178,96822
5:1:6,0,-1,103179,96821
3:3:5,0,-1,103180,96820
4:1:6,0,-1,103181,96819
2:3:3,1,1,103180,96820
1:1:3,0,-1,103181,96819
1:3:2,1,1,103180,96820
5:2:3,1,1,103179,96821
4:1:4,0,-1,103180,96820
2:3:5,1,1,103179,96821
4:3:6,0,-1,103180,96820
2:4:2,2,2,103178,96822
2:5:6,1,1,103177,96823
2:6:4,1,1,103176,96824
4:6:5,0,-1,103177,96823
1:1:6,0,-1,103178,96822
4:6:4,0,-1,103179,96821
6:6:5,0,-1,103180,96820
5:6:6,0,-1,103181,96819
5:3:4,0,-1,103182,96818
1:3:2,1,1,103181,96819
6:1:6,0,-1,103182,96818
6:2:3,1,1,103181,96819
1:3:6,0,-1,103182,96818
6:5:5,0,-1,103183,96817
6:1:4,0,-1,103184,96816
1:6:4,0,-1,103185,96815
5:2:4,1,1,103184,96816
1:5:3,0,-1,103185,96815
3:6:6,0,-1,103186,96814
6:6:4,0,-1,103187,96813
1:5:2,1,1,103186,96814
5:5:5,0,-1,103187,96813
3:2:4,1,1,103186,96814
5:6:1,0,-1,103187,96813
5:4:6,0,-1,103188,96812
3:4:6,0,-1,103189,96811
5:3:4,0,-1,103190,96810
1:1:6,0,-1,103191,96809
3:2:5,1,1,103190,96810
5:5:4,0,-1,103191,96809
2:4:2,2,2,103189,96811
2:5:6,1,1,103188,96812
5:4:4,0,-1,103189,96811
3:5:1,0,-1,103190,96810
6:1:4,0,-1,103191,96809
1:1:1,0,-1,103192,96808
5:3:2,1,1,103191,96809
3:1:4,0,-1,103192,96808
1:4:3,0,-1,103193,96807
4:3:4,0,-1,103194,96806
2:5:4,1,1,103193,96807
4:1:4,0,-1,103194,96806
2:2:1,2,2,103192,96808
2:1:5,1,1,103191,96809
5:4:1,0,-1,103192,96808
4:5:1,0,-1,103193,96807
4:2:4,1,1,103192,96808
2:6:6,1,1,103191,96809
4:4:5,0,-1,103192,96808
1:2:6,1,1,103191,96809
3:2:6,1,1,103190,96810
2:4:6,1,1,103189,96811
4:5:4,0,-1,103190,96810
5:5:5,0,-1,103191,96809
1:3:3,0,-1,103192,96808
5:5:2,1,1,103191,96809
1:2:3,1,1,103190,96810
5:3:2,1,1,103189,96811
5:4:4,0,-1,103190,96810
1:3:3,0,-1,103191,96809
2:5:5,1,1,103190,96810
6:5:6,0,-1,103191,96809
1:1:3,0,-1,103192,96808
5:2:3,1,1,103191,96809
3:4:5,0,-1,103192,96808
5:1:1,0,-1,103193,96807
1:3:1,0,-1,103194,96806
1:3:1,0,-1,103195,96805
1:1:4,0,-1,103196,96804
2:2:1,2,2,103194,96806
1:5:6,0,-1,103195,96805
6:6:6,0,-1,103196,96804
5:5:1,0,-1,103197,96803
1:1:5,0,-1,103198,96802
4:6:4,0,-1,103199,96801
6:2:4,1,1,103198,96802
6:3:3,0,-1,103199,96801
2:3:2,2,2,103197,96803
6:1:6,0,-1,103198,96802
4:2:2,2,2,103196,96804
2:1:2,2,2,103194,96806
5:6:2,1,1,103193,96807
4:6:1,0,-1,103194,96806
5:3:5,0,-1,103195,96805
4:3:2,1,1,103194,96806
4:5:5,0,-1,103195,96805
4:2:3,1,1,103194,96806
6:6:2,1,1,103193,96807
6:5:3,0,-1,103194,96806
6:6:1,0,-1,103195,96805
3:4:6,0,-1,103196,96804
4:6:4,0,-1,103197,96803
2:6:6,1,1,103196,96804
6:1:3,0,-1,103197,96803
4:5:5,0,-1,103198,96802
1:2:4,1,1,103197,96803
5:5:5,0,-1,103198,96802
1:5:2,1,1,103197,96803
5:3:3,0,-1,103198,96802
3:1:5,0,-1,103199,96801
1:3:4,0,-1,103200,96800
1:3:6,0,-1,103201,96799
4:4:4,0,-1,103202,96798
6:1:3,0,-1,103203,96797
6:1:3,0,-1,103204,96796
2:2:6,2,2,103202,96798
6:4:3,0,-1,103203,96797
3:5:1,0,-1,103204,96796
3:5:3,0,-1,103205,96795
4:3:4,0,-1,103206,96794
6:4:1,0,-1,103207,96793
4:1:2,1,1,103206,96794
6:1:1,0,-1,103207,96793
2:3:5,1,1,103206,96794
2:5:3,1,1,103205,96795
2:4:4,1,1,103204,96796
3:4:6,0,-1,103205,96795
6:4:3,0,-1,103206,96794
3:3:2,1,1,103205,96795
3:3:5,0,-1,103206,96794
4:6:2,1,1,103205,96795
1:4:3,0,-1,103206,96794
3:3:5,0,-1,103207,96793
6:6:1,0,-1,103208,96792
3:6:4,0,-1,103209,96791
6:4:6,0,-1,103210,96790
1:1:6,0,-1,103211,96789
4:1:4,0,-1,103212,96788
6:4:2,1,1,103211,96789
3:5:6,0,-1,103212,96788
1:2:6,1,1,103211,96789
5:3:1,0,-1,103212,96788
1:2:5,1,1,103211,96789
4:6:1,0,-1,103212,96788
2:2:5,2,2,103210,96790
4:2:2,2,2,103208,96792
2:5:3,1,1,103207,96793
3:3:6,0,-1,103208,96792
2:2:3,2,2,103206,96794
5:5:4,0,-1,103207,96793
6:3:6,0,-1,103208,96792
1:1:2,1,1,103207,96793
4:1:4,0,-1,103208,96792
6:6:3,0,-1,103209,96791
1:1:6,0,-1,103210,96790
2:2:5,2,2,103208,96792
4:4:5,0,-1,103209,96791
4:6:3,0,-1,103210,96790
2:2:5,2,2,103208,96792
6:2:6,1,1,103207,96793
1:3:4,0,-1,103208,96792
6:2:1,1,1,103207,96793
5:2:1,1,1,103206,96794
6:3:2,1,1,103205,96795
1:6:5,0,-1,103206,96794
3:1:2,1,1,103205,96795
5:3:6,0,-1,103206,96794
3:6:4,0,-1,103207,96793
2:6:6,1,1,103206,96794
2:6:4,1,1,103205,96795
6:2:1,1,1,103204,96796
5:4:6,0,-1,103205,96795
1:6:1,0,-1,103206,96794
4:2:6,1,1,103205,96795
3:6:4,0,-1,103206,96794
6:2:4,1,1,103205,96795
3:4:2,1,1,103204,96796
2:5:5,1,1,103203,96797
4:3:3,0,-1,103204,96796
4:1:6,0,-1,103205,96795
5:1:6,0,-1,103206,96794
3:4:3,0,-1,103207,96793
5:4:6,0,-1,103208,96792
5:6:3,0,-1,103209,96791
2:6:6,1,1,103208,96792
6:5:3,0,-1,103209,96791
6:5:6,0,-1,103210,96790
1:4:3,0,-1,103211,96789
2:5:2,2,2,103209,96791
4:1:5,0,-1,103210,96790
3:5:6,0,-1,103211,96789
2:5:2,2,2,103209,96791
5:5:6,0,-1,103210,96790
6:6:6,0,-1,103211,96789
5:2:1,1,1,103210,96790
3:1:1,0,-1,103211,96789
4:6:6,0,-1,103212,96788
1:4:3,0,-1,103213,96787
2:3:5,1,1,103212,96788
3:3:4,0,-1,103213,96787
2:6:1,1,1,103212,96788
1:4:5,0,-1,103213,96787
5:3:6,0,-1,103214,96786
5:5:6,0,-1,103215,96785
6:5:4,0,-1,103216,96784
4:2:3,1,1,103215,96785
4:1:5,0,-1,103216,96784
5:5:1,0,-1,103217,96783
4:3:5,0,-1,103218,96782
5:4:4,0,-1,103219,96781
2:3:3,1,1,103218,96782
4:5:5,0,-1,103219,96781
6:1:6,0,-1,103220,96780
1:6:3,0,-1,103221,96779
4:3:5,0,-1,103222,96778
2:4:6,1,1,103221,96779
2:1:4,1,1,103220,96780
5:6:4,0,-1,103221,96779
4:4:4,0,-1,103222,96778
6:1:6,0,-1,103223,96777
1:6:4,0,-1,103224,96776
5:2:4,1,1,103223,96777
1:3:6,0,-1,103224,96776
1:3:2,1,1,103223,96777
1:4:6,0,-1,103224,96776
3:3:6,0,-1,103225,96775
5:3:1,0,-1,103226,96774
4:2:5,1,1,103225,96775
5:6:5,0,-1,103226,96774
3:4:1,0,-1,103227,96773
4:6:1,0,-1,103228,96772
4:2:3,1,1,103227,96773
6:3:5,0,-1,103228,96772
1:5:1,0,-1,103229,96771
3:1:3,0,-1,103230,96770
5:2:1,1,1,103229,96771
1:5:1,0,-1,103230,96770
2:5:4,1,1,103229,96771
5:2:1,1,1,103228,96772
1:1:4,0,-1,103229,96771
4:6:6,0,-1,103230,96770
4:6:6,0,-1,103231,96769
6:5:2,1,1,103230,96770
5:5:1,0,-1,103231,96769
1:3:6,0,-1,103232,96768
2:6:6,1,1,103231,96769
4:3:4,0,-1,103232,96768
2:5:2,2,2,103230,96770
5:5:5,0,-1,103231,96769
5:2:3,1,1,103230,96770
5:2:5,1,1,103229,96771
6:4:5,0,-1,103230,96770
3:4:5,0,-1,103231,96769
5:5:4,0,-1,103232,96768
4:4:5,0,-1,103233,96767
5:6:6,0,-1,103234,96766
1:3:2,1,1,103233,96767
4:3:1,0,-1,103234,96766
5:5:1,0,-1,103235,96765
4:2:1,1,1,103234,96766
2:4:2,2,2,103232,96768
2:1:4,1,1,103231,96769
3:4:1,0,-1,103232,96768
5:2:5,1,1,103231,96769
6:6:6,0,-1,103232,96768
3:2:2,2,2,103230,96770
4:1:3,0,-1,103231,96769
4:5:1,0,-1,103232,96768
3:1:3,0,-1,103233,96767
6:3:2,1,1,103232,96768
6:2:2,2,2,103230,96770
6:3:2,1,1,103229,96771
4:4:4,0,-1,103230,96770
2:5:3,1,1,103229,96771
6:1:5,0,-1,103230,96770
3:2:1,1,1,103229,96771
1:4:3,0,-1,103230,96770
2:4:2,2,2,103228,96772
1:6:2,1,1,103227,96773
2:5:1,1,1,103226,96774
2:2:3,2,2,103224,96776
6:5:5,0,-1,103225,96775
2:1:6,1,1,103224,96776
4:4:4,0,-1,103225,96775
1:6:2,1,1,103224,96776
4:4:6,0,-1,103225,96775
5:2:5,1,1,103224,96776
1:3:2,1,1,103223,96777
6:4:1,0,-1,103224,96776
1:6:1,0,-1,103225,96775
4:4:5,0,-1,103226,96774
2:1:4,1,1,103225,96775
3:6:6,0,-1,103226,96774
1:3:2,1,1,103225,96775
3:5:6,0,-1,103226,96774
2:1:3,1,1,103225,96775
4:4:1,0,-1,103226,96774
4:2:3,1,1,103225,96775
3:4:4,0,-1,103226,96774
3:5:1,0,-1,103227,96773
4:2:5,1,1,103226,96774
6:6:3,0,-1,103227,96773
2:1:4,1,1,103226,96774
3:2:5,1,1,103225,96775
4:4:2,1,1,103224,96776
6:1:4,0,-1,103225,96775
2:4:2,2,2,103223,96777
1:6:1,0,-1,103224,96776
6:5:4,0,-1,103225,96775
5:3:2,1,1,103224,96776
5:5:5,0,-1,103225,96775
1:5:3,0,-1,103226,96774
3:5:5,0,-1,103227,96773
4:3:5,0,-1,103228,96772
3:4:3,0,-1,103229,96771
3:3:6,0,-1,103230,96770
5:1:3,0,-1,103231,96769
4:6:1,0,-1,103232,96768
4:6:4,0,-1,103233,96767
4:5:1,0,-1,103234,96766
1:3:5,0,-1,103235,96765
2:4:3,1,1,103234,96766
5:3:1,0,-1,103235,96765
2:2:3,2,2,103233,96767
2:1:4,1,1,103232,96768
4:6:6,0,-1,103233,96767
6:6:3,0,-1,103234,96766
4:4:1,0,-1,103235,96765
1:6:5,0,-1,103236,96764
2:1:2,2,2,103234,96766
2:3:3,1,1,103233,96767
6:3:5,0,-1,103234,96766
6:2:4,1,1,103233,96767
1:1:2,1,1,103232,96768
6:1:6,0,-1,103233,96767
4:3:4,0,-1,103234,96766
4:6:4,0,-1,103235,96765
3:3:1,0,-1,103236,96764
4:2:4,1,1,103235,96765
6:5:1,0,-1,103236,96764
1:2:3,1,1,103235,96765
1:6:4,0,-1,103236,96764
6:2:4,1,1,103235,96765
4:3:1,0,-1,103236,96764
4:4:5,0,-1,103237,96763
4:4:6,0,-1,103238,96762
5:3:1,0,-1,103239,96761
1:4:4,0,-1,103240,96760
3:3:4,0,-1,103241,96759
4:5:5,0,-1,103242,96758
4:5:6,0,-1,103243,96757
1:5:4,0,-1,103244,96756
1:3:3,0,-1,103245,96755
2:2:3,2,2,103243,96757
4:3:4,0,-1,103244,96756
5:4:2,1,1,103243,96757
5:4:1,0,-1,103244,96756
2:6:4,1,1,103243,96757
5:1:1,0,-1,103244,96756
5:5:4,0,-1,103245,96755
4:3:2,1,1,103244,96756
3:2:5,1,1,103243,96757
3:6:6,0,-1,103244,96756
2:3:2,2,2,103242,96758
3:4:4,0,-1,103243,96757
4:4:1,0,-1,103244,96756
2:1:4,1,1,103243,96757
6:4:1,0,-1,103244,96756
5:1:2,1,1,103243,96757
2:3:2,2,2,103241,96759
5:2:6,1,1,103240,96760
6:3:6,0,-1,103241,96759
3:1:2,1,1,103240,96760
6:6:2,1,1,103239,96761
2:5:2,2,2,103237,96763
2:2:2,3,3,103234,96766
2:3:3,1,1,103233,96767
4:6:4,0,-1,103234,96766
5:6:6,0,-1,103235,96765
4:4:3,0,-1,103236,96764
1:5:6,0,-1,103237,96763
2:5:2,2,2,103235,96765
3:4:1,0,-1,103236,96764
5:1:2,1,1,103235,96765
5:1:2,1,1,103234,96766
4:4:2,1,1,103233,96767
1:1:2,1,1,103232,96768
6:5:3,0,-1,103233,96767
4:5:6,0,-1,103234,96766
3:5:5,0,-1,103235,96765
1:6:3,0,-1,103236,96764
1:6:6,0,-1,103237,96763
4:5:2,1,1,103236,96764
3:3:6,0,-1,103237,96763
3:5:4,0,-1,103238,96762
2:1:4,1,1,103237,96763
5:1:5,0,-1,103238,96762
2:3:1,1,1,103237,96763
5:4:4,0,-1,103238,96762
2:1:2,2,2,103236,96764
1:3:3,0,-1,103237,96763
1:5:6,0,-1,103238,96762
2:5:6,1,1,103237,96763
2:3:5,1,1,103236,96764
2:3:4,1,1,103235,96765
1:4:2,1,1,103234,96766
5:2:6,1,1,103233,96767
1:2:6,1,1,103232,96768
4:3:3,0,-1,103233,96767
3:4:1,0,-1,103234,96766
6:3:6,0,-1,103235,96765
3:1:4,0,-1,103236,96764
1:1:3,0,-1,103237,96763
1:6:5,0,-1,103238,96762
4:2:5,1,1,103237,96763
5:1:4,0,-1,103238,96762
1:3:1,0,-1,103239,96761
2:1:2,2,2,103237,96763
1:6:6,0,-1,103238,96762
5:4:2,1,1,103237,96763
6:5:1,0,-1,103238,96762
5:4:1,0,-1,103239,96761
4:5:1,0,-1,103240,96760
1:1:5,0,-1,103241,96759
4:5:3,0,-1,103242,96758
1:6:3,0,-1,103243,96757
2:4:1,1,1,103242,96758
5:1:6,0,-1,103243,96757
4:4:3,0,-1,103244,96756
4:4:4,0,-1,103245,96755
4:3:1,0,-1,103246,96754
5:3:4,0,-1,103247,96753
3:5:4,0,-1,103248,96752
3:3:6,0,-1,103249,96751
3:4:3,0,-1,103250,96750
3:3:4,0,-1,103251,96749
1:6:4,0,-1,103252,96748
3:4:1,0,-1,103253,96747
5:5:3,0,-1,103254,96746
6:4:4,0,-1,103255,96745
6:4:1,0,-1,103256,96744
3:4:1,0,-1,103257,96743
2:1:6,1,1,103256,96744
4:1:4,0,-1,103257,96743
3:6:5,0,-1,103258,96742
4:1:6,0,-1,103259,96741
2:1:6,1,1,103258,96742
3:2:1,1,1,103257,96743
4:2:4,1,1,103256,96744
1:2:2,2,2,103254,96746
4:1:5,0,-1,103255,96745
1:4:3,0,-1,103256,96744
2:1:2,2,2,103254,96746
5:5:1,0,-1,103255,96745
4:1:2,1,1,103254,96746
1:1:4,0,-1,103255,96745
3:5:2,1,1,103254,96746
1:6:5,0,-1,103255,96745
2:2:3,2,2,103253,96747
6:5:1,0,-1,103254,96746
2:5:5,1,1,103253,96747
5:6:5,0,-1,103254,96746
6:2:5,1,1,103253,96747
6:6:3,0,-1,103254,96746
3:1:5,0,-1,103255,96745
2:4:5,1,1,103254,96746
6:2:6,1,1,103253,96747
3:6:4,0,-1,103254,96746
6:1:3,0,-1,103255,96745
5:6:1,0,-1,103256,96744
6:4:5,0,-1,103257,96743
3:2:1,1,1,103256,96744
6:4:5,0,-1,103257,96743
6:5:6,0,-1,103258,96742
1:6:1,0,-1,103259,96741
1:4:1,0,-1,103260,96740
6:6:4,0,-1,103261,96739
3:4:1,0,-1,103262,96738
1:2:6,1,1,103261,96739
4:3:5,0,-1,103262,96738
4:6:1,0,-1,103263,96737
6:3:4,0,-1,103264,96736
5:1:3,0,-1,103265,96735
6:1:3,0,-1,103266,96734
5:1:6,0,-1,103267,96733
3:2:3,1,1,103266,96734
4:5:3,0,-1,103267,96733
2:2:3,2,2,103265,96735
4:2:6,1,1,103264,96736
2:2:1,2,2,103262,96738
1:1:2,1,1,103261,96739
5:2:4,1,1,103260,96740
6:2:6,1,1,103259,96741
3:2:4,1,1,103258,96742
3:3:1,0,-1,103259,96741
6:1:3,0,-1,103260,96740
5:6:5,0,-1,103261,96739
5:5:3,0,-1,103262,96738
5:2:5,1,1,103261,96739
2:3:1,1,1,103260,96740
3:6:2,1,1,103259,96741
3:5:5,0,-1,103260,96740
1:6:2,1,1,103259,96741
4:3:1,0,-1,103260,96740
2:1:5,1,1,103259,96741
5:1:2,1,1,103258,96742
2:3:4,1,1,103257,96743
6:1:3,0,-1,103258,96742
2:6:5,1,1,103257,96743
5:6:6,0,-1,103258,96742
1:2:1,1,1,103257,96743
1:2:3,1,1,103256,96744
4:3:3,0,-1,103257,96743
6:3:2,1,1,103256,96744
5:3:6,0,-1,103257,96743
2:1:6,1,1,103256,96744
1:4:2,1,1,103255,96745
5:3:2,1,1,103254,96746
4:1:1,0,-1,103255,96745
2:2:5,2,2,103253,96747
6:6:4,0,-1,103254,96746
6:1:1,0,-1,103255,96745
1:1:5,0,-1,103256,96744
3:6:4,0,-1,103257,96743
2:2:1,2,2,103255,96745
5:2:3,1,1,103254,96746
4:1:2,1,1,103253,96747
1:6:4,0,-1,103254,96746
2:5:2,2,2,103252,96748
5:2:2,2,2,103250,96750
2:1:6,1,1,103249,96751
2:1:5,1,1,103248,96752
6:5:6,0,-1,103249,96751
1:5:2,1,1,103248,96752
5:5:1,0,-1,103249,96751
1:3:1,0,-1,103250,96750
2:3:2,2,2,103248,96752
2:4:2,2,2,103246,96754
6:5:3,0,-1,103247,96753
1:5:4,0,-1,103248,96752
1:3:6,0,-1,103249,96751
5:1:3,0,-1,103250,96750
6:5:4,0,-1,103251,96749
5:1:4,0,-1,103252,96748
6:6:3,0,-1,103253,96747
6:3:5,0,-1,103254,96746
1:5:5,0,-1,103255,96745
3:4:1,0,-1,103256,96744
3:3:2,1,1,103255,96745
2:5:6,1,1,103254,96746
3:1:6,0,-1,103255,96745
2:1:4,1,1,103254,96746
4:2:6,1,1,103253,96747
6:2:6,1,1,103252,96748
2:5:2,2,2,103250,96750
5:5:6,0,-1,103251,96749
3:4:1,0,-1,103252,96748
3:3:2,1,1,103251,96749
5:4:5,0,-1,103252,96748
3:4:4,0,-1,103253,96747
1:3:4,0,-1,103254,96746
5:6:2,1,1,103253,96747
3:3:4,0,-1,103254,96746
2:3:6,1,1,103253,96747
1:6:6,0,-1,103254,96746
2:2:2,3,3,103251,96749
3:1:5,0,-1,103252,96748
5:5:1,0,-1,103253,96747
6:6:6,0,-1,103254,96746
4:3:5,0,-1,103255,96745
4:6:1,0,-1,103256,96744
5:1:2,1,1,103255,96745
3:2:4,1,1,103254,96746
6:1:5,0,-1,103255,96745
3:2:4,1,1,103254,96746
4:3:1,0,-1,103255,96745
2:4:2,2,2,103253,96747
5:5:3,0,-1,103254,96746
1:2:2,2,2,103252,96748
5:4:5,0,-1,103253,96747
6:6:5,0,-1,103254,96746
6:3:5,0,-1,103255,96745
5:3:2,1,1,103254,96746
6:5:1,0,-1,103255,96745
3:3:3,0,-1,103256,96744
1:5:4,0,-1,103257,96743
6:5:4,0,-1,103258,96742
3:4:4,0,-1,103259,96741
3:4:1,0,-1,103260,96740
1:4:4,0,-1,103261,96739
5:4:6,0,-1,103262,96738
6:1:5,0,-1,103263,96737
4:6:2,1,1,103262,96738
5:1:1,0,-1,103263,96737
6:3:2,1,1,103262,96738
6:2:3,1,1,103261,96739
2:3:6,1,1,103260,96740
5:2:4,1,1,103259,96741
6:2:3,1,1,103258,96742
5:3:5,0,-1,103259,96741
6:6:6,0,-1,103260,96740
3:4:3,0,-1,103261,96739
4:3:1,0,-1,103262,96738
1:6:1,0,-1,103263,96737
6:5:5,0,-1,103264,96736
2:2:5,2,2,103262,96738
4:2:4,1,1,103261,96739
3:6:5,0,-1,103262,96738
4:3:5,0,-1,103263,96737
5:4:4,0,-1,103264,96736
2:3:4,1,1,103263,96737
3:3:4,0,-1,103264,96736
3:1:2,1,1,103263,96737
1:2:2,2,2,103261,96739
4:4:1,0,-1,103262,96738
2:6:2,2,2,103260,96740
1:4:4,0,-1,103261,96739
1:5:2,1,1,103260,96740
3:4:1,0,-1,103261,96739
2:3:3,1,1,103260,96740
1:2:1,1,1,103259,96741
4:5:6,0,-1,103260,96740
3:3:1,0,-1,103261,96739
2:3:6,1,1,103260,96740
2:6:6,1,1,103259,96741
6:4:6,0,-1,103260,96740
6:1:6,0,-1,103261,96739
6:6:5,0,-1,103262,96738
4:4:1,0,-1,103263,96737
5:3:3,0,-1,103264,96736
2:6:5,1,1,103263,96737
6:3:4,0,-1,103264,96736
2:3:4,1,1,103263,96737
3:4:4,0,-1,103264,96736
2:6:6,1,1,103263,96737
3:3:3,0,-1,103264,96736
4:4:4,0,-1,103265,96735
1:3:5,0,-1,103266,96734
6:4:5,0,-1,103267,96733
4:6:3,0,-1,103268,96732
6:4:2,1,1,103267,96733
1:6:5,0,-1,103268,96732
6:3:2,1,1,103267,96733
2:2:6,2,2,103265,96735
5:4:4,0,-1,103266,96734
3:5:5,0,-1,103267,96733
6:4:4,0,-1,103268,96732
5:6:2,1,1,103267,96733
3:1:6,0,-1,103268,96732
3:6:3,0,-1,103269,96731
2:1:3,1,1,103268,96732
5:4:3,0,-1,103269,96731
1:2:3,1,1,103268,96732
2:5:6,1,1,103267,96733
6:2:3,1,1,103266,96734
6:4:4,0,-1,103267,96733
3:5:3,0,-1,103268,96732
6:1:2,1,1,103267,96733
1:6:5,0,-1,103268,96732
2:1:1,1,1,103267,96733
1:2:3,1,1,103266,96734
2:1:4,1,1,103265,96735
5:6:1,0,-1,103266,96734
5:3:2,1,1,103265,96735
4:5:6,0,-1,103266,96734
4:2:2,2,2,103264,96736
6:4:6,0,-1,103265,96735
5:1:3,0,-1,103266,96734
3:2:3,1,1,103265,96735
6:1:4,0,-1,103266,96734
4:5:4,0,-1,103267,96733
1:6:1,0,-1,103268,96732
4:2:3,1,1,103267,96733
3:2:3,1,1,103266,96734
3:6:6,0,-1,103267,96733
1:1:1,0,-1,103268,96732
6:5:3,0,-1,103269,96731
2:3:2,2,2,103267,96733
6:5:3,0,-1,103268,96732
5:5:1,0,-1,103269,96731
5:5:5,0,-1,103270,96730
1:5:4,0,-1,103271,96729
3:2:2,2,2,103269,96731
4:2:1,1,1,103268,96732
5:6:4,0,-1,103269,96731
4:2:5,1,1,103268,96732
6:5:6,0,-1,103269,96731
6:5:1,0,-1,103270,96730
1:4:5,0,-1,103271,96729
4:1:1,0,-1,103272,96728
3:6:1,0,-1,103273,96727
6:6:5,0,-1,103274,96726
6:6:6,0,-1,103275,96725
3:1:6,0,-1,103276,96724
1:5:2,1,1,103275,96725
5:3:6,0,-1,103276,96724
4:5:4,0,-1,103277,96723
3:4:5,0,-1,103278,96722
6:5:4,0,-1,103279,96721
2:3:3,1,1,103278,96722
4:4:6,0,-1,103279,96721
4:3:1,0,-1,103280,96720
2:4:5,1,1,103279,96721
2:1:1,1,1,103278,96722
6:2:1,1,1,103277,96723
3:3:3,0,-1,103278,96722
2:1:3,1,1,103277,96723
3:6:4,0,-1,103278,96722
2:1:3,1,1,103277,96723
4:4:6,0,-1,103278,96722
2:2:4,2,2,103276,96724
4:4:1,0,-1,103277,96723
4:3:2,1,1,103276,96724
1:3:1,0,-1,103277,96723
6:2:1,1,1,103276,96724
6:2:4,1,1,103275,96725
5:6:4,0,-1,103276,96724
3:1:6,0,-1,103277,96723
5:4:5,0,-1,103278,96722
5:5:3,0,-1,103279,96721
5:5:3,0,-1,103280,96720
5:6:6,0,-1,103281,96719
3:6:2,1,1,103280,96720
3:4:4,0,-1,103281,96719
3:4:4,0,-1,103282,96718
6:5:5,0,-1,103283,96717
3:2:5,1,1,103282,96718
3:2:3,1,1,103281,96719
3:6:4,0,-1,103282,96718
3:6:5,0,-1,103283,96717
6:2:1,1,1,103282,96718
6:4:6,0,-1,103283,96717
4:4:1,0,-1,103284,96716
6:1:4,0,-1,103285,96715
3:4:4,0,-1,103286,96714
1:2:3,1,1,103285,96715
6:1:2,1,1,103284,96716
2:2:1,2,2,103282,96718
4:4:5,0,-1,103283,96717
1:2:3,1,1,103282,96718
2:6:4,1,1,103281,96719
4:6:2,1,1,103280,96720
6:1:3,0,-1,103281,96719
3:5:5,0,-1,103282,96718
4:6:4,0,-1,103283,96717
2:5:5,1,1,103282,96718
3:4:3,0,-1,103283,96717
1:3:3,0,-1,103284,96716
3:1:3,0,-1,103285,96715
5:2:3,1,1,103284,96716
5:3:6,0,-1,103285,96715
6:1:6,0,-1,103286,96714
6:1:2,1,1,103285,96715
3:5:5,0,-1,103286,96714
3:6:1,0,-1,103287,96713
4:4:1,0,-1,103288,96712
5:5:6,0,-1,103289,96711
3:1:1,0,-1,103290,96710
2:3:4,1,1,103289,96711
1:4:6,0,-1,103290,96710
1:6:1,0,-1,103291,96709
5:1:4,0,-1,103292,96708
1:2:1,1,1,103291,96709
4:1:3,0,-1,103292,96708
6:3:2,1,1,103291,96709
4:5:1,0,-1,103292,96708
5:4:3,0,-1,103293,96707
4:1:1,0,-1,103294,96706
3:4:5,0,-1,103295,96705
4:1:3,0,-1,103296,96704
4:1:4,0,-1,103297,96703
4:2:5,1,1,103296,96704
4:3:5,0,-1,103297,96703
4:6:2,1,1,103296,96704
5:5:5,0,-1,103297,96703
5:6:1,0,-1,103298,96702
5:5:4,0,-1,103299,96701
3:3:4,0,-1,103300,96700
4:6:6,0,-1,103301,96699
4:2:4,1,1,103300,96700
6:1:1,0,-1,103301,96699
5:3:1,0,-1,103302,96698
3:6:5,0,-1,103303,96697
4:5:6,0,-1,103304,96696
4:2:4,1,1,103303,96697
3:2:1,1,1,103302,96698
2:1:4,1,1,103301,96699
1:6:2,1,1,103300,96700
2:5:3,1,1,103299,96701
4:4:5,0,-1,103300,96700
5:4:5,0,-1,103301,96699
5:1:5,0,-1,103302,96698
6:1:1,0,-1,103303,96697
2:5:3,1,1,103302,96698
2:6:1,1,1,103301,96699
1:3:3,0,-1,103302,96698
4:2:6,1,1,103301,96699
2:3:3,1,1,103300,96700
3:4:3,0,-1,103301,96699
1:6:1,0,-1,103302,96698
1:5:2,1,1,103301,96699
4:2:1,1,1,103300,96700
5:5:2,1,1,103299,96701
6:5:6,0,-1,103300,96700
2:1:4,1,1,103299,96701
5:6:3,0,-1,103300,96700
1:4:1,0,-1,103301,96699
6:1:5,0,-1,103302,96698
5:6:5,0,-1,103303,96697
6:5:1,0,-1,103304,96696
3:5:4,0,-1,103305,96695
2:3:4,1,1,103304,96696
2:5:4,1,1,103303,96697
4:3:3,0,-1,103304,96696
1:2:1,1,1,103303,96697
2:5:5,1,1,103302,96698
5:5:6,0,-1,103303,96697
1:2:4,1,1,103302,96698
4:2:3,1,1,103301,96699
6:5:6,0,-1,103302,96698
5:1:2,1,1,103301,96699
6:1:5,0,-1,103302,96698
6:4:2,1,1,103301,96699
3:6:3,0,-1,103302,96698
4:4:6,0,-1,103303,96697
4:1:3,0,-1,103304,96696
3:5:1,0,-1,103305,96695
1:6:1,0,-1,103306,96694
2:2:3,2,2,103304,96696
6:1:1,0,-1,103305,96695
1:3:5,0,-1,103306,96694
2:4:1,1,1,103305,96695
4:2:4,1,1,103304,96696
3:6:6,0,-1,103305,96695
3:6:2,1,1,103304,96696
6:1:2,1,1,103303,96697
3:5:6,0,-1,103304,96696
3:4:1,0,-1,103305,96695
2:4:5,1,1,103304,96696
3:4:1,0,-1,103305,96695
5:3:4,0,-1,103306,96694
6:4:2,1,1,103305,96695
4:5:5,0,-1,103306,96694
6:4:5,0,-1,103307,96693
2:6:4,1,1,103306,96694
6:2:3,1,1,103305,96695
1:2:3,1,1,103304,96696
2:4:5,1,1,103303,96697
6:2:6,1,1,103302,96698
3:6:6,0,-1,103303,96697
4:4:5,0,-1,103304,96696
3:5:1,0,-1,103305,96695
3:1:4,0,-1,103306,96694
5:3:4,0,-1,103307,96693
6:6:3,0,-1,103308,96692
5:6:5,0,-1,103309,96691
3:1:3,0,-1,103310,96690
6:2:1,1,1,103309,96691
5:4:6,0,-1,103310,96690
1:1:5,0,-1,103311,96689
1:3:6,0,-1,103312,96688
4:4:2,1,1,103311,96689
1:3:3,0,-1,103312,96688
4:3:4,0,-1,103313,96687
1:5:5,0,-1,103314,96686
5:5:1,0,-1,103315,96685
4:6:2,1,1,103314,96686
3:3:1,0,-1,103315,96685
5:6:5,0,-1,103316,96684
2:5:6,1,1,103315,96685
3:3:3,0,-1,103316,96684
4:4:3,0,-1,103317,96683
4:4:6,0,-1,103318,96682
1:2:6,1,1,103317,96683
5:1:2,1,1,103316,96684
1:1:5,0,-1,103317,96683
6:5:5,0,-1,103318,96682
2:6:3,1,1,103317,96683
5:5:1,0,-1,103318,96682
1:1:3,0,-1,103319,96681
2:3:4,1,1,103318,96682
5:3:4,0,-1,103319,96681
4:1:2,1,1,103318,96682
3:4:5,0,-1,103319,96681
4:6:5,0,-1,103320,96680
6:6:2,1,1,103319,96681
3:4:2,1,1,103318,96682
6:3:5,0,-1,103319,96681
3:5:2,1,1,103318,96682
4:2:1,1,1,103317,96683
1:1:3,0,-1,103318,96682
1:6:5,0,-1,103319,96681
5:5:3,0,-1,103320,96680
3:2:4,1,1,103319,96681
3:4:4,0,-1,103320,96680
2:1:1,1,1,103319,96681
3:5:3,0,-1,103320,96680
4:5:2,1,1,103319,96681
1:2:1,1,1,103318,96682
3:6:4,0,-1,103319,96681
5:6:4,0,-1,103320,96680
6:6:2,1,1,103319,96681
4:3:5,0,-1,103320,96680
4:4:4,0,-1,103321,96679
2:2:3,2,2,103319,96681
6:1:2,1,1,103318,96682
1:3:2,1,1,103317,96683
6:6:6,0,-1,103318,96682
4:1:6,0,-1,103319,96681
6:1:5,0,-1,103320,96680
6:4:6,0,-1,103321,96679
2:4:6,1,1,103320,96680
1:4:2,1,1,103319,96681
3:4:5,0,-1,103320,96680
1:1:5,0,-1,103321,96679
2:2:6,2,2,103319,96681
5:5:1,0,-1,103320,96680
1:2:3,1,1,103319,96681
6:6:5,0,-1,103320,96680
5:6:6,0,-1,103321,96679
6:4:2,1,1,103320,96680
2:5:2,2,2,103318,96682
1:3:2,1,1,103317,96683
5:6:3,0,-1,103318,96682
5:5:5,0,-1,103319,96681
1:5:1,0,-1,103320,96680
1:5:2,1,1,103319,96681
5:3:5,0,-1,103320,96680
6:5:2,1,1,103319,96681
4:1:1,0,-1,103320,96680
6:3:6,0,-1,103321,96679
3:5:1,0,-1,103322,96678
3:3:3,0,-1,103323,96677
5:4:1,0,-1,103324,96676
4:2:3,1,1,103323,96677
1:6:2,1,1,103322,96678
3:3:1,0,-1,103323,96677
6:6:2,1,1,103322,96678
5:2:1,1,1,103321,96679
2:3:3,1,1,103320,96680
1:2:2,2,2,103318,96682
1:5:3,0,-1,103319,96681
2:2:5,2,2,103317,96683
3:1:5,0,-1,103318,96682
3:1:2,1,1,103317,96683
1:2:1,1,1,103316,96684
3:3:6,0,-1,103317,96683
2:5:1,1,1,103316,96684
4:2:3,1,1,103315,96685
1:3:4,0,-1,103316,96684
4:5:4,0,-1,103317,96683
3:5:2,1,1,103316,96684
6:5:1,0,-1,103317,96683
6:4:2,1,1,103316,96684
6:1:6,0,-1,103317,96683
1:3:6,0,-1,103318,96682
2:6:2,2,2,103316,96684
5:3:1,0,-1,103317,96683
3:6:5,0,-1,103318,96682
1:4:1,0,-1,103319,96681
1:6:2,1,1,103318,96682
2:5:5,1,1,103317,96683
4:6:6,0,-1,103318,96682
2:5:3,1,1,103317,96683
6:2:3,1,1,103316,96684
4:1:3,0,-1,103317,96683
1:2:2,2,2,103315,96685
4:1:6,0,-1,103316,96684
3:4:3,0,-1,103317,96683
2:4:2,2,2,103315,96685
2:1:2,2,2,103313,96687
1:4:5,0,-1,103314,96686
2:6:6,1,1,103313,96687
4:1:5,0,-1,103314,96686
3:4:4,0,-1,103315,96685
1:3:2,1,1,103314,96686
4:5:5,0,-1,103315,96685
4:4:4,0,-1,103316,96684
2:1:1,1,1,103315,96685
3:3:4,0,-1,103316,96684
3:1:5,0,-1,103317,96683
5:1:5,0,-1,103318,96682
1:4:3,0,-1,103319,96681
4:1:4,0,-1,103320,96680
4:6:3,0,-1,103321,96679
5:1:5,0,-1,103322,96678
4:4:5,0,-1,103323,96677
5:5:2,1,1,103322,96678
5:6:2,1,1,103321,96679
4:6:1,0,-1,103322,96678
5:1:5,0,-1,103323,96677
2:2:2,3,3,103320,96680
2:3:3,1,1,103319,96681
1:1:6,0,-1,103320,96680
6:2:1,1,1,103319,96681
3:6:4,0,-1,103320,96680
3:1:4,0,-1,103321,96679
2:5:6,1,1,103320,96680
4:5:6,0,-1,103321,96679
5:6:1,0,-1,103322,96678
3:6:2,1,1,103321,96679
3:6:1,0,-1,103322,96678
4:5:3,0,-1,103323,96677
5:2:6,1,1,103322,96678
1:2:5,1,1,103321,96679
4:3:6,0,-1,103322,96678
3:4:4,0,-1,103323,96677
6:3:5,0,-1,103324,96676
2:3:3,1,1,103323,96677
2:5:4,1,1,103322,96678
3:3:3,0,-1,103323,96677
1:1:4,0,-1,103324,96676
5:3:3,0,-1,103325,96675
1:6:2,1,1,103324,96676
5:1:3,0,-1,103325,96675
4:1:6,0,-1,103326,96674
3:2:5,1,1,103325,96675
4:3:2,1,1,103324,96676
4:4:3,0,-1,103325,96675
3:6:4,0,-1,103326,96674
1:5:1,0,-1,103327,96673
6:3:4,0,-1,103328,96672
1:6:2,1,1,103327,96673
3:6:5,0,-1,103328,96672
5:5:4,0,-1,103329,96671
6:6:4,0,-1,103330,96670
1:2:1,1,1,103329,96671
1:1:4,0,-1,103330,96670
1:1:4,0,-1,103331,96669
6:3:3,0,-1,103332,96668
5:6:3,0,-1,103333,96667
2:4:3,1,1,103332,96668
1:3:2,1,1,103331,96669
3:6:5,0,-1,103332,96668
4:2:6,1,1,103331,96669
2:6:1,1,1,103330,96670
5:2:6,1,1,103329,96671
6:5:2,1,1,103328,96672
5:2:3,1,1,103327,96673
2:2:3,2,2,103325,96675
1:2:6,1,1,103324,96676
4:2:3,1,1,103323,96677
2:4:6,1,1,103322,96678
1:3:2,1,1,103321,96679
5:3:5,0,-1,103322,96678
5:6:3,0,-1,103323,96677
3:6:1,0,-1,103324,96676
4:1:4,0,-1,103325,96675
5:6:2,1,1,103324,96676
4:5:6,0,-1,103325,96675
2:3:2,2,2,103323,96677
4:2:2,2,2,103321,96679
6:2:4,1,1,103320,96680
5:6:3,0,-1,103321,96679
3:1:1,0,-1,103322,96678
1:3:5,0,-1,103323,96677
6:6:5,0,-1,103324,96676
3:4:1,0,-1,103325,96675
1:6:4,0,-1,103326,96674
4:1:1,0,-1,103327,96673
1:5:3,0,-1,103328,96672
2:4:1,1,1,103327,96673
4:3:5,0,-1,103328,96672
5:2:5,1,1,103327,96673
2:2:4,2,2,103325,96675
1:6:1,0,-1,103326,96674
6:6:4,0,-1,103327,96673
2:5:5,1,1,103326,96674
2:3:6,1,1,103325,96675
4:4:3,0,-1,103326,96674
5:3:1,0,-1,103327,96673
3:3:1,0,-1,103328,96672
1:5:2,1,1,103327,96673
3:2:1,1,1,103326,96674
2:3:3,1,1,103325,96675
2:6:2,2,2,103323,96677
4:6:1,0,-1,103324,96676
3:5:5,0,-1,103325,96675
1:4:4,0,-1,103326,96674
2:1:3,1,1,103325,96675
4:2:3,1,1,103324,96676
1:1:6,0,-1,103325,96675
4:2:5,1,1,103324,96676
5:3:2,1,1,103323,96677
5:1:4,0,-1,103324,96676
3:6:2,1,1,103323,96677
5:3:4,0,-1,103324,96676
2:6:4,1,1,103323,96677
5:5:4,0,-1,103324,96676
3:6:6,0,-1,103325,96675
4:6:5,0,-1,103326,96674
6:2:6,1,1,103325,96675
6:3:3,0,-1,103326,96674
6:2:3,1,1,103325,96675
2:4:3,1,1,103324,96676
4:6:1,0,-1,103325,96675
3:1:2,1,1,103324,96676
1:6:1,0,-1,103325,96675
4:6:5,0,-1,103326,96674
3:6:3,0,-1,103327,96673
5:5:1,0,-1,103328,96672
6:6:1,0,-1,103329,96671
2:5:6,1,1,103328,96672
5:4:5,0,-1,103329,96671
5:6:6,0,-1,103330,96670
5:3:3,0,-1,103331,96669
4:4:2,1,1,103330,96670
3:2:5,1,1,103329,96671
2:3:6,1,1,103328,96672
5:5:6,0,-1,103329,96671
5:1:3,0,-1,103330,96670
2:2:5,2,2,103328,96672
4:2:5,1,1,103327,96673
4:2:1,1,1,103326,96674
3:3:1,0,-1,103327,96673
1:1:4,0,-1,103328,96672
1:2:2,2,2,103326,96674
3:2:5,1,1,103325,96675
6:4:2,1,1,103324,96676
2:3:6,1,1,103323,96677
1:1:4,0,-1,103324,96676
3:3:2,1,1,103323,96677
2:3:4,1,1,103322,96678
5:3:4,0,-1,103323,96677
4:5:2,1,1,103322,96678
5:5:5,0,-1,103323,96677
3:3:2,1,1,103322,96678
3:6:4,0,-1,103323,96677
1:2:1,1,1,103322,96678
3:2:3,1,1,103321,96679
2:6:6,1,1,103320,96680
5:3:6,0,-1,103321,96679
6:6:2,1,1,103320,96680
5:6:3,0,-1,103321,96679
1:1:6,0,-1,103322,96678
3:6:1,0,-1,103323,96677
4:2:5,1,1,103322,96678
4:1:5,0,-1,103323,96677
6:1:5,0,-1,103324,96676
3:5:4,0,-1,103325,96675
2:2:5,2,2,103323,96677
4:3:4,0,-1,103324,96676
1:6:3,0,-1,103325,96675
6:6:5,0,-1,103326,96674
2:6:5,1,1,103325,96675
2:3:1,1,1,103324,96676
4:2:2,2,2,103322,96678
3:2:5,1,1,103321,96679
5:1:4,0,-1,103322,96678
4:4:2,1,1,103321,96679
1:4:2,1,1,103320,96680
3:6:2,1,1,103319,96681
6:4:3,0,-1,103320,96680
3:2:2,2,2,103318,96682
1:1:1,0,-1,103319,96681
3:1:2,1,1,103318,96682
2:1:5,1,1,103317,96683
6:5:6,0,-1,103318,96682
5:5:1,0,-1,103319,96681
6:3:2,1,1,103318,96682
5:3:1,0,-1,103319,96681
3:3:6,0,-1,103320,96680
3:4:6,0,-1,103321,96679
3:2:1,1,1,103320,96680
5:1:4,0,-1,103321,96679
3:6:6,0,-1,103322,96678
4:3:5,0,-1,103323,96677
3:2:5,1,1,103322,96678
3:1:3,0,-1,103323,96677
4:2:2,2,2,103321,96679
4:1:1,0,-1,103322,96678
3:5:4,0,-1,103323,96677
3:5:4,0,-1,103324,96676
2:3:4,1,1,103323,96677
6:4:6,0,-1,103324,96676
6:1:2,1,1,103323,96677
2:5:2,2,2,103321,96679
4:4:6,0,-1,103322,96678
5:1:4,0,-1,103323,96677
1:6:3,0,-1,103324,96676
5:1:3,0,-1,103325,96675
6:1:1,0,-1,103326,96674
5:3:5,0,-1,103327,96673
1:4:6,0,-1,103328,96672
2:4:4,1,1,103327,96673
4:1:1,0,-1,103328,96672
6:3:3,0,-1,103329,96671
5:4:5,0,-1,103330,96670
6:4:5,0,-1,103331,96669
3:6:1,0,-1,103332,96668
5:4:4,0,-1,103333,96667
2:5:3,1,1,103332,96668
5:1:2,1,1,103331,96669
5:5:6,0,-1,103332,96668
1:5:3,0,-1,103333,96667
3:5:3,0,-1,103334,96666
3:6:5,0,-1,103335,96665
5:2:4,1,1,103334,96666
6:4:6,0,-1,103335,96665
4:3:1,0,-1,103336,96664
6:4:5,0,-1,103337,96663
4:1:1,0,-1,103338,96662
1:1:3,0,-1,103339,96661
3:5:4,0,-1,103340,96660
1:6:3,0,-1,103341,96659
2:6:3,1,1,103340,96660
6:3:6,0,-1,103341,96659
1:6:5,0,-1,103342,96658
2:4:3,1,1,103341,96659
1:3:4,0,-1,103342,96658
1:4:5,0,-1,103343,96657
5:6:1,0,-1,103344,96656
6:5:2,1,1,103343,96657
2:1:6,1,1,103342,96658
5:6:1,0,-1,103343,96657
4:2:5,1,1,103342,96658
5:3:5,0,-1,103343,96657
2:4:6,1,1,103342,96658
4:3:6,0,-1,103343,96657
6:2:6,1,1,103342,96658
3:3:2,1,1,103341,96659
1:1:5,0,-1,103342,96658
1:4:4,0,-1,103343,96657
4:4:4,0,-1,103344,96656
1:1:1,0,-1,103345,96655
6:6:1,0,-1,103346,96654
2:1:5,1,1,103345,96655
5:2:3,1,1,103344,96656
6:1:4,0,-1,103345,96655
3:2:2,2,2,103343,96657
3:2:3,1,1,103342,96658
3:6:4,0,-1,103343,96657
6:2:3,1,1,103342,96658
4:3:3,0,-1,103343,96657
1:6:4,0,-1,103344,96656
5:3:3,0,-1,103345,96655
6:5:3,0,-1,103346,96654
3:2:5,1,1,103345,96655
4:2:4,1,1,103344,96656
4:2:2,2,2,103342,96658
4:1:6,0,-1,103343,96657
3:4:6,0,-1,103344,96656
5:5:1,0,-1,103345,96655
4:3:3,0,-1,103346,96654
4:1:4,0,-1,103347,96653
6:6:3,0,-1,103348,96652
2:1:1,1,1,103347,96653
5:6:1,0,-1,103348,96652
1:5:1,0,-1,103349,96651
2:6:3,1,1,103348,96652
4:5:6,0,-1,103349,96651
6:2:6,1,1,103348,96652
4:6:5,0,-1,103349,96651
1:3:2,1,1,103348,96652
3:6:5,0,-1,103349,96651
3:5:5,0,-1,103350,96650
3:5:1,0,-1,103351,96649
2:6:6,1,1,103350,96650
2:5:2,2,2,103348,96652
3:6:2,1,1,103347,96653
6:5:6,0,-1,103348,96652
5:1:5,0,-1,103349,96651
2:4:6,1,1,103348,96652
5:3:4,0,-1,103349,96651
3:1:4,0,-1,103350,96650
2:4:5,1,1,103349,96651
2:2:2,3,3,103346,96654
2:1:2,2,2,103344,96656
4:3:1,0,-1,103345,96655
5:4:2,1,1,103344,96656
6:5:5,0,-1,103345,96655
1:2:3,1,1,103344,96656
6:1:2,1,1,103343,96657
2:3:6,1,1,103342,96658
2:6:6,1,1,103341,96659
6:1:3,0,-1,103342,96658
3:4:6,0,-1,103343,96657
1:5:6,0,-1,103344,96656
2:5:3,1,1,103343,96657
1:2:2,2,2,103341,96659
4:6:2,1,1,103340,96660
4:6:6,0,-1,103341,96659
6:5:6,0,-1,103342,96658
2:3:6,1,1,103341,96659
4:2:4,1,1,103340,96660
5:1:6,0,-1,103341,96659
3:5:3,0,-1,103342,96658
1:3:4,0,-1,103343,96657
4:6:1,0,-1,103344,96656
6:5:3,0,-1,103345,96655
4:3:6,0,-1,103346,96654
1:1:1,0,-1,103347,96653
6:5:3,0,-1,103348,96652
2:5:3,1,1,103347,96653
1:4:4,0,-1,103348,96652
1:6:2,1,1,103347,96653
5:5:5,0,-1,103348,96652
3:6:5,0,-1,103349,96651
5:4:6,0,-1,103350,96650
2:1:4,1,1,103349,96651
3:6:1,0,-1,103350,96650
6:2:3,1,1,103349,96651
6:1:5,0,-1,103350,96650
1:2:5,1,1,103349,96651
5:1:4,0,-1,103350,96650
1:1:5,0,-1,103351,96649
3:4:5,0,-1,103352,96648
4:6:3,0,-1,103353,96647
2:5:4,1,1,103352,96648
3:3:5,0,-1,103353,96647
6:2:5,1,1,103352,96648
6:2:3,1,1,103351,96649
2:6:3,1,1,103350,96650
1:3:3,0,-1,103351,96649
3:4:1,0,-1,103352,96648
5:6:2,1,1,103351,96649
3:3:1,0,-1,103352,96648
5:2:3,1,1,103351,96649
5:5:1,0,-1,103352,96648
2:5:2,2,2,103350,96650
2:2:5,2,2,103348,96652
3:1:3,0,-1,103349,96651
5:1:1,0,-1,103350,96650
6:1:2,1,1,103349,96651
3:1:2,1,1,103348,96652
1:1:1,0,-1,103349,96651
5:5:4,0,-1,103350,96650
1:2:5,1,1,103349,96651
3:5:2,1,1,103348,96652
2:2:4,2,2,103346,96654
1:3:2,1,1,103345,96655
5:2:5,1,1,103344,96656
3:3:1,0,-1,103345,96655
3:2:5,1,1,103344,96656
2:1:4,1,1,103343,96657
5:6:6,0,-1,103344,96656
2:3:6,1,1,103343,96657
5:2:3,1,1,103342,96658
3:4:2,1,1,103341,96659
6:4:5,0,-1,103342,96658
2:1:4,1,1,103341,96659
3:5:6,0,-1,103342,96658
2:5:2,2,2,103340,96660
5:5:4,0,-1,103341,96659
5:3:2,1,1,103340,96660
5:6:2,1,1,103339,96661
1:4:3,0,-1,103340,96660
6:5:5,0,-1,103341,96659
4:2:2,2,2,103339,96661
3:3:2,1,1,103338,96662
3:3:4,0,-1,103339,96661
1:2:1,1,1,103338,96662
2:1:6,1,1,103337,96663
3:4:1,0,-1,103338,96662
6:1:6,0,-1,103339,96661
2:1:3,1,1,103338,96662
1:4:4,0,-1,103339,96661
1:3:4,0,-1,103340,96660
2:2:3,2,2,103338,96662
3:5:4,0,-1,103339,96661
5:4:1,0,-1,103340,96660
1:1:3,0,-1,103341,96659
2:1:5,1,1,103340,96660
4:3:1,0,-1,103341,96659
2:1:2,2,2,103339,96661
3:1:3,0,-1,103340,96660
2:1:5,1,1,103339,96661
3:3:4,0,-1,103340,96660
6:6:5,0,-1,103341,96659
3:4:2,1,1,103340,96660
6:6:2,1,1,103339,96661
3:1:5,0,-1,103340,96660
5:2:4,1,1,103339,96661
6:1:5,0,-1,103340,96660
4:4:5,0,-1,103341,96659
2:2:1,2,2,103339,96661
1:5:3,0,-1,103340,96660
5:6:5,0,-1,103341,96659
4:2:6,1,1,103340,96660
2:6:3,1,1,103339,96661
6:3:5,0,-1,103340,96660
6:1:3,0,-1,103341,96659
4:5:3,0,-1,103342,96658
4:5:6,0,-1,103343,96657
5:5:1,0,-1,103344,96656
4:2:3,1,1,103343,96657
4:2:4,1,1,103342,96658
4:1:6,0,-1,103343,96657
2:6:2,2,2,103341,96659
3:5:3,0,-1,103342,96658
1:1:3,0,-1,103343,96657
2:6:3,1,1,103342,96658
4:2:2,2,2,103340,96660
6:1:4,0,-1,103341,96659
1:4:4,0,-1,103342,96658
5:6:3,0,-1,103343,96657
4:1:4,0,-1,103344,96656
5:3:3,0,-1,103345,96655
5:2:4,1,1,103344,96656
6:3:1,0,-1,103345,96655
2:6:5,1,1,103344,96656
2:6:4,1,1,103343,96657
4:4:5,0,-1,103344,96656
4:2:6,1,1,103343,96657
1:1:5,0,-1,103344,96656
1:5:4,0,-1,103345,96655
2:5:4,1,1,103344,96656
2:2:6,2,2,103342,96658
3:6:2,1,1,103341,96659
4:1:1,0,-1,103342,96658
5:4:6,0,-1,103343,96657
2:4:6,1,1,103342,96658
2:6:6,1,1,103341,96659
1:4:4,0,-1,103342,96658
6:6:5,0,-1,103343,96657
2:6:6,1,1,103342,96658
2:5:1,1,1,103341,96659
6:6:1,0,-1,103342,96658
1:2:6,1,1,103341,96659
1:6:6,0,-1,103342,96658
1:2:6,1,1,103341,96659
1:4:6,0,-1,103342,96658
1:5:3,0,-1,103343,96657
3:5:5,0,-1,103344,96656
2:4:5,1,1,103343,96657
3:6:1,0,-1,103344,96656
2:4:5,1,1,103343,96657
4:1:6,0,-1,103344,96656
2:3:2,2,2,103342,96658
3:6:2,1,1,103341,96659
1:4:5,0,-1,103342,96658
4:2:1,1,1,103341,96659
4:4:1,0,-1,103342,96658
2:2:3,2,2,103340,96660
6:6:4,0,-1,103341,96659
5:4:2,1,1,103340,96660
1:5:5,0,-1,103341,96659
2:5:3,1,1,103340,96660
1:6:1,0,-1,103341,96659
5:5:5,0,-1,103342,96658
3:5:2,1,1,103341,96659
1:1:5,0,-1,103342,96658
3:1:2,1,1,103341,96659
4:3:2,1,1,103340,96660
1:6:4,0,-1,103341,96659
6:1:1,0,-1,103342,96658
6:2:1,1,1,103341,96659
1:5:6,0,-1,103342,96658
4:6:5,0,-1,103343,96657
3:1:3,0,-1,103344,96656
4:1:1,0,-1,103345,96655
5:1:5,0,-1,103346,96654
3:3:5,0,-1,103347,96653
6:1:2,1,1,103346,96654
4:5:4,0,-1,103347,96653
3:1:6,0,-1,103348,96652
5:2:1,1,1,103347,96653
2:1:4,1,1,103346,96654
2:5:6,1,1,103345,96655
1:5:6,0,-1,103346,96654
3:3:2,1,1,103345,96655
3:4:6,0,-1,103346,96654
5:1:2,1,1,103345,96655
4:3:6,0,-1,103346,96654
5:3:2,1,1,103345,96655
1:1:3,0,-1,103346,96654
1:1:3,0,-1,103347,96653
3:1:5,0,-1,103348,96652
6:2:2,2,2,103346,96654
5:3:1,0,-1,103347,96653
6:4:2,1,1,103346,96654
4:5:5,0,-1,103347,96653
4:4:1,0,-1,103348,96652
6:4:5,0,-1,103349,96651
1:6:3,0,-1,103350,96650
1:3:1,0,-1,103351,96649
1:2:5,1,1,103350,96650
3:4:4,0,-1,103351,96649
5:3:3,0,-1,103352,96648
5:3:5,0,-1,103353,96647
5:1:6,0,-1,103354,96646
4:2:5,1,1,103353,96647
2:6:6,1,1,103352,96648
5:3:2,1,1,103351,96649
5:4:1,0,-1,103352,96648
5:1:2,1,1,103351,96649
1:4:3,0,-1,103352,96648
3:1:5,0,-1,103353,96647
1:1:3,0,-1,103354,96646
2:6:2,2,2,103352,96648
2:5:1,1,1,103351,96649
4:4:5,0,-1,103352,96648
6:3:5,0,-1,103353,96647
3:6:5,0,-1,103354,96646
4:6:1,0,-1,103355,96645
6:1:2,1,1,103354,96646
1:1:1,0,-1,103355,96645
5:4:1,0,-1,103356,96644
5:6:2,1,1,103355,96645
6:3:6,0,-1,103356,96644
2:5:4,1,1,103355,96645
2:1:2,2,2,103353,96647
5:5:1,0,-1,103354,96646
3:5:6,0,-1,103355,96645
1:5:2,1,1,103354,96646
4:5:4,0,-1,103355,96645
3:1:6,0,-1,103356,96644
1:1:3,0,-1,103357,96643
4:3:1,0,-1,103358,96642
6:2:6,1,1,103357,96643
3:6:6,0,-1,103358,96642
2:6:2,2,2,103356,96644
1:6:4,0,-1,103357,96643
4:5:6,0,-1,103358,96642
3:3:2,1,1,103357,96643
3:2:4,1,1,103356,96644
3:4:1,0,-1,103357,96643
4:2:1,1,1,103356,96644
3:2:3,1,1,103355,96645
5:6:2,1,1,103354,96646
6:1:5,0,-1,103355,96645
6:3:4,0,-1,103356,96644
1:1:5,0,-1,103357,96643
6:4:5,0,-1,103358,96642
6:3:4,0,-1,103359,96641
3:5:5,0,-1,103360,96640
5:5:5,0,-1,103361,96639
2:5:2,2,2,103359,96641
6:3:3,0,-1,103360,96640
6:5:5,0,-1,103361,96639
6:4:2,1,1,103360,96640
5:6:1,0,-1,103361,96639
1:5:6,0,-1,103362,96638
1:6:2,1,1,103361,96639
6:1:5,0,-1,103362,96638
4:6:2,1,1,103361,96639
1:4:6,0,-1,103362,96638
1:4:3,0,-1,103363,96637
3:2:4,1,1,103362,96638
1:5:2,1,1,103361,96639
6:1:1,0,-1,103362,96638
1:5:5,0,-1,103363,96637
3:2:1,1,1,103362,96638
4:6:1,0,-1,103363,96637
3:1:1,0,-1,103364,96636
1:6:5,0,-1,103365,96635
2:1:3,1,1,103364,96636
4:4:2,1,1,103363,96637
4:4:3,0,-1,103364,96636
2:4:5,1,1,103363,96637
6:2:1,1,1,103362,96638
1:2:1,1,1,103361,96639
4:1:4,0,-1,103362,96638
3:4:3,0,-1,103363,96637
5:6:6,0,-1,103364,96636
3:4:3,0,-1,103365,96635
1:2:6,1,1,103364,96636
6:5:6,0,-1,103365,96635
6:6:5,0,-1,103366,96634
4:1:2,1,1,103365,96635
2:4:1,1,1,103364,96636
1:1:1,0,-1,103365,96635
4:1:5,0,-1,103366,96634
2:1:2,2,2,103364,96636
3:4:1,0,-1,103365,96635
2:3:6,1,1,103364,96636
5:5:2,1,1,103363,96637
3:6:6,0,-1,103364,96636
6:3:2,1,1,103363,96637
1:1:3,0,-1,103364,96636
6:6:5,0,-1,103365,96635
4:5:1,0,-1,103366,96634
4:6:5,0,-1,103367,96633
3:6:4,0,-1,103368,96632
6:3:6,0,-1,103369,96631
6:6:2,1,1,103368,96632
6:4:2,1,1,103367,96633
1:2:4,1,1,103366,96634
2:2:4,2,2,103364,96636
1:2:2,2,2,103362,96638
6:4:6,0,-1,103363,96637
2:6:1,1,1,103362,96638
5:6:1,0,-1,103363,96637
1:5:3,0,-1,103364,96636
1:3:2,1,1,103363,96637
6:2:1,1,1,103362,96638
1:5:6,0,-1,103363,96637
1:3:1,0,-1,103364,96636
2:1:2,2,2,103362,96638
2:5:5,1,1,103361,96639
4:3:6,0,-1,103362,96638
2:4:3,1,1,103361,96639
5:5:1,0,-1,103362,96638
2:5:1,1,1,103361,96639
6:1:5,0,-1,103362,96638
6:5:4,0,-1,103363,96637
3:2:4,1,1,103362,96638
1:4:1,0,-1,103363,96637
3:2:6,1,1,103362,96638
5:4:4,0,-1,103363,96637
3:3:2,1,1,103362,96638
1:5:4,0,-1,103363,96637
2:3:5,1,1,103362,96638
5:4:4,0,-1,103363,96637
3:1:3,0,-1,103364,96636
2:4:6,1,1,103363,96637
4:3:1,0,-1,103364,96636
2:3:2,2,2,103362,96638
1:1:4,0,-1,103363,96637
6:5:1,0,-1,103364,96636
3:1:1,0,-1,103365,96635
3:2:1,1,1,103364,96636
3:6:6,0,-1,103365,96635
4:4:5,0,-1,103366,96634
5:5:5,0,-1,103367,96633
6:2:6,1,1,103366,96634
5:5:5,0,-1,103367,96633
5:5:5,0,-1,103368,96632
3:3:2,1,1,103367,96633
3:5:1,0,-1,103368,96632
2:3:2,2,2,103366,96634
6:5:2,1,1,103365,96635
3:4:3,0,-1,103366,96634
1:3:2,1,1,103365,96635
2:2:3,2,2,103363,96637
1:3:1,0,-1,103364,96636
2:5:6,1,1,103363,96637
3:3:1,0,-1,103364,96636
5:6:2,1,1,103363,96637
1:3:6,0,-1,103364,96636
2:6:4,1,1,103363,96637
1:5:6,0,-1,103364,96636
5:1:6,0,-1,103365,96635
5:1:6,0,-1,103366,96634
3:2:6,1,1,103365,96635
2:6:1,1,1,103364,96636
5:5:1,0,-1,103365,96635
2:1:3,1,1,103364,96636
6:2:1,1,1,103363,96637
5:6:3,0,-1,103364,96636
4:6:3,0,-1,103365,96635
4:4:4,0,-1,103366,96634
3:6:1,0,-1,103367,96633
3:2:5,1,1,103366,96634
2:5:5,1,1,103365,96635
5:5:3,0,-1,103366,96634
2:1:5,1,1,103365,96635
5:5:3,0,-1,103366,96634
3:2:4,1,1,103365,96635
1:2:4,1,1,103364,96636
3:6:1,0,-1,103365,96635
1:6:6,0,-1,103366,96634
1:3:3,0,-1,103367,96633
5:3:3,0,-1,103368,96632
6:1:6,0,-1,103369,96631
4:3:3,0,-1,103370,96630
3:5:6,0,-1,103371,96629
3:6:3,0,-1,103372,96628
2:2:2,3,3,103369,96631
3:2:4,1,1,103368,96632
2:5:4,1,1,103367,96633
2:5:3,1,1,103366,96634
4:5:2,1,1,103365,96635
1:4:5,0,-1,103366,96634
4:3:6,0,-1,103367,96633
2:4:3,1,1,103366,96634
3:2:6,1,1,103365,96635
3:3:2,1,1,103364,96636
1:6:2,1,1,103363,96637
4:5:4,0,-1,103364,96636
6:4:1,0,-1,103365,96635
2:6:4,1,1,103364,96636
6:1:5,0,-1,103365,96635
1:4:2,1,1,103364,96636
3:1:1,0,-1,103365,96635
1:3:6,0,-1,103366,96634
5:6:6,0,-1,103367,96633
2:2:1,2,2,103365,96635
2:6:4,1,1,103364,96636
1:5:6,0,-1,103365,96635
3:1:2,1,1,103364,96636
3:3:5,0,-1,103365,96635
5:3:1,0,-1,103366,96634
6:5:5,0,-1,103367,96633
3:3:6,0,-1,103368,96632
5:6:5,0,-1,103369,96631
6:1:1,0,-1,103370,96630
1:4:3,0,-1,103371,96629
4:3:4,0,-1,103372,96628
4:5:5,0,-1,103373,96627
3:6:5,0,-1,103374,96626
2:3:2,2,2,103372,96628
2:5:4,1,1,103371,96629
2:5:4,1,1,103370,96630
6:1:2,1,1,103369,96631
1:6:6,0,-1,103370,96630
4:1:4,0,-1,103371,96629
4:6:5,0,-1,103372,96628
1:2:6,1,1,103371,96629
1:5:5,0,-1,103372,96628
4:3:1,0,-1,103373,96627
6:1:5,0,-1,103374,96626
4:3:1,0,-1,103375,96625
1:3:5,0,-1,103376,96624
5:6:6,0,-1,103377,96623
5:2:1,1,1,103376,96624
4:6:4,0,-1,103377,96623
4:1:3,0,-1,103378,96622
4:2:4,1,1,103377,96623
6:6:4,0,-1,103378,96622
1:5:2,1,1,103377,96623
5:2:2,2,2,103375,96625
2:4:3,1,1,103374,96626
2:4:4,1,1,103373,96627
5:6:3,0,-1,103374,96626
6:2:3,1,1,103373,96627
4:3:4,0,-1,103374,96626
6:6:6,0,-1,103375,96625
2:2:1,2,2,103373,96627
5:1:2,1,1,103372,96628
1:6:2,1,1,103371,96629
6:6:2,1,1,103370,96630
2:3:4,1,1,103369,96631
5:1:6,0,-1,103370,96630
3:1:2,1,1,103369,96631
3:6:3,0,-1,103370,96630
6:2:2,2,2,103368,96632
2:4:6,1,1,103367,96633
3:4:3,0,-1,103368,96632
2:6:4,1,1,103367,96633
5:2:6,1,1,103366,96634
6:1:5,0,-1,103367,96633
2:5:5,1,1,103366,96634
2:5:2,2,2,103364,96636
5:4:6,0,-1,103365,96635
3:5:5,0,-1,103366,96634
5:1:3,0,-1,103367,96633
2:3:5,1,1,103366,96634
4:2:2,2,2,103364,96636
1:6:3,0,-1,103365,96635
4:3:2,1,1,103364,96636
4:3:5,0,-1,103365,96635
6:4:1,0,-1,103366,96634
5:6:2,1,1,103365,96635
6:5:4,0,-1,103366,96634
1:3:3,0,-1,103367,96633
5:2:5,1,1,103366,96634
3:3:2,1,1,103365,96635
5:4:3,0,-1,103366,96634
4:2:6,1,1,103365,96635
1:6:5,0,-1,103366,96634
6:2:4,1,1,103365,96635
1:2:4,1,1,103364,96636
4:4:3,0,-1,103365,96635
5:4:2,1,1,103364,96636
2:1:4,1,1,103363,96637
5:1:3,0,-1,103364,96636
2:1:2,2,2,103362,96638
1:6:2,1,1,103361,96639
1:6:4,0,-1,103362,96638
4:1:1,0,-1,103363,96637
1:1:5,0,-1,103364,96636
6:3:5,0,-1,103365,96635
1:2:1,1,1,103364,96636
6:2:3,1,1,103363,96637
6:3:3,0,-1,103364,96636
6:4:4,0,-1,103365,96635
3:2:4,1,1,103364,96636
1:3:5,0,-1,103365,96635
4:6:5,0,-1,103366,96634
4:1:5,0,-1,103367,96633
5:1:5,0,-1,103368,96632
6:6:2,1,1,103367,96633
4:6:1,0,-1,103368,96632
4:2:4,1,1,103367,96633
4:1:3,0,-1,103368,96632
2:2:4,2,2,103366,96634
1:2:6,1,1,103365,96635
1:5:5,0,-1,103366,96634
5:4:4,0,-1,103367,96633
6:5:2,1,1,103366,96634
5:2:4,1,1,103365,96635
4:4:2,1,1,103364,96636
2:6:1,1,1,103363,96637
6:1:6,0,-1,103364,96636
6:6:3,0,-1,103365,96635
3:6:6,0,-1,103366,96634
1:1:4,0,-1,103367,96633
5:1:4,0,-1,103368,96632
3:5:2,1,1,103367,96633
2:3:4,1,1,103366,96634
5:4:1,0,-1,103367,96633
3:5:2,1,1,103366,96634
4:2:1,1,1,103365,96635
2:6:6,1,1,103364,96636
3:6:5,0,-1,103365,96635
4:2:2,2,2,103363,96637
6:4:3,0,-1,103364,96636
3:3:2,1,1,103363,96637
3:2:2,2,2,103361,96639
6:1:5,0,-1,103362,96638
6:5:6,0,-1,103363,96637
1:4:4,0,-1,103364,96636
1:6:5,0,-1,103365,96635
5:5:6,0,-1,103366,96634
5:4:4,0,-1,103367,96633
1:6:2,1,1,103366,96634
3:6:4,0,-1,103367,96633
5:5:2,1,1,103366,96634
3:1:5,0,-1,103367,96633
5:5:3,0,-1,103368,96632
6:3:2,1,1,103367,96633
4:5:1,0,-1,103368,96632
4:3:1,0,-1,103369,96631
4:5:2,1,1,103368,96632
3:3:5,0,-1,103369,96631
4:1:2,1,1,103368,96632
5:2:4,1,1,103367,96633
6:2:6,1,1,103366,96634
4:1:2,1,1,103365,96635
1:5:6,0,-1,103366,96634
5:2:4,1,1,103365,96635
3:6:1,0,-1,103366,96634
4:3:5,0,-1,103367,96633
5:2:3,1,1,103366,96634
5:6:3,0,-1,103367,96633
6:5:4,0,-1,103368,96632
4:2:2,2,2,103366,96634
6:6:6,0,-1,103367,96633
5:4:4,0,-1,103368,96632
3:3:1,0,-1,103369,96631
2:2:1,2,2,103367,96633
3:6:2,1,1,103366,96634
6:1:2,1,1,103365,96635
4:2:4,1,1,103364,96636
5:2:4,1,1,103363,96637
3:2:5,1,1,103362,96638
3:2:4,1,1,103361,96639
1:3:6,0,-1,103362,96638
2:3:1,1,1,103361,96639
2:1:6,1,1,103360,96640
5:6:5,0,-1,103361,96639
5:5:2,1,1,103360,96640
5:3:4,0,-1,103361,96639
2:6:3,1,1,103360,96640
6:6:3,0,-1,103361,96639
3:5:2,1,1,103360,96640
5:2:3,1,1,103359,96641
3:1:4,0,-1,103360,96640
2:6:6,1,1,103359,96641
1:2:1,1,1,103358,96642
1:4:5,0,-1,103359,96641
6:5:6,0,-1,103360,96640
6:1:5,0,-1,103361,96639
6:6:4,0,-1,103362,96638
2:5:5,1,1,103361,96639
4:5:1,0,-1,103362,96638
3:3:6,0,-1,103363,96637
2:3:1,1,1,103362,96638
5:6:1,0,-1,103363,96637
1:6:2,1,1,103362,96638
1:6:4,0,-1,103363,96637
1:1:6,0,-1,103364,96636
2:4:5,1,1,103363,96637
4:3:2,1,1,103362,96638
6:5:4,0,-1,103363,96637
1:2:4,1,1,103362,96638
1:2:5,1,1,103361,96639
1:1:3,0,-1,103362,96638
1:3:5,0,-1,103363,96637
3:1:1,0,-1,103364,96636
3:4:2,1,1,103363,96637
4:2:4,1,1,103362,96638
6:6:6,0,-1,103363,96637
4:2:1,1,1,103362,96638
4:3:3,0,-1,103363,96637
2:4:3,1,1,103362,96638
2:4:2,2,2,103360,96640
1:6:2,1,1,103359,96641
1:2:4,1,1,103358,96642
4:6:3,0,-1,103359,96641
4:5:1,0,-1,103360,96640
4:1:2,1,1,103359,96641
3:5:5,0,-1,103360,96640
1:4:4,0,-1,103361,96639
4:5:1,0,-1,103362,96638
2:6:4,1,1,103361,96639
1:4:6,0,-1,103362,96638
1:5:3,0,-1,103363,96637
4:3:1,0,-1,103364,96636
1:6:5,0,-1,103365,96635
3:2:3,1,1,103364,96636
4:2:1,1,1,103363,96637
6:5:1,0,-1,103364,96636
6:4:3,0,-1,103365,96635
1:4:5,0,-1,103366,96634
6:4:3,0,-1,103367,96633
6:5:5,0,-1,103368,96632
5:1:2,1,1,103367,96633
2:5:3,1,1,103366,96634
3:1:1,0,-1,103367,96633
6:3:5,0,-1,103368,96632
1:6:6,0,-1,103369,96631
2:4:1,1,1,103368,96632
4:6:5,0,-1,103369,96631
3:2:2,2,2,103367,96633
3:3:4,0,-1,103368,96632
6:6:5,0,-1,103369,96631
6:4:3,0,-1,103370,96630
5:6:1,0,-1,103371,96629
5:1:5,0,-1,103372,96628
3:1:5,0,-1,103373,96627
4:4:3,0,-1,103374,96626
4:6:2,1,1,103373,96627
4:4:4,0,-1,103374,96626
6:1:5,0,-1,103375,96625
4:6:5,0,-1,103376,96624
1:4:3,0,-1,103377,96623
2:4:3,1,1,103376,96624
1:5:5,0,-1,103377,96623
4:5:2,1,1,103376,96624
1:6:5,0,-1,103377,96623
4:5:4,0,-1,103378,96622
5:2:1,1,1,103377,96623
4:4:1,0,-1,103378,96622
3:5:3,0,-1,103379,96621
5:5:2,1,1,103378,96622
3:3:6,0,-1,103379,96621
3:4:4,0,-1,103380,96620
6:2:4,1,1,103379,96621
6:5:5,0,-1,103380,96620
1:6:2,1,1,103379,96621
4:2:6,1,1,103378,96622
1:6:1,0,-1,103379,96621
3:3:4,0,-1,103380,96620
2:5:4,1,1,103379,96621
1:2:4,1,1,103378,96622
1:6:2,1,1,103377,96623
3:1:2,1,1,103376,96624
3:4:4,0,-1,103377,96623
3:1:4,0,-1,103378,96622
5:1:1,0,-1,103379,96621
3:2:2,2,2,103377,96623
2:2:2,3,3,103374,96626
5:5:5,0,-1,103375,96625
2:1:6,1,1,103374,96626
4:1:4,0,-1,103375,96625
2:4:1,1,1,103374,96626
6:4:2,1,1,103373,96627
6:6:1,0,-1,103374,96626
4:1:5,0,-1,103375,96625
3:1:6,0,-1,103376,96624
1:5:5,0,-1,103377,96623
1:6:1,0,-1,103378,96622
1:3:5,0,-1,103379,96621
6:5:5,0,-1,103380,96620
2:2:6,2,2,103378,96622
4:6:2,1,1,103377,96623
6:5:3,0,-1,103378,96622
5:1:3,0,-1,103379,96621
2:2:4,2,2,103377,96623
2:1:6,1,1,103376,96624
3:6:5,0,-1,103377,96623
2:5:5,1,1,103376,96624
6:1:6,0,-1,103377,96623
4:4:6,0,-1,103378,96622
5:5:6,0,-1,103379,96621
5:1:4,0,-1,103380,96620
6:4:5,0,-1,103381,96619
6:6:1,0,-1,103382,96618
2:1:5,1,1,103381,96619
1:3:3,0,-1,103382,96618
2:5:5,1,1,103381,96619
2:2:1,2,2,103379,96621
3:3:5,0,-1,103380,96620
2:2:5,2,2,103378,96622
3:6:3,0,-1,103379,96621
1:1:2,1,1,103378,96622
6:3:5,0,-1,103379,96621
6:2:1,1,1,103378,96622
6:3:6,0,-1,103379,96621
3:4:1,0,-1,103380,96620
3:6:2,1,1,103379,96621
2:2:3,2,2,103377,96623
4:4:4,0,-1,103378,96622
1:4:3,0,-1,103379,96621
4:2:3,1,1,103378,96622
5:1:6,0,-1,103379,96621
3:1:6,0,-1,103380,96620
5:6:5,0,-1,103381,96619
2:3:2,2,2,103379,96621
1:5:1,0,-1,103380,96620
2:5:2,2,2,103378,96622
5:3:6,0,-1,103379,96621
2:4:5,1,1,103378,96622
2:4:4,1,1,103377,96623
3:1:1,0,-1,103378,96622
5:1:1,0,-1,103379,96621
3:4:4,0,-1,103380,96620
1:1:2,1,1,103379,96621
1:5:3,0,-1,103380,96620
1:1:3,0,-1,103381,96619
4:1:2,1,1,103380,96620
1:1:2,1,1,103379,96621
2:4:2,2,2,103377,96623
4:4:3,0,-1,103378,96622
6:5:5,0,-1,103379,96621
4:4:1,0,-1,103380,96620
1:3:6,0,-1,103381,96619
2:6:5,1,1,103380,96620
4:2:1,1,1,103379,96621
4:1:4,0,-1,103380,96620
1:5:5,0,-1,103381,96619
6:5:6,0,-1,103382,96618
6:3:1,0,-1,103383,96617
5:4:2,1,1,103382,96618
6:3:5,0,-1,103383,96617
1:2:5,1,1,103382,96618
6:4:6,0,-1,103383,96617
5:4:3,0,-1,103384,96616
2:6:5,1,1,103383,96617
4:4:2,1,1,103382,96618
2:6:3,1,1,103381,96619
2:1:5,1,1,103380,96620
4:4:6,0,-1,103381,96619
2:4:6,1,1,103380,96620
4:4:6,0,-1,103381,96619
3:4:2,1,1,103380,96620
2:6:2,2,2,103378,96622
2:1:2,2,2,103376,96624
5:2:4,1,1,103375,96625
3:5:4,0,-1,103376,96624
1:3:1,0,-1,103377,96623
6:1:6,0,-1,103378,96622
2:1:6,1,1,103377,96623
5:5:1,0,-1,103378,96622
5:4:5,0,-1,103379,96621
2:3:5,1,1,103378,96622
6:3:5,0,-1,103379,96621
5:5:3,0,-1,103380,96620
1:2:1,1,1,103379,96621
4:6:2,1,1,103378,96622
4:6:1,0,-1,103379,96621
6:2:2,2,2,103377,96623
1:6:5,0,-1,103378,96622
4:6:6,0,-1,103379,96621
1:2:6,1,1,103378,96622
6:4:4,0,-1,103379,96621
4:4:6,0,-1,103380,96620
6:4:5,0,-1,103381,96619
2:2:1,2,2,103379,96621
3:3:2,1,1,103378,96622
5:5:1,0,-1,103379,96621
3:6:4,0,-1,103380,96620
1:3:1,0,-1,103381,96619
4:3:1,0,-1,103382,96618
2:4:5,1,1,103381,96619
4:5:3,0,-1,103382,96618
6:5:4,0,-1,103383,96617
5:6:2,1,1,103382,96618
1:3:1,0,-1,103383,96617
5:3:5,0,-1,103384,96616
5:1:6,0,-1,103385,96615
5:1:2,1,1,103384,96616
1:6:3,0,-1,103385,96615
2:4:5,1,1,103384,96616
6:1:4,0,-1,103385,96615
2:2:4,2,2,103383,96617
5:4:4,0,-1,103384,96616
2:5:4,1,1,103383,96617
6:1:2,1,1,103382,96618
4:4:5,0,-1,103383,96617
5:3:1,0,-1,103384,96616
3:4:5,0,-1,103385,96615
1:1:4,0,-1,103386,96614
6:4:4,0,-1,103387,96613
6:4:2,1,1,103386,96614
6:6:6,0,-1,103387,96613
2:3:1,1,1,103386,96614
2:4:6,1,1,103385,96615
2:2:6,2,2,103383,96617
6:2:5,1,1,103382,96618
1:6:3,0,-1,103383,96617
2:5:5,1,1,103382,96618
3:2:2,2,2,103380,96620
3:1:1,0,-1,103381,96619
5:1:4,0,-1,103382,96618
1:4:6,0,-1,103383,96617
4:3:5,0,-1,103384,96616
3:2:1,1,1,103383,96617
3:6:5,0,-1,103384,96616
2:1:2,2,2,103382,96618
4:2:4,1,1,103381,96619
3:1:2,1,1,103380,96620
2:4:6,1,1,103379,96621
5:5:3,0,-1,103380,96620
2:4:4,1,1,103379,96621
2:2:1,2,2,103377,96623
2:4:3,1,1,103376,96624
3:5:3,0,-1,103377,96623
5:1:6,0,-1,103378,96622
4:6:3,0,-1,103379,96621
2:2:4,2,2,103377,96623
6:2:2,2,2,103375,96625
6:5:1,0,-1,103376,96624
5:6:3,0,-1,103377,96623
3:5:4,0,-1,103378,96622
3:5:3,0,-1,103379,96621
2:4:3,1,1,103378,96622
6:5:3,0,-1,103379,96621
5:5:2,1,1,103378,96622
4:4:6,0,-1,103379,96621
6:5:2,1,1,103378,96622
6:3:1,0,-1,103379,96621
4:1:4,0,-1,103380,96620
5:4:2,1,1,103379,96621
3:3:5,0,-1,103380,96620
1:3:6,0,-1,103381,96619
5:3:4,0,-1,103382,96618
4:1:2,1,1,103381,96619
4:3:1,0,-1,103382,96618
2:2:4,2,2,103380,96620
2:5:3,1,1,103379,96621
3:3:4,0,-1,103380,96620
1:1:1,0,-1,103381,96619
1:1:3,0,-1,103382,96618
5:1:2,1,1,103381,96619
6:6:6,0,-1,103382,96618
1:5:4,0,-1,103383,96617
3:6:2,1,1,103382,96618
6:3:2,1,1,103381,96619
2:3:2,2,2,103379,96621
1:1:5,0,-1,103380,96620
4:5:6,0,-1,103381,96619
3:1:1,0,-1,103382,96618
5:2:5,1,1,103381,96619
4:3:6,0,-1,103382,96618
4:6:3,0,-1,103383,96617
3:4:5,0,-1,103384,96616
1:3:5,0,-1,103385,96615
6:1:6,0,-1,103386,96614
5:5:2,1,1,103385,96615
5:3:2,1,1,103384,96616
2:1:6,1,1,103383,96617
1:5:6,0,-1,103384,96616
4:6:6,0,-1,103385,96615
3:6:3,0,-1,103386,96614
6:2:3,1,1,103385,96615
2:5:2,2,2,103383,96617
2:4:2,2,2,103381,96619
5:5:5,0,-1,103382,96618
3:1:5,0,-1,103383,96617
6:2:5,1,1,103382,96618
1:3:1,0,-1,103383,96617
3:1:6,0,-1,103384,96616
6:1:3,0,-1,103385,96615
3:1:5,0,-1,103386,96614
6:2:2,2,2,103384,96616
5:3:3,0,-1,103385,96615
4:3:6,0,-1,103386,96614
3:5:4,0,-1,103387,96613
2:4:6,1,1,103386,96614
2:4:3,1,1,103385,96615
1:6:2,1,1,103384,96616
4:1:4,0,-1,103385,96615
2:5:2,2,2,103383,96617
4:3:6,0,-1,103384,96616
4:1:5,0,-1,103385,96615
5:2:4,1,1,103384,96616
3:4:1,0,-1,103385,96615
6:2:4,1,1,103384,96616
2:4:4,1,1,103383,96617
2:1:4,1,1,103382,96618
4:6:3,0,-1,103383,96617
5:1:1,0,-1,103384,96616
1:1:2,1,1,103383,96617
4:4:4,0,-1,103384,96616
6:1:3,0,-1,103385,96615
5:5:6,0,-1,103386,96614
5:6:2,1,1,103385,96615
6:4:1,0,-1,103386,96614
5:5:5,0,-1,103387,96613
6:1:1,0,-1,103388,96612
1:4:5,0,-1,103389,96611
3:5:5,0,-1,103390,96610
1:2:5,1,1,103389,96611
5:2:1,1,1,103388,96612
1:2:3,1,1,103387,96613
2:1:5,1,1,103386,96614
1:1:4,0,-1,103387,96613
3:2:6,1,1,103386,96614
3:4:3,0,-1,103387,96613
5:2:1,1,1,103386,96614
6:5:5,0,-1,103387,96613
1:5:6,0,-1,103388,96612
6:5:5,0,-1,103389,96611
1:2:6,1,1,103388,96612
1:1:2,1,1,103387,96613
5:4:2,1,1,103386,96614
6:1:1,0,-1,103387,96613
2:4:5,1,1,103386,96614
5:1:3,0,-1,103387,96613
2:5:1,1,1,103386,96614
2:1:4,1,1,103385,96615
1:6:4,0,-1,103386,96614
4:3:4,0,-1,103387,96613
6:5:5,0,-1,103388,96612
1:6:2,1,1,103387,96613
2:6:5,1,1,103386,96614
5:6:5,0,-1,103387,96613
1:1:3,0,-1,103388,96612
3:2:5,1,1,103387,96613
3:1:5,0,-1,103388,96612
3:1:1,0,-1,103389,96611
1:4:4,0,-1,103390,96610
1:4:2,1,1,103389,96611
3:1:3,0,-1,103390,96610
5:6:2,1,1,103389,96611
5:6:1,0,-1,103390,96610
3:6:3,0,-1,103391,96609
1:3:1,0,-1,103392,96608
6:3:1,0,-1,103393,96607
2:6:5,1,1,103392,96608
4:4:6,0,-1,103393,96607
3:1:5,0,-1,103394,96606
5:3:3,0,-1,103395,96605
1:6:2,1,1,103394,96606
6:1:4,0,-1,103395,96605
4:6:2,1,1,103394,96606
3:3:6,0,-1,103395,96605
6:4:5,0,-1,103396,96604
6:3:5,0,-1,103397,96603
1:6:5,0,-1,103398,96602
2:6:2,2,2,103396,96604
1:3:3,0,-1,103397,96603
5:4:3,0,-1,103398,96602
3:6:3,0,-1,103399,96601
6:2:4,1,1,103398,96602
1:2:6,1,1,103397,96603
6:2:6,1,1,103396,96604
6:4:2,1,1,103395,96605
1:6:2,1,1,103394,96606
2:5:6,1,1,103393,96607
5:2:2,2,2,103391,96609
4:4:4,0,-1,103392,96608
5:4:2,1,1,103391,96609
3:1:1,0,-1,103392,96608
2:6:1,1,1,103391,96609
5:2:3,1,1,103390,96610
4:5:4,0,-1,103391,96609
1:3:4,0,-1,103392,96608
5:1:3,0,-1,103393,96607
4:5:4,0,-1,103394,96606
3:3:4,0,-1,103395,96605
2:6:5,1,1,103394,96606
2:4:2,2,2,103392,96608
2:5:2,2,2,103390,96610
4:1:1,0,-1,103391,96609
1:6:5,0,-1,103392,96608
5:5:6,0,-1,103393,96607
6:1:6,0,-1,103394,96606
3:1:6,0,-1,103395,96605
5:1:3,0,-1,103396,96604
3:5:6,0,-1,103397,96603
1:1:1,0,-1,103398,96602
3:5:6,0,-1,103399,96601
2:2:2,3,3,103396,96604
5:6:3,0,-1,103397,96603
3:3:4,0,-1,103398,96602
5:2:2,2,2,103396,96604
6:3:3,0,-1,103397,96603
1:2:5,1,1,103396,96604
6:5:5,0,-1,103397,96603
6:3:1,0,-1,103398,96602
6:2:1,1,1,103397,96603
3:3:2,1,1,103396,96604
6:1:1,0,-1,103397,96603
6:1:3,0,-1,103398,96602
2:3:2,2,2,103396,96604
5:4:5,0,-1,103397,96603
1:1:3,0,-1,103398,96602
3:2:1,1,1,103397,96603
2:6:6,1,1,103396,96604
6:4:6,0,-1,103397,96603
5:4:5,0,-1,103398,96602
4:6:3,0,-1,103399,96601
5:3:6,0,-1,103400,96600
4:1:5,0,-1,103401,96599
3:2:1,1,1,103400,96600
3:6:2,1,1,103399,96601
6:4:6,0,-1,103400,96600
3:1:3,0,-1,103401,96599
6:6:2,1,1,103400,96600
1:6:1,0,-1,103401,96599
4:1:2,1,1,103400,96600
3:6:5,0,-1,103401,96599
2:6:5,1,1,103400,96600
3:3:5,0,-1,103401,96599
1:5:5,0,-1,103402,96598
1:5:4,0,-1,103403,96597
2:3:5,1,1,103402,96598
4:2:4,1,1,103401,96599
4:1:4,0,-1,103402,96598
1:3:4,0,-1,103403,96597
1:4:1,0,-1,103404,96596
2:1:5,1,1,103403,96597
6:5:5,0,-1,103404,96596
1:6:4,0,-1,103405,96595
1:1:2,1,1,103404,96596
6:4:5,0,-1,103405,96595
6:3:2,1,1,103404,96596
1:6:3,0,-1,103405,96595
5:6:6,0,-1,103406,96594
2:5:3,1,1,103405,96595
6:5:6,0,-1,103406,96594
5:6:3,0,-1,103407,96593
1:3:2,1,1,103406,96594
3:5:6,0,-1,103407,96593
2:6:3,1,1,103406,96594
6:4:6,0,-1,103407,96593
4:1:6,0,-1,103408,96592
1:3:1,0,-1,103409,96591
6:5:6,0,-1,103410,96590
5:6:2,1,1,103409,96591
1:6:1,0,-1,103410,96590
2:2:6,2,2,103408,96592
2:1:3,1,1,103407,96593
2:6:4,1,1,103406,96594
3:5:4,0,-1,103407,96593
2:6:2,2,2,103405,96595
2:1:6,1,1,103404,96596
2:4:2,2,2,103402,96598
2:3:5,1,1,103401,96599
4:6:1,0,-1,103402,96598
4:6:3,0,-1,103403,96597
2:2:4,2,2,103401,96599
2:5:2,2,2,103399,96601
1:3:6,0,-1,103400,96600
6:4:2,1,1,103399,96601
2:1:6,1,1,103398,96602
4:5:2,1,1,103397,96603
6:5:2,1,1,103396,96604
6:6:4,0,-1,103397,96603
2:6:2,2,2,103395,96605
4:3:1,0,-1,103396,96604
1:6:5,0,-1,103397,96603
4:6:5,0,-1,103398,96602
2:5:4,1,1,103397,96603
5:6:5,0,-1,103398,96602
5:1:1,0,-1,103399,96601
1:4:6,0,-1,103400,96600
3:2:4,1,1,103399,96601
3:3:2,1,1,103398,96602
2:3:2,2,2,103396,96604
1:4:1,0,-1,103397,96603
4:1:5,0,-1,103398,96602
3:4:2,1,1,103397,96603
6:3:2,1,1,103396,96604
6:4:4,0,-1,103397,96603
5:2:2,2,2,103395,96605
4:3:4,0,-1,103396,96604
6:4:2,1,1,103395,96605
2:2:3,2,2,103393,96607
6:1:6,0,-1,103394,96606
1:2:4,1,1,103393,96607
4:3:6,0,-1,103394,96606
2:5:2,2,2,103392,96608
6:1:5,0,-1,103393,96607
1:3:3,0,-1,103394,96606
2:2:3,2,2,103392,96608
1:6:3,0,-1,103393,96607
6:1:6,0,-1,103394,96606
2:5:4,1,1,103393,96607
5:3:3,0,-1,103394,96606
4:5:3,0,-1,103395,96605
2:1:2,2,2,103393,96607
2:2:2,3,3,103390,96610
1:2:2,2,2,103388,96612
3:5:4,0,-1,103389,96611
5:6:2,1,1,103388,96612
5:3:1,0,-1,103389,96611
5:6:4,0,-1,103390,96610
4:5:4,0,-1,103391,96609
5:6:1,0,-1,103392,96608
5:4:2,1,1,103391,96609
4:3:4,0,-1,103392,96608
6:3:4,0,-1,103393,96607
5:3:5,0,-1,103394,96606
1:2:5,1,1,103393,96607
6:1:3,0,-1,103394,96606
3:4:1,0,-1,103395,96605
3:6:2,1,1,103394,96606
6:5:2,1,1,103393,96607
2:1:2,2,2,103391,96609
4:3:4,0,-1,103392,96608
2:1:6,1,1,103391,96609
1:6:3,0,-1,103392,96608
3:2:2,2,2,103390,96610
6:5:2,1,1,103389,96611
3:5:2,1,1,103388,96612
2:1:6,1,1,103387,96613
6:1:2,1,1,103386,96614
1:5:2,1,1,103385,96615
3:5:2,1,1,103384,96616
2:4:6,1,1,103383,96617
5:2:5,1,1,103382,96618
1:5:2,1,1,103381,96619
2:1:6,1,1,103380,96620
6:6:1,0,-1,103381,96619
6:5:3,0,-1,103382,96618
3:1:5,0,-1,103383,96617
4:6:2,1,1,103382,96618
4:2:1,1,1,103381,96619
6:4:2,1,1,103380,96620
3:6:4,0,-1,103381,96619
5:2:6,1,1,103380,96620
4:3:4,0,-1,103381,96619
2:4:5,1,1,103380,96620
1:1:2,1,1,103379,96621
5:2:1,1,1,103378,96622
5:4:5,0,-1,103379,96621
1:4:5,0,-1,103380,96620
5:5:6,0,-1,103381,96619
1:3:3,0,-1,103382,96618
2:4:4,1,1,103381,96619
1:2:4,1,1,103380,96620
4:3:1,0,-1,103381,96619
1:6:2,1,1,103380,96620
1:5:2,1,1,103379,96621
1:5:3,0,-1,103380,96620
1:4:4,0,-1,103381,96619
2:4:3,1,1,103380,96620
1:4:2,1,1,103379,96621
5:6:5,0,-1,103380,96620
4:5:2,1,1,103379,96621
1:2:5,1,1,103378,96622
5:2:1,1,1,103377,96623
5:2:3,1,1,103376,96624
3:1:4,0,-1,103377,96623
1:6:1,0,-1,103378,96622
4:2:5,1,1,103377,96623
2:1:1,1,1,103376,96624
2:2:2,3,3,103373,96627
1:3:5,0,-1,103374,96626
1:5:6,0,-1,103375,96625
6:4:5,0,-1,103376,96624
3:4:1,0,-1,103377,96623
5:3:1,0,-1,103378,96622
4:4:2,1,1,103377,96623
3:5:6,0,-1,103378,96622
2:6:1,1,1,103377,96623
4:6:2,1,1,103376,96624
2:2:5,2,2,103374,96626
5:4:5,0,-1,103375,96625
6:4:1,0,-1,103376,96624
5:5:4,0,-1,103377,96623
5:4:5,0,-1,103378,96622
2:2:6,2,2,103376,96624
4:3:2,1,1,103375,96625
5:6:6,0,-1,103376,96624
5:1:4,0,-1,103377,96623
2:1:4,1,1,103376,96624
2:5:1,1,1,103375,96625
5:5:1,0,-1,103376,96624
1:1:4,0,-1,103377,96623
1:3:5,0,-1,103378,96622
4:6:4,0,-1,103379,96621
3:6:5,0,-1,103380,96620
5:4:3,0,-1,103381,96619
2:3:6,1,1,103380,96620
3:5:1,0,-1,103381,96619
4:6:3,0,-1,103382,96618
2:2:2,3,3,103379,96621
2:3:3,1,1,103378,96622
4:2:6,1,1,103377,96623
6:3:5,0,-1,103378,96622
2:2:1,2,2,103376,96624
2:3:5,1,1,103375,96625
1:4:1,0,-1,103376,96624
5:6:2,1,1,103375,96625
5:4:2,1,1,103374,96626
6:1:4,0,-1,103375,96625
2:3:1,1,1,103374,96626
1:1:6,0,-1,103375,96625
1:2:2,2,2,103373,96627
4:4:1,0,-1,103374,96626
3:3:4,0,-1,103375,96625
4:1:2,1,1,103374,96626
3:6:1,0,-1,103375,96625
5:5:4,0,-1,103376,96624
5:3:5,0,-1,103377,96623
6:4:3,0,-1,103378,96622
1:3:1,0,-1,103379,96621
6:4:3,0,-1,103380,96620
6:6:3,0,-1,103381,96619
5:1:6,0,-1,103382,96618
4:5:2,1,1,103381,96619
1:3:2,1,1,103380,96620
5:6:1,0,-1,103381,96619
4:4:3,0,-1,103382,96618
1:3:2,1,1,103381,96619
2:1:2,2,2,103379,96621
4:3:1,0,-1,103380,96620
4:5:3,0,-1,103381,96619
1:5:1,0,-1,103382,96618
3:2:5,1,1,103381,96619
3:5:1,0,-1,103382,96618
4:6:2,1,1,103381,96619
2:2:6,2,2,103379,96621
6:1:1,0,-1,103380,96620
4:2:5,1,1,103379,96621
1:4:4,0,-1,103380,96620
3:2:3,1,1,103379,96621
3:2:6,1,1,103378,96622
4:2:3,1,1,103377,96623
3:5:5,0,-1,103378,96622
2:4:1,1,1,103377,96623
3:2:3,1,1,103376,96624
4:5:1,0,-1,103377,96623
3:2:1,1,1,103376,96624
1:2:6,1,1,103375,96625
2:4:5,1,1,103374,96626
2:1:3,1,1,103373,96627
1:5:5,0,-1,103374,96626
2:5:1,1,1,103373,96627
5:2:4,1,1,103372,96628
1:3:1,0,-1,103373,96627
2:3:6,1,1,103372,96628
1:4:5,0,-1,103373,96627
6:2:4,1,1,103372,96628
1:2:4,1,1,103371,96629
1:3:2,1,1,103370,96630
3:6:6,0,-1,103371,96629
5:2:2,2,2,103369,96631
1:2:4,1,1,103368,96632
1:3:6,0,-1,103369,96631
4:5:2,1,1,103368,96632
3:1:5,0,-1,103369,96631
5:3:4,0,-1,103370,96630
3:3:1,0,-1,103371,96629
1:5:6,0,-1,103372,96628
3:6:6,0,-1,103373,96627
3:2:3,1,1,103372,96628
4:3:6,0,-1,103373,96627
1:3:5,0,-1,103374,96626
4:3:3,0,-1,103375,96625
2:3:6,1,1,103374,96626
3:1:4,0,-1,103375,96625
4:6:2,1,1,103374,96626
6:5:1,0,-1,103375,96625
6:1:6,0,-1,103376,96624
4:6:3,0,-1,103377,96623
6:3:4,0,-1,103378,96622
2:4:6,1,1,103377,96623
1:3:4,0,-1,103378,96622
1:2:5,1,1,103377,96623
5:1:2,1,1,103376,96624
2:3:6,1,1,103375,96625
1:4:5,0,-1,103376,96624
6:6:3,0,-1,103377,96623
6:6:5,0,-1,103378,96622
2:3:6,1,1,103377,96623
5:5:6,0,-1,103378,96622
4:6:1,0,-1,103379,96621
2:6:2,2,2,103377,96623
1:2:5,1,1,103376,96624
6:5:1,0,-1,103377,96623
2:5:4,1,1,103376,96624
3:1:6,0,-1,103377,96623
3:4:4,0,-1,103378,96622
6:6:6,0,-1,103379,96621
3:5:5,0,-1,103380,96620
6:5:4,0,-1,103381,96619
1:1:1,0,-1,103382,96618
4:5:6,0,-1,103383,96617
2:6:1,1,1,103382,96618
4:5:4,0,-1,103383,96617
6:3:2,1,1,103382,96618
4:4:4,0,-1,103383,96617
2:6:1,1,1,103382,96618
4:2:5,1,1,103381,96619
4:2:2,2,2,103379,96621
4:1:3,0,-1,103380,96620
6:1:5,0,-1,103381,96619
3:5:5,0,-1,103382,96618
5:4:4,0,-1,103383,96617
6:3:4,0,-1,103384,96616
6:3:6,0,-1,103385,96615
1:6:6,0,-1,103386,96614
2:5:1,1,1,103385,96615
2:4:3,1,1,103384,96616
3:2:3,1,1,103383,96617
3:5:4,0,-1,103384,96616
6:2:1,1,1,103383,96617
4:2:3,1,1,103382,96618
2:3:1,1,1,103381,96619
3:5:4,0,-1,103382,96618
3:1:2,1,1,103381,96619
2:3:1,1,1,103380,96620
4:4:6,0,-1,103381,96619
6:3:3,0,-1,103382,96618
5:5:1,0,-1,103383,96617
1:5:1,0,-1,103384,96616
2:5:3,1,1,103383,96617
5:3:4,0,-1,103384,96616
6:5:5,0,-1,103385,96615
3:3:3,0,-1,103386,96614
3:4:2,1,1,103385,96615
3:2:6,1,1,103384,96616
3:1:6,0,-1,103385,96615
6:4:3,0,-1,103386,96614
5:3:1,0,-1,103387,96613
1:3:3,0,-1,103388,96612
2:2:1,2,2,103386,96614
6:2:4,1,1,103385,96615
5:4:4,0,-1,103386,96614
4:5:4,0,-1,103387,96613
2:4:2,2,2,103385,96615
3:4:2,1,1,103384,96616
1:6:4,0,-1,103385,96615
4:1:5,0,-1,103386,96614
1:1:6,0,-1,103387,96613
5:3:5,0,-1,103388,96612
5:1:1,0,-1,103389,96611
2:5:4,1,1,103388,96612
5:3:6,0,-1,103389,96611
2:1:6,1,1,103388,96612
1:2:2,2,2,103386,96614
1:1:5,0,-1,103387,96613
3:5:5,0,-1,103388,96612
4:1:3,0,-1,103389,96611
5:6:5,0,-1,103390,96610
4:4:2,1,1,103389,96611
1:3:3,0,-1,103390,96610
1:5:2,1,1,103389,96611
3:4:4,0,-1,103390,96610
2:6:1,1,1,103389,96611
5:6:3,0,-1,103390,96610
6:2:5,1,1,103389,96611
3:3:4,0,-1,103390,96610
1:1:2,1,1,103389,96611
5:6:1,0,-1,103390,96610
5:2:2,2,2,103388,96612
3:1:5,0,-1,103389,96611
5:6:3,0,-1,103390,96610
1:5:4,0,-1,103391,96609
6:5:1,0,-1,103392,96608
6:4:3,0,-1,103393,96607
5:1:4,0,-1,103394,96606
3:3:4,0,-1,103395,96605
2:6:2,2,2,103393,96607
1:6:5,0,-1,103394,96606
5:6:6,0,-1,103395,96605
1:2:4,1,1,103394,96606
4:3:3,0,-1,103395,96605
2:5:6,1,1,103394,96606
3:6:4,0,-1,103395,96605
5:1:1,0,-1,103396,96604
1:4:3,0,-1,103397,96603
6:6:2,1,1,103396,96604
3:2:5,1,1,103395,96605
4:2:3,1,1,103394,96606
1:6:1,0,-1,103395,96605
6:4:6,0,-1,103396,96604
6:3:1,0,-1,103397,96603
6:3:5,0,-1,103398,96602
6:6:4,0,-1,103399,96601
2:6:6,1,1,103398,96602
5:2:3,1,1,103397,96603
6:3:4,0,-1,103398,96602
2:2:5,2,2,103396,96604
3:1:3,0,-1,103397,96603
2:5:2,2,2,103395,96605
3:4:2,1,1,103394,96606
5:6:3,0,-1,103395,96605
1:4:2,1,1,103394,96606
3:2:5,1,1,103393,96607
5:3:6,0,-1,103394,96606
5:6:6,0,-1,103395,96605
1:3:6,0,-1,103396,96604
4:2:1,1,1,103395,96605
5:2:5,1,1,103394,96606
2:3:1,1,1,103393,96607
6:4:4,0,-1,103394,96606
5:4:2,1,1,103393,96607
4:2:5,1,1,103392,96608
1:3:5,0,-1,103393,96607
3:3:6,0,-1,103394,96606
5:4:6,0,-1,103395,96605
2:6:4,1,1,103394,96606
3:6:5,0,-1,103395,96605
2:2:3,2,2,103393,96607
2:2:5,2,2,103391,96609
1:6:2,1,1,103390,96610
1:3:2,1,1,103389,96611
5:5:1,0,-1,103390,96610
2:6:5,1,1,103389,96611
1:5:2,1,1,103388,96612
6:5:4,0,-1,103389,96611
1:4:5,0,-1,103390,96610
3:5:4,0,-1,103391,96609
2:6:4,1,1,103390,96610
3:4:1,0,-1,103391,96609
4:5:6,0,-1,103392,96608
5:6:1,0,-1,103393,96607
6:2:5,1,1,103392,96608
1:1:5,0,-1,103393,96607
6:5:1,0,-1,103394,96606
5:4:6,0,-1,103395,96605
1:2:5,1,1,103394,96606
1:3:6,0,-1,103395,96605
4:1:3,0,-1,103396,96604
1:4:1,0,-1,103397,96603
2:4:1,1,1,103396,96604
4:5:3,0,-1,103397,96603
1:5:1,0,-1,103398,96602
1:3:5,0,-1,103399,96601
3:4:2,1,1,103398,96602
5:3:3,0,-1,103399,96601
6:1:2,1,1,103398,96602
4:2:5,1,1,103397,96603
3:4:6,0,-1,103398,96602
3:5:5,0,-1,103399,96601
5:6:2,1,1,103398,96602
2:4:4,1,1,103397,96603
3:6:2,1,1,103396,96604
5:5:2,1,1,103395,96605
5:1:1,0,-1,103396,96604
3:5:1,0,-1,103397,96603
5:5:4,0,-1,103398,96602
4:3:2,1,1,103397,96603
6:6:2,1,1,103396,96604
6:2:6,1,1,103395,96605
5:2:3,1,1,103394,96606
6:2:1,1,1,103393,96607
1:6:4,0,-1,103394,96606
2:6:3,1,1,103393,96607
6:5:6,0,-1,103394,96606
4:6:1,0,-1,103395,96605
1:2:4,1,1,103394,96606
4:6:3,0,-1,103395,96605
2:5:2,2,2,103393,96607
2:6:2,2,2,103391,96609
1:3:4,0,-1,103392,96608
6:3:2,1,1,103391,96609
2:1:1,1,1,103390,96610
3:2:4,1,1,103389,96611
1:6:6,0,-1,103390,96610
2:2:5,2,2,103388,96612
5:3:4,0,-1,103389,96611
6:5:1,0,-1,103390,96610
4:1:6,0,-1,103391,96609
2:4:5,1,1,103390,96610
5:2:2,2,2,103388,96612
6:1:2,1,1,103387,96613
3:4:4,0,-1,103388,96612
6:4:5,0,-1,103389,96611
4:4:3,0,-1,103390,96610
5:6:5,0,-1,103391,96609
5:6:6,0,-1,103392,96608
1:5:3,0,-1,103393,96607
1:3:2,1,1,103392,96608
1:1:2,1,1,103391,96609
3:4:1,0,-1,103392,96608
2:4:2,2,2,103390,96610
5:2:2,2,2,103388,96612
3:2:5,1,1,103387,96613
2:2:2,3,3,103384,96616
4:1:2,1,1,103383,96617
2:4:6,1,1,103382,96618
4:2:4,1,1,103381,96619
3:6:1,0,-1,103382,96618
4:4:5,0,-1,103383,96617
5:3:1,0,-1,103384,96616
5:3:3,0,-1,103385,96615
2:4:4,1,1,103384,96616
4:5:4,0,-1,103385,96615
6:6:2,1,1,103384,96616
6:5:2,1,1,103383,96617
5:4:6,0,-1,103384,96616
6:4:5,0,-1,103385,96615
4:5:1,0,-1,103386,96614
3:2:1,1,1,103385,96615
6:5:1,0,-1,103386,96614
1:4:1,0,-1,103387,96613
1:1:4,0,-1,103388,96612
2:1:1,1,1,103387,96613
2:5:2,2,2,103385,96615
6:5:2,1,1,103384,96616
3:1:1,0,-1,103385,96615
1:1:3,0,-1,103386,96614
3:5:5,0,-1,103387,96613
4:3:1,0,-1,103388,96612
6:2:1,1,1,103387,96613
4:3:4,0,-1,103388,96612
1:5:2,1,1,103387,96613
6:3:4,0,-1,103388,96612
4:3:4,0,-1,103389,96611
5:5:1,0,-1,103390,96610
3:5:5,0,-1,103391,96609
2:2:4,2,2,103389,96611
3:2:2,2,2,103387,96613
6:1:6,0,-1,103388,96612
1:5:5,0,-1,103389,96611
6:3:1,0,-1,103390,96610
2:6:1,1,1,103389,96611
6:4:1,0,-1,103390,96610
1:4:3,0,-1,103391,96609
4:6:1,0,-1,103392,96608
4:6:6,0,-1,103393,96607
5:5:5,0,-1,103394,96606
5:1:6,0,-1,103395,96605
4:6:5,0,-1,103396,96604
5:1:1,0,-1,103397,96603
3:6:3,0,-1,103398,96602
5:3:6,0,-1,103399,96601
5:4:2,1,1,103398,96602
2:1:5,1,1,103397,96603
6:6:2,1,1,103396,96604
3:1:4,0,-1,103397,96603
2:4:5,1,1,103396,96604
5:4:5,0,-1,103397,96603
1:2:6,1,1,103396,96604
6:4:1,0,-1,103397,96603
2:3:3,1,1,103396,96604
1:4:4,0,-1,103397,96603
3:4:3,0,-1,103398,96602
4:5:3,0,-1,103399,96601
4:6:6,0,-1,103400,96600
1:6:4,0,-1,103401,96599
6:4:4,0,-1,103402,96598
6:4:1,0,-1,103403,96597
2:3:3,1,1,103402,96598
6:6:2,1,1,103401,96599
5:4:1,0,-1,103402,96598
6:2:4,1,1,103401,96599
5:5:1,0,-1,103402,96598
1:6:3,0,-1,103403,96597
5:5:4,0,-1,103404,96596
4:4:5,0,-1,103405,96595
1:6:3,0,-1,103406,96594
2:1:4,1,1,103405,96595
1:5:6,0,-1,103406,96594
1:1:4,0,-1,103407,96593
3:4:4,0,-1,103408,96592
5:1:5,0,-1,103409,96591
1:5:5,0,-1,103410,96590
4:5:3,0,-1,103411,96589
6:6:6,0,-1,103412,96588
3:3:5,0,-1,103413,96587
3:3:3,0,-1,103414,96586
4:4:5,0,-1,103415,96585
1:4:1,0,-1,103416,96584
5:5:1,0,-1,103417,96583
6:5:3,0,-1,103418,96582
5:1:2,1,1,103417,96583
3:3:6,0,-1,103418,96582
5:3:2,1,1,103417,96583
2:5:6,1,1,103416,96584
5:3:5,0,-1,103417,96583
1:4:6,0,-1,103418,96582
6:2:2,2,2,103416,96584
3:2:1,1,1,103415,96585
1:6:3,0,-1,103416,96584
3:2:6,1,1,103415,96585
6:1:6,0,-1,103416,96584
1:2:4,1,1,103415,96585
1:2:1,1,1,103414,96586
2:2:5,2,2,103412,96588
1:5:4,0,-1,103413,96587
3:6:4,0,-1,103414,96586
3:2:3,1,1,103413,96587
6:6:1,0,-1,103414,96586
5:2:4,1,1,103413,96587
3:2:3,1,1,103412,96588
6:4:2,1,1,103411,96589
5:6:6,0,-1,103412,96588
6:5:1,0,-1,103413,96587
5:4:5,0,-1,103414,96586
5:1:2,1,1,103413,96587
5:2:5,1,1,103412,96588
1:6:6,0,-1,103413,96587
6:5:4,0,-1,103414,96586
4:3:6,0,-1,103415,96585
3:1:2,1,1,103414,96586
6:4:1,0,-1,103415,96585
4:3:1,0,-1,103416,96584
6:6:1,0,-1,103417,96583
1:6:2,1,1,103416,96584
3:4:1,0,-1,103417,96583
4:3:3,0,-1,103418,96582
3:6:5,0,-1,103419,96581
3:2:5,1,1,103418,96582
5:6:4,0,-1,103419,96581
3:5:2,1,1,103418,96582
2:3:2,2,2,103416,96584
6:5:4,0,-1,103417,96583
1:2:1,1,1,103416,96584
5:1:6,0,-1,103417,96583
1:2:5,1,1,103416,96584
1:4:1,0,-1,103417,96583
2:4:5,1,1,103416,96584
1:1:1,0,-1,103417,96583
4:6:4,0,-1,103418,96582
1:5:3,0,-1,103419,96581
5:5:4,0,-1,103420,96580
4:4:3,0,-1,103421,96579
5:2:3,1,1,103420,96580
5:6:3,0,-1,103421,96579
2:6:5,1,1,103420,96580
6:3:2,1,1,103419,96581
4:2:2,2,2,103417,96583
6:2:2,2,2,103415,96585
2:4:5,1,1,103414,96586
2:1:5,1,1,103413,96587
2:5:3,1,1,103412,96588
1:1:5,0,-1,103413,96587
1:6:5,0,-1,103414,96586
6:3:1,0,-1,103415,96585
2:1:2,2,2,103413,96587
3:1:3,0,-1,103414,96586
2:2:6,2,2,103412,96588
1:4:3,0,-1,103413,96587
5:4:4,0,-1,103414,96586
5:1:1,0,-1,103415,96585
3:2:6,1,1,103414,96586
1:6:5,0,-1,103415,96585
6:4:5,0,-1,103416,96584
3:3:6,0,-1,103417,96583
5:4:4,0,-1,103418,96582
2:4:4,1,1,103417,96583
5:1:4,0,-1,103418,96582
6:3:1,0,-1,103419,96581
4:5:3,0,-1,103420,96580
6:1:3,0,-1,103421,96579
4:3:4,0,-1,103422,96578
3:6:1,0,-1,103423,96577
6:2:5,1,1,103422,96578
2:1:5,1,1,103421,96579
2:3:2,2,2,103419,96581
1:3:1,0,-1,103420,96580
5:2:6,1,1,103419,96581
3:4:1,0,-1,103420,96580
3:6:5,0,-1,103421,96579
4:1:1,0,-1,103422,96578
4:4:2,1,1,103421,96579
3:4:5,0,-1,103422,96578
2:3:6,1,1,103421,96579
6:4:3,0,-1,103422,96578
5:6:1,0,-1,103423,96577
5:3:4,0,-1,103424,96576
1:6:2,1,1,103423,96577
3:5:4,0,-1,103424,96576
5:3:4,0,-1,103425,96575
1:1:5,0,-1,103426,96574
3:4:6,0,-1,103427,96573
6:6:6,0,-1,103428,96572
5:2:1,1,1,103427,96573
5:4:1,0,-1,103428,96572
3:5:1,0,-1,103429,96571
4:4:1,0,-1,103430,96570
3:4:1,0,-1,103431,96569
6:5:1,0,-1,103432,96568
4:3:5,0,-1,103433,96567
5:2:1,1,1,103432,96568
6:5:6,0,-1,103433,96567
3:1:6,0,-1,103434,96566
4:4:1,0,-1,103435,96565
5:3:1,0,-1,103436,96564
6:4:1,0,-1,103437,96563
1:3:1,0,-1,103438,96562
1:3:5,0,-1,103439,96561
2:5:2,2,2,103437,96563
2:5:2,2,2,103435,96565
4:5:3,0,-1,103436,96564
1:6:6,0,-1,103437,96563
1:1:3,0,-1,103438,96562
6:6:5,0,-1,103439,96561
3:6:1,0,-1,103440,96560
4:2:3,1,1,103439,96561
1:1:4,0,-1,103440,96560
1:6:4,0,-1,103441,96559
2:1:2,2,2,103439,96561
1:2:1,1,1,103438,96562
3:6:5,0,-1,103439,96561
2:2:1,2,2,103437,96563
4:2:3,1,1,103436,96564
1:1:2,1,1,103435,96565
2:1:1,1,1,103434,96566
4:2:5,1,1,103433,96567
2:4:2,2,2,103431,96569
6:4:5,0,-1,103432,96568
6:5:6,0,-1,103433,96567
1:4:3,0,-1,103434,96566
1:4:1,0,-1,103435,96565
3:1:4,0,-1,103436,96564
1:5:5,0,-1,103437,96563
5:3:3,0,-1,103438,96562
5:1:2,1,1,103437,96563
1:2:2,2,2,103435,96565
4:1:2,1,1,103434,96566
5:1:6,0,-1,103435,96565
1:2:3,1,1,103434,96566
2:1:1,1,1,103433,96567
1:5:2,1,1,103432,96568
4:6:2,1,1,103431,96569
6:3:6,0,-1,103432,96568
4:6:6,0,-1,103433,96567
2:2:1,2,2,103431,96569
4:2:1,1,1,103430,96570
6:3:6,0,-1,103431,96569
6:5:1,0,-1,103432,96568
2:6:5,1,1,103431,96569
4:1:6,0,-1,103432,96568
2:5:3,1,1,103431,96569
5:6:3,0,-1,103432,96568
5:2:5,1,1,103431,96569
2:4:1,1,1,103430,96570
1:3:5,0,-1,103431,96569
3:3:3,0,-1,103432,96568
2:5:2,2,2,103430,96570
3:4:2,1,1,103429,96571
1:2:5,1,1,103428,96572
5:6:3,0,-1,103429,96571
3:1:3,0,-1,103430,96570
1:6:1,0,-1,103431,96569
4:1:2,1,1,103430,96570
4:4:1,0,-1,103431,96569
2:3:4,1,1,103430,96570
5:6:2,1,1,103429,96571
4:2:2,2,2,103427,96573
6:5:4,0,-1,103428,96572
6:3:4,0,-1,103429,96571
4:5:3,0,-1,103430,96570
1:2:2,2,2,103428,96572
5:3:5,0,-1,103429,96571
3:4:3,0,-1,103430,96570
6:4:1,0,-1,103431,96569
4:6:2,1,1,103430,96570
6:4:3,0,-1,103431,96569
2:3:6,1,1,103430,96570
6:1:3,0,-1,103431,96569
3:5:2,1,1,103430,96570
4:6:1,0,-1,103431,96569
1:4:6,0,-1,103432,96568
3:4:5,0,-1,103433,96567
2:1:1,1,1,103432,96568
1:2:3,1,1,103431,96569
1:3:2,1,1,103430,96570
5:5:6,0,-1,103431,96569
3:3:3,0,-1,103432,96568
2:2:1,2,2,103430,96570
6:5:1,0,-1,103431,96569
4:1:4,0,-1,103432,96568
1:1:2,1,1,103431,96569
4:5:5,0,-1,103432,96568
2:6:2,2,2,103430,96570
4:6:5,0,-1,103431,96569
5:5:3,0,-1,103432,96568
2:5:3,1,1,103431,96569
1:2:6,1,1,103430,96570
2:4:6,1,1,103429,96571
6:6:6,0,-1,103430,96570
5:4:3,0,-1,103431,96569
5:4:6,0,-1,103432,96568
4:2:5,1,1,103431,96569
4:2:5,1,1,103430,96570
4:6:1,0,-1,103431,96569
1:6:2,1,1,103430,96570
3:3:5,0,-1,103431,96569
6:2:5,1,1,103430,96570
4:3:6,0,-1,103431,96569
4:1:3,0,-1,103432,96568
3:2:2,2,2,103430,96570
6:5:6,0,-1,103431,96569
4:5:6,0,-1,103432,96568
1:2:5,1,1,103431,96569
6:3:3,0,-1,103432,96568
5:1:1,0,-1,103433,96567
6:4:6,0,-1,103434,96566
5:4:5,0,-1,103435,96565
5:4:1,0,-1,103436,96564
6:2:1,1,1,103435,96565
2:6:1,1,1,103434,96566
6:6:6,0,-1,103435,96565
4:1:4,0,-1,103436,96564
2:1:6,1,1,103435,96565
4:4:6,0,-1,103436,96564
1:1:1,0,-1,103437,96563
4:1:5,0,-1,103438,96562
5:4:2,1,1,103437,96563
2:3:1,1,1,103436,96564
2:6:5,1,1,103435,96565
1:5:2,1,1,103434,96566
2:6:1,1,1,103433,96567
1:6:3,0,-1,103434,96566
5:1:5,0,-1,103435,96565
3:5:1,0,-1,103436,96564
2:4:5,1,1,103435,96565
4:3:4,0,-1,103436,96564
5:6:3,0,-1,103437,96563
1:6:2,1,1,103436,96564
2:5:4,1,1,103435,96565
4:1:6,0,-1,103436,96564
2:5:5,1,1,103435,96565
1:2:1,1,1,103434,96566
6:2:3,1,1,103433,96567
1:1:3,0,-1,103434,96566
2:5:1,1,1,103433,96567
1:2:5,1,1,103432,96568
3:4:1,0,-1,103433,96567
5:1:1,0,-1,103434,96566
2:2:4,2,2,103432,96568
6:4:4,0,-1,103433,96567
6:1:5,0,-1,103434,96566
6:4:5,0,-1,103435,96565
4:4:4,0,-1,103436,96564
2:5:5,1,1,103435,96565
1:3:1,0,-1,103436,96564
5:5:3,0,-1,103437,96563
2:4:1,1,1,103436,96564
5:5:3,0,-1,103437,96563
2:5:3,1,1,103436,96564
2:5:2,2,2,103434,96566
1:6:2,1,1,103433,96567
5:2:3,1,1,103432,96568
3:1:5,0,-1,103433,96567
4:5:2,1,1,103432,96568
2:6:5,1,1,103431,96569
5:1:4,0,-1,103432,96568
5:5:2,1,1,103431,96569
3:6:5,0,-1,103432,96568
2:5:5,1,1,103431,96569
4:1:6,0,-1,103432,96568
1:3:3,0,-1,103433,96567
5:6:6,0,-1,103434,96566
5:1:3,0,-1,103435,96565
1:4:5,0,-1,103436,96564
3:3:5,0,-1,103437,96563
1:2:1,1,1,103436,96564
1:6:4,0,-1,103437,96563
6:4:5,0,-1,103438,96562
2:3:5,1,1,103437,96563
1:5:4,0,-1,103438,96562
2:5:3,1,1,103437,96563
2:5:3,1,1,103436,96564
1:5:5,0,-1,103437,96563
3:2:2,2,2,103435,96565
3:5:3,0,-1,103436,96564
4:5:1,0,-1,103437,96563
6:6:5,0,-1,103438,96562
3:4:1,0,-1,103439,96561
2:1:6,1,1,103438,96562
2:3:2,2,2,103436,96564
3:5:3,0,-1,103437,96563
2:4:2,2,2,103435,96565
1:2:6,1,1,103434,96566
3:1:3,0,-1,103435,96565
5:5:4,0,-1,103436,96564
1:5:1,0,-1,103437,96563
6:6:2,1,1,103436,96564
1:4:2,1,1,103435,96565
2:3:4,1,1,103434,96566
6:4:5,0,-1,103435,96565
4:2:6,1,1,103434,96566
1:6:2,1,1,103433,96567
3:1:3,0,-1,103434,96566
1:2:3,1,1,103433,96567
5:2:4,1,1,103432,96568
3:2:1,1,1,103431,96569
2:1:4,1,1,103430,96570
5:3:6,0,-1,103431,96569
2:2:6,2,2,103429,96571
4:6:6,0,-1,103430,96570
2:2:2,3,3,103427,96573
6:5:4,0,-1,103428,96572
6:5:5,0,-1,103429,96571
2:2:6,2,2,103427,96573
3:5:4,0,-1,103428,96572
4:4:3,0,-1,103429,96571
6:5:5,0,-1,103430,96570
3:5:3,0,-1,103431,96569
1:5:5,0,-1,103432,96568
6:4:6,0,-1,103433,96567
5:1:6,0,-1,103434,96566
3:4:2,1,1,103433,96567
1:2:5,1,1,103432,96568
5:6:6,0,-1,103433,96567
3:2:4,1,1,103432,96568
6:6:1,0,-1,103433,96567
5:4:1,0,-1,103434,96566
1:3:3,0,-1,103435,96565
4:3:5,0,-1,103436,96564
4:1:2,1,1,103435,96565
4:5:2,1,1,103434,96566
1:1:2,1,1,103433,96567
4:2:3,1,1,103432,96568
5:3:3,0,-1,103433,96567
4:2:4,1,1,103432,96568
5:5:1,0,-1,103433,96567
3:5:3,0,-1,103434,96566
5:3:1,0,-1,103435,96565
6:1:4,0,-1,103436,96564
1:4:1,0,-1,103437,96563
5:5:4,0,-1,103438,96562
2:2:2,3,3,103435,96565
3:6:3,0,-1,103436,96564
3:3:3,0,-1,103437,96563
3:6:1,0,-1,103438,96562
5:3:2,1,1,103437,96563
6:6:3,0,-1,103438,96562
3:4:4,0,-1,103439,96561
3:5:2,1,1,103438,96562
5:6:2,1,1,103437,96563
2:1:4,1,1,103436,96564
1:2:1,1,1,103435,96565
4:2:3,1,1,103434,96566
2:3:4,1,1,103433,96567
2:3:6,1,1,103432,96568
2:4:5,1,1,103431,96569
3:4:6,0,-1,103432,96568
6:6:5,0,-1,103433,96567
4:5:4,0,-1,103434,96566
5:2:5,1,1,103433,96567
1:2:1,1,1,103432,96568
6:1:6,0,-1,103433,96567
3:3:3,0,-1,103434,96566
6:4:6,0,-1,103435,96565
4:4:2,1,1,103434,96566
1:1:1,0,-1,103435,96565
3:5:1,0,-1,103436,96564
2:3:6,1,1,103435,96565
1:4:5,0,-1,103436,96564
5:3:4,0,-1,103437,96563
5:6:4,0,-1,103438,96562
2:4:6,1,1,103437,96563
1:2:2,2,2,103435,96565
3:1:6,0,-1,103436,96564
4:3:5,0,-1,103437,96563
3:6:5,0,-1,103438,96562
1:5:2,1,1,103437,96563
6:6:6,0,-1,103438,96562
1:5:4,0,-1,103439,96561
5:1:1,0,-1,103440,96560
6:2:6,1,1,103439,96561
1:4:2,1,1,103438,96562
4:3:2,1,1,103437,96563
3:6:4,0,-1,103438,96562
1:6:1,0,-1,103439,96561
4:5:2,1,1,103438,96562
4:5:5,0,-1,103439,96561
5:3:3,0,-1,103440,96560
3:6:1,0,-1,103441,96559
5:3:4,0,-1,103442,96558
4:2:1,1,1,103441,96559
1:6:4,0,-1,103442,96558
6:2:2,2,2,103440,96560
6:2:5,1,1,103439,96561
1:5:3,0,-1,103440,96560
3:3:6,0,-1,103441,96559
5:3:1,0,-1,103442,96558
3:1:6,0,-1,103443,96557
3:6:3,0,-1,103444,96556
6:1:4,0,-1,103445,96555
1:5:4,0,-1,103446,96554
2:1:5,1,1,103445,96555
6:5:6,0,-1,103446,96554
2:1:1,1,1,103445,96555
6:6:5,0,-1,103446,96554
3:6:6,0,-1,103447,96553
5:2:6,1,1,103446,96554
5:4:5,0,-1,103447,96553
4:1:4,0,-1,103448,96552
6:6:6,0,-1,103449,96551
1:6:2,1,1,103448,96552
2:5:3,1,1,103447,96553
1:1:4,0,-1,103448,96552
4:5:5,0,-1,103449,96551
1:1:3,0,-1,103450,96550
5:1:3,0,-1,103451,96549
5:1:1,0,-1,103452,96548
6:2:4,1,1,103451,96549
1:5:1,0,-1,103452,96548
5:3:6,0,-1,103453,96547
6:1:5,0,-1,103454,96546
5:1:1,0,-1,103455,96545
5:2:5,1,1,103454,96546
5:3:5,0,-1,103455,96545
4:2:2,2,2,103453,96547
3:4:4,0,-1,103454,96546
3:5:3,0,-1,103455,96545
5:3:6,0,-1,103456,96544
5:4:4,0,-1,103457,96543
2:3:6,1,1,103456,96544
4:2:6,1,1,103455,96545
3:6:1,0,-1,103456,96544
5:6:4,0,-1,103457,96543
5:4:4,0,-1,103458,96542
6:4:6,0,-1,103459,96541
5:5:2,1,1,103458,96542
4:1:5,0,-1,103459,96541
1:2:5,1,1,103458,96542
5:2:4,1,1,103457,96543
1:1:4,0,-1,103458,96542
2:3:2,2,2,103456,96544
6:1:2,1,1,103455,96545
2:1:6,1,1,103454,96546
4:5:6,0,-1,103455,96545
5:2:1,1,1,103454,96546
2:3:6,1,1,103453,96547
1:6:6,0,-1,103454,96546
1:3:1,0,-1,103455,96545
3:1:1,0,-1,103456,96544
3:3:4,0,-1,103457,96543
3:1:4,0,-1,103458,96542
6:4:3,0,-1,103459,96541
1:4:5,0,-1,103460,96540
4:2:3,1,1,103459,96541
1:2:6,1,1,103458,96542
4:1:3,0,-1,103459,96541
4:4:3,0,-1,103460,96540
4:2:3,1,1,103459,96541
5:3:6,0,-1,103460,96540
2:2:1,2,2,103458,96542
1:5:5,0,-1,103459,96541
6:5:2,1,1,103458,96542
6:1:4,0,-1,103459,96541
6:6:6,0,-1,103460,96540
6:4:2,1,1,103459,96541
6:3:4,0,-1,103460,96540
6:6:3,0,-1,103461,96539
3:4:1,0,-1,103462,96538
3:4:4,0,-1,103463,96537
4:4:5,0,-1,103464,96536
6:2:3,1,1,103463,96537
4:3:1,0,-1,103464,96536
5:2:4,1,1,103463,96537
4:2:4,1,1,103462,96538
4:3:4,0,-1,103463,96537
4:5:3,0,-1,103464,96536
3:1:5,0,-1,103465,96535
4:4:4,0,-1,103466,96534
5:2:1,1,1,103465,96535
6:2:3,1,1,103464,96536
4:1:1,0,-1,103465,96535
6:4:1,0,-1,103466,96534
2:2:2,3,3,103463,96537
5:3:6,0,-1,103464,96536
4:6:4,0,-1,103465,96535
3:4:3,0,-1,103466,96534
2:1:4,1,1,103465,96535
1:2:6,1,1,103464,96536
3:2:6,1,1,103463,96537
1:4:6,0,-1,103464,96536
5:5:6,0,-1,103465,96535
1:2:2,2,2,103463,96537
2:6:1,1,1,103462,96538
1:3:2,1,1,103461,96539
1:4:5,0,-1,103462,96538
1:2:2,2,2,103460,96540
5:2:5,1,1,103459,96541
4:5:3,0,-1,103460,96540
3:5:2,1,1,103459,96541
3:2:5,1,1,103458,96542
5:6:1,0,-1,103459,96541
2:6:2,2,2,103457,96543
1:1:6,0,-1,103458,96542
4:6:2,1,1,103457,96543
3:1:3,0,-1,103458,96542
3:4:3,0,-1,103459,96541
4:6:2,1,1,103458,96542
2:3:1,1,1,103457,96543
2:6:2,2,2,103455,96545
6:3:1,0,-1,103456,96544
4:4:5,0,-1,103457,96543
3:4:6,0,-1,103458,96542
3:3:2,1,1,103457,96543
2:3:4,1,1,103456,96544
1:3:3,0,-1,103457,96543
5:6:4,0,-1,103458,96542
1:3:4,0,-1,103459,96541
5:2:3,1,1,103458,96542
2:1:5,1,1,103457,96543
5:4:3,0,-1,103458,96542
3:6:4,0,-1,103459,96541
2:5:5,1,1,103458,96542
4:2:6,1,1,103457,96543
1:3:6,0,-1,103458,96542
5:1:6,0,-1,103459,96541
6:4:3,0,-1,103460,96540
1:3:6,0,-1,103461,96539
4:5:4,0,-1,103462,96538
2:4:4,1,1,103461,96539
2:6:2,2,2,103459,96541
4:4:5,0,-1,103460,96540
1:4:2,1,1,103459,96541
5:2:3,1,1,103458,96542
2:2:6,2,2,103456,96544
6:5:4,0,-1,103457,96543
4:4:4,0,-1,103458,96542
5:5:6,0,-1,103459,96541
4:4:5,0,-1,103460,96540
4:3:3,0,-1,103461,96539
5:3:1,0,-1,103462,96538
5:2:6,1,1,103461,96539
4:3:4,0,-1,103462,96538
6:2:6,1,1,103461,96539
2:6:5,1,1,103460,96540
6:3:3,0,-1,103461,96539
4:5:6,0,-1,103462,96538
6:5:4,0,-1,103463,96537
1:5:2,1,1,103462,96538
4:3:4,0,-1,103463,96537
3:6:4,0,-1,103464,96536
3:2:3,1,1,103463,96537
3:2:1,1,1,103462,96538
3:4:5,0,-1,103463,96537
1:1:6,0,-1,103464,96536
1:1:3,0,-1,103465,96535
1:6:1,0,-1,103466,96534
6:3:4,0,-1,103467,96533
6:5:3,0,-1,103468,96532
1:3:3,0,-1,103469,96531
3:4:1,0,-1,103470,96530
1:5:6,0,-1,103471,96529
2:4:1,1,1,103470,96530
3:3:1,0,-1,103471,96529
1:5:4,0,-1,103472,96528
1:1:2,1,1,103471,96529
1:4:1,0,-1,103472,96528
5:3:1,0,-1,103473,96527
3:5:2,1,1,103472,96528
6:4:5,0,-1,103473,96527
5:5:4,0,-1,103474,96526
1:5:5,0,-1,103475,96525
4:4:2,1,1,103474,96526
4:3:4,0,-1,103475,96525
4:1:5,0,-1,103476,96524
4:2:1,1,1,103475,96525
1:6:3,0,-1,103476,96524
2:3:6,1,1,103475,96525
2:6:6,1,1,103474,96526
1:6:3,0,-1,103475,96525
4:3:3,0,-1,103476,96524
1:3:5,0,-1,103477,96523
3:3:6,0,-1,103478,96522
6:1:1,0,-1,103479,96521
6:6:2,1,1,103478,96522
3:4:4,0,-1,103479,96521
3:5:2,1,1,103478,96522
2:6:3,1,1,103477,96523
4:2:4,1,1,103476,96524
6:4:2,1,1,103475,96525
6:3:1,0,-1,103476,96524
3:2:1,1,1,103475,96525
5:6:4,0,-1,103476,96524
5:2:5,1,1,103475,96525
3:4:1,0,-1,103476,96524
5:2:4,1,1,103475,96525
6:5:1,0,-1,103476,96524
6:5:3,0,-1,103477,96523
4:2:5,1,1,103476,96524
2:4:3,1,1,103475,96525
6:3:1,0,-1,103476,96524
5:4:1,0,-1,103477,96523
3:1:5,0,-1,103478,96522
4:1:1,0,-1,103479,96521
6:5:4,0,-1,103480,96520
1:6:4,0,-1,103481,96519
2:2:2,3,3,103478,96522
5:5:2,1,1,103477,96523
3:1:1,0,-1,103478,96522
6:1:4,0,-1,103479,96521
6:6:4,0,-1,103480,96520
4:1:3,0,-1,103481,96519
4:2:1,1,1,103480,96520
1:4:3,0,-1,103481,96519
2:2:6,2,2,103479,96521
1:2:2,2,2,103477,96523
3:3:4,0,-1,103478,96522
6:5:2,1,1,103477,96523
4:3:2,1,1,103476,96524
2:2:3,2,2,103474,96526
5:1:1,0,-1,103475,96525
1:2:2,2,2,103473,96527
5:3:1,0,-1,103474,96526
4:4:2,1,1,103473,96527
4:1:6,0,-1,103474,96526
1:3:3,0,-1,103475,96525
2:2:6,2,2,103473,96527
2:5:4,1,1,103472,96528
5:3:5,0,-1,103473,96527
3:1:2,1,1,103472,96528
6:5:1,0,-1,103473,96527
3:5:1,0,-1,103474,96526
6:2:2,2,2,103472,96528
6:1:5,0,-1,103473,96527
1:5:3,0,-1,103474,96526
5:2:1,1,1,103473,96527
6:4:6,0,-1,103474,96526
5:5:5,0,-1,103475,96525
3:6:6,0,-1,103476,96524
3:4:5,0,-1,103477,96523
2:4:1,1,1,103476,96524
5:2:2,2,2,103474,96526
4:6:4,0,-1,103475,96525
1:5:6,0,-1,103476,96524
1:2:5,1,1,103475,96525
1:1:4,0,-1,103476,96524
6:1:4,0,-1,103477,96523
6:3:3,0,-1,103478,96522
2:3:2,2,2,103476,96524
4:2:3,1,1,103475,96525
6:5:2,1,1,103474,96526
2:3:2,2,2,103472,96528
3:2:6,1,1,103471,96529
6:4:6,0,-1,103472,96528
1:2:4,1,1,103471,96529
5:1:6,0,-1,103472,96528
1:4:4,0,-1,103473,96527
4:5:2,1,1,103472,96528
4:2:6,1,1,103471,96529
4:4:5,0,-1,103472,96528
1:2:4,1,1,103471,96529
3:5:3,0,-1,103472,96528
1:5:4,0,-1,103473,96527
2:1:1,1,1,103472,96528
2:4:3,1,1,103471,96529
3:2:4,1,1,103470,96530
6:2:4,1,1,103469,96531
3:5:3,0,-1,103470,96530
4:6:3,0,-1,103471,96529
3:1:6,0,-1,103472,96528
3:4:6,0,-1,103473,96527
6:2:2,2,2,103471,96529
3:6:1,0,-1,103472,96528
5:6:4,0,-1,103473,96527
5:2:4,1,1,103472,96528
5:5:4,0,-1,103473,96527
3:1:4,0,-1,103474,96526
2:5:4,1,1,103473,96527
4:6:4,0,-1,103474,96526
5:6:2,1,1,103473,96527
1:2:3,1,1,103472,96528
5:2:6,1,1,103471,96529
2:1:2,2,2,103469,96531
2:3:5,1,1,103468,96532
6:5:4,0,-1,103469,96531
5:6:6,0,-1,103470,96530
6:4:6,0,-1,103471,96529
5:4:1,0,-1,103472,96528
1:4:3,0,-1,103473,96527
4:5:6,0,-1,103474,96526
6:2:1,1,1,103473,96527
5:6:2,1,1,103472,96528
1:3:6,0,-1,103473,96527
2:3:3,1,1,103472,96528
3:1:5,0,-1,103473,96527
1:1:6,0,-1,103474,96526
4:6:4,0,-1,103475,96525
1:2:5,1,1,103474,96526
2:4:1,1,1,103473,96527
1:1:1,0,-1,103474,96526
1:2:1,1,1,103473,96527
1:4:2,1,1,103472,96528
2:4:1,1,1,103471,96529
4:1:6,0,-1,103472,96528
5:2:3,1,1,103471,96529
5:2:2,2,2,103469,96531
2:5:4,1,1,103468,96532
1:1:2,1,1,103467,96533
2:5:2,2,2,103465,96535
2:1:3,1,1,103464,96536
6:3:1,0,-1,103465,96535
6:6:3,0,-1,103466,96534
2:6:4,1,1,103465,96535
4:3:2,1,1,103464,96536
1:5:2,1,1,103463,96537
5:4:1,0,-1,103464,96536
3:4:2,1,1,103463,96537
1:4:4,0,-1,103464,96536
3:3:3,0,-1,103465,96535
5:6:3,0,-1,103466,96534
4:5:5,0,-1,103467,96533
6:6:3,0,-1,103468,96532
3:3:3,0,-1,103469,96531
3:3:2,1,1,103468,96532
6:3:5,0,-1,103469,96531
1:2:1,1,1,103468,96532
1:3:4,0,-1,103469,96531
4:6:3,0,-1,103470,96530
2:6:1,1,1,103469,96531
5:1:3,0,-1,103470,96530
1:5:4,0,-1,103471,96529
3:2:5,1,1,103470,96530
3:5:5,0,-1,103471,96529
4:4:1,0,-1,103472,96528
1:4:4,0,-1,103473,96527
5:1:6,0,-1,103474,96526
3:2:1,1,1,103473,96527
5:1:1,0,-1,103474,96526
4:5:6,0,-1,103475,96525
4:2:5,1,1,103474,96526
4:6:6,0,-1,103475,96525
3:1:4,0,-1,103476,96524
2:4:1,1,1,103475,96525
3:4:4,0,-1,103476,96524
5:2:1,1,1,103475,96525
1:5:4,0,-1,103476,96524
4:1:4,0,-1,103477,96523
1:5:2,1,1,103476,96524
5:3:3,0,-1,103477,96523
5:4:3,0,-1,103478,96522
6:1:6,0,-1,103479,96521
1:2:5,1,1,103478,96522
4:6:5,0,-1,103479,96521
1:2:6,1,1,103478,96522
3:5:2,1,1,103477,96523
6:4:3,0,-1,103478,96522
6:6:5,0,-1,103479,96521
6:4:6,0,-1,103480,96520
4:1:4,0,-1,103481,96519
4:3:5,0,-1,103482,96518
4:6:6,0,-1,103483,96517
2:3:4,1,1,103482,96518
2:2:5,2,2,103480,96520
5:1:6,0,-1,103481,96519
2:6:1,1,1,103480,96520
2:2:5,2,2,103478,96522
2:6:5,1,1,103477,96523
1:3:3,0,-1,103478,96522
6:3:4,0,-1,103479,96521
6:6:3,0,-1,103480,96520
6:3:6,0,-1,103481,96519
2:1:3,1,1,103480,96520
6:3:3,0,-1,103481,96519
5:5:6,0,-1,103482,96518
4:2:5,1,1,103481,96519
4:2:5,1,1,103480,96520
6:3:6,0,-1,103481,96519
6:5:4,0,-1,103482,96518
5:2:2,2,2,103480,96520
1:4:4,0,-1,103481,96519
1:4:5,0,-1,103482,96518
2:2:4,2,2,103480,96520
5:4:3,0,-1,103481,96519
4:3:6,0,-1,103482,96518
5:6:3,0,-1,103483,96517
2:3:3,1,1,103482,96518
1:4:5,0,-1,103483,96517
4:5:6,0,-1,103484,96516
3:1:4,0,-1,103485,96515
4:2:2,2,2,103483,96517
3:2:6,1,1,103482,96518
4:3:4,0,-1,103483,96517
1:1:1,0,-1,103484,96516
5:3:3,0,-1,103485,96515
5:6:5,0,-1,103486,96514
4:4:3,0,-1,103487,96513
5:6:6,0,-1,103488,96512
2:3:1,1,1,103487,96513
4:3:5,0,-1,103488,96512
1:5:2,1,1,103487,96513
3:2:2,2,2,103485,96515
2:4:1,1,1,103484,96516
5:3:1,0,-1,103485,96515
4:6:4,0,-1,103486,96514
5:1:2,1,1,103485,96515
4:2:1,1,1,103484,96516
5:6:2,1,1,103483,96517
4:5:6,0,-1,103484,96516
5:3:6,0,-1,103485,96515
4:1:1,0,-1,103486,96514
5:2:4,1,1,103485,96515
1:3:3,0,-1,103486,96514
5:1:1,0,-1,103487,96513
4:5:5,0,-1,103488,96512
2:6:3,1,1,103487,96513
3:1:3,0,-1,103488,96512
1:5:1,0,-1,103489,96511
6:5:3,0,-1,103490,96510
1:2:4,1,1,103489,96511
5:5:4,0,-1,103490,96510
2:1:3,1,1,103489,96511
3:5:2,1,1,103488,96512
2:5:5,1,1,103487,96513
6:3:4,0,-1,103488,96512
5:6:6,0,-1,103489,96511
2:2:4,2,2,103487,96513
5:4:6,0,-1,103488,96512
6:3:1,0,-1,103489,96511
2:3:5,1,1,103488,96512
5:5:2,1,1,103487,96513
3:6:3,0,-1,103488,96512
5:6:6,0,-1,103489,96511
5:3:3,0,-1,103490,96510
5:4:4,0,-1,103491,96509
4:5:6,0,-1,103492,96508
5:5:5,0,-1,103493,96507
5:6:6,0,-1,103494,96506
3:5:3,0,-1,103495,96505
6:1:3,0,-1,103496,96504
6:5:2,1,1,103495,96505
5:1:4,0,-1,103496,96504
5:5:4,0,-1,103497,96503
1:5:6,0,-1,103498,96502
4:4:2,1,1,103497,96503
6:3:6,0,-1,103498,96502
4:2:1,1,1,103497,96503
1:4:1,0,-1,103498,96502
1:1:3,0,-1,103499,96501
1:5:4,0,-1,103500,96500
5:4:6,0,-1,103501,96499
3:4:6,0,-1,103502,96498
6:1:6,0,-1,103503,96497
3:2:5,1,1,103502,96498
3:1:2,1,1,103501,96499
2:2:4,2,2,103499,96501
1:3:6,0,-1,103500,96500
1:4:3,0,-1,103501,96499
3:2:1,1,1,103500,96500
4:2:6,1,1,103499,96501
3:3:1,0,-1,103500,96500
1:4:3,0,-1,103501,96499
3:2:1,1,1,103500,96500
3:4:2,1,1,103499,96501
6:3:4,0,-1,103500,96500
5:3:1,0,-1,103501,96499
4:4:1,0,-1,103502,96498
5:5:4,0,-1,103503,96497
4:3:6,0,-1,103504,96496
4:4:5,0,-1,103505,96495
4:6:4,0,-1,103506,96494
4:4:1,0,-1,103507,96493
5:4:3,0,-1,103508,96492
2:1:4,1,1,103507,96493
2:4:4,1,1,103506,96494
3:5:6,0,-1,103507,96493
6:6:6,0,-1,103508,96492
4:2:2,2,2,103506,96494
2:5:5,1,1,103505,96495
1:6:4,0,-1,103506,96494
4:4:5,0,-1,103507,96493
4:3:4,0,-1,103508,96492
3:6:4,0,-1,103509,96491
6:6:6,0,-1,103510,96490
1:4:4,0,-1,103511,96489
5:4:5,0,-1,103512,96488
5:2:2,2,2,103510,96490
3:2:4,1,1,103509,96491
5:2:4,1,1,103508,96492
5:3:2,1,1,103507,96493
3:1:3,0,-1,103508,96492
1:2:3,1,1,103507,96493
2:1:5,1,1,103506,96494
5:1:6,0,-1,103507,96493
2:3:2,2,2,103505,96495
3:3:3,0,-1,103506,96494
2:5:3,1,1,103505,96495
6:4:2,1,1,103504,96496
6:3:5,0,-1,103505,96495
5:5:2,1,1,103504,96496
4:2:3,1,1,103503,96497
6:5:5,0,-1,103504,96496
1:3:5,0,-1,103505,96495
5:6:5,0,-1,103506,96494
3:5:3,0,-1,103507,96493
3:2:4,1,1,103506,96494
4:3:5,0,-1,103507,96493
5:2:2,2,2,103505,96495
4:4:5,0,-1,103506,96494
1:3:4,0,-1,103507,96493
5:5:2,1,1,103506,96494
2:3:3,1,1,103505,96495
1:4:2,1,1,103504,96496
3:3:4,0,-1,103505,96495
6:6:2,1,1,103504,96496
6:3:3,0,-1,103505,96495
1:1:1,0,-1,103506,96494
4:2:3,1,1,103505,96495
2:6:3,1,1,103504,96496
2:2:3,2,2,103502,96498
4:4:4,0,-1,103503,96497
5:4:4,0,-1,103504,96496
5:2:6,1,1,103503,96497
3:2:3,1,1,103502,96498
6:3:5,0,-1,103503,96497
6:1:5,0,-1,103504,96496
4:5:6,0,-1,103505,96495
1:5:6,0,-1,103506,96494
2:4:4,1,1,103505,96495
2:2:4,2,2,103503,96497
1:4:4,0,-1,103504,96496
1:2:2,2,2,103502,96498
6:5:2,1,1,103501,96499
3:1:5,0,-1,103502,96498
3:3:4,0,-1,103503,96497
1:6:3,0,-1,103504,96496
6:2:6,1,1,103503,96497
6:2:6,1,1,103502,96498
2:2:1,2,2,103500,96500
5:1:3,0,-1,103501,96499
2:4:4,1,1,103500,96500
1:5:1,0,-1,103501,96499
5:3:1,0,-1,103502,96498
3:2:3,1,1,103501,96499
1:6:4,0,-1,103502,96498
4:5:2,1,1,103501,96499
6:5:4,0,-1,103502,96498
6:1:5,0,-1,103503,96497
5:6:3,0,-1,103504,96496
5:2:4,1,1,103503,96497
2:5:4,1,1,103502,96498
5:6:6,0,-1,103503,96497
2:4:3,1,1,103502,96498
2:1:5,1,1,103501,96499
1:4:2,1,1,103500,96500
3:1:5,0,-1,103501,96499
3:5:2,1,1,103500,96500
5:2:4,1,1,103499,96501
6:1:4,0,-1,103500,96500
3:6:2,1,1,103499,96501
2:4:1,1,1,103498,96502
6:5:4,0,-1,103499,96501
6:5:5,0,-1,103500,96500
2:6:4,1,1,103499,96501
3:4:3,0,-1,103500,96500
3:2:6,1,1,103499,96501
4:4:4,0,-1,103500,96500
6:3:4,0,-1,103501,96499
1:5:2,1,1,103500,96500
6:3:2,1,1,103499,96501
5:2:5,1,1,103498,96502
2:6:1,1,1,103497,96503
1:3:2,1,1,103496,96504
6:4:5,0,-1,103497,96503
2:3:3,1,1,103496,96504
1:5:4,0,-1,103497,96503
3:5:5,0,-1,103498,96502
2:1:6,1,1,103497,96503
1:6:3,0,-1,103498,96502
6:2:2,2,2,103496,96504
5:3:3,0,-1,103497,96503
3:4:6,0,-1,103498,96502
6:2:5,1,1,103497,96503
5:6:1,0,-1,103498,96502
5:2:6,1,1,103497,96503
2:6:2,2,2,103495,96505
1:1:2,1,1,103494,96506
1:6:4,0,-1,103495,96505
3:3:3,0,-1,103496,96504
6:3:3,0,-1,103497,96503
2:4:6,1,1,103496,96504
5:5:5,0,-1,103497,96503
3:1:1,0,-1,103498,96502
2:4:2,2,2,103496,96504
4:5:3,0,-1,103497,96503
3:1:2,1,1,103496,96504
4:5:1,0,-1,103497,96503
1:2:6,1,1,103496,96504
6:2:6,1,1,103495,96505
5:1:5,0,-1,103496,96504
2:1:1,1,1,103495,96505
3:5:3,0,-1,103496,96504
3:6:1,0,-1,103497,96503
2:3:3,1,1,103496,96504
1:6:4,0,-1,103497,96503
4:1:6,0,-1,103498,96502
4:5:4,0,-1,103499,96501
4:2:6,1,1,103498,96502
4:4:6,0,-1,103499,96501
1:6:6,0,-1,103500,96500
4:1:3,0,-1,103501,96499
3:3:5,0,-1,103502,96498
3:5:2,1,1,103501,96499
1:3:5,0,-1,103502,96498
3:2:2,2,2,103500,96500
6:6:2,1,1,103499,96501
6:3:3,0,-1,103500,96500
2:6:2,2,2,103498,96502
2:4:1,1,1,103497,96503
6:4:4,0,-1,103498,96502
3:4:3,0,-1,103499,96501
1:4:3,0,-1,103500,96500
2:1:4,1,1,103499,96501
6:6:3,0,-1,103500,96500
3:4:6,0,-1,103501,96499
6:5:6,0,-1,103502,96498
4:2:5,1,1,103501,96499
3:2:6,1,1,103500,96500
2:5:5,1,1,103499,96501
2:2:6,2,2,103497,96503
6:1:6,0,-1,103498,96502
2:3:5,1,1,103497,96503
4:1:1,0,-1,103498,96502
6:5:3,0,-1,103499,96501
4:3:5,0,-1,103500,96500
2:5:6,1,1,103499,96501
6:2:5,1,1,103498,96502
2:5:1,1,1,103497,96503
1:4:5,0,-1,103498,96502
6:3:1,0,-1,103499,96501
1:1:3,0,-1,103500,96500
4:4:2,1,1,103499,96501
3:4:1,0,-1,103500,96500
6:3:1,0,-1,103501,96499
3:4:3,0,-1,103502,96498
3:6:4,0,-1,103503,96497
1:3:1,0,-1,103504,96496
5:2:4,1,1,103503,96497
1:1:3,0,-1,103504,96496
4:1:2,1,1,103503,96497
4:2:2,2,2,103501,96499
5:2:1,1,1,103500,96500
4:5:2,1,1,103499,96501
3:5:4,0,-1,103500,96500
6:5:4,0,-1,103501,96499
1:6:4,0,-1,103502,96498
4:3:5,0,-1,103503,96497
2:5:5,1,1,103502,96498
5:6:5,0,-1,103503,96497
1:1:5,0,-1,103504,96496
2:5:4,1,1,103503,96497
4:6:5,0,-1,103504,96496
2:2:4,2,2,103502,96498
2:2:5,2,2,103500,96500
2:4:6,1,1,103499,96501
5:1:6,0,-1,103500,96500
2:5:5,1,1,103499,96501
3:2:4,1,1,103498,96502
6:4:4,0,-1,103499,96501
3:2:2,2,2,103497,96503
3:2:5,1,1,103496,96504
4:6:2,1,1,103495,96505
6:5:5,0,-1,103496,96504
3:4:2,1,1,103495,96505
3:2:6,1,1,103494,96506
6:2:3,1,1,103493,96507
1:5:1,0,-1,103494,96506
5:1:4,0,-1,103495,96505
2:2:6,2,2,103493,96507
5:4:2,1,1,103492,96508
2:6:3,1,1,103491,96509
6:4:6,0,-1,103492,96508
5:5:1,0,-1,103493,96507
6:4:6,0,-1,103494,96506
2:3:3,1,1,103493,96507
3:6:3,0,-1,103494,96506
3:4:6,0,-1,103495,96505
6:1:3,0,-1,103496,96504
2:1:5,1,1,103495,96505
1:2:4,1,1,103494,96506
6:2:6,1,1,103493,96507
4:3:5,0,-1,103494,96506
2:2:3,2,2,103492,96508
6:3:2,1,1,103491,96509
4:6:6,0,-1,103492,96508
4:2:1,1,1,103491,96509
3:1:5,0,-1,103492,96508
6:1:1,0,-1,103493,96507
5:5:6,0,-1,103494,96506
3:3:5,0,-1,103495,96505
5:1:3,0,-1,103496,96504
4:2:1,1,1,103495,96505
2:1:4,1,1,103494,96506
2:2:1,2,2,103492,96508
2:4:6,1,1,103491,96509
4:1:2,1,1,103490,96510
5:4:1,0,-1,103491,96509
1:4:4,0,-1,103492,96508
2:2:4,2,2,103490,96510
5:2:6,1,1,103489,96511
5:4:2,1,1,103488,96512
5:2:1,1,1,103487,96513
5:5:1,0,-1,103488,96512
4:4:3,0,-1,103489,96511
1:3:2,1,1,103488,96512
3:3:1,0,-1,103489,96511
4:4:5,0,-1,103490,96510
5:3:5,0,-1,103491,96509
6:5:3,0,-1,103492,96508
3:3:3,0,-1,103493,96507
2:3:2,2,2,103491,96509
1:5:4,0,-1,103492,96508
1:6:1,0,-1,103493,96507
1:5:2,1,1,103492,96508
4:2:2,2,2,103490,96510
4:2:4,1,1,103489,96511
5:2:3,1,1,103488,96512
2:4:1,1,1,103487,96513
4:5:3,0,-1,103488,96512
2:6:5,1,1,103487,96513
4:3:2,1,1,103486,96514
5:4:6,0,-1,103487,96513
1:5:3,0,-1,103488,96512
1:2:2,2,2,103486,96514
5:1:6,0,-1,103487,96513
1:2:1,1,1,103486,96514
2:2:6,2,2,103484,96516
3:5:4,0,-1,103485,96515
4:1:4,0,-1,103486,96514
4:5:1,0,-1,103487,96513
1:5:4,0,-1,103488,96512
6:5:4,0,-1,103489,96511
2:4:1,1,1,103488,96512
1:5:6,0,-1,103489,96511
5:4:3,0,-1,103490,96510
4:4:5,0,-1,103491,96509
4:6:6,0,-1,103492,96508
5:5:3,0,-1,103493,96507
2:1:3,1,1,103492,96508
4:4:3,0,-1,103493,96507
1:4:6,0,-1,103494,96506
3:5:4,0,-1,103495,96505
5:3:3,0,-1,103496,96504
1:6:6,0,-1,103497,96503
1:5:1,0,-1,103498,96502
6:3:2,1,1,103497,96503
6:3:4,0,-1,103498,96502
3:4:1,0,-1,103499,96501
3:1:5,0,-1,103500,96500
3:1:5,0,-1,103501,96499
4:4:6,0,-1,103502,96498
2:1:3,1,1,103501,96499
2:5:2,2,2,103499,96501
5:2:5,1,1,103498,96502
2:3:3,1,1,103497,96503
4:4:3,0,-1,103498,96502
3:2:6,1,1,103497,96503
2:4:5,1,1,103496,96504
2:6:4,1,1,103495,96505
2:6:2,2,2,103493,96507
3:2:4,1,1,103492,96508
4:3:6,0,-1,103493,96507
2:6:2,2,2,103491,96509
4:4:4,0,-1,103492,96508
3:3:1,0,-1,103493,96507
5:3:3,0,-1,103494,96506
3:2:3,1,1,103493,96507
4:6:6,0,-1,103494,96506
1:2:2,2,2,103492,96508
3:4:1,0,-1,103493,96507
1:4:4,0,-1,103494,96506
1:4:4,0,-1,103495,96505
3:1:2,1,1,103494,96506
1:2:5,1,1,103493,96507
3:5:5,0,-1,103494,96506
5:2:1,1,1,103493,96507
6:2:6,1,1,103492,96508
5:2:4,1,1,103491,96509
5:4:2,1,1,103490,96510
1:1:6,0,-1,103491,96509
1:3:1,0,-1,103492,96508
6:6:1,0,-1,103493,96507
6:5:1,0,-1,103494,96506
4:6:4,0,-1,103495,96505
5:6:3,0,-1,103496,96504
2:5:5,1,1,103495,96505
3:3:2,1,1,103494,96506
6:5:3,0,-1,103495,96505
6:5:1,0,-1,103496,96504
5:1:1,0,-1,103497,96503
4:2:2,2,2,103495,96505
1:6:5,0,-1,103496,96504
3:3:1,0,-1,103497,96503
3:5:2,1,1,103496,96504
3:3:3,0,-1,103497,96503
5:6:4,0,-1,103498,96502
3:1:2,1,1,103497,96503
2:4:6,1,1,103496,96504
2:1:1,1,1,103495,96505
6:1:2,1,1,103494,96506
4:3:5,0,-1,103495,96505
1:4:3,0,-1,103496,96504
5:1:2,1,1,103495,96505
3:5:3,0,-1,103496,96504
1:4:1,0,-1,103497,96503
4:3:4,0,-1,103498,96502
3:3:4,0,-1,103499,96501
3:5:6,0,-1,103500,96500
6:6:5,0,-1,103501,96499
3:3:4,0,-1,103502,96498
2:5:3,1,1,103501,96499
3:4:1,0,-1,103502,96498
1:5:1,0,-1,103503,96497
4:1:2,1,1,103502,96498
4:1:3,0,-1,103503,96497
4:5:6,0,-1,103504,96496
1:1:5,0,-1,103505,96495
1:3:3,0,-1,103506,96494
2:5:4,1,1,103505,96495
4:5:1,0,-1,103506,96494
6:4:5,0,-1,103507,96493
3:6:3,0,-1,103508,96492
1:2:2,2,2,103506,96494
1:4:5,0,-1,103507,96493
3:4:6,0,-1,103508,96492
6:4:1,0,-1,103509,96491
2:4:2,2,2,103507,96493
1:2:1,1,1,103506,96494
5:5:4,0,-1,103507,96493
6:5:3,0,-1,103508,96492
4:6:6,0,-1,103509,96491
6:6:4,0,-1,103510,96490
6:5:3,0,-1,103511,96489
1:3:3,0,-1,103512,96488
4:2:6,1,1,103511,96489
6:5:5,0,-1,103512,96488
1:1:1,0,-1,103513,96487
2:5:6,1,1,103512,96488
6:1:1,0,-1,103513,96487
5:2:4,1,1,103512,96488
2:6:6,1,1,103511,96489
1:6:1,0,-1,103512,96488
4:3:2,1,1,103511,96489
3:1:6,0,-1,103512,96488
2:4:5,1,1,103511,96489
3:2:4,1,1,103510,96490
1:1:4,0,-1,103511,96489
3:5:2,1,1,103510,96490
1:4:3,0,-1,103511,96489
4:4:3,0,-1,103512,96488
2:2:1,2,2,103510,96490
4:5:4,0,-1,103511,96489
3:3:5,0,-1,103512,96488
6:1:6,0,-1,103513,96487
3:6:2,1,1,103512,96488
4:6:6,0,-1,103513,96487
2:2:2,3,3,103510,96490
6:6:4,0,-1,103511,96489
2:2:6,2,2,103509,96491
6:6:2,1,1,103508,96492
5:5:6,0,-1,103509,96491
4:4:6,0,-1,103510,96490
3:2:5,1,1,103509,96491
5:5:5,0,-1,103510,96490
1:3:1,0,-1,103511,96489
3:1:6,0,-1,103512,96488
5:5:5,0,-1,103513,96487
4:4:3,0,-1,103514,96486
4:1:4,0,-1,103515,96485
5:4:3,0,-1,103516,96484
2:6:4,1,1,103515,96485
3:4:1,0,-1,103516,96484
2:2:2,3,3,103513,96487
2:3:2,2,2,103511,96489
5:5:6,0,-1,103512,96488
1:3:2,1,1,103511,96489
1:5:4,0,-1,103512,96488
3:6:4,0,-1,103513,96487
3:5:3,0,-1,103514,96486
5:2:6,1,1,103513,96487
2:6:4,1,1,103512,96488
6:2:3,1,1,103511,96489
4:5:2,1,1,103510,96490
4:6:5,0,-1,103511,96489
1:2:2,2,2,103509,96491
4:1:3,0,-1,103510,96490
5:5:1,0,-1,103511,96489
3:6:5,0,-1,103512,96488
3:5:3,0,-1,103513,96487
2:5:4,1,1,103512,96488
3:4:4,0,-1,103513,96487
4:2:3,1,1,103512,96488
2:2:3,2,2,103510,96490
5:3:5,0,-1,103511,96489
3:6:2,1,1,103510,96490
4:3:4,0,-1,103511,96489
1:4:6,0,-1,103512,96488
5:5:4,0,-1,103513,96487
1:5:5,0,-1,103514,96486
3:4:1,0,-1,103515,96485
1:6:1,0,-1,103516,96484
3:6:5,0,-1,103517,96483
3:6:2,1,1,103516,96484
5:2:4,1,1,103515,96485
1:3:2,1,1,103514,96486
2:6:3,1,1,103513,96487
3:4:2,1,1,103512,96488
1:2:3,1,1,103511,96489
3:1:1,0,-1,103512,96488
2:5:5,1,1,103511,96489
6:3:4,0,-1,103512,96488
6:3:3,0,-1,103513,96487
4:1:6,0,-1,103514,96486
3:4:5,0,-1,103515,96485
3:4:6,0,-1,103516,96484
5:1:3,0,-1,103517,96483
1:3:4,0,-1,103518,96482
1:2:3,1,1,103517,96483
5:6:3,0,-1,103518,96482
4:4:4,0,-1,103519,96481
4:6:4,0,-1,103520,96480
6:4:6,0,-1,103521,96479
1:1:2,1,1,103520,96480
5:6:3,0,-1,103521,96479
6:5:5,0,-1,103522,96478
1:4:4,0,-1,103523,96477
4:3:6,0,-1,103524,96476
1:6:4,0,-1,103525,96475
2:1:4,1,1,103524,96476
1:6:6,0,-1,103525,96475
6:2:2,2,2,103523,96477
4:2:3,1,1,103522,96478
5:3:5,0,-1,103523,96477
5:1:2,1,1,103522,96478
6:1:1,0,-1,103523,96477
4:3:3,0,-1,103524,96476
3:1:3,0,-1,103525,96475
1:5:1,0,-1,103526,96474
4:1:2,1,1,103525,96475
1:6:3,0,-1,103526,96474
1:4:4,0,-1,103527,96473
3:6:2,1,1,103526,96474
2:4:5,1,1,103525,96475
3:2:3,1,1,103524,96476
3:3:2,1,1,103523,96477
5:1:5,0,-1,103524,96476
6:2:4,1,1,103523,96477
2:4:3,1,1,103522,96478
2:2:6,2,2,103520,96480
6:1:5,0,-1,103521,96479
1:3:6,0,-1,103522,96478
2:6:1,1,1,103521,96479
6:5:3,0,-1,103522,96478
4:5:6,0,-1,103523,96477
4:4:5,0,-1,103524,96476
3:1:4,0,-1,103525,96475
1:5:2,1,1,103524,96476
3:6:5,0,-1,103525,96475
5:5:6,0,-1,103526,96474
3:3:3,0,-1,103527,96473
4:3:1,0,-1,103528,96472
6:6:3,0,-1,103529,96471
6:5:6,0,-1,103530,96470
5:2:4,1,1,103529,96471
1:3:4,0,-1,103530,96470
6:4:1,0,-1,103531,96469
1:1:5,0,-1,103532,96468
2:1:4,1,1,103531,96469
2:6:5,1,1,103530,96470
2:6:3,1,1,103529,96471
3:2:2,2,2,103527,96473
5:4:3,0,-1,103528,96472
3:1:5,0,-1,103529,96471
4:4:6,0,-1,103530,96470
5:2:4,1,1,103529,96471
4:3:3,0,-1,103530,96470
3:5:2,1,1,103529,96471
1:3:1,0,-1,103530,96470
3:4:4,0,-1,103531,96469
6:3:3,0,-1,103532,96468
4:4:1,0,-1,103533,96467
1:6:1,0,-1,103534,96466
1:5:2,1,1,103533,96467
5:3:3,0,-1,103534,96466
2:2:3,2,2,103532,96468
4:6:2,1,1,103531,96469
4:6:3,0,-1,103532,96468
6:6:1,0,-1,103533,96467
4:4:1,0,-1,103534,96466
3:3:3,0,-1,103535,96465
4:6:5,0,-1,103536,96464
2:1:3,1,1,103535,96465
2:1:6,1,1,103534,96466
3:1:6,0,-1,103535,96465
2:2:3,2,2,103533,96467
2:1:6,1,1,103532,96468
3:3:2,1,1,103531,96469
5:3:6,0,-1,103532,96468
3:4:6,0,-1,103533,96467
1:3:2,1,1,103532,96468
5:1:6,0,-1,103533,96467
3:4:2,1,1,103532,96468
3:1:2,1,1,103531,96469
1:4:3,0,-1,103532,96468
4:4:1,0,-1,103533,96467
2:2:1,2,2,103531,96469
1:4:1,0,-1,103532,96468
5:1:2,1,1,103531,96469
3:3:1,0,-1,103532,96468
6:6:5,0,-1,103533,96467
2:4:5,1,1,103532,96468
2:4:3,1,1,103531,96469
1:1:5,0,-1,103532,96468
6:1:6,0,-1,103533,96467
3:5:4,0,-1,103534,96466
1:1:2,1,1,103533,96467
4:4:6,0,-1,103534,96466
3:1:3,0,-1,103535,96465
2:3:5,1,1,103534,96466
1:5:1,0,-1,103535,96465
3:3:1,0,-1,103536,96464
3:3:5,0,-1,103537,96463
5:3:5,0,-1,103538,96462
4:3:2,1,1,103537,96463
6:2:4,1,1,103536,96464
1:6:4,0,-1,103537,96463
3:6:5,0,-1,103538,96462
1:1:6,0,-1,103539,96461
2:1:3,1,1,103538,96462
5:3:6,0,-1,103539,96461
3:5:2,1,1,103538,96462
1:4:6,0,-1,103539,96461
4:3:4,0,-1,103540,96460
4:4:5,0,-1,103541,96459
5:5:3,0,-1,103542,96458
3:3:3,0,-1,103543,96457
4:3:4,0,-1,103544,96456
5:3:4,0,-1,103545,96455
1:1:1,0,-1,103546,96454
5:2:5,1,1,103545,96455
2:1:3,1,1,103544,96456
3:4:5,0,-1,103545,96455
6:3:6,0,-1,103546,96454
6:6:2,1,1,103545,96455
5:5:2,1,1,103544,96456
4:1:6,0,-1,103545,96455
6:2:3,1,1,103544,96456
2:6:6,1,1,103543,96457
4:2:5,1,1,103542,96458
3:6:1,0,-1,103543,96457
3:1:4,0,-1,103544,96456
2:1:2,2,2,103542,96458
4:2:2,2,2,103540,96460
3:6:2,1,1,103539,96461
6:5:6,0,-1,103540,96460
3:1:1,0,-1,103541,96459
3:6:1,0,-1,103542,96458
4:4:2,1,1,103541,96459
3:5:6,0,-1,103542,96458
3:5:3,0,-1,103543,96457
1:3:4,0,-1,103544,96456
4:5:4,0,-1,103545,96455
3:6:6,0,-1,103546,96454
2:1:6,1,1,103545,96455
3:5:3,0,-1,103546,96454
6:3:1,0,-1,103547,96453
4:1:5,0,-1,103548,96452
4:4:3,0,-1,103549,96451
4:2:2,2,2,103547,96453
1:6:5,0,-1,103548,96452
2:2:5,2,2,103546,96454
6:2:6,1,1,103545,96455
5:1:3,0,-1,103546,96454
2:3:4,1,1,103545,96455
2:4:1,1,1,103544,96456
6:6:4,0,-1,103545,96455
5:6:5,0,-1,103546,96454
5:5:4,0,-1,103547,96453
5:6:5,0,-1,103548,96452
3:1:6,0,-1,103549,96451
5:1:6,0,-1,103550,96450
6:4:6,0,-1,103551,96449
5:2:6,1,1,103550,96450
4:6:3,0,-1,103551,96449
4:1:6,0,-1,103552,96448
3:5:2,1,1,103551,96449
3:3:5,0,-1,103552,96448
3:1:6,0,-1,103553,96447
5:4:4,0,-1,103554,96446
5:1:3,0,-1,103555,96445
2:3:1,1,1,103554,96446
5:3:2,1,1,103553,96447
2:6:4,1,1,103552,96448
6:4:3,0,-1,103553,96447
2:3:6,1,1,103552,96448
3:5:5,0,-1,103553,96447
1:5:2,1,1,103552,96448
4:4:2,1,1,103551,96449
4:4:1,0,-1,103552,96448
3:6:2,1,1,103551,96449
5:1:3,0,-1,103552,96448
6:3:5,0,-1,103553,96447
2:1:3,1,1,103552,96448
3:2:6,1,1,103551,96449
3:5:1,0,-1,103552,96448
4:4:6,0,-1,103553,96447
6:1:3,0,-1,103554,96446
4:5:3,0,-1,103555,96445
6:4:2,1,1,103554,96446
5:6:6,0,-1,103555,96445
6:5:4,0,-1,103556,96444
3:2:4,1,1,103555,96445
2:2:5,2,2,103553,96447
2:3:6,1,1,103552,96448
4:6:3,0,-1,103553,96447
1:1:6,0,-1,103554,96446
6:6:3,0,-1,103555,96445
5:3:4,0,-1,103556,96444
5:3:3,0,-1,103557,96443
5:5:3,0,-1,103558,96442
5:6:6,0,-1,103559,96441
5:4:4,0,-1,103560,96440
3:2:1,1,1,103559,96441
2:1:2,2,2,103557,96443
6:3:5,0,-1,103558,96442
2:5:2,2,2,103556,96444
3:3:4,0,-1,103557,96443
3:5:1,0,-1,103558,96442
6:2:2,2,2,103556,96444
4:1:4,0,-1,103557,96443
1:4:6,0,-1,103558,96442
4:2:6,1,1,103557,96443
5:5:3,0,-1,103558,96442
4:3:1,0,-1,103559,96441
1:3:5,0,-1,103560,96440
1:6:1,0,-1,103561,96439
3:3:6,0,-1,103562,96438
4:1:5,0,-1,103563,96437
3:1:6,0,-1,103564,96436
3:4:4,0,-1,103565,96435
4:4:3,0,-1,103566,96434
2:1:6,1,1,103565,96435
2:4:4,1,1,103564,96436
6:6:4,0,-1,103565,96435
1:5:4,0,-1,103566,96434
2:6:2,2,2,103564,96436
5:3:4,0,-1,103565,96435
2:6:2,2,2,103563,96437
5:3:1,0,-1,103564,96436
6:5:2,1,1,103563,96437
3:2:1,1,1,103562,96438
3:5:2,1,1,103561,96439
6:5:1,0,-1,103562,96438
5:1:6,0,-1,103563,96437
4:2:3,1,1,103562,96438
2:5:4,1,1,103561,96439
4:1:6,0,-1,103562,96438
6:3:5,0,-1,103563,96437
4:4:5,0,-1,103564,96436
6:4:6,0,-1,103565,96435
2:3:2,2,2,103563,96437
4:3:6,0,-1,103564,96436
5:3:5,0,-1,103565,96435
1:3:1,0,-1,103566,96434
3:4:5,0,-1,103567,96433
3:1:6,0,-1,103568,96432
2:2:4,2,2,103566,96434
3:4:1,0,-1,103567,96433
5:1:1,0,-1,103568,96432
2:4:2,2,2,103566,96434
3:5:1,0,-1,103567,96433
5:6:1,0,-1,103568,96432
3:6:4,0,-1,103569,96431
2:3:2,2,2,103567,96433
4:1:2,1,1,103566,96434
6:3:1,0,-1,103567,96433
6:5:4,0,-1,103568,96432
4:5:6,0,-1,103569,96431
2:6:6,1,1,103568,96432
3:6:5,0,-1,103569,96431
3:4:2,1,1,103568,96432
1:3:4,0,-1,103569,96431
3:2:3,1,1,103568,96432
6:2:2,2,2,103566,96434
3:3:5,0,-1,103567,96433
1:4:2,1,1,103566,96434
1:3:1,0,-1,103567,96433
5:6:6,0,-1,103568,96432
5:5:5,0,-1,103569,96431
5:5:2,1,1,103568,96432
1:6:4,0,-1,103569,96431
1:2:5,1,1,103568,96432
5:5:2,1,1,103567,96433
1:3:4,0,-1,103568,96432
2:3:1,1,1,103567,96433
1:4:6,0,-1,103568,96432
6:2:6,1,1,103567,96433
5:4:4,0,-1,103568,96432
3:4:3,0,-1,103569,96431
6:3:3,0,-1,103570,96430
5:3:4,0,-1,103571,96429
1:3:5,0,-1,103572,96428
5:1:4,0,-1,103573,96427
3:3:5,0,-1,103574,96426
1:6:6,0,-1,103575,96425
3:6:6,0,-1,103576,96424
2:4:3,1,1,103575,96425
1:1:4,0,-1,103576,96424
4:5:5,0,-1,103577,96423
2:6:3,1,1,103576,96424
6:2:3,1,1,103575,96425
2:5:2,2,2,103573,96427
4:3:3,0,-1,103574,96426
6:5:3,0,-1,103575,96425
4:2:2,2,2,103573,96427
2:3:4,1,1,103572,96428
2:4:1,1,1,103571,96429
4:6:2,1,1,103570,96430
4:1:3,0,-1,103571,96429
6:4:2,1,1,103570,96430
6:5:4,0,-1,103571,96429
2:2:2,3,3,103568,96432
6:6:4,0,-1,103569,96431
4:2:1,1,1,103568,96432
3:6:1,0,-1,103569,96431
5:5:4,0,-1,103570,96430
1:2:2,2,2,103568,96432
2:1:5,1,1,103567,96433
6:6:5,0,-1,103568,96432
3:4:4,0,-1,103569,96431
6:3:5,0,-1,103570,96430
5:1:2,1,1,103569,96431
4:6:4,0,-1,103570,96430
5:1:4,0,-1,103571,96429
1:4:1,0,-1,103572,96428
3:4:5,0,-1,103573,96427
2:2:6,2,2,103571,96429
5:4:4,0,-1,103572,96428
5:3:2,1,1,103571,96429
6:2:5,1,1,103570,96430
3:4:2,1,1,103569,96431
2:6:6,1,1,103568,96432
2:5:2,2,2,103566,96434
4:1:2,1,1,103565,96435
1:4:6,0,-1,103566,96434
1:4:6,0,-1,103567,96433
5:6:2,1,1,103566,96434
1:5:4,0,-1,103567,96433
5:5:1,0,-1,103568,96432
6:4:6,0,-1,103569,96431
2:2:5,2,2,103567,96433
4:2:3,1,1,103566,96434
2:3:2,2,2,103564,96436
6:6:6,0,-1,103565,96435
2:4:5,1,1,103564,96436
4:4:2,1,1,103563,96437
3:5:3,0,-1,103564,96436
2:5:5,1,1,103563,96437
1:2:2,2,2,103561,96439
5:5:2,1,1,103560,96440
2:6:4,1,1,103559,96441
1:1:5,0,-1,103560,96440
5:1:4,0,-1,103561,96439
1:5:4,0,-1,103562,96438
5:3:3,0,-1,103563,96437
2:6:4,1,1,103562,96438
6:1:5,0,-1,103563,96437
1:3:6,0,-1,103564,96436
2:2:2,3,3,103561,96439
3:6:4,0,-1,103562,96438
4:6:6,0,-1,103563,96437
5:1:2,1,1,103562,96438
3:4:2,1,1,103561,96439
6:3:4,0,-1,103562,96438
4:3:2,1,1,103561,96439
5:5:3,0,-1,103562,96438
5:3:1,0,-1,103563,96437
5:3:3,0,-1,103564,96436
5:4:3,0,-1,103565,96435
1:5:6,0,-1,103566,96434
6:5:4,0,-1,103567,96433
2:1:4,1,1,103566,96434
1:5:6,0,-1,103567,96433
2:1:3,1,1,103566,96434
4:5:4,0,-1,103567,96433
5:5:3,0,-1,103568,96432
2:5:5,1,1,103567,96433
3:3:1,0,-1,103568,96432
1:5:3,0,-1,103569,96431
2:6:1,1,1,103568,96432
3:5:5,0,-1,103569,96431
5:2:3,1,1,103568,96432
6:6:3,0,-1,103569,96431
2:5:6,1,1,103568,96432
5:4:3,0,-1,103569,96431
5:1:3,0,-1,103570,96430
6:4:2,1,1,103569,96431
2:1:3,1,1,103568,96432
2:3:5,1,1,103567,96433
6:5:2,1,1,103566,96434
1:3:2,1,1,103565,96435
5:5:3,0,-1,103566,96434
4:2:5,1,1,103565,96435
5:1:4,0,-1,103566,96434
3:1:2,1,1,103565,96435
3:2:5,1,1,103564,96436
3:6:2,1,1,103563,96437
2:2:2,3,3,103560,96440
6:6:2,1,1,103559,96441
3:2:2,2,2,103557,96443
4:6:4,0,-1,103558,96442
6:5:6,0,-1,103559,96441
6:1:5,0,-1,103560,96440
5:4:4,0,-1,103561,96439
2:2:3,2,2,103559,96441
6:5:6,0,-1,103560,96440
4:2:4,1,1,103559,96441
5:4:1,0,-1,103560,96440
4:4:2,1,1,103559,96441
2:5:6,1,1,103558,96442
1:2:3,1,1,103557,96443
1:5:4,0,-1,103558,96442
2:5:6,1,1,103557,96443
4:1:5,0,-1,103558,96442
4:2:5,1,1,103557,96443
4:5:1,0,-1,103558,96442
3:2:1,1,1,103557,96443
2:3:1,1,1,103556,96444
4:2:1,1,1,103555,96445
1:2:6,1,1,103554,96446
5:6:4,0,-1,103555,96445
4:4:3,0,-1,103556,96444
2:5:2,2,2,103554,96446
3:5:6,0,-1,103555,96445
6:2:2,2,2,103553,96447
3:4:3,0,-1,103554,96446
1:5:3,0,-1,103555,96445
3:5:1,0,-1,103556,96444
4:2:4,1,1,103555,96445
6:3:5,0,-1,103556,96444
6:4:3,0,-1,103557,96443
2:1:2,2,2,103555,96445
2:6:4,1,1,103554,96446
1:3:2,1,1,103553,96447
5:1:3,0,-1,103554,96446
5:6:5,0,-1,103555,96445
2:6:6,1,1,103554,96446
1:3:1,0,-1,103555,96445
3:3:3,0,-1,103556,96444
2:6:4,1,1,103555,96445
3:6:4,0,-1,103556,96444
5:1:3,0,-1,103557,96443
2:2:1,2,2,103555,96445
6:2:5,1,1,103554,96446
4:6:6,0,-1,103555,96445
3:3:5,0,-1,103556,96444
4:6:2,1,1,103555,96445
1:6:4,0,-1,103556,96444
4:4:6,0,-1,103557,96443
4:3:3,0,-1,103558,96442
2:5:4,1,1,103557,96443
1:5:4,0,-1,103558,96442
6:4:5,0,-1,103559,96441
3:6:5,0,-1,103560,96440
6:5:5,0,-1,103561,96439
5:3:4,0,-1,103562,96438
2:1:6,1,1,103561,96439
3:2:3,1,1,103560,96440
6:3:5,0,-1,103561,96439
1:1:3,0,-1,103562,96438
3:4:2,1,1,103561,96439
6:2:5,1,1,103560,96440
5:6:2,1,1,103559,96441
1:2:1,1,1,103558,96442
5:2:4,1,1,103557,96443
4:2:5,1,1,103556,96444
4:4:4,0,-1,103557,96443
6:6:1,0,-1,103558,96442
5:5:2,1,1,103557,96443
3:1:4,0,-1,103558,96442
4:6:1,0,-1,103559,96441
1:2:3,1,1,103558,96442
3:5:3,0,-1,103559,96441
6:5:3,0,-1,103560,96440
6:2:3,1,1,103559,96441
5:3:6,0,-1,103560,96440
1:4:4,0,-1,103561,96439
1:5:5,0,-1,103562,96438
2:6:6,1,1,103561,96439
4:1:1,0,-1,103562,96438
3:3:1,0,-1,103563,96437
5:6:2,1,1,103562,96438
5:3:4,0,-1,103563,96437
6:2:6,1,1,103562,96438
4:2:3,1,1,103561,96439
5:1:1,0,-1,103562,96438
4:1:3,0,-1,103563,96437
5:6:4,0,-1,103564,96436
3:3:5,0,-1,103565,96435
4:4:3,0,-1,103566,96434
1:3:3,0,-1,103567,96433
5:5:4,0,-1,103568,96432
5:1:4,0,-1,103569,96431
2:2:3,2,2,103567,96433
3:5:1,0,-1,103568,96432
3:6:2,1,1,103567,96433
3:1:2,1,1,103566,96434
2:4:6,1,1,103565,96435
1:4:1,0,-1,103566,96434
5:2:6,1,1,103565,96435
5:2:1,1,1,103564,96436
3:6:3,0,-1,103565,96435
2:5:3,1,1,103564,96436
2:2:5,2,2,103562,96438
1:1:1,0,-1,103563,96437
1:5:1,0,-1,103564,96436
6:6:2,1,1,103563,96437
3:6:3,0,-1,103564,96436
1:1:2,1,1,103563,96437
3:5:6,0,-1,103564,96436
1:6:3,0,-1,103565,96435
5:4:5,0,-1,103566,96434
3:6:5,0,-1,103567,96433
2:2:1,2,2,103565,96435
2:3:6,1,1,103564,96436
2:6:1,1,1,103563,96437
3:4:1,0,-1,103564,96436
3:6:6,0,-1,103565,96435
6:2:3,1,1,103564,96436
5:2:1,1,1,103563,96437
5:1:3,0,-1,103564,96436
4:3:2,1,1,103563,96437
6:4:3,0,-1,103564,96436
4:1:3,0,-1,103565,96435
2:3:1,1,1,103564,96436
1:1:2,1,1,103563,96437
5:5:1,0,-1,103564,96436
5:2:3,1,1,103563,96437
5:4:4,0,-1,103564,96436
6:5:3,0,-1,103565,96435
2:6:4,1,1,103564,96436
4:6:5,0,-1,103565,96435
4:3:6,0,-1,103566,96434
4:1:1,0,-1,103567,96433
4:2:6,1,1,103566,96434
4:2:3,1,1,103565,96435
3:1:4,0,-1,103566,96434
3:6:2,1,1,103565,96435
5:1:4,0,-1,103566,96434
6:4:2,1,1,103565,96435
1:4:1,0,-1,103566,96434
5:3:1,0,-1,103567,96433
1:2:2,2,2,103565,96435
2:1:2,2,2,103563,96437
6:2:5,1,1,103562,96438
3:4:6,0,-1,103563,96437
2:2:1,2,2,103561,96439
5:2:5,1,1,103560,96440
3:3:4,0,-1,103561,96439
3:1:4,0,-1,103562,96438
5:3:3,0,-1,103563,96437
5:4:6,0,-1,103564,96436
5:3:6,0,-1,103565,96435
5:3:5,0,-1,103566,96434
6:2:6,1,1,103565,96435
2:2:5,2,2,103563,96437
1:5:5,0,-1,103564,96436
2:5:3,1,1,103563,96437
2:1:5,1,1,103562,96438
2:3:4,1,1,103561,96439
3:1:5,0,-1,103562,96438
2:5:2,2,2,103560,96440
6:2:5,1,1,103559,96441
3:3:5,0,-1,103560,96440
3:1:5,0,-1,103561,96439
5:4:5,0,-1,103562,96438
5:6:5,0,-1,103563,96437
4:4:3,0,-1,103564,96436
5:3:6,0,-1,103565,96435
6:4:6,0,-1,103566,96434
5:5:1,0,-1,103567,96433
1:6:4,0,-1,103568,96432
2:4:1,1,1,103567,96433
3:2:2,2,2,103565,96435
4:2:2,2,2,103563,96437
1:5:4,0,-1,103564,96436
6:6:5,0,-1,103565,96435
1:5:2,1,1,103564,96436
1:2:3,1,1,103563,96437
4:1:4,0,-1,103564,96436
2:3:5,1,1,103563,96437
4:5:5,0,-1,103564,96436
3:4:1,0,-1,103565,96435
3:3:3,0,-1,103566,96434
1:5:5,0,-1,103567,96433
6:6:3,0,-1,103568,96432
1:4:5,0,-1,103569,96431
1:6:2,1,1,103568,96432
3:2:6,1,1,103567,96433
2:3:5,1,1,103566,96434
5:3:5,0,-1,103567,96433
4:3:4,0,-1,103568,96432
1:6:2,1,1,103567,96433
5:1:1,0,-1,103568,96432
6:2:5,1,1,103567,96433
4:5:6,0,-1,103568,96432
4:6:6,0,-1,103569,96431
3:5:3,0,-1,103570,96430
5:3:2,1,1,103569,96431
5:1:2,1,1,103568,96432
5:1:6,0,-1,103569,96431
4:6:4,0,-1,103570,96430
2:5:3,1,1,103569,96431
2:6:5,1,1,103568,96432
3:1:3,0,-1,103569,96431
5:5:6,0,-1,103570,96430
2:1:5,1,1,103569,96431
5:2:2,2,2,103567,96433
3:6:1,0,-1,103568,96432
4:3:6,0,-1,103569,96431
3:3:6,0,-1,103570,96430
6:3:2,1,1,103569,96431
6:2:1,1,1,103568,96432
4:3:2,1,1,103567,96433
2:2:3,2,2,103565,96435
2:1:4,1,1,103564,96436
2:4:2,2,2,103562,96438
4:6:1,0,-1,103563,96437
5:6:3,0,-1,103564,96436
2:6:4,1,1,103563,96437
4:1:2,1,1,103562,96438
2:2:6,2,2,103560,96440
2:4:4,1,1,103559,96441
3:3:3,0,-1,103560,96440
3:6:6,0,-1,103561,96439
1:2:6,1,1,103560,96440
2:5:6,1,1,103559,96441
6:5:6,0,-1,103560,96440
6:4:5,0,-1,103561,96439
3:6:6,0,-1,103562,96438
6:6:6,0,-1,103563,96437
2:3:1,1,1,103562,96438
6:5:6,0,-1,103563,96437
3:5:6,0,-1,103564,96436
2:6:4,1,1,103563,96437
4:1:4,0,-1,103564,96436
4:5:4,0,-1,103565,96435
6:6:4,0,-1,103566,96434
4:5:6,0,-1,103567,96433
6:5:2,1,1,103566,96434
4:1:5,0,-1,103567,96433
2:2:3,2,2,103565,96435
4:1:2,1,1,103564,96436
5:2:6,1,1,103563,96437
3:6:1,0,-1,103564,96436
1:1:6,0,-1,103565,96435
1:3:6,0,-1,103566,96434
3:6:2,1,1,103565,96435
6:4:2,1,1,103564,96436
3:4:5,0,-1,103565,96435
5:2:1,1,1,103564,96436
3:3:5,0,-1,103565,96435
3:6:2,1,1,103564,96436
3:5:6,0,-1,103565,96435
3:2:4,1,1,103564,96436
2:2:1,2,2,103562,96438
2:6:5,1,1,103561,96439
2:4:4,1,1,103560,96440
1:6:2,1,1,103559,96441
5:1:4,0,-1,103560,96440
5:5:6,0,-1,103561,96439
5:1:4,0,-1,103562,96438
1:1:1,0,-1,103563,96437
6:1:5,0,-1,103564,96436
2:3:3,1,1,103563,96437
2:2:1,2,2,103561,96439
2:6:3,1,1,103560,96440
4:1:3,0,-1,103561,96439
5:1:1,0,-1,103562,96438
6:4:4,0,-1,103563,96437
3:1:6,0,-1,103564,96436
6:3:6,0,-1,103565,96435
2:5:1,1,1,103564,96436
4:5:6,0,-1,103565,96435
5:1:1,0,-1,103566,96434
3:6:3,0,-1,103567,96433
4:2:3,1,1,103566,96434
2:5:5,1,1,103565,96435
1:1:2,1,1,103564,96436
6:1:6,0,-1,103565,96435
6:2:4,1,1,103564,96436
6:3:6,0,-1,103565,96435
1:4:2,1,1,103564,96436
3:2:4,1,1,103563,96437
1:1:2,1,1,103562,96438
4:3:2,1,1,103561,96439
3:2:3,1,1,103560,96440
4:6:6,0,-1,103561,96439
3:3:3,0,-1,103562,96438
2:4:5,1,1,103561,96439
4:6:3,0,-1,103562,96438
1:3:5,0,-1,103563,96437
5:2:3,1,1,103562,96438
4:6:3,0,-1,103563,96437
5:1:4,0,-1,103564,96436
6:2:6,1,1,103563,96437
2:6:4,1,1,103562,96438
6:3:3,0,-1,103563,96437
6:5:5,0,-1,103564,96436
5:1:3,0,-1,103565,96435
4:1:2,1,1,103564,96436
4:4:6,0,-1,103565,96435
4:3:6,0,-1,103566,96434
1:3:5,0,-1,103567,96433
4:1:4,0,-1,103568,96432
4:1:2,1,1,103567,96433
6:5:3,0,-1,103568,96432
3:4:3,0,-1,103569,96431
2:3:1,1,1,103568,96432
3:6:4,0,-1,103569,96431
6:5:5,0,-1,103570,96430
2:2:3,2,2,103568,96432
2:6:1,1,1,103567,96433
3:4:3,0,-1,103568,96432
3:2:2,2,2,103566,96434
1:4:4,0,-1,103567,96433
2:1:5,1,1,103566,96434
3:3:1,0,-1,103567,96433
2:1:4,1,1,103566,96434
4:6:1,0,-1,103567,96433
3:1:6,0,-1,103568,96432
6:1:5,0,-1,103569,96431
1:5:1,0,-1,103570,96430
2:6:1,1,1,103569,96431
6:3:5,0,-1,103570,96430
3:6:1,0,-1,103571,96429
1:4:4,0,-1,103572,96428
5:3:4,0,-1,103573,96427
2:2:4,2,2,103571,96429
5:1:3,0,-1,103572,96428
4:1:4,0,-1,103573,96427
1:3:1,0,-1,103574,96426
3:5:1,0,-1,103575,96425
2:4:3,1,1,103574,96426
6:3:6,0,-1,103575,96425
1:3:1,0,-1,103576,96424
2:4:6,1,1,103575,96425
4:6:1,0,-1,103576,96424
1:6:1,0,-1,103577,96423
2:2:3,2,2,103575,96425
4:1:6,0,-1,103576,96424
1:6:1,0,-1,103577,96423
3:5:5,0,-1,103578,96422
1:2:2,2,2,103576,96424
1:1:4,0,-1,103577,96423
4:3:5,0,-1,103578,96422
2:3:1,1,1,103577,96423
4:3:2,1,1,103576,96424
5:6:2,1,1,103575,96425
5:1:4,0,-1,103576,96424
5:4:6,0,-1,103577,96423
5:6:5,0,-1,103578,96422
6:2:5,1,1,103577,96423
5:5:2,1,1,103576,96424
6:5:4,0,-1,103577,96423
1:5:1,0,-1,103578,96422
5:2:3,1,1,103577,96423
3:1:6,0,-1,103578,96422
4:5:5,0,-1,103579,96421
3:5:6,0,-1,103580,96420
2:6:4,1,1,103579,96421
4:5:3,0,-1,103580,96420
1:3:4,0,-1,103581,96419
4:4:2,1,1,103580,96420
1:3:2,1,1,103579,96421
2:1:1,1,1,103578,96422
3:2:2,2,2,103576,96424
5:6:5,0,-1,103577,96423
6:3:4,0,-1,103578,96422
1:3:1,0,-1,103579,96421
3:4:6,0,-1,103580,96420
6:1:1,0,-1,103581,96419
4:5:4,0,-1,103582,96418
1:5:2,1,1,103581,96419
5:2:4,1,1,103580,96420
2:2:2,3,3,103577,96423
6:2:5,1,1,103576,96424
2:5:1,1,1,103575,96425
3:2:6,1,1,103574,96426
3:5:6,0,-1,103575,96425
5:3:2,1,1,103574,96426
3:2:3,1,1,103573,96427
4:1:3,0,-1,103574,96426
3:2:3,1,1,103573,96427
5:1:6,0,-1,103574,96426
3:6:5,0,-1,103575,96425
6:3:4,0,-1,103576,96424
4:4:2,1,1,103575,96425
6:2:5,1,1,103574,96426
2:6:5,1,1,103573,96427
6:5:5,0,-1,103574,96426
2:6:5,1,1,103573,96427
1:6:1,0,-1,103574,96426
2:4:2,2,2,103572,96428
6:3:5,0,-1,103573,96427
3:4:6,0,-1,103574,96426
3:3:5,0,-1,103575,96425
1:4:4,0,-1,103576,96424
3:6:4,0,-1,103577,96423
1:3:1,0,-1,103578,96422
4:2:3,1,1,103577,96423
5:1:6,0,-1,103578,96422
2:4:3,1,1,103577,96423
2:6:3,1,1,103576,96424
4:3:6,0,-1,103577,96423
4:1:6,0,-1,103578,96422
1:3:2,1,1,103577,96423
6:6:6,0,-1,103578,96422
2:6:1,1,1,103577,96423
6:4:4,0,-1,103578,96422
4:3:5,0,-1,103579,96421
4:2:4,1,1,103578,96422
3:2:3,1,1,103577,96423
1:3:2,1,1,103576,96424
3:3:3,0,-1,103577,96423
1:2:5,1,1,103576,96424
1:6:2,1,1,103575,96425
4:5:5,0,-1,103576,96424
5:1:5,0,-1,103577,96423
2:5:6,1,1,103576,96424
4:2:1,1,1,103575,96425
4:4:3,0,-1,103576,96424
4:5:2,1,1,103575,96425
3:3:2,1,1,103574,96426
3:1:2,1,1,103573,96427
1:5:3,0,-1,103574,96426
2:2:1,2,2,103572,96428
6:3:3,0,-1,103573,96427
2:1:5,1,1,103572,96428
3:5:3,0,-1,103573,96427
3:3:1,0,-1,103574,96426
3:3:5,0,-1,103575,96425
1:5:4,0,-1,103576,96424
1:1:5,0,-1,103577,96423
2:2:6,2,2,103575,96425
4:1:2,1,1,103574,96426
2:5:5,1,1,103573,96427
6:4:1,0,-1,103574,96426
1:2:1,1,1,103573,96427
4:4:2,1,1,103572,96428
5:4:2,1,1,103571,96429
5:3:4,0,-1,103572,96428
4:4:1,0,-1,103573,96427
3:2:1,1,1,103572,96428
6:2:2,2,2,103570,96430
1:6:5,0,-1,103571,96429
4:2:5,1,1,103570,96430
3:1:4,0,-1,103571,96429
3:4:1,0,-1,103572,96428
2:1:5,1,1,103571,96429
1:6:2,1,1,103570,96430
4:4:6,0,-1,103571,96429
3:4:2,1,1,103570,96430
1:3:1,0,-1,103571,96429
4:5:4,0,-1,103572,96428
6:5:1,0,-1,103573,96427
6:4:3,0,-1,103574,96426
4:4:2,1,1,103573,96427
5:6:2,1,1,103572,96428
5:6:5,0,-1,103573,96427
4:6:6,0,-1,103574,96426
3:1:3,0,-1,103575,96425
4:2:4,1,1,103574,96426
4:4:6,0,-1,103575,96425
1:3:6,0,-1,103576,96424
4:5:2,1,1,103575,96425
5:1:6,0,-1,103576,96424
3:5:3,0,-1,103577,96423
5:5:6,0,-1,103578,96422
1:6:1,0,-1,103579,96421
1:3:5,0,-1,103580,96420
1:6:3,0,-1,103581,96419
3:1:3,0,-1,103582,96418
3:5:3,0,-1,103583,96417
5:3:6,0,-1,103584,96416
3:1:4,0,-1,103585,96415
1:3:4,0,-1,103586,96414
3:1:3,0,-1,103587,96413
6:3:3,0,-1,103588,96412
3:3:3,0,-1,103589,96411
6:2:4,1,1,103588,96412
2:5:6,1,1,103587,96413
1:5:3,0,-1,103588,96412
6:5:6,0,-1,103589,96411
1:1:5,0,-1,103590,96410
6:4:6,0,-1,103591,96409
4:1:4,0,-1,103592,96408
3:6:1,0,-1,103593,96407
6:3:1,0,-1,103594,96406
2:6:3,1,1,103593,96407
1:3:2,1,1,103592,96408
4:3:6,0,-1,103593,96407
6:6:6,0,-1,103594,96406
6:6:4,0,-1,103595,96405
2:4:5,1,1,103594,96406
4:4:1,0,-1,103595,96405
6:1:1,0,-1,103596,96404
2:2:4,2,2,103594,96406
2:1:5,1,1,103593,96407
6:6:4,0,-1,103594,96406
2:6:6,1,1,103593,96407
1:1:2,1,1,103592,96408
2:6:2,2,2,103590,96410
2:2:2,3,3,103587,96413
1:1:2,1,1,103586,96414
1:3:5,0,-1,103587,96413
5:1:3,0,-1,103588,96412
2:3:3,1,1,103587,96413
1:1:5,0,-1,103588,96412
4:3:1,0,-1,103589,96411
4:3:4,0,-1,103590,96410
6:5:3,0,-1,103591,96409
1:3:4,0,-1,103592,96408
2:1:4,1,1,103591,96409
2:1:3,1,1,103590,96410
5:6:2,1,1,103589,96411
1:6:4,0,-1,103590,96410
2:1:2,2,2,103588,96412
4:5:1,0,-1,103589,96411
4:1:1,0,-1,103590,96410
4:1:6,0,-1,103591,96409
2:2:4,2,2,103589,96411
2:6:3,1,1,103588,96412
6:4:5,0,-1,103589,96411
5:5:2,1,1,103588,96412
6:4:4,0,-1,103589,96411
1:4:6,0,-1,103590,96410
3:5:6,0,-1,103591,96409
1:6:4,0,-1,103592,96408
4:1:3,0,-1,103593,96407
3:1:5,0,-1,103594,96406
2:6:6,1,1,103593,96407
1:2:2,2,2,103591,96409
5:4:1,0,-1,103592,96408
6:5:5,0,-1,103593,96407
5:1:5,0,-1,103594,96406
5:6:2,1,1,103593,96407
4:5:2,1,1,103592,96408
4:1:5,0,-1,103593,96407
2:5:2,2,2,103591,96409
2:3:3,1,1,103590,96410
6:3:5,0,-1,103591,96409
6:4:6,0,-1,103592,96408
1:1:5,0,-1,103593,96407
3:5:1,0,-1,103594,96406
3:3:3,0,-1,103595,96405
5:1:4,0,-1,103596,96404
5:4:2,1,1,103595,96405
3:4:3,0,-1,103596,96404
4:3:6,0,-1,103597,96403
6:6:4,0,-1,103598,96402
6:4:5,0,-1,103599,96401
4:3:6,0,-1,103600,96400
3:1:4,0,-1,103601,96399
3:4:5,0,-1,103602,96398
4:2:3,1,1,103601,96399
1:4:2,1,1,103600,96400
1:6:3,0,-1,103601,96399
3:5:1,0,-1,103602,96398
1:4:1,0,-1,103603,96397
3:1:1,0,-1,103604,96396
3:2:4,1,1,103603,96397
6:5:2,1,1,103602,96398
4:6:5,0,-1,103603,96397
1:1:1,0,-1,103604,96396
6:1:2,1,1,103603,96397
2:2:6,2,2,103601,96399
4:5:2,1,1,103600,96400
2:2:6,2,2,103598,96402
1:5:1,0,-1,103599,96401
4:5:1,0,-1,103600,96400
2:6:2,2,2,103598,96402
4:6:2,1,1,103597,96403
3:6:3,0,-1,103598,96402
3:6:1,0,-1,103599,96401
3:3:1,0,-1,103600,96400
6:6:6,0,-1,103601,96399
4:5:3,0,-1,103602,96398
3:4:1,0,-1,103603,96397
4:5:4,0,-1,103604,96396
6:4:5,0,-1,103605,96395
2:5:1,1,1,103604,96396
1:4:2,1,1,103603,96397
6:5:3,0,-1,103604,96396
1:2:1,1,1,103603,96397
2:5:6,1,1,103602,96398
5:1:1,0,-1,103603,96397
3:3:1,0,-1,103604,96396
1:4:6,0,-1,103605,96395
2:3:5,1,1,103604,96396
4:3:1,0,-1,103605,96395
3:3:1,0,-1,103606,96394
4:6:4,0,-1,103607,96393
1:2:5,1,1,103606,96394
4:4:6,0,-1,103607,96393
2:3:6,1,1,103606,96394
2:5:5,1,1,103605,96395
6:1:6,0,-1,103606,96394
6:3:1,0,-1,103607,96393
5:4:3,0,-1,103608,96392
4:3:3,0,-1,103609,96391
3:4:4,0,-1,103610,96390
2:3:6,1,1,103609,96391
5:5:3,0,-1,103610,96390
1:1:5,0,-1,103611,96389
6:6:4,0,-1,103612,96388
5:2:5,1,1,103611,96389
4:5:5,0,-1,103612,96388
5:4:2,1,1,103611,96389
2:2:1,2,2,103609,96391
3:3:1,0,-1,103610,96390
6:6:5,0,-1,103611,96389
4:6:5,0,-1,103612,96388
3:3:2,1,1,103611,96389
4:5:5,0,-1,103612,96388
6:3:1,0,-1,103613,96387
4:4:6,0,-1,103614,96386
2:1:2,2,2,103612,96388
5:1:4,0,-1,103613,96387
5:5:1,0,-1,103614,96386
4:4:4,0,-1,103615,96385
2:3:2,2,2,103613,96387
1:1:4,0,-1,103614,96386
1:3:5,0,-1,103615,96385
6:3:2,1,1,103614,96386
5:1:4,0,-1,103615,96385
3:2:3,1,1,103614,96386
5:5:3,0,-1,103615,96385
5:4:5,0,-1,103616,96384
6:1:3,0,-1,103617,96383
5:4:5,0,-1,103618,96382
4:1:5,0,-1,103619,96381
2:2:5,2,2,103617,96383
4:1:3,0,-1,103618,96382
5:2:5,1,1,103617,96383
3:5:5,0,-1,103618,96382
5:3:2,1,1,103617,96383
2:4:4,1,1,103616,96384
1:6:3,0,-1,103617,96383
6:1:5,0,-1,103618,96382
5:6:4,0,-1,103619,96381
1:4:1,0,-1,103620,96380
4:5:6,0,-1,103621,96379
1:6:3,0,-1,103622,96378
2:3:6,1,1,103621,96379
2:4:6,1,1,103620,96380
1:1:2,1,1,103619,96381
6:5:2,1,1,103618,96382
4:5:4,0,-1,103619,96381
2:6:2,2,2,103617,96383
1:6:5,0,-1,103618,96382
4:5:6,0,-1,103619,96381
3:5:6,0,-1,103620,96380
4:2:5,1,1,103619,96381
6:1:3,0,-1,103620,96380
6:5:6,0,-1,103621,96379
6:6:1,0,-1,103622,96378
5:1:1,0,-1,103623,96377
3:1:3,0,-1,103624,96376
4:1:4,0,-1,103625,96375
4:5:1,0,-1,103626,96374
2:4:5,1,1,103625,96375
6:5:3,0,-1,103626,96374
3:5:1,0,-1,103627,96373
4:4:2,1,1,103626,96374
6:1:2,1,1,103625,96375
5:3:2,1,1,103624,96376
1:6:6,0,-1,103625,96375
5:6:1,0,-1,103626,96374
3:5:1,0,-1,103627,96373
6:3:6,0,-1,103628,96372
1:6:3,0,-1,103629,96371
3:2:5,1,1,103628,96372
2:4:3,1,1,103627,96373
2:1:2,2,2,103625,96375
2:6:4,1,1,103624,96376
1:2:6,1,1,103623,96377
6:2:2,2,2,103621,96379
1:5:5,0,-1,103622,96378
5:5:2,1,1,103621,96379
3:6:3,0,-1,103622,96378
2:5:5,1,1,103621,96379
3:1:4,0,-1,103622,96378
1:6:4,0,-1,103623,96377
2:2:2,3,3,103620,96380
4:3:4,0,-1,103621,96379
3:6:5,0,-1,103622,96378
6:1:1,0,-1,103623,96377
1:5:3,0,-1,103624,96376
5:3:3,0,-1,103625,96375
3:5:1,0,-1,103626,96374
6:2:3,1,1,103625,96375
5:2:4,1,1,103624,96376
3:3:2,1,1,103623,96377
4:3:1,0,-1,103624,96376
2:2:5,2,2,103622,96378
1:1:1,0,-1,103623,96377
1:1:1,0,-1,103624,96376
4:4:2,1,1,103623,96377
3:3:3,0,-1,103624,96376
5:1:3,0,-1,103625,96375
4:2:2,2,2,103623,96377
3:5:5,0,-1,103624,96376
1:4:1,0,-1,103625,96375
5:3:4,0,-1,103626,96374
5:2:2,2,2,103624,96376
4:3:5,0,-1,103625,96375
3:6:6,0,-1,103626,96374
2:5:3,1,1,103625,96375
2:3:3,1,1,103624,96376
4:3:2,1,1,103623,96377
3:4:2,1,1,103622,96378
3:2:2,2,2,103620,96380
5:5:2,1,1,103619,96381
5:1:3,0,-1,103620,96380
5:3:1,0,-1,103621,96379
4:3:3,0,-1,103622,96378
3:3:2,1,1,103621,96379
2:4:6,1,1,103620,96380
2:5:4,1,1,103619,96381
3:3:5,0,-1,103620,96380
3:3:6,0,-1,103621,96379
3:4:1,0,-1,103622,96378
5:4:5,0,-1,103623,96377
4:6:3,0,-1,103624,96376
5:1:5,0,-1,103625,96375
1:4:6,0,-1,103626,96374
2:2:5,2,2,103624,96376
4:6:1,0,-1,103625,96375
6:1:4,0,-1,103626,96374
6:5:4,0,-1,103627,96373
5:3:4,0,-1,103628,96372
1:1:1,0,-1,103629,96371
3:5:1,0,-1,103630,96370
5:1:2,1,1,103629,96371
2:6:2,2,2,103627,96373
2:3:1,1,1,103626,96374
1:3:1,0,-1,103627,96373
4:6:3,0,-1,103628,96372
4:4:3,0,-1,103629,96371
3:6:4,0,-1,103630,96370
2:5:5,1,1,103629,96371
2:5:1,1,1,103628,96372
2:3:1,1,1,103627,96373
6:4:3,0,-1,103628,96372
5:6:5,0,-1,103629,96371
5:4:1,0,-1,103630,96370
2:4:4,1,1,103629,96371
6:1:3,0,-1,103630,96370
5:6:1,0,-1,103631,96369
4:2:4,1,1,103630,96370
2:5:1,1,1,103629,96371
1:6:1,0,-1,103630,96370
4:3:2,1,1,103629,96371
6:5:6,0,-1,103630,96370
2:2:4,2,2,103628,96372
4:4:5,0,-1,103629,96371
2:1:5,1,1,103628,96372
2:1:1,1,1,103627,96373
2:5:1,1,1,103626,96374
2:6:4,1,1,103625,96375
4:2:5,1,1,103624,96376
1:6:1,0,-1,103625,96375
5:1:5,0,-1,103626,96374
1:3:6,0,-1,103627,96373
5:4:1,0,-1,103628,96372
5:2:2,2,2,103626,96374
2:1:2,2,2,103624,96376
1:1:4,0,-1,103625,96375
4:5:2,1,1,103624,96376
4:1:1,0,-1,103625,96375
1:2:5,1,1,103624,96376
3:6:6,0,-1,103625,96375
6:6:5,0,-1,103626,96374
6:6:3,0,-1,103627,96373
6:2:3,1,1,103626,96374
4:3:4,0,-1,103627,96373
4:2:2,2,2,103625,96375
6:5:4,0,-1,103626,96374
3:2:4,1,1,103625,96375
6:6:5,0,-1,103626,96374
4:3:2,1,1,103625,96375
3:3:1,0,-1,103626,96374
2:3:5,1,1,103625,96375
5:4:4,0,-1,103626,96374
3:6:5,0,-1,103627,96373
6:1:3,0,-1,103628,96372
6:2:6,1,1,103627,96373
2:4:2,2,2,103625,96375
3:1:1,0,-1,103626,96374
2:1:5,1,1,103625,96375
2:3:2,2,2,103623,96377
6:1:1,0,-1,103624,96376
6:1:2,1,1,103623,96377
5:2:4,1,1,103622,96378
5:3:4,0,-1,103623,96377
3:3:3,0,-1,103624,96376
2:5:6,1,1,103623,96377
2:6:6,1,1,103622,96378
6:2:3,1,1,103621,96379
1:4:2,1,1,103620,96380
4:5:5,0,-1,103621,96379
2:2:3,2,2,103619,96381
3:2:3,1,1,103618,96382
3:2:2,2,2,103616,96384
1:4:3,0,-1,103617,96383
5:1:5,0,-1,103618,96382
2:4:5,1,1,103617,96383
4:3:4,0,-1,103618,96382
2:4:6,1,1,103617,96383
5:4:2,1,1,103616,96384
4:3:6,0,-1,103617,96383
6:6:6,0,-1,103618,96382
1:6:6,0,-1,103619,96381
3:1:2,1,1,103618,96382
5:3:1,0,-1,103619,96381
1:6:5,0,-1,103620,96380
6:3:6,0,-1,103621,96379
6:3:4,0,-1,103622,96378
5:6:4,0,-1,103623,96377
4:3:6,0,-1,103624,96376
6:3:1,0,-1,103625,96375
6:2:6,1,1,103624,96376
3:6:5,0,-1,103625,96375
4:3:5,0,-1,103626,96374
5:6:4,0,-1,103627,96373
2:2:5,2,2,103625,96375
5:2:5,1,1,103624,96376
4:4:2,1,1,103623,96377
4:2:3,1,1,103622,96378
1:3:5,0,-1,103623,96377
2:3:6,1,1,103622,96378
6:2:4,1,1,103621,96379
1:4:5,0,-1,103622,96378
1:1:5,0,-1,103623,96377
2:4:1,1,1,103622,96378
1:5:1,0,-1,103623,96377
5:3:5,0,-1,103624,96376
4:5:5,0,-1,103625,96375
5:5:2,1,1,103624,96376
3:4:3,0,-1,103625,96375
5:1:2,1,1,103624,96376
5:1:2,1,1,103623,96377
5:5:1,0,-1,103624,96376
3:3:3,0,-1,103625,96375
2:1:5,1,1,103624,96376
6:2:5,1,1,103623,96377
4:5:5,0,-1,103624,96376
2:1:3,1,1,103623,96377
6:5:1,0,-1,103624,96376
5:6:5,0,-1,103625,96375
3:6:1,0,-1,103626,96374
4:5:3,0,-1,103627,96373
1:4:2,1,1,103626,96374
4:4:5,0,-1,103627,96373
4:3:6,0,-1,103628,96372
3:2:3,1,1,103627,96373
5:3:6,0,-1,103628,96372
1:5:3,0,-1,103629,96371
3:1:2,1,1,103628,96372
4:3:4,0,-1,103629,96371
4:3:3,0,-1,103630,96370
1:6:1,0,-1,103631,96369
4:4:6,0,-1,103632,96368
4:6:1,0,-1,103633,96367
5:5:3,0,-1,103634,96366
5:3:6,0,-1,103635,96365
2:1:3,1,1,103634,96366
1:6:2,1,1,103633,96367
5:3:3,0,-1,103634,96366
1:5:5,0,-1,103635,96365
2:4:6,1,1,103634,96366
1:3:1,0,-1,103635,96365
4:3:1,0,-1,103636,96364
3:1:3,0,-1,103637,96363
5:3:3,0,-1,103638,96362
6:5:5,0,-1,103639,96361
3:1:5,0,-1,103640,96360
1:3:3,0,-1,103641,96359
5:5:1,0,-1,103642,96358
5:3:5,0,-1,103643,96357
4:5:6,0,-1,103644,96356
3:2:6,1,1,103643,96357
3:2:5,1,1,103642,96358
5:2:3,1,1,103641,96359
6:1:2,1,1,103640,96360
5:1:2,1,1,103639,96361
3:1:1,0,-1,103640,96360
3:3:5,0,-1,103641,96359
5:4:3,0,-1,103642,96358
4:4:2,1,1,103641,96359
1:2:3,1,1,103640,96360
6:3:3,0,-1,103641,96359
3:5:4,0,-1,103642,96358
2:4:2,2,2,103640,96360
5:5:5,0,-1,103641,96359
6:2:5,1,1,103640,96360
1:6:1,0,-1,103641,96359
5:4:2,1,1,103640,96360
5:2:2,2,2,103638,96362
1:4:3,0,-1,103639,96361
6:2:3,1,1,103638,96362
3:2:3,1,1,103637,96363
5:6:5,0,-1,103638,96362
1:4:2,1,1,103637,96363
4:4:6,0,-1,103638,96362
1:4:5,0,-1,103639,96361
5:6:1,0,-1,103640,96360
5:6:4,0,-1,103641,96359
5:5:3,0,-1,103642,96358
4:4:1,0,-1,103643,96357
6:2:5,1,1,103642,96358
1:3:5,0,-1,103643,96357
3:4:6,0,-1,103644,96356
3:4:3,0,-1,103645,96355
3:1:5,0,-1,103646,96354
4:2:4,1,1,103645,96355
4:2:4,1,1,103644,96356
3:3:1,0,-1,103645,96355
4:5:3,0,-1,103646,96354
6:5:4,0,-1,103647,96353
4:4:4,0,-1,103648,96352
5:4:3,0,-1,103649,96351
3:3:2,1,1,103648,96352
3:4:2,1,1,103647,96353
5:6:5,0,-1,103648,96352
5:5:2,1,1,103647,96353
4:1:6,0,-1,103648,96352
2:2:4,2,2,103646,96354
5:3:6,0,-1,103647,96353
3:6:5,0,-1,103648,96352
4:1:2,1,1,103647,96353
3:4:4,0,-1,103648,96352
4:5:6,0,-1,103649,96351
4:3:1,0,-1,103650,96350
1:2:4,1,1,103649,96351
3:2:4,1,1,103648,96352
6:3:2,1,1,103647,96353
6:1:2,1,1,103646,96354
5:6:3,0,-1,103647,96353
1:6:1,0,-1,103648,96352
6:4:6,0,-1,103649,96351
1:6:2,1,1,103648,96352
1:3:6,0,-1,103649,96351
4:4:6,0,-1,103650,96350
4:4:4,0,-1,103651,96349
5:5:6,0,-1,103652,96348
1:3:6,0,-1,103653,96347
3:2:6,1,1,103652,96348
3:5:1,0,-1,103653,96347
2:1:2,2,2,103651,96349
6:5:5,0,-1,103652,96348
5:2:5,1,1,103651,96349
3:5:5,0,-1,103652,96348
4:4:1,0,-1,103653,96347
4:1:6,0,-1,103654,96346
2:4:3,1,1,103653,96347
1:3:3,0,-1,103654,96346
4:2:1,1,1,103653,96347
5:5:5,0,-1,103654,96346
5:6:6,0,-1,103655,96345
2:5:1,1,1,103654,96346
1:2:2,2,2,103652,96348
4:1:1,0,-1,103653,96347
6:3:2,1,1,103652,96348
2:2:1,2,2,103650,96350
3:2:6,1,1,103649,96351
2:6:2,2,2,103647,96353
3:2:3,1,1,103646,96354
2:1:5,1,1,103645,96355
4:3:3,0,-1,103646,96354
2:1:4,1,1,103645,96355
1:6:3,0,-1,103646,96354
2:6:4,1,1,103645,96355
2:1:2,2,2,103643,96357
3:6:3,0,-1,103644,96356
5:1:4,0,-1,103645,96355
3:1:2,1,1,103644,96356
6:5:2,1,1,103643,96357
2:3:6,1,1,103642,96358
6:2:1,1,1,103641,96359
6:3:6,0,-1,103642,96358
1:3:3,0,-1,103643,96357
2:2:1,2,2,103641,96359
3:5:1,0,-1,103642,96358
5:1:5,0,-1,103643,96357
6:6:2,1,1,103642,96358
1:1:6,0,-1,103643,96357
2:4:3,1,1,103642,96358
6:2:2,2,2,103640,96360
6:1:1,0,-1,103641,96359
6:6:4,0,-1,103642,96358
6:6:1,0,-1,103643,96357
1:6:5,0,-1,103644,96356
1:3:1,0,-1,103645,96355
3:4:1,0,-1,103646,96354
2:3:2,2,2,103644,96356
2:3:5,1,1,103643,96357
6:5:6,0,-1,103644,96356
1:2:6,1,1,103643,96357
2:5:4,1,1,103642,96358
6:4:1,0,-1,103643,96357
5:4:3,0,-1,103644,96356
1:1:6,0,-1,103645,96355
5:5:3,0,-1,103646,96354
4:6:4,0,-1,103647,96353
4:4:1,0,-1,103648,96352
6:6:4,0,-1,103649,96351
1:2:6,1,1,103648,96352
5:4:3,0,-1,103649,96351
4:4:1,0,-1,103650,96350
3:6:2,1,1,103649,96351
3:1:5,0,-1,103650,96350
2:1:6,1,1,103649,96351
3:1:3,0,-1,103650,96350
4:4:3,0,-1,103651,96349
3:6:4,0,-1,103652,96348
3:5:1,0,-1,103653,96347
5:6:1,0,-1,103654,96346
5:4:5,0,-1,103655,96345
4:6:4,0,-1,103656,96344
5:3:2,1,1,103655,96345
6:4:3,0,-1,103656,96344
3:5:6,0,-1,103657,96343
6:2:5,1,1,103656,96344
2:6:3,1,1,103655,96345
1:4:3,0,-1,103656,96344
5:2:1,1,1,103655,96345
4:3:6,0,-1,103656,96344
6:2:1,1,1,103655,96345
3:3:1,0,-1,103656,96344
5:4:6,0,-1,103657,96343
4:6:4,0,-1,103658,96342
4:4:5,0,-1,103659,96341
3:2:6,1,1,103658,96342
6:2:5,1,1,103657,96343
1:3:1,0,-1,103658,96342
3:6:6,0,-1,103659,96341
4:2:4,1,1,103658,96342
6:3:5,0,-1,103659,96341
3:6:5,0,-1,103660,96340
3:2:6,1,1,103659,96341
1:6:6,0,-1,103660,96340
3:2:3,1,1,103659,96341
1:3:5,0,-1,103660,96340
5:5:2,1,1,103659,96341
4:2:1,1,1,103658,96342
4:4:5,0,-1,103659,96341
2:6:4,1,1,103658,96342
2:6:6,1,1,103657,96343
6:6:1,0,-1,103658,96342
6:3:5,0,-1,103659,96341
5:6:1,0,-1,103660,96340
1:5:3,0,-1,103661,96339
3:5:3,0,-1,103662,96338
1:1:5,0,-1,103663,96337
2:5:2,2,2,103661,96339
6:6:3,0,-1,103662,96338
2:4:5,1,1,103661,96339
4:6:2,1,1,103660,96340
5:5:5,0,-1,103661,96339
3:1:4,0,-1,103662,96338
5:6:4,0,-1,103663,96337
3:3:4,0,-1,103664,96336
6:3:3,0,-1,103665,96335
3:1:3,0,-1,103666,96334
3:3:5,0,-1,103667,96333
6:1:1,0,-1,103668,96332
3:3:4,0,-1,103669,96331
5:3:6,0,-1,103670,96330
2:1:1,1,1,103669,96331
2:5:4,1,1,103668,96332
2:6:4,1,1,103667,96333
2:5:1,1,1,103666,96334
2:3:6,1,1,103665,96335
2:3:1,1,1,103664,96336
5:2:6,1,1,103663,96337
2:4:1,1,1,103662,96338
5:5:2,1,1,103661,96339
2:3:1,1,1,103660,96340
6:2:2,2,2,103658,96342
4:4:6,0,-1,103659,96341
1:2:5,1,1,103658,96342
1:6:6,0,-1,103659,96341
2:2:5,2,2,103657,96343
3:1:6,0,-1,103658,96342
1:5:3,0,-1,103659,96341
2:2:2,3,3,103656,96344
5:3:4,0,-1,103657,96343
3:6:1,0,-1,103658,96342
3:6:1,0,-1,103659,96341
5:3:1,0,-1,103660,96340
6:5:5,0,-1,103661,96339
3:1:3,0,-1,103662,96338
3:2:2,2,2,103660,96340
6:1:2,1,1,103659,96341
5:1:1,0,-1,103660,96340
6:4:5,0,-1,103661,96339
5:1:4,0,-1,103662,96338
2:1:6,1,1,103661,96339
1:1:5,0,-1,103662,96338
4:3:4,0,-1,103663,96337
2:2:1,2,2,103661,96339
3:2:3,1,1,103660,96340
5:1:3,0,-1,103661,96339
3:6:5,0,-1,103662,96338
3:2:1,1,1,103661,96339
3:6:1,0,-1,103662,96338
6:5:4,0,-1,103663,96337
6:1:4,0,-1,103664,96336
6:6:2,1,1,103663,96337
3:6:4,0,-1,103664,96336
2:3:3,1,1,103663,96337
6:1:1,0,-1,103664,96336
4:1:5,0,-1,103665,96335
5:6:2,1,1,103664,96336
6:4:5,0,-1,103665,96335
2:5:5,1,1,103664,96336
2:3:1,1,1,103663,96337
6:2:6,1,1,103662,96338
6:5:5,0,-1,103663,96337
2:3:2,2,2,103661,96339
3:3:5,0,-1,103662,96338
4:3:3,0,-1,103663,96337
3:4:2,1,1,103662,96338
3:5:5,0,-1,103663,96337
6:3:2,1,1,103662,96338
1:1:5,0,-1,103663,96337
1:5:5,0,-1,103664,96336
5:4:2,1,1,103663,96337
1:6:1,0,-1,103664,96336
4:4:5,0,-1,103665,96335
3:1:5,0,-1,103666,96334
5:6:2,1,1,103665,96335
6:5:4,0,-1,103666,96334
6:1:2,1,1,103665,96335
6:2:3,1,1,103664,96336
2:3:5,1,1,103663,96337
4:3:6,0,-1,103664,96336
3:4:4,0,-1,103665,96335
3:1:3,0,-1,103666,96334
2:5:3,1,1,103665,96335
5:3:4,0,-1,103666,96334
5:6:2,1,1,103665,96335
3:4:3,0,-1,103666,96334
3:1:3,0,-1,103667,96333
4:6:6,0,-1,103668,96332
3:6:5,0,-1,103669,96331
5:1:3,0,-1,103670,96330
6:4:1,0,-1,103671,96329
2:5:5,1,1,103670,96330
5:3:5,0,-1,103671,96329
5:4:3,0,-1,103672,96328
6:2:3,1,1,103671,96329
6:4:3,0,-1,103672,96328
1:4:3,0,-1,103673,96327
3:2:1,1,1,103672,96328
1:6:5,0,-1,103673,96327
5:4:2,1,1,103672,96328
2:4:3,1,1,103671,96329
1:3:6,0,-1,103672,96328
2:5:1,1,1,103671,96329
3:6:5,0,-1,103672,96328
1:1:3,0,-1,103673,96327
6:6:4,0,-1,103674,96326
1:4:3,0,-1,103675,96325
3:2:1,1,1,103674,96326
3:5:2,1,1,103673,96327
6:6:1,0,-1,103674,96326
6:6:4,0,-1,103675,96325
4:2:2,2,2,103673,96327
6:2:6,1,1,103672,96328
6:3:6,0,-1,103673,96327
3:1:6,0,-1,103674,96326
2:3:3,1,1,103673,96327
3:5:6,0,-1,103674,96326
5:5:2,1,1,103673,96327
6:4:2,1,1,103672,96328
1:3:5,0,-1,103673,96327
4:5:3,0,-1,103674,96326
3:5:1,0,-1,103675,96325
3:4:2,1,1,103674,96326
4:1:5,0,-1,103675,96325
4:1:2,1,1,103674,96326
4:3:5,0,-1,103675,96325
6:4:4,0,-1,103676,96324
5:1:6,0,-1,103677,96323
2:6:2,2,2,103675,96325
1:6:3,0,-1,103676,96324
2:1:1,1,1,103675,96325
6:3:2,1,1,103674,96326
1:6:5,0,-1,103675,96325
1:3:4,0,-1,103676,96324
5:5:3,0,-1,103677,96323
2:6:5,1,1,103676,96324
2:3:4,1,1,103675,96325
1:4:4,0,-1,103676,96324
5:2:1,1,1,103675,96325
5:4:2,1,1,103674,96326
1:2:6,1,1,103673,96327
3:5:6,0,-1,103674,96326
5:3:3,0,-1,103675,96325
5:5:4,0,-1,103676,96324
3:4:2,1,1,103675,96325
1:3:1,0,-1,103676,96324
6:6:5,0,-1,103677,96323
5:6:2,1,1,103676,96324
2:4:2,2,2,103674,96326
3:3:4,0,-1,103675,96325
5:1:5,0,-1,103676,96324
4:2:4,1,1,103675,96325
2:5:3,1,1,103674,96326
2:5:1,1,1,103673,96327
2:4:3,1,1,103672,96328
6:4:5,0,-1,103673,96327
5:4:4,0,-1,103674,96326
1:4:1,0,-1,103675,96325
6:2:3,1,1,103674,96326
6:4:1,0,-1,103675,96325
2:3:6,1,1,103674,96326
3:5:5,0,-1,103675,96325
6:3:4,0,-1,103676,96324
1:1:1,0,-1,103677,96323
4:2:4,1,1,103676,96324
3:5:5,0,-1,103677,96323
6:3:6,0,-1,103678,96322
3:3:1,0,-1,103679,96321
4:3:5,0,-1,103680,96320
4:6:6,0,-1,103681,96319
3:5:5,0,-1,103682,96318
4:1:4,0,-1,103683,96317
3:2:1,1,1,103682,96318
1:5:3,0,-1,103683,96317
3:6:3,0,-1,103684,96316
3:4:6,0,-1,103685,96315
3:4:5,0,-1,103686,96314
4:4:3,0,-1,103687,96313
1:3:5,0,-1,103688,96312
3:4:1,0,-1,103689,96311
1:6:3,0,-1,103690,96310
4:2:5,1,1,103689,96311
1:3:5,0,-1,103690,96310
1:1:1,0,-1,103691,96309
4:5:1,0,-1,103692,96308
5:3:6,0,-1,103693,96307
2:6:4,1,1,103692,96308
2:3:1,1,1,103691,96309
6:2:2,2,2,103689,96311
4:2:6,1,1,103688,96312
1:5:3,0,-1,103689,96311
1:6:3,0,-1,103690,96310
2:1:2,2,2,103688,96312
6:1:5,0,-1,103689,96311
5:3:4,0,-1,103690,96310
5:6:6,0,-1,103691,96309
2:2:4,2,2,103689,96311
4:4:2,1,1,103688,96312
3:3:1,0,-1,103689,96311
1:5:6,0,-1,103690,96310
4:3:5,0,-1,103691,96309
5:2:6,1,1,103690,96310
1:2:4,1,1,103689,96311
6:3:5,0,-1,103690,96310
5:5:4,0,-1,103691,96309
6:1:6,0,-1,103692,96308
4:4:2,1,1,103691,96309
3:4:2,1,1,103690,96310
4:6:1,0,-1,103691,96309
3:6:5,0,-1,103692,96308
1:6:6,0,-1,103693,96307
1:4:2,1,1,103692,96308
1:6:3,0,-1,103693,96307
3:2:6,1,1,103692,96308
2:2:1,2,2,103690,96310
3:1:2,1,1,103689,96311
5:1:2,1,1,103688,96312
3:5:4,0,-1,103689,96311
4:4:6,0,-1,103690,96310
3:5:1,0,-1,103691,96309
2:1:3,1,1,103690,96310
6:6:6,0,-1,103691,96309
1:3:5,0,-1,103692,96308
3:6:1,0,-1,103693,96307
2:4:2,2,2,103691,96309
4:1:4,0,-1,103692,96308
6:6:4,0,-1,103693,96307
1:5:3,0,-1,103694,96306
4:1:6,0,-1,103695,96305
2:3:1,1,1,103694,96306
4:1:6,0,-1,103695,96305
2:2:5,2,2,103693,96307
1:5:4,0,-1,103694,96306
6:1:4,0,-1,103695,96305
1:5:3,0,-1,103696,96304
3:6:5,0,-1,103697,96303
2:1:2,2,2,103695,96305
4:1:5,0,-1,103696,96304
6:2:2,2,2,103694,96306
1:4:5,0,-1,103695,96305
4:5:6,0,-1,103696,96304
6:4:4,0,-1,103697,96303
2:6:3,1,1,103696,96304
3:1:4,0,-1,103697,96303
3:5:3,0,-1,103698,96302
5:3:4,0,-1,103699,96301
4:4:6,0,-1,103700,96300
2:1:1,1,1,103699,96301
3:2:5,1,1,103698,96302
4:3:6,0,-1,103699,96301
3:1:4,0,-1,103700,96300
6:2:2,2,2,103698,96302
2:5:1,1,1,103697,96303
3:6:5,0,-1,103698,96302
3:1:6,0,-1,103699,96301
1:6:5,0,-1,103700,96300
2:3:1,1,1,103699,96301
1:2:4,1,1,103698,96302
4:6:2,1,1,103697,96303
4:5:3,0,-1,103698,96302
5:2:3,1,1,103697,96303
4:3:3,0,-1,103698,96302
5:5:2,1,1,103697,96303
5:3:3,0,-1,103698,96302
5:4:2,1,1,103697,96303
6:6:3,0,-1,103698,96302
3:2:6,1,1,103697,96303
2:4:6,1,1,103696,96304
5:6:6,0,-1,103697,96303
3:4:3,0,-1,103698,96302
2:5:5,1,1,103697,96303
2:6:3,1,1,103696,96304
3:1:5,0,-1,103697,96303
6:2:5,1,1,103696,96304
2:6:4,1,1,103695,96305
2:1:1,1,1,103694,96306
4:4:6,0,-1,103695,96305
3:2:6,1,1,103694,96306
5:3:3,0,-1,103695,96305
1:1:2,1,1,103694,96306
5:6:3,0,-1,103695,96305
5:6:2,1,1,103694,96306
2:1:1,1,1,103693,96307
6:3:1,0,-1,103694,96306
5:4:1,0,-1,103695,96305
2:1:4,1,1,103694,96306
5:2:1,1,1,103693,96307
6:4:1,0,-1,103694,96306
1:4:4,0,-1,103695,96305
5:6:3,0,-1,103696,96304
3:5:6,0,-1,103697,96303
1:4:5,0,-1,103698,96302
1:1:1,0,-1,103699,96301
1:1:2,1,1,103698,96302
2:1:3,1,1,103697,96303
3:5:4,0,-1,103698,96302
4:3:1,0,-1,103699,96301
6:5:2,1,1,103698,96302
1:1:6,0,-1,103699,96301
1:4:2,1,1,103698,96302
5:4:4,0,-1,103699,96301
5:3:1,0,-1,103700,96300
4:4:6,0,-1,103701,96299
4:5:4,0,-1,103702,96298
4:4:5,0,-1,103703,96297
4:6:5,0,-1,103704,96296
5:5:6,0,-1,103705,96295
6:6:5,0,-1,103706,96294
3:1:3,0,-1,103707,96293
2:3:5,1,1,103706,96294
2:1:2,2,2,103704,96296
2:3:6,1,1,103703,96297
4:1:1,0,-1,103704,96296
2:1:1,1,1,103703,96297
6:4:2,1,1,103702,96298
1:3:4,0,-1,103703,96297
1:6:6,0,-1,103704,96296
5:2:6,1,1,103703,96297
6:4:5,0,-1,103704,96296
6:4:4,0,-1,103705,96295
6:4:1,0,-1,103706,96294
6:1:3,0,-1,103707,96293
4:5:3,0,-1,103708,96292
2:2:2,3,3,103705,96295
5:2:6,1,1,103704,96296
1:2:1,1,1,103703,96297
1:2:1,1,1,103702,96298
5:6:6,0,-1,103703,96297
4:6:5,0,-1,103704,96296
5:4:6,0,-1,103705,96295
6:4:4,0,-1,103706,96294
1:1:2,1,1,103705,96295
6:1:4,0,-1,103706,96294
2:3:4,1,1,103705,96295
2:5:5,1,1,103704,96296
1:2:4,1,1,103703,96297
6:5:2,1,1,103702,96298
3:3:5,0,-1,103703,96297
6:5:4,0,-1,103704,96296
4:6:5,0,-1,103705,96295
6:5:5,0,-1,103706,96294
6:1:2,1,1,103705,96295
6:5:1,0,-1,103706,96294
4:3:1,0,-1,103707,96293
3:4:3,0,-1,103708,96292
3:4:1,0,-1,103709,96291
4:4:4,0,-1,103710,96290
5:1:4,0,-1,103711,96289
3:4:5,0,-1,103712,96288
6:3:5,0,-1,103713,96287
4:1:5,0,-1,103714,96286
4:3:3,0,-1,103715,96285
3:1:1,0,-1,103716,96284
6:5:3,0,-1,103717,96283
5:6:1,0,-1,103718,96282
1:5:5,0,-1,103719,96281
6:4:6,0,-1,103720,96280
3:2:2,2,2,103718,96282
1:2:4,1,1,103717,96283
4:4:3,0,-1,103718,96282
6:1:3,0,-1,103719,96281
5:5:4,0,-1,103720,96280
6:2:6,1,1,103719,96281
3:4:1,0,-1,103720,96280
5:3:2,1,1,103719,96281
3:2:2,2,2,103717,96283
5:1:5,0,-1,103718,96282
6:3:3,0,-1,103719,96281
4:4:5,0,-1,103720,96280
4:1:2,1,1,103719,96281
2:6:4,1,1,103718,96282
1:2:6,1,1,103717,96283
3:2:4,1,1,103716,96284
5:5:3,0,-1,103717,96283
6:1:1,0,-1,103718,96282
5:1:5,0,-1,103719,96281
3:3:2,1,1,103718,96282
1:3:4,0,-1,103719,96281
6:2:6,1,1,103718,96282
1:3:4,0,-1,103719,96281
3:2:1,1,1,103718,96282
6:5:5,0,-1,103719,96281
5:1:4,0,-1,103720,96280
2:3:1,1,1,103719,96281
2:6:2,2,2,103717,96283
2:1:6,1,1,103716,96284
2:1:3,1,1,103715,96285
1:6:1,0,-1,103716,96284
3:5:5,0,-1,103717,96283
1:6:5,0,-1,103718,96282
5:3:6,0,-1,103719,96281
2:3:2,2,2,103717,96283
1:2:4,1,1,103716,96284
5:2:6,1,1,103715,96285
1:4:2,1,1,103714,96286
6:5:1,0,-1,103715,96285
1:4:3,0,-1,103716,96284
4:1:1,0,-1,103717,96283
5:2:4,1,1,103716,96284
3:1:3,0,-1,103717,96283
2:2:3,2,2,103715,96285
2:2:5,2,2,103713,96287
6:6:5,0,-1,103714,96286
3:4:2,1,1,103713,96287
1:3:4,0,-1,103714,96286
5:5:1,0,-1,103715,96285
2:5:6,1,1,103714,96286
2:6:3,1,1,103713,96287
5:5:1,0,-1,103714,96286
2:4:3,1,1,103713,96287
1:5:1,0,-1,103714,96286
1:5:3,0,-1,103715,96285
2:3:5,1,1,103714,96286
1:2:5,1,1,103713,96287
3:1:2,1,1,103712,96288
6:2:3,1,1,103711,96289
1:1:3,0,-1,103712,96288
4:1:1,0,-1,103713,96287
4:4:2,1,1,103712,96288
3:3:1,0,-1,103713,96287
2:2:3,2,2,103711,96289
6:2:4,1,1,103710,96290
6:2:1,1,1,103709,96291
1:3:1,0,-1,103710,96290
2:2:4,2,2,103708,96292
6:4:3,0,-1,103709,96291
6:2:1,1,1,103708,96292
4:3:2,1,1,103707,96293
2:1:6,1,1,103706,96294
3:5:2,1,1,103705,96295
5:3:5,0,-1,103706,96294
6:5:1,0,-1,103707,96293
6:6:6,0,-1,103708,96292
2:3:2,2,2,103706,96294
6:3:4,0,-1,103707,96293
6:5:5,0,-1,103708,96292
3:2:4,1,1,103707,96293
2:6:1,1,1,103706,96294
6:1:3,0,-1,103707,96293
5:6:6,0,-1,103708,96292
1:3:6,0,-1,103709,96291
3:5:2,1,1,103708,96292
5:2:6,1,1,103707,96293
5:1:1,0,-1,103708,96292
1:1:6,0,-1,103709,96291
2:1:3,1,1,103708,96292
1:1:3,0,-1,103709,96291
1:6:4,0,-1,103710,96290
4:4:1,0,-1,103711,96289
5:2:6,1,1,103710,96290
2:1:2,2,2,103708,96292
4:4:2,1,1,103707,96293
4:5:1,0,-1,103708,96292
1:6:5,0,-1,103709,96291
2:2:4,2,2,103707,96293
4:4:1,0,-1,103708,96292
1:4:1,0,-1,103709,96291
1:4:5,0,-1,103710,96290
2:5:2,2,2,103708,96292
6:4:5,0,-1,103709,96291
3:3:3,0,-1,103710,96290
6:1:3,0,-1,103711,96289
6:2:6,1,1,103710,96290
5:5:3,0,-1,103711,96289
2:2:1,2,2,103709,96291
6:4:6,0,-1,103710,96290
3:6:5,0,-1,103711,96289
4:2:3,1,1,103710,96290
5:3:1,0,-1,103711,96289
6:3:5,0,-1,103712,96288
1:1:3,0,-1,103713,96287
5:6:6,0,-1,103714,96286
2:2:6,2,2,103712,96288
2:1:4,1,1,103711,96289
2:3:4,1,1,103710,96290
5:3:5,0,-1,103711,96289
5:1:2,1,1,103710,96290
2:3:4,1,1,103709,96291
5:2:5,1,1,103708,96292
5:1:5,0,-1,103709,96291
5:6:6,0,-1,103710,96290
2:1:3,1,1,103709,96291
2:1:1,1,1,103708,96292
4:3:6,0,-1,103709,96291
3:4:3,0,-1,103710,96290
6:5:1,0,-1,103711,96289
3:3:4,0,-1,103712,96288
1:5:2,1,1,103711,96289
4:1:5,0,-1,103712,96288
2:4:3,1,1,103711,96289
2:3:4,1,1,103710,96290
5:5:1,0,-1,103711,96289
5:5:2,1,1,103710,96290
3:4:5,0,-1,103711,96289
3:4:5,0,-1,103712,96288
5:4:6,0,-1,103713,96287
2:4:1,1,1,103712,96288
2:3:5,1,1,103711,96289
4:3:5,0,-1,103712,96288
3:1:4,0,-1,103713,96287
6:4:4,0,-1,103714,96286
4:1:3,0,-1,103715,96285
1:5:5,0,-1,103716,96284
6:5:1,0,-1,103717,96283
3:3:6,0,-1,103718,96282
4:3:4,0,-1,103719,96281
6:2:3,1,1,103718,96282
6:5:2,1,1,103717,96283
1:4:3,0,-1,103718,96282
2:5:1,1,1,103717,96283
2:2:5,2,2,103715,96285
3:6:4,0,-1,103716,96284
2:3:4,1,1,103715,96285
6:3:2,1,1,103714,96286
5:1:6,0,-1,103715,96285
5:3:5,0,-1,103716,96284
4:1:6,0,-1,103717,96283
3:1:4,0,-1,103718,96282
6:1:3,0,-1,103719,96281
6:5:2,1,1,103718,96282
6:2:2,2,2,103716,96284
4:1:1,0,-1,103717,96283
5:3:4,0,-1,103718,96282
4:5:4,0,-1,103719,96281
1:2:2,2,2,103717,96283
6:2:4,1,1,103716,96284
6:1:3,0,-1,103717,96283
4:5:3,0,-1,103718,96282
2:6:4,1,1,103717,96283
4:5:3,0,-1,103718,96282
5:3:3,0,-1,103719,96281
2:4:4,1,1,103718,96282
2:5:2,2,2,103716,96284
4:2:1,1,1,103715,96285
1:2:2,2,2,103713,96287
6:1:3,0,-1,103714,96286
1:1:5,0,-1,103715,96285
6:6:6,0,-1,103716,96284
2:3:4,1,1,103715,96285
1:6:5,0,-1,103716,96284
4:6:4,0,-1,103717,96283
1:3:1,0,-1,103718,96282
3:2:5,1,1,103717,96283
6:3:4,0,-1,103718,96282
6:3:5,0,-1,103719,96281
1:3:3,0,-1,103720,96280
2:4:1,1,1,103719,96281
6:3:5,0,-1,103720,96280
5:3:3,0,-1,103721,96279
2:3:2,2,2,103719,96281
5:6:1,0,-1,103720,96280
3:5:6,0,-1,103721,96279
2:2:4,2,2,103719,96281
6:6:6,0,-1,103720,96280
5:2:3,1,1,103719,96281
5:5:2,1,1,103718,96282
2:4:4,1,1,103717,96283
1:4:3,0,-1,103718,96282
1:6:3,0,-1,103719,96281
2:1:1,1,1,103718,96282
3:6:1,0,-1,103719,96281
1:6:1,0,-1,103720,96280
6:2:3,1,1,103719,96281
4:6:1,0,-1,103720,96280
2:3:2,2,2,103718,96282
1:4:1,0,-1,103719,96281
5:6:1,0,-1,103720,96280
5:6:2,1,1,103719,96281
4:2:3,1,1,103718,96282
4:5:2,1,1,103717,96283
6:2:5,1,1,103716,96284
6:2:1,1,1,103715,96285
4:5:6,0,-1,103716,96284
6:1:6,0,-1,103717,96283
3:5:6,0,-1,103718,96282
3:5:5,0,-1,103719,96281
4:1:6,0,-1,103720,96280
2:6:6,1,1,103719,96281
5:5:6,0,-1,103720,96280
6:2:3,1,1,103719,96281
5:3:1,0,-1,103720,96280
6:2:2,2,2,103718,96282
1:2:5,1,1,103717,96283
5:6:1,0,-1,103718,96282
6:4:2,1,1,103717,96283
4:6:5,0,-1,103718,96282
1:3:5,0,-1,103719,96281
1:6:5,0,-1,103720,96280
3:1:5,0,-1,103721,96279
4:2:4,1,1,103720,96280
5:1:3,0,-1,103721,96279
2:2:3,2,2,103719,96281
6:5:1,0,-1,103720,96280
1:5:5,0,-1,103721,96279
1:4:4,0,-1,103722,96278
1:2:2,2,2,103720,96280
5:4:2,1,1,103719,96281
4:1:3,0,-1,103720,96280
2:5:1,1,1,103719,96281
2:6:6,1,1,103718,96282
1:1:2,1,1,103717,96283
4:1:4,0,-1,103718,96282
4:1:3,0,-1,103719,96281
6:1:2,1,1,103718,96282
5:1:1,0,-1,103719,96281
1:3:6,0,-1,103720,96280
6:6:3,0,-1,103721,96279
2:4:5,1,1,103720,96280
1:6:2,1,1,103719,96281
5:3:1,0,-1,103720,96280
2:4:3,1,1,103719,96281
5:1:4,0,-1,103720,96280
4:3:4,0,-1,103721,96279
3:3:6,0,-1,103722,96278
6:5:5,0,-1,103723,96277
6:4:3,0,-1,103724,96276
3:2:2,2,2,103722,96278
6:1:2,1,1,103721,96279
6:6:2,1,1,103720,96280
2:6:2,2,2,103718,96282
2:5:2,2,2,103716,96284
6:3:4,0,-1,103717,96283
6:2:5,1,1,103716,96284
3:3:2,1,1,103715,96285
6:6:3,0,-1,103716,96284
4:3:3,0,-1,103717,96283
5:6:4,0,-1,103718,96282
1:6:3,0,-1,103719,96281
5:2:6,1,1,103718,96282
4:4:3,0,-1,103719,96281
2:5:1,1,1,103718,96282
2:1:1,1,1,103717,96283
2:1:1,1,1,103716,96284
4:3:4,0,-1,103717,96283
2:2:6,2,2,103715,96285
1:1:6,0,-1,103716,96284
1:4:4,0,-1,103717,96283
2:2:6,2,2,103715,96285
4:5:2,1,1,103714,96286
6:2:1,1,1,103713,96287
4:4:2,1,1,103712,96288
1:2:2,2,2,103710,96290
3:5:2,1,1,103709,96291
5:5:6,0,-1,103710,96290
1:2:1,1,1,103709,96291
5:3:2,1,1,103708,96292
3:4:3,0,-1,103709,96291
2:3:5,1,1,103708,96292
6:4:6,0,-1,103709,96291
1:5:3,0,-1,103710,96290
5:4:5,0,-1,103711,96289
2:4:1,1,1,103710,96290
3:6:6,0,-1,103711,96289
2:5:2,2,2,103709,96291
6:5:5,0,-1,103710,96290
2:3:3,1,1,103709,96291
3:4:2,1,1,103708,96292
6:2:4,1,1,103707,96293
4:5:6,0,-1,103708,96292
6:2:3,1,1,103707,96293
6:3:1,0,-1,103708,96292
1:3:3,0,-1,103709,96291
4:6:3,0,-1,103710,96290
4:2:2,2,2,103708,96292
6:2:2,2,2,103706,96294
6:1:4,0,-1,103707,96293
1:6:3,0,-1,103708,96292
4:5:3,0,-1,103709,96291
2:4:4,1,1,103708,96292
5:3:4,0,-1,103709,96291
5:2:6,1,1,103708,96292
6:1:1,0,-1,103709,96291
6:5:5,0,-1,103710,96290
4:5:4,0,-1,103711,96289
6:4:3,0,-1,103712,96288
3:6:2,1,1,103711,96289
3:2:4,1,1,103710,96290
5:2:1,1,1,103709,96291
1:2:5,1,1,103708,96292
1:3:1,0,-1,103709,96291
2:4:4,1,1,103708,96292
5:3:4,0,-1,103709,96291
2:5:3,1,1,103708,96292
3:5:1,0,-1,103709,96291
3:1:3,0,-1,103710,96290
6:4:1,0,-1,103711,96289
1:4:3,0,-1,103712,96288
6:3:6,0,-1,103713,96287
5:2:2,2,2,103711,96289
1:1:5,0,-1,103712,96288
3:3:5,0,-1,103713,96287
2:2:2,3,3,103710,96290
5:4:5,0,-1,103711,96289
5:2:2,2,2,103709,96291
5:6:6,0,-1,103710,96290
3:5:2,1,1,103709,96291
5:6:5,0,-1,103710,96290
5:3:4,0,-1,103711,96289
1:6:6,0,-1,103712,96288
4:5:4,0,-1,103713,96287
3:6:6,0,-1,103714,96286
4:5:3,0,-1,103715,96285
3:2:4,1,1,103714,96286
3:1:1,0,-1,103715,96285
1:6:6,0,-1,103716,96284
2:5:3,1,1,103715,96285
1:5:2,1,1,103714,96286
1:4:6,0,-1,103715,96285
5:2:4,1,1,103714,96286
5:1:3,0,-1,103715,96285
4:4:3,0,-1,103716,96284
1:3:1,0,-1,103717,96283
4:2:5,1,1,103716,96284
3:6:4,0,-1,103717,96283
3:2:5,1,1,103716,96284
6:3:3,0,-1,103717,96283
3:3:6,0,-1,103718,96282
1:2:2,2,2,103716,96284
3:2:6,1,1,103715,96285
2:1:5,1,1,103714,96286
2:3:1,1,1,103713,96287
3:3:2,1,1,103712,96288
3:1:3,0,-1,103713,96287
5:3:6,0,-1,103714,96286
1:4:4,0,-1,103715,96285
3:2:6,1,1,103714,96286
3:2:2,2,2,103712,96288
6:4:4,0,-1,103713,96287
4:4:2,1,1,103712,96288
3:6:3,0,-1,103713,96287
2:1:6,1,1,103712,96288
4:6:1,0,-1,103713,96287
6:1:1,0,-1,103714,96286
4:4:4,0,-1,103715,96285
5:1:3,0,-1,103716,96284
3:2:3,1,1,103715,96285
5:6:3,0,-1,103716,96284
6:2:4,1,1,103715,96285
5:4:4,0,-1,103716,96284
3:3:2,1,1,103715,96285
6:3:4,0,-1,103716,96284
1:1:1,0,-1,103717,96283
1:5:4,0,-1,103718,96282
4:1:2,1,1,103717,96283
3:3:4,0,-1,103718,96282
2:2:6,2,2,103716,96284
6:5:1,0,-1,103717,96283
3:5:5,0,-1,103718,96282
5:1:3,0,-1,103719,96281
5:1:5,0,-1,103720,96280
3:5:5,0,-1,103721,96279
2:2:3,2,2,103719,96281
2:5:4,1,1,103718,96282
2:2:3,2,2,103716,96284
6:2:5,1,1,103715,96285
1:4:2,1,1,103714,96286
6:5:1,0,-1,103715,96285
2:5:6,1,1,103714,96286
2:4:3,1,1,103713,96287
4:4:2,1,1,103712,96288
5:3:3,0,-1,103713,96287
1:6:4,0,-1,103714,96286
6:5:2,1,1,103713,96287
6:2:3,1,1,103712,96288
3:2:4,1,1,103711,96289
3:5:3,0,-1,103712,96288
2:6:5,1,1,103711,96289
3:4:5,0,-1,103712,96288
4:6:5,0,-1,103713,96287
1:1:4,0,-1,103714,96286
1:3:4,0,-1,103715,96285
5:1:2,1,1,103714,96286
5:3:6,0,-1,103715,96285
1:5:2,1,1,103714,96286
1:3:3,0,-1,103715,96285
6:2:1,1,1,103714,96286
4:5:5,0,-1,103715,96285
3:6:2,1,1,103714,96286
5:6:2,1,1,103713,96287
1:5:5,0,-1,103714,96286
6:4:5,0,-1,103715,96285
3:5:2,1,1,103714,96286
5:5:4,0,-1,103715,96285
2:5:2,2,2,103713,96287
3:1:4,0,-1,103714,96286
6:3:3,0,-1,103715,96285
2:1:6,1,1,103714,96286
2:3:6,1,1,103713,96287
2:3:1,1,1,103712,96288
4:5:4,0,-1,103713,96287
6:2:5,1,1,103712,96288
4:3:2,1,1,103711,96289
6:1:5,0,-1,103712,96288
5:1:1,0,-1,103713,96287
1:1:1,0,-1,103714,96286
2:5:5,1,1,103713,96287
6:3:4,0,-1,103714,96286
4:4:5,0,-1,103715,96285
2:2:6,2,2,103713,96287
6:2:5,1,1,103712,96288
2:6:6,1,1,103711,96289
5:1:2,1,1,103710,96290
3:4:4,0,-1,103711,96289
6:3:2,1,1,103710,96290
4:1:5,0,-1,103711,96289
1:1:5,0,-1,103712,96288
4:2:5,1,1,103711,96289
5:1:4,0,-1,103712,96288
3:6:1,0,-1,103713,96287
1:1:6,0,-1,103714,96286
6:5:4,0,-1,103715,96285
5:6:3,0,-1,103716,96284
6:3:3,0,-1,103717,96283
5:1:3,0,-1,103718,96282
2:5:5,1,1,103717,96283
6:2:3,1,1,103716,96284
6:3:2,1,1,103715,96285
3:4:6,0,-1,103716,96284
5:5:3,0,-1,103717,96283
3:2:5,1,1,103716,96284
6:1:4,0,-1,103717,96283
1:2:5,1,1,103716,96284
1:1:1,0,-1,103717,96283
5:6:1,0,-1,103718,96282
2:6:2,2,2,103716,96284
1:5:3,0,-1,103717,96283
6:6:6,0,-1,103718,96282
6:3:4,0,-1,103719,96281
6:6:4,0,-1,103720,96280
1:5:5,0,-1,103721,96279
1:3:5,0,-1,103722,96278
6:2:5,1,1,103721,96279
3:5:2,1,1,103720,96280
1:5:6,0,-1,103721,96279
3:4:1,0,-1,103722,96278
1:1:3,0,-1,103723,96277
4:2:6,1,1,103722,96278
4:1:2,1,1,103721,96279
4:2:4,1,1,103720,96280
5:5:5,0,-1,103721,96279
5:6:4,0,-1,103722,96278
5:3:3,0,-1,103723,96277
4:6:3,0,-1,103724,96276
6:3:6,0,-1,103725,96275
3:2:6,1,1,103724,96276
4:1:2,1,1,103723,96277
1:2:6,1,1,103722,96278
2:4:4,1,1,103721,96279
4:2:2,2,2,103719,96281
6:1:4,0,-1,103720,96280
4:1:1,0,-1,103721,96279
4:4:1,0,-1,103722,96278
5:1:6,0,-1,103723,96277
3:2:5,1,1,103722,96278
6:3:3,0,-1,103723,96277
1:6:4,0,-1,103724,96276
2:1:6,1,1,103723,96277
1:6:5,0,-1,103724,96276
1:1:4,0,-1,103725,96275
2:6:3,1,1,103724,96276
4:5:1,0,-1,103725,96275
5:2:1,1,1,103724,96276
1:5:3,0,-1,103725,96275
6:2:4,1,1,103724,96276
3:3:4,0,-1,103725,96275
2:2:1,2,2,103723,96277
3:2:2,2,2,103721,96279
6:2:4,1,1,103720,96280
2:4:5,1,1,103719,96281
3:3:3,0,-1,103720,96280
2:3:4,1,1,103719,96281
1:6:5,0,-1,103720,96280
6:3:4,0,-1,103721,96279
2:3:1,1,1,103720,96280
6:1:3,0,-1,103721,96279
6:4:5,0,-1,103722,96278
4:3:4,0,-1,103723,96277
3:6:1,0,-1,103724,96276
3:2:5,1,1,103723,96277
1:2:5,1,1,103722,96278
1:2:4,1,1,103721,96279
1:2:6,1,1,103720,96280
1:4:4,0,-1,103721,96279
1:3:1,0,-1,103722,96278
2:6:6,1,1,103721,96279
2:1:5,1,1,103720,96280
3:5:5,0,-1,103721,96279
2:4:4,1,1,103720,96280
4:5:1,0,-1,103721,96279
4:4:1,0,-1,103722,96278
4:5:6,0,-1,103723,96277
6:3:2,1,1,103722,96278
4:1:2,1,1,103721,96279
3:2:5,1,1,103720,96280
4:2:4,1,1,103719,96281
4:1:3,0,-1,103720,96280
4:1:4,0,-1,103721,96279
6:5:6,0,-1,103722,96278
3:3:4,0,-1,103723,96277
4:1:5,0,-1,103724,96276
1:6:4,0,-1,103725,96275
3:5:6,0,-1,103726,96274
4:5:6,0,-1,103727,96273
2:1:6,1,1,103726,96274
4:4:4,0,-1,103727,96273
3:1:3,0,-1,103728,96272
3:4:6,0,-1,103729,96271
1:4:1,0,-1,103730,96270
5:5:4,0,-1,103731,96269
6:1:4,0,-1,103732,96268
1:5:4,0,-1,103733,96267
3:5:3,0,-1,103734,96266
6:1:1,0,-1,103735,96265
3:6:6,0,-1,103736,96264
6:5:5,0,-1,103737,96263
6:2:6,1,1,103736,96264
6:4:2,1,1,103735,96265
4:3:2,1,1,103734,96266
4:4:6,0,-1,103735,96265
6:5:4,0,-1,103736,96264
5:3:1,0,-1,103737,96263
1:2:2,2,2,103735,96265
1:3:4,0,-1,103736,96264
4:6:1,0,-1,103737,96263
3:1:4,0,-1,103738,96262
4:4:5,0,-1,103739,96261
6:2:4,1,1,103738,96262
3:1:3,0,-1,103739,96261
5:6:4,0,-1,103740,96260
2:5:2,2,2,103738,96262
5:4:3,0,-1,103739,96261
4:4:3,0,-1,103740,96260
6:3:6,0,-1,103741,96259
5:1:1,0,-1,103742,96258
5:5:1,0,-1,103743,96257
6:4:5,0,-1,103744,96256
2:5:6,1,1,103743,96257
2:4:5,1,1,103742,96258
1:1:4,0,-1,103743,96257
2:4:1,1,1,103742,96258
1:1:1,0,-1,103743,96257
4:4:6,0,-1,103744,96256
4:3:4,0,-1,103745,96255
5:4:1,0,-1,103746,96254
3:4:2,1,1,103745,96255
4:6:5,0,-1,103746,96254
1:4:4,0,-1,103747,96253
4:3:1,0,-1,103748,96252
6:5:6,0,-1,103749,96251
2:1:3,1,1,103748,96252
1:1:6,0,-1,103749,96251
1:4:1,0,-1,103750,96250
3:4:3,0,-1,103751,96249
2:5:1,1,1,103750,96250
3:4:3,0,-1,103751,96249
5:6:2,1,1,103750,96250
5:1:2,1,1,103749,96251
1:4:1,0,-1,103750,96250
3:6:2,1,1,103749,96251
6:6:1,0,-1,103750,96250
4:6:6,0,-1,103751,96249
4:3:1,0,-1,103752,96248
5:1:5,0,-1,103753,96247
3:5:6,0,-1,103754,96246
2:5:3,1,1,103753,96247
6:5:5,0,-1,103754,96246
3:3:4,0,-1,103755,96245
6:3:6,0,-1,103756,96244
6:3:5,0,-1,103757,96243
6:5:2,1,1,103756,96244
5:6:3,0,-1,103757,96243
4:4:2,1,1,103756,96244
2:4:4,1,1,103755,96245
5:1:2,1,1,103754,96246
2:1:4,1,1,103753,96247
1:6:6,0,-1,103754,96246
4:5:1,0,-1,103755,96245
3:6:3,0,-1,103756,96244
1:4:4,0,-1,103757,96243
4:2:2,2,2,103755,96245
6:6:5,0,-1,103756,96244
1:6:4,0,-1,103757,96243
6:3:1,0,-1,103758,96242
4:3:3,0,-1,103759,96241
2:1:3,1,1,103758,96242
2:4:1,1,1,103757,96243
3:1:3,0,-1,103758,96242
3:6:6,0,-1,103759,96241
4:3:5,0,-1,103760,96240
5:4:5,0,-1,103761,96239
6:5:6,0,-1,103762,96238
2:3:5,1,1,103761,96239
6:1:1,0,-1,103762,96238
1:2:4,1,1,103761,96239
2:3:5,1,1,103760,96240
1:4:6,0,-1,103761,96239
4:5:2,1,1,103760,96240
1:2:1,1,1,103759,96241
5:4:6,0,-1,103760,96240
1:2:6,1,1,103759,96241
1:6:5,0,-1,103760,96240
4:6:6,0,-1,103761,96239
1:5:1,0,-1,103762,96238
4:1:1,0,-1,103763,96237
5:4:3,0,-1,103764,96236
5:2:2,2,2,103762,96238
6:2:4,1,1,103761,96239
3:1:1,0,-1,103762,96238
1:4:4,0,-1,103763,96237
5:3:5,0,-1,103764,96236
4:2:3,1,1,103763,96237
4:6:3,0,-1,103764,96236
1:5:2,1,1,103763,96237
6:6:2,1,1,103762,96238
3:3:3,0,-1,103763,96237
2:4:2,2,2,103761,96239
5:1:2,1,1,103760,96240
1:1:3,0,-1,103761,96239
2:3:6,1,1,103760,96240
5:2:1,1,1,103759,96241
1:1:6,0,-1,103760,96240
3:5:2,1,1,103759,96241
4:1:4,0,-1,103760,96240
5:1:5,0,-1,103761,96239
4:2:4,1,1,103760,96240
1:3:2,1,1,103759,96241
1:4:6,0,-1,103760,96240
2:6:2,2,2,103758,96242
6:4:5,0,-1,103759,96241
1:6:4,0,-1,103760,96240
3:2:1,1,1,103759,96241
2:4:5,1,1,103758,96242
2:6:2,2,2,103756,96244
3:3:4,0,-1,103757,96243
2:6:6,1,1,103756,96244
5:5:1,0,-1,103757,96243
2:5:4,1,1,103756,96244
4:1:2,1,1,103755,96245
5:5:6,0,-1,103756,96244
2:6:3,1,1,103755,96245
5:5:6,0,-1,103756,96244
4:5:5,0,-1,103757,96243
6:1:6,0,-1,103758,96242
6:5:2,1,1,103757,96243
1:1:5,0,-1,103758,96242
1:6:5,0,-1,103759,96241
1:4:2,1,1,103758,96242
6:2:6,1,1,103757,96243
3:2:2,2,2,103755,96245
1:3:1,0,-1,103756,96244
1:1:6,0,-1,103757,96243
1:1:4,0,-1,103758,96242
4:1:6,0,-1,103759,96241
6:6:3,0,-1,103760,96240
6:5:2,1,1,103759,96241
2:6:6,1,1,103758,96242
1:1:4,0,-1,103759,96241
2:1:3,1,1,103758,96242
3:5:4,0,-1,103759,96241
4:5:3,0,-1,103760,96240
2:2:3,2,2,103758,96242
5:3:4,0,-1,103759,96241
2:5:6,1,1,103758,96242
4:4:3,0,-1,103759,96241
5:3:4,0,-1,103760,96240
5:5:5,0,-1,103761,96239
5:1:4,0,-1,103762,96238
2:5:3,1,1,103761,96239
3:4:6,0,-1,103762,96238
4:5:5,0,-1,103763,96237
1:2:4,1,1,103762,96238
3:4:1,0,-1,103763,96237
6:5:6,0,-1,103764,96236
2:5:4,1,1,103763,96237
6:2:1,1,1,103762,96238
1:6:6,0,-1,103763,96237
4:4:4,0,-1,103764,96236
3:3:4,0,-1,103765,96235
5:4:2,1,1,103764,96236
5:4:3,0,-1,103765,96235
1:2:5,1,1,103764,96236
4:4:4,0,-1,103765,96235
1:6:2,1,1,103764,96236
1:1:4,0,-1,103765,96235
4:1:5,0,-1,103766,96234
4:2:1,1,1,103765,96235
6:5:5,0,-1,103766,96234
6:1:5,0,-1,103767,96233
3:3:1,0,-1,103768,96232
2:2:3,2,2,103766,96234
4:4:3,0,-1,103767,96233
2:3:6,1,1,103766,96234
2:6:4,1,1,103765,96235
4:1:4,0,-1,103766,96234
6:3:6,0,-1,103767,96233
3:5:2,1,1,103766,96234
5:6:4,0,-1,103767,96233
2:3:2,2,2,103765,96235
3:1:6,0,-1,103766,96234
6:5:1,0,-1,103767,96233
5:4:3,0,-1,103768,96232
1:3:2,1,1,103767,96233
1:3:4,0,-1,103768,96232
2:5:3,1,1,103767,96233
6:3:2,1,1,103766,96234
4:2:2,2,2,103764,96236
4:6:6,0,-1,103765,96235
1:5:1,0,-1,103766,96234
5:3:4,0,-1,103767,96233
2:3:1,1,1,103766,96234
1:1:2,1,1,103765,96235
2:5:2,2,2,103763,96237
1:6:2,1,1,103762,96238
5:5:2,1,1,103761,96239
3:4:6,0,-1,103762,96238
3:2:4,1,1,103761,96239
3:4:1,0,-1,103762,96238
3:1:2,1,1,103761,96239
2:6:1,1,1,103760,96240
1:6:4,0,-1,103761,96239
3:1:4,0,-1,103762,96238
5:1:5,0,-1,103763,96237
5:6:5,0,-1,103764,96236
5:4:4,0,-1,103765,96235
4:2:1,1,1,103764,96236
3:2:6,1,1,103763,96237
1:3:6,0,-1,103764,96236
2:3:6,1,1,103763,96237
5:2:1,1,1,103762,96238
6:1:3,0,-1,103763,96237
1:4:6,0,-1,103764,96236
2:4:2,2,2,103762,96238
3:1:1,0,-1,103763,96237
6:3:5,0,-1,103764,96236
4:1:6,0,-1,103765,96235
5:2:3,1,1,103764,96236
4:2:6,1,1,103763,96237
5:5:4,0,-1,103764,96236
3:4:2,1,1,103763,96237
1:4:2,1,1,103762,96238
5:4:4,0,-1,103763,96237
3:5:5,0,-1,103764,96236
2:5:4,1,1,103763,96237
4:4:3,0,-1,103764,96236
2:4:4,1,1,103763,96237
3:6:6,0,-1,103764,96236
6:4:5,0,-1,103765,96235
6:3:3,0,-1,103766,96234
1:5:2,1,1,103765,96235
6:3:1,0,-1,103766,96234
4:5:6,0,-1,103767,96233
2:6:4,1,1,103766,96234
5:2:4,1,1,103765,96235
1:2:5,1,1,103764,96236
3:1:6,0,-1,103765,96235
6:2:6,1,1,103764,96236
4:5:6,0,-1,103765,96235
4:5:6,0,-1,103766,96234
3:4:4,0,-1,103767,96233
2:4:6,1,1,103766,96234
4:3:2,1,1,103765,96235
2:4:2,2,2,103763,96237
4:6:2,1,1,103762,96238
6:6:2,1,1,103761,96239
5:2:2,2,2,103759,96241
4:5:6,0,-1,103760,96240
1:1:6,0,-1,103761,96239
6:1:3,0,-1,103762,96238
6:6:4,0,-1,103763,96237
1:5:4,0,-1,103764,96236
4:5:6,0,-1,103765,96235
6:3:2,1,1,103764,96236
6:6:6,0,-1,103765,96235
4:6:4,0,-1,103766,96234
5:3:4,0,-1,103767,96233
2:2:6,2,2,103765,96235
4:6:1,0,-1,103766,96234
2:2:2,3,3,103763,96237
5:1:2,1,1,103762,96238
1:6:1,0,-1,103763,96237
3:5:1,0,-1,103764,96236
2:2:6,2,2,103762,96238
6:2:2,2,2,103760,96240
4:4:6,0,-1,103761,96239
4:3:4,0,-1,103762,96238
2:5:4,1,1,103761,96239
6:3:2,1,1,103760,96240
5:5:4,0,-1,103761,96239
1:3:6,0,-1,103762,96238
5:4:2,1,1,103761,96239
3:5:3,0,-1,103762,96238
6:1:1,0,-1,103763,96237
1:1:4,0,-1,103764,96236
2:6:4,1,1,103763,96237
5:2:6,1,1,103762,96238
1:4:2,1,1,103761,96239
6:6:3,0,-1,103762,96238
2:3:6,1,1,103761,96239
6:2:1,1,1,103760,96240
5:1:1,0,-1,103761,96239
1:3:1,0,-1,103762,96238
1:2:5,1,1,103761,96239
3:3:6,0,-1,103762,96238
3:2:2,2,2,103760,96240
1:3:6,0,-1,103761,96239
2:1:5,1,1,103760,96240
5:1:3,0,-1,103761,96239
4:1:3,0,-1,103762,96238
6:2:3,1,1,103761,96239
2:6:3,1,1,103760,96240
3:1:5,0,-1,103761,96239
1:6:5,0,-1,103762,96238
2:1:1,1,1,103761,96239
2:6:5,1,1,103760,96240
6:4:4,0,-1,103761,96239
5:5:1,0,-1,103762,96238
6:3:4,0,-1,103763,96237
2:4:6,1,1,103762,96238
6:1:3,0,-1,103763,96237
5:4:4,0,-1,103764,96236
2:2:2,3,3,103761,96239
1:6:2,1,1,103760,96240
5:4:1,0,-1,103761,96239
3:1:5,0,-1,103762,96238
4:2:4,1,1,103761,96239
1:5:5,0,-1,103762,96238
4:6:5,0,-1,103763,96237
2:2:3,2,2,103761,96239
1:3:2,1,1,103760,96240
6:2:1,1,1,103759,96241
5:4:1,0,-1,103760,96240
1:2:4,1,1,103759,96241
4:2:2,2,2,103757,96243
4:3:4,0,-1,103758,96242
2:6:4,1,1,103757,96243
6:2:5,1,1,103756,96244
6:5:6,0,-1,103757,96243
6:2:5,1,1,103756,96244
6:6:6,0,-1,103757,96243
2:5:3,1,1,103756,96244
4:6:1,0,-1,103757,96243
1:2:4,1,1,103756,96244
4:5:3,0,-1,103757,96243
1:5:4,0,-1,103758,96242
3:4:3,0,-1,103759,96241
3:2:2,2,2,103757,96243
4:3:2,1,1,103756,96244
5:6:5,0,-1,103757,96243
4:5:2,1,1,103756,96244
5:2:3,1,1,103755,96245
2:1:5,1,1,103754,96246
3:6:6,0,-1,103755,96245
3:3:3,0,-1,103756,96244
3:4:3,0,-1,103757,96243
2:3:4,1,1,103756,96244
6:1:4,0,-1,103757,96243
6:2:3,1,1,103756,96244
2:6:2,2,2,103754,96246
1:3:1,0,-1,103755,96245
4:6:3,0,-1,103756,96244
6:2:2,2,2,103754,96246
1:1:1,0,-1,103755,96245
2:2:3,2,2,103753,96247
5:5:4,0,-1,103754,96246
5:1:4,0,-1,103755,96245
4:6:1,0,-1,103756,96244
4:5:1,0,-1,103757,96243
2:6:4,1,1,103756,96244
1:6:3,0,-1,103757,96243
6:4:6,0,-1,103758,96242
4:2:5,1,1,103757,96243
3:6:4,0,-1,103758,96242
5:6:1,0,-1,103759,96241
6:2:4,1,1,103758,96242
3:3:6,0,-1,103759,96241
5:2:6,1,1,103758,96242
2:2:6,2,2,103756,96244
3:5:2,1,1,103755,96245
4:6:4,0,-1,103756,96244
4:5:5,0,-1,103757,96243
4:3:3,0,-1,103758,96242
1:1:5,0,-1,103759,96241
6:1:6,0,-1,103760,96240
4:5:4,0,-1,103761,96239
4:2:2,2,2,103759,96241
2:1:6,1,1,103758,96242
4:3:3,0,-1,103759,96241
1:1:4,0,-1,103760,96240
3:5:4,0,-1,103761,96239
2:6:5,1,1,103760,96240
5:3:4,0,-1,103761,96239
3:2:6,1,1,103760,96240
4:4:2,1,1,103759,96241
1:3:2,1,1,103758,96242
6:4:3,0,-1,103759,96241
6:6:2,1,1,103758,96242
6:3:6,0,-1,103759,96241
4:6:6,0,-1,103760,96240
4:2:1,1,1,103759,96241
6:1:5,0,-1,103760,96240
5:5:5,0,-1,103761,96239
5:5:6,0,-1,103762,96238
6:2:4,1,1,103761,96239
2:6:6,1,1,103760,96240
6:6:4,0,-1,103761,96239
1:1:3,0,-1,103762,96238
1:4:4,0,-1,103763,96237
3:4:3,0,-1,103764,96236
5:2:2,2,2,103762,96238
2:2:5,2,2,103760,96240
6:3:5,0,-1,103761,96239
6:5:3,0,-1,103762,96238
1:2:2,2,2,103760,96240
4:6:2,1,1,103759,96241
3:5:4,0,-1,103760,96240
4:3:4,0,-1,103761,96239
5:6:1,0,-1,103762,96238
2:4:1,1,1,103761,96239
1:6:1,0,-1,103762,96238
2:4:4,1,1,103761,96239
2:3:6,1,1,103760,96240
2:4:4,1,1,103759,96241
5:6:5,0,-1,103760,96240
2:2:2,3,3,103757,96243
3:2:6,1,1,103756,96244
5:6:1,0,-1,103757,96243
6:3:6,0,-1,103758,96242
1:1:4,0,-1,103759,96241
5:1:5,0,-1,103760,96240
1:1:3,0,-1,103761,96239
2:5:2,2,2,103759,96241
3:1:6,0,-1,103760,96240
1:5:1,0,-1,103761,96239
3:5:3,0,-1,103762,96238
1:3:4,0,-1,103763,96237
6:6:1,0,-1,103764,96236
5:2:3,1,1,103763,96237
4:1:3,0,-1,103764,96236
5:1:5,0,-1,103765,96235
3:2:3,1,1,103764,96236
4:1:5,0,-1,103765,96235
2:1:2,2,2,103763,96237
4:4:2,1,1,103762,96238
3:5:5,0,-1,103763,96237
3:6:3,0,-1,103764,96236
5:6:5,0,-1,103765,96235
2:2:4,2,2,103763,96237
5:4:4,0,-1,103764,96236
5:1:5,0,-1,103765,96235
1:2:3,1,1,103764,96236
2:5:4,1,1,103763,96237
1:1:6,0,-1,103764,96236
1:6:6,0,-1,103765,96235
6:6:6,0,-1,103766,96234
3:2:3,1,1,103765,96235
1:6:6,0,-1,103766,96234
1:6:4,0,-1,103767,96233
4:6:2,1,1,103766,96234
4:2:2,2,2,103764,96236
3:3:2,1,1,103763,96237
3:1:5,0,-1,103764,96236
4:5:2,1,1,103763,96237
6:5:2,1,1,103762,96238
4:2:1,1,1,103761,96239
5:5:3,0,-1,103762,96238
4:4:2,1,1,103761,96239
4:3:6,0,-1,103762,96238
4:2:4,1,1,103761,96239
5:4:3,0,-1,103762,96238
2:5:5,1,1,103761,96239
1:1:3,0,-1,103762,96238
3:5:4,0,-1,103763,96237
6:4:6,0,-1,103764,96236
3:6:4,0,-1,103765,96235
4:3:5,0,-1,103766,96234
2:6:5,1,1,103765,96235
4:5:5,0,-1,103766,96234
4:6:4,0,-1,103767,96233
2:5:6,1,1,103766,96234
1:6:5,0,-1,103767,96233
4:4:2,1,1,103766,96234
4:3:5,0,-1,103767,96233
4:3:3,0,-1,103768,96232
1:6:4,0,-1,103769,96231
2:5:3,1,1,103768,96232
1:1:6,0,-1,103769,96231
4:1:6,0,-1,103770,96230
6:3:4,0,-1,103771,96229
2:6:5,1,1,103770,96230
6:2:4,1,1,103769,96231
4:1:6,0,-1,103770,96230
1:5:4,0,-1,103771,96229
4:4:1,0,-1,103772,96228
5:4:6,0,-1,103773,96227
6:5:4,0,-1,103774,96226
3:6:2,1,1,103773,96227
4:1:4,0,-1,103774,96226
3:5:2,1,1,103773,96227
2:1:1,1,1,103772,96228
4:3:6,0,-1,103773,96227
1:6:4,0,-1,103774,96226
3:6:2,1,1,103773,96227
6:6:4,0,-1,103774,96226
4:1:1,0,-1,103775,96225
1:3:1,0,-1,103776,96224
1:6:4,0,-1,103777,96223
2:2:3,2,2,103775,96225
1:5:4,0,-1,103776,96224
3:4:6,0,-1,103777,96223
3:2:5,1,1,103776,96224
2:4:1,1,1,103775,96225
2:2:1,2,2,103773,96227
6:3:4,0,-1,103774,96226
6:1:1,0,-1,103775,96225
6:3:6,0,-1,103776,96224
1:2:1,1,1,103775,96225
3:5:2,1,1,103774,96226
1:2:6,1,1,103773,96227
6:2:4,1,1,103772,96228
3:3:3,0,-1,103773,96227
1:2:4,1,1,103772,96228
3:2:5,1,1,103771,96229
1:5:3,0,-1,103772,96228
6:5:6,0,-1,103773,96227
4:2:6,1,1,103772,96228
6:6:1,0,-1,103773,96227
2:6:5,1,1,103772,96228
6:5:6,0,-1,103773,96227
1:3:1,0,-1,103774,96226
6:6:6,0,-1,103775,96225
5:1:6,0,-1,103776,96224
6:3:4,0,-1,103777,96223
1:4:4,0,-1,103778,96222
6:2:2,2,2,103776,96224
2:6:1,1,1,103775,96225
2:6:1,1,1,103774,96226
6:1:5,0,-1,103775,96225
1:5:2,1,1,103774,96226
2:3:6,1,1,103773,96227
1:4:6,0,-1,103774,96226
2:6:4,1,1,103773,96227
1:3:1,0,-1,103774,96226
4:5:2,1,1,103773,96227
6:6:5,0,-1,103774,96226
6:4:3,0,-1,103775,96225
1:3:4,0,-1,103776,96224
4:5:4,0,-1,103777,96223
6:1:2,1,1,103776,96224
6:6:3,0,-1,103777,96223
4:2:3,1,1,103776,96224
5:6:2,1,1,103775,96225
1:1:2,1,1,103774,96226
4:1:2,1,1,103773,96227
5:1:4,0,-1,103774,96226
6:1:2,1,1,103773,96227
5:4:6,0,-1,103774,96226
2:1:3,1,1,103773,96227
5:3:3,0,-1,103774,96226
6:6:6,0,-1,103775,96225
1:5:5,0,-1,103776,96224
2:1:5,1,1,103775,96225
2:4:6,1,1,103774,96226
5:6:3,0,-1,103775,96225
1:1:6,0,-1,103776,96224
2:5:6,1,1,103775,96225
1:2:5,1,1,103774,96226
6:2:4,1,1,103773,96227
1:6:3,0,-1,103774,96226
1:2:1,1,1,103773,96227
3:5:1,0,-1,103774,96226
5:1:1,0,-1,103775,96225
6:5:2,1,1,103774,96226
4:6:6,0,-1,103775,96225
4:3:3,0,-1,103776,96224
3:2:4,1,1,103775,96225
2:3:2,2,2,103773,96227
5:1:2,1,1,103772,96228
1:2:2,2,2,103770,96230
5:3:3,0,-1,103771,96229
4:5:6,0,-1,103772,96228
4:4:2,1,1,103771,96229
3:4:5,0,-1,103772,96228
1:6:5,0,-1,103773,96227
6:4:6,0,-1,103774,96226
2:4:5,1,1,103773,96227
3:2:5,1,1,103772,96228
6:2:1,1,1,103771,96229
2:5:2,2,2,103769,96231
5:3:1,0,-1,103770,96230
1:2:1,1,1,103769,96231
2:5:1,1,1,103768,96232
4:2:6,1,1,103767,96233
5:4:6,0,-1,103768,96232
1:2:6,1,1,103767,96233
2:6:3,1,1,103766,96234
1:6:6,0,-1,103767,96233
1:2:4,1,1,103766,96234
6:6:3,0,-1,103767,96233
6:5:3,0,-1,103768,96232
1:2:1,1,1,103767,96233
3:5:4,0,-1,103768,96232
6:5:4,0,-1,103769,96231
2:4:5,1,1,103768,96232
6:4:6,0,-1,103769,96231
1:6:2,1,1,103768,96232
5:2:4,1,1,103767,96233
1:3:6,0,-1,103768,96232
5:3:2,1,1,103767,96233
5:3:2,1,1,103766,96234
5:5:4,0,-1,103767,96233
2:1:1,1,1,103766,96234
2:5:3,1,1,103765,96235
5:5:3,0,-1,103766,96234
4:1:1,0,-1,103767,96233
3:3:6,0,-1,103768,96232
4:6:5,0,-1,103769,96231
4:5:1,0,-1,103770,96230
2:2:6,2,2,103768,96232
3:6:5,0,-1,103769,96231
4:3:2,1,1,103768,96232
6:4:2,1,1,103767,96233
2:2:2,3,3,103764,96236
3:3:1,0,-1,103765,96235
5:4:5,0,-1,103766,96234
2:2:2,3,3,103763,96237
3:2:1,1,1,103762,96238
1:2:5,1,1,103761,96239
3:3:1,0,-1,103762,96238
5:3:1,0,-1,103763,96237
6:1:5,0,-1,103764,96236
3:3:4,0,-1,103765,96235
2:6:6,1,1,103764,96236
3:4:6,0,-1,103765,96235
6:6:1,0,-1,103766,96234
4:2:3,1,1,103765,96235
6:6:4,0,-1,103766,96234
5:2:4,1,1,103765,96235
6:4:2,1,1,103764,96236
3:3:1,0,-1,103765,96235
3:2:3,1,1,103764,96236
5:1:6,0,-1,103765,96235
6:4:2,1,1,103764,96236
1:1:1,0,-1,103765,96235
5:2:3,1,1,103764,96236
6:5:6,0,-1,103765,96235
6:4:2,1,1,103764,96236
1:1:3,0,-1,103765,96235
2:4:6,1,1,103764,96236
2:6:1,1,1,103763,96237
4:1:3,0,-1,103764,96236
5:2:3,1,1,103763,96237
6:2:4,1,1,103762,96238
2:4:6,1,1,103761,96239
4:3:6,0,-1,103762,96238
1:3:3,0,-1,103763,96237
4:3:2,1,1,103762,96238
2:2:6,2,2,103760,96240
3:5:3,0,-1,103761,96239
1:3:3,0,-1,103762,96238
4:5:3,0,-1,103763,96237
4:3:4,0,-1,103764,96236
1:5:1,0,-1,103765,96235
5:3:6,0,-1,103766,96234
4:3:3,0,-1,103767,96233
1:4:1,0,-1,103768,96232
2:2:4,2,2,103766,96234
5:1:1,0,-1,103767,96233
6:6:6,0,-1,103768,96232
3:3:6,0,-1,103769,96231
6:5:2,1,1,103768,96232
1:3:4,0,-1,103769,96231
1:6:6,0,-1,103770,96230
5:3:2,1,1,103769,96231
1:6:2,1,1,103768,96232
4:3:2,1,1,103767,96233
2:3:4,1,1,103766,96234
2:5:5,1,1,103765,96235
5:5:2,1,1,103764,96236
2:4:3,1,1,103763,96237
5:3:1,0,-1,103764,96236
3:3:1,0,-1,103765,96235
1:5:1,0,-1,103766,96234
3:1:1,0,-1,103767,96233
5:1:4,0,-1,103768,96232
4:4:3,0,-1,103769,96231
4:6:3,0,-1,103770,96230
4:6:5,0,-1,103771,96229
5:1:3,0,-1,103772,96228
1:3:5,0,-1,103773,96227
4:6:3,0,-1,103774,96226
3:6:3,0,-1,103775,96225
3:1:3,0,-1,103776,96224
6:4:4,0,-1,103777,96223
6:2:5,1,1,103776,96224
1:1:4,0,-1,103777,96223
6:2:3,1,1,103776,96224
5:6:1,0,-1,103777,96223
2:3:5,1,1,103776,96224
1:1:5,0,-1,103777,96223
3:1:6,0,-1,103778,96222
1:6:3,0,-1,103779,96221
6:3:6,0,-1,103780,96220
2:6:4,1,1,103779,96221
2:5:5,1,1,103778,96222
3:4:2,1,1,103777,96223
6:4:6,0,-1,103778,96222
4:2:3,1,1,103777,96223
2:1:6,1,1,103776,96224
6:1:2,1,1,103775,96225
2:6:2,2,2,103773,96227
6:3:2,1,1,103772,96228
3:5:4,0,-1,103773,96227
1:1:6,0,-1,103774,96226
1:6:2,1,1,103773,96227
6:1:6,0,-1,103774,96226
6:6:4,0,-1,103775,96225
5:5:1,0,-1,103776,96224
6:6:6,0,-1,103777,96223
6:1:6,0,-1,103778,96222
3:3:2,1,1,103777,96223
4:4:6,0,-1,103778,96222
2:1:6,1,1,103777,96223
4:4:2,1,1,103776,96224
2:6:2,2,2,103774,96226
5:5:5,0,-1,103775,96225
1:1:4,0,-1,103776,96224
1:6:2,1,1,103775,96225
4:2:2,2,2,103773,96227
5:4:6,0,-1,103774,96226
2:1:3,1,1,103773,96227
6:4:4,0,-1,103774,96226
6:1:3,0,-1,103775,96225
5:1:5,0,-1,103776,96224
2:2:6,2,2,103774,96226
1:3:5,0,-1,103775,96225
6:3:4,0,-1,103776,96224
2:6:3,1,1,103775,96225
5:3:2,1,1,103774,96226
3:5:3,0,-1,103775,96225
1:5:2,1,1,103774,96226
4:4:2,1,1,103773,96227
6:4:4,0,-1,103774,96226
5:5:4,0,-1,103775,96225
6:6:4,0,-1,103776,96224
2:1:6,1,1,103775,96225
3:1:2,1,1,103774,96226
2:4:5,1,1,103773,96227
4:6:4,0,-1,103774,96226
3:6:2,1,1,103773,96227
1:3:3,0,-1,103774,96226
6:4:4,0,-1,103775,96225
6:2:3,1,1,103774,96226
1:2:4,1,1,103773,96227
2:5:6,1,1,103772,96228
1:5:5,0,-1,103773,96227
2:1:1,1,1,103772,96228
4:5:3,0,-1,103773,96227
4:4:2,1,1,103772,96228
1:6:6,0,-1,103773,96227
3:5:4,0,-1,103774,96226
3:3:4,0,-1,103775,96225
2:1:3,1,1,103774,96226
4:3:5,0,-1,103775,96225
2:5:6,1,1,103774,96226
4:1:1,0,-1,103775,96225
4:5:1,0,-1,103776,96224
2:3:5,1,1,103775,96225
6:3:3,0,-1,103776,96224
3:2:1,1,1,103775,96225
1:4:6,0,-1,103776,96224
4:6:5,0,-1,103777,96223
3:3:2,1,1,103776,96224
2:4:5,1,1,103775,96225
2:5:2,2,2,103773,96227
2:1:6,1,1,103772,96228
3:1:3,0,-1,103773,96227
5:4:4,0,-1,103774,96226
6:2:4,1,1,103773,96227
2:4:3,1,1,103772,96228
5:4:2,1,1,103771,96229
4:5:6,0,-1,103772,96228
3:4:4,0,-1,103773,96227
1:2:6,1,1,103772,96228
3:1:2,1,1,103771,96229
1:1:5,0,-1,103772,96228
3:4:4,0,-1,103773,96227
6:6:6,0,-1,103774,96226
3:1:3,0,-1,103775,96225
2:6:5,1,1,103774,96226
1:2:2,2,2,103772,96228
1:2:6,1,1,103771,96229
1:5:6,0,-1,103772,96228
6:3:5,0,-1,103773,96227
4:4:6,0,-1,103774,96226
1:1:4,0,-1,103775,96225
1:1:4,0,-1,103776,96224
2:5:1,1,1,103775,96225
2:2:4,2,2,103773,96227
2:5:6,1,1,103772,96228
1:4:1,0,-1,103773,96227
5:1:1,0,-1,103774,96226
3:4:4,0,-1,103775,96225
4:1:5,0,-1,103776,96224
1:2:6,1,1,103775,96225
3:3:3,0,-1,103776,96224
2:6:5,1,1,103775,96225
5:4:4,0,-1,103776,96224
3:1:5,0,-1,103777,96223
3:1:5,0,-1,103778,96222
6:1:4,0,-1,103779,96221
6:3:1,0,-1,103780,96220
6:6:2,1,1,103779,96221
5:3:2,1,1,103778,96222
3:3:3,0,-1,103779,96221
2:5:2,2,2,103777,96223
5:5:6,0,-1,103778,96222
1:2:2,2,2,103776,96224
4:1:4,0,-1,103777,96223
6:2:5,1,1,103776,96224
1:2:5,1,1,103775,96225
2:6:2,2,2,103773,96227
6:5:3,0,-1,103774,96226
2:5:6,1,1,103773,96227
3:2:4,1,1,103772,96228
2:1:4,1,1,103771,96229
3:6:4,0,-1,103772,96228
5:1:3,0,-1,103773,96227
4:6:6,0,-1,103774,96226
3:2:5,1,1,103773,96227
3:4:5,0,-1,103774,96226
2:4:2,2,2,103772,96228
2:4:1,1,1,103771,96229
3:4:2,1,1,103770,96230
5:4:2,1,1,103769,96231
3:6:3,0,-1,103770,96230
2:3:3,1,1,103769,96231
6:1:6,0,-1,103770,96230
5:1:5,0,-1,103771,96229
6:3:1,0,-1,103772,96228
5:6:4,0,-1,103773,96227
6:4:1,0,-1,103774,96226
3:5:6,0,-1,103775,96225
1:2:3,1,1,103774,96226
5:2:5,1,1,103773,96227
2:2:5,2,2,103771,96229
4:2:1,1,1,103770,96230
1:1:6,0,-1,103771,96229
1:4:1,0,-1,103772,96228
2:1:3,1,1,103771,96229
6:3:4,0,-1,103772,96228
6:2:5,1,1,103771,96229
2:4:2,2,2,103769,96231
5:6:1,0,-1,103770,96230
6:6:5,0,-1,103771,96229
6:2:4,1,1,103770,96230
5:4:1,0,-1,103771,96229
5:3:5,0,-1,103772,96228
2:5:6,1,1,103771,96229
4:6:1,0,-1,103772,96228
5:1:2,1,1,103771,96229
3:3:5,0,-1,103772,96228
4:1:3,0,-1,103773,96227
2:5:3,1,1,103772,96228
3:3:2,1,1,103771,96229
5:2:5,1,1,103770,96230
5:3:3,0,-1,103771,96229
2:5:4,1,1,103770,96230
6:1:5,0,-1,103771,96229
3:3:2,1,1,103770,96230
6:2:6,1,1,103769,96231
2:5:5,1,1,103768,96232
4:6:1,0,-1,103769,96231
4:6:5,0,-1,103770,96230
2:3:4,1,1,103769,96231
2:2:6,2,2,103767,96233
3:4:2,1,1,103766,96234
6:6:5,0,-1,103767,96233
5:3:2,1,1,103766,96234
5:3:4,0,-1,103767,96233
1:4:5,0,-1,103768,96232
2:3:4,1,1,103767,96233
2:5:1,1,1,103766,96234
3:5:6,0,-1,103767,96233
5:1:3,0,-1,103768,96232
4:2:6,1,1,103767,96233
3:5:4,0,-1,103768,96232
5:2:3,1,1,103767,96233
3:2:4,1,1,103766,96234
4:3:5,0,-1,103767,96233
3:2:2,2,2,103765,96235
1:5:6,0,-1,103766,96234
3:1:3,0,-1,103767,96233
1:2:6,1,1,103766,96234
3:6:5,0,-1,103767,96233
5:3:1,0,-1,103768,96232
1:3:5,0,-1,103769,96231
2:5:6,1,1,103768,96232
6:5:3,0,-1,103769,96231
5:6:4,0,-1,103770,96230
2:1:4,1,1,103769,96231
2:6:6,1,1,103768,96232
5:4:2,1,1,103767,96233
5:6:1,0,-1,103768,96232
1:4:6,0,-1,103769,96231
2:5:6,1,1,103768,96232
1:6:2,1,1,103767,96233
1:2:6,1,1,103766,96234
2:3:4,1,1,103765,96235
3:1:5,0,-1,103766,96234
1:1:4,0,-1,103767,96233
3:5:4,0,-1,103768,96232
3:3:3,0,-1,103769,96231
2:4:3,1,1,103768,96232
6:1:2,1,1,103767,96233
4:5:2,1,1,103766,96234
4:4:3,0,-1,103767,96233
2:3:6,1,1,103766,96234
6:3:5,0,-1,103767,96233
5:5:2,1,1,103766,96234
1:2:3,1,1,103765,96235
4:5:4,0,-1,103766,96234
3:5:1,0,-1,103767,96233
2:6:5,1,1,103766,96234
2:2:2,3,3,103763,96237
1:6:4,0,-1,103764,96236
4:4:3,0,-1,103765,96235
4:5:1,0,-1,103766,96234
4:5:2,1,1,103765,96235
3:2:1,1,1,103764,96236
3:5:2,1,1,103763,96237
3:6:5,0,-1,103764,96236
3:3:6,0,-1,103765,96235
1:6:6,0,-1,103766,96234
4:3:4,0,-1,103767,96233
1:4:5,0,-1,103768,96232
1:6:1,0,-1,103769,96231
6:5:3,0,-1,103770,96230
3:2:3,1,1,103769,96231
3:2:5,1,1,103768,96232
1:6:6,0,-1,103769,96231
4:4:5,0,-1,103770,96230
1:1:1,0,-1,103771,96229
4:3:3,0,-1,103772,96228
3:3:2,1,1,103771,96229
5:4:4,0,-1,103772,96228
2:4:3,1,1,103771,96229
3:1:2,1,1,103770,96230
3:6:2,1,1,103769,96231
4:3:1,0,-1,103770,96230
3:4:3,0,-1,103771,96229
1:4:3,0,-1,103772,96228
3:6:6,0,-1,103773,96227
2:5:6,1,1,103772,96228
4:2:4,1,1,103771,96229
5:4:6,0,-1,103772,96228
4:5:6,0,-1,103773,96227
5:6:6,0,-1,103774,96226
3:2:1,1,1,103773,96227
2:6:1,1,1,103772,96228
6:5:2,1,1,103771,96229
4:4:4,0,-1,103772,96228
2:5:2,2,2,103770,96230
5:6:3,0,-1,103771,96229
1:5:1,0,-1,103772,96228
6:1:1,0,-1,103773,96227
1:1:1,0,-1,103774,96226
6:3:3,0,-1,103775,96225
4:2:4,1,1,103774,96226
4:1:3,0,-1,103775,96225
1:1:6,0,-1,103776,96224
2:2:3,2,2,103774,96226
4:3:5,0,-1,103775,96225
6:3:5,0,-1,103776,96224
5:6:2,1,1,103775,96225
3:6:6,0,-1,103776,96224
4:3:5,0,-1,103777,96223
5:5:6,0,-1,103778,96222
5:5:1,0,-1,103779,96221
1:4:1,0,-1,103780,96220
6:4:2,1,1,103779,96221
3:4:6,0,-1,103780,96220
6:6:5,0,-1,103781,96219
5:5:5,0,-1,103782,96218
5:2:1,1,1,103781,96219
4:2:5,1,1,103780,96220
1:4:2,1,1,103779,96221
3:6:1,0,-1,103780,96220
6:1:1,0,-1,103781,96219
6:4:4,0,-1,103782,96218
3:3:4,0,-1,103783,96217
2:2:3,2,2,103781,96219
2:4:2,2,2,103779,96221
5:4:5,0,-1,103780,96220
6:4:4,0,-1,103781,96219
2:6:1,1,1,103780,96220
3:2:5,1,1,103779,96221
3:2:6,1,1,103778,96222
5:6:3,0,-1,103779,96221
1:6:6,0,-1,103780,96220
1:1:2,1,1,103779,96221
5:6:2,1,1,103778,96222
1:6:3,0,-1,103779,96221
1:5:5,0,-1,103780,96220
6:4:2,1,1,103779,96221
3:6:6,0,-1,103780,96220
1:6:3,0,-1,103781,96219
5:3:5,0,-1,103782,96218
3:4:1,0,-1,103783,96217
2:4:6,1,1,103782,96218
5:5:1,0,-1,103783,96217
5:2:6,1,1,103782,96218
6:5:1,0,-1,103783,96217
2:5:6,1,1,103782,96218
2:2:4,2,2,103780,96220
6:1:2,1,1,103779,96221
2:4:6,1,1,103778,96222
5:3:5,0,-1,103779,96221
5:3:3,0,-1,103780,96220
1:3:1,0,-1,103781,96219
4:4:1,0,-1,103782,96218
5:2:2,2,2,103780,96220
6:5:3,0,-1,103781,96219
5:2:6,1,1,103780,96220
3:5:6,0,-1,103781,96219
1:6:6,0,-1,103782,96218
2:1:1,1,1,103781,96219
3:3:5,0,-1,103782,96218
6:6:4,0,-1,103783,96217
1:1:3,0,-1,103784,96216
1:5:2,1,1,103783,96217
6:5:2,1,1,103782,96218
2:6:6,1,1,103781,96219
2:5:2,2,2,103779,96221
3:2:2,2,2,103777,96223
5:5:3,0,-1,103778,96222
1:3:2,1,1,103777,96223
3:5:1,0,-1,103778,96222
4:1:2,1,1,103777,96223
2:2:1,2,2,103775,96225
2:1:6,1,1,103774,96226
5:5:6,0,-1,103775,96225
5:4:4,0,-1,103776,96224
3:3:4,0,-1,103777,96223
2:3:1,1,1,103776,96224
1:1:5,0,-1,103777,96223
1:2:4,1,1,103776,96224
1:6:2,1,1,103775,96225
6:2:3,1,1,103774,96226
5:3:6,0,-1,103775,96225
2:4:3,1,1,103774,96226
5:5:5,0,-1,103775,96225
3:1:1,0,-1,103776,96224
2:3:5,1,1,103775,96225
4:2:3,1,1,103774,96226
1:3:4,0,-1,103775,96225
5:3:2,1,1,103774,96226
6:3:6,0,-1,103775,96225
6:3:2,1,1,103774,96226
1:6:1,0,-1,103775,96225
3:4:3,0,-1,103776,96224
1:2:4,1,1,103775,96225
3:3:6,0,-1,103776,96224
1:5:2,1,1,103775,96225
1:6:1,0,-1,103776,96224
5:5:5,0,-1,103777,96223
5:5:1,0,-1,103778,96222
5:3:6,0,-1,103779,96221
1:1:3,0,-1,103780,96220
3:6:6,0,-1,103781,96219
2:1:2,2,2,103779,96221
2:5:6,1,1,103778,96222
5:3:6,0,-1,103779,96221
2:5:5,1,1,103778,96222
2:5:3,1,1,103777,96223
5:1:2,1,1,103776,96224
3:5:5,0,-1,103777,96223
2:2:5,2,2,103775,96225
4:6:3,0,-1,103776,96224
4:1:1,0,-1,103777,96223
5:2:4,1,1,103776,96224
2:2:5,2,2,103774,96226
2:1:3,1,1,103773,96227
4:3:2,1,1,103772,96228
3:3:1,0,-1,103773,96227
6:3:5,0,-1,103774,96226
6:5:5,0,-1,103775,96225
1:2:1,1,1,103774,96226
5:3:2,1,1,103773,96227
5:3:3,0,-1,103774,96226
5:3:3,0,-1,103775,96225
5:4:4,0,-1,103776,96224
5:1:4,0,-1,103777,96223
1:4:3,0,-1,103778,96222
2:2:5,2,2,103776,96224
3:5:3,0,-1,103777,96223
6:6:2,1,1,103776,96224
3:5:5,0,-1,103777,96223
6:4:1,0,-1,103778,96222
1:2:5,1,1,103777,96223
4:4:2,1,1,103776,96224
1:6:5,0,-1,103777,96223
2:4:3,1,1,103776,96224
3:3:3,0,-1,103777,96223
3:4:4,0,-1,103778,96222
3:1:1,0,-1,103779,96221
4:6:6,0,-1,103780,96220
3:6:5,0,-1,103781,96219
5:4:2,1,1,103780,96220
4:4:6,0,-1,103781,96219
3:3:1,0,-1,103782,96218
1:5:3,0,-1,103783,96217
5:3:3,0,-1,103784,96216
4:6:1,0,-1,103785,96215
4:5:2,1,1,103784,96216
1:3:1,0,-1,103785,96215
5:4:4,0,-1,103786,96214
6:5:6,0,-1,103787,96213
6:2:2,2,2,103785,96215
1:2:2,2,2,103783,96217
5:5:4,0,-1,103784,96216
5:4:4,0,-1,103785,96215
4:4:4,0,-1,103786,96214
6:5:2,1,1,103785,96215
4:1:6,0,-1,103786,96214
3:5:6,0,-1,103787,96213
3:3:2,1,1,103786,96214
5:2:4,1,1,103785,96215
6:1:5,0,-1,103786,96214
1:6:1,0,-1,103787,96213
2:5:4,1,1,103786,96214
3:6:2,1,1,103785,96215
5:1:6,0,-1,103786,96214
1:5:1,0,-1,103787,96213
5:2:4,1,1,103786,96214
1:1:1,0,-1,103787,96213
4:4:5,0,-1,103788,96212
1:3:2,1,1,103787,96213
1:4:1,0,-1,103788,96212
4:1:4,0,-1,103789,96211
2:3:6,1,1,103788,96212
6:2:3,1,1,103787,96213
1:3:3,0,-1,103788,96212
6:1:5,0,-1,103789,96211
6:4:3,0,-1,103790,96210
4:5:6,0,-1,103791,96209
6:4:5,0,-1,103792,96208
5:1:4,0,-1,103793,96207
5:3:4,0,-1,103794,96206
1:2:1,1,1,103793,96207
4:4:4,0,-1,103794,96206
4:6:5,0,-1,103795,96205
2:2:3,2,2,103793,96207
4:2:6,1,1,103792,96208
2:2:4,2,2,103790,96210
2:2:6,2,2,103788,96212
2:1:4,1,1,103787,96213
3:1:2,1,1,103786,96214
6:1:1,0,-1,103787,96213
6:2:2,2,2,103785,96215
4:4:6,0,-1,103786,96214
4:1:4,0,-1,103787,96213
1:1:5,0,-1,103788,96212
1:3:3,0,-1,103789,96211
6:5:6,0,-1,103790,96210
4:1:3,0,-1,103791,96209
5:5:6,0,-1,103792,96208
2:3:4,1,1,103791,96209
5:2:2,2,2,103789,96211
4:4:1,0,-1,103790,96210
2:6:5,1,1,103789,96211
4:4:1,0,-1,103790,96210
2:2:4,2,2,103788,96212
1:1:3,0,-1,103789,96211
3:5:2,1,1,103788,96212
2:5:2,2,2,103786,96214
2:6:1,1,1,103785,96215
4:3:1,0,-1,103786,96214
3:4:5,0,-1,103787,96213
6:3:6,0,-1,103788,96212
3:1:4,0,-1,103789,96211
3:5:6,0,-1,103790,96210
5:3:5,0,-1,103791,96209
3:2:1,1,1,103790,96210
5:2:6,1,1,103789,96211
4:6:2,1,1,103788,96212
5:5:5,0,-1,103789,96211
5:4:2,1,1,103788,96212
3:4:6,0,-1,103789,96211
4:5:1,0,-1,103790,96210
1:1:3,0,-1,103791,96209
1:1:3,0,-1,103792,96208
4:1:1,0,-1,103793,96207
6:1:4,0,-1,103794,96206
6:1:4,0,-1,103795,96205
6:1:1,0,-1,103796,96204
1:6:5,0,-1,103797,96203
1:1:4,0,-1,103798,96202
2:4:1,1,1,103797,96203
4:3:6,0,-1,103798,96202
3:6:2,1,1,103797,96203
5:1:4,0,-1,103798,96202
5:3:6,0,-1,103799,96201
3:2:2,2,2,103797,96203
5:1:6,0,-1,103798,96202
6:6:1,0,-1,103799,96201
5:1:4,0,-1,103800,96200
5:3:6,0,-1,103801,96199
3:4:6,0,-1,103802,96198
3:2:4,1,1,103801,96199
3:2:6,1,1,103800,96200
6:5:2,1,1,103799,96201
2:2:5,2,2,103797,96203
1:1:6,0,-1,103798,96202
2:2:5,2,2,103796,96204
2:4:3,1,1,103795,96205
3:5:4,0,-1,103796,96204
3:6:5,0,-1,103797,96203
5:6:2,1,1,103796,96204
5:3:3,0,-1,103797,96203
4:4:1,0,-1,103798,96202
1:1:2,1,1,103797,96203
2:2:3,2,2,103795,96205
5:3:1,0,-1,103796,96204
3:1:6,0,-1,103797,96203
2:2:2,3,3,103794,96206
6:5:6,0,-1,103795,96205
1:2:2,2,2,103793,96207
1:4:3,0,-1,103794,96206
6:1:1,0,-1,103795,96205
6:6:5,0,-1,103796,96204
4:6:4,0,-1,103797,96203
3:5:3,0,-1,103798,96202
4:5:5,0,-1,103799,96201
2:4:3,1,1,103798,96202
1:1:4,0,-1,103799,96201
4:3:5,0,-1,103800,96200
1:5:4,0,-1,103801,96199
1:4:6,0,-1,103802,96198
6:5:2,1,1,103801,96199
3:2:6,1,1,103800,96200
4:3:4,0,-1,103801,96199
1:3:6,0,-1,103802,96198
4:1:3,0,-1,103803,96197
5:4:5,0,-1,103804,96196
3:1:5,0,-1,103805,96195
5:3:5,0,-1,103806,96194
4:3:4,0,-1,103807,96193
5:5:1,0,-1,103808,96192
1:1:1,0,-1,103809,96191
4:6:6,0,-1,103810,96190
2:3:3,1,1,103809,96191
2:4:1,1,1,103808,96192
1:5:6,0,-1,103809,96191
5:4:2,1,1,103808,96192
3:4:5,0,-1,103809,96191
3:6:3,0,-1,103810,96190
1:5:3,0,-1,103811,96189
2:4:6,1,1,103810,96190
5:1:2,1,1,103809,96191
3:1:5,0,-1,103810,96190
3:6:5,0,-1,103811,96189
3:5:6,0,-1,103812,96188
2:4:6,1,1,103811,96189
4:6:1,0,-1,103812,96188
4:4:4,0,-1,103813,96187
6:1:5,0,-1,103814,96186
1:5:4,0,-1,103815,96185
3:2:5,1,1,103814,96186
2:2:3,2,2,103812,96188
2:3:3,1,1,103811,96189
4:1:2,1,1,103810,96190
2:3:4,1,1,103809,96191
5:3:4,0,-1,103810,96190
1:3:3,0,-1,103811,96189
5:3:6,0,-1,103812,96188
1:1:4,0,-1,103813,96187
1:6:1,0,-1,103814,96186
5:1:6,0,-1,103815,96185
1:1:4,0,-1,103816,96184
2:6:1,1,1,103815,96185
3:1:5,0,-1,103816,96184
2:4:3,1,1,103815,96185
3:5:5,0,-1,103816,96184
4:2:2,2,2,103814,96186
1:6:6,0,-1,103815,96185
6:5:2,1,1,103814,96186
2:3:1,1,1,103813,96187
4:1:6,0,-1,103814,96186
5:2:1,1,1,103813,96187
3:1:4,0,-1,103814,96186
2:3:5,1,1,103813,96187
3:4:3,0,-1,103814,96186
2:4:4,1,1,103813,96187
6:2:5,1,1,103812,96188
3:4:3,0,-1,103813,96187
5:5:4,0,-1,103814,96186
4:1:6,0,-1,103815,96185
2:1:6,1,1,103814,96186
5:4:5,0,-1,103815,96185
6:5:4,0,-1,103816,96184
3:4:2,1,1,103815,96185
2:2:5,2,2,103813,96187
5:5:5,0,-1,103814,96186
3:4:4,0,-1,103815,96185
3:6:6,0,-1,103816,96184
2:4:2,2,2,103814,96186
2:2:5,2,2,103812,96188
3:2:5,1,1,103811,96189
5:2:1,1,1,103810,96190
2:4:4,1,1,103809,96191
3:1:2,1,1,103808,96192
4:5:2,1,1,103807,96193
2:4:6,1,1,103806,96194
1:1:4,0,-1,103807,96193
4:1:6,0,-1,103808,96192
6:4:2,1,1,103807,96193
2:3:4,1,1,103806,96194
1:6:6,0,-1,103807,96193
3:6:5,0,-1,103808,96192
2:6:3,1,1,103807,96193
5:3:5,0,-1,103808,96192
2:1:4,1,1,103807,96193
2:4:3,1,1,103806,96194
5:6:6,0,-1,103807,96193
4:5:6,0,-1,103808,96192
3:5:5,0,-1,103809,96191
2:1:3,1,1,103808,96192
5:2:3,1,1,103807,96193
1:6:3,0,-1,103808,96192
6:1:2,1,1,103807,96193
4:2:3,1,1,103806,96194
5:5:1,0,-1,103807,96193
4:2:4,1,1,103806,96194
2:3:4,1,1,103805,96195
6:4:6,0,-1,103806,96194
5:1:3,0,-1,103807,96193
4:6:6,0,-1,103808,96192
3:3:2,1,1,103807,96193
1:5:6,0,-1,103808,96192
1:5:2,1,1,103807,96193
5:3:6,0,-1,103808,96192
2:4:3,1,1,103807,96193
3:2:3,1,1,103806,96194
2:5:5,1,1,103805,96195
5:2:4,1,1,103804,96196
2:3:1,1,1,103803,96197
2:5:2,2,2,103801,96199
3:6:3,0,-1,103802,96198
3:4:5,0,-1,103803,96197
5:4:4,0,-1,103804,96196
4:1:2,1,1,103803,96197
1:1:3,0,-1,103804,96196
1:6:3,0,-1,103805,96195
5:5:1,0,-1,103806,96194
3:5:5,0,-1,103807,96193
3:3:5,0,-1,103808,96192
6:4:6,0,-1,103809,96191
6:2:5,1,1,103808,96192
3:4:6,0,-1,103809,96191
6:1:2,1,1,103808,96192
2:2:3,2,2,103806,96194
4:4:4,0,-1,103807,96193
1:1:1,0,-1,103808,96192
1:5:1,0,-1,103809,96191
6:5:3,0,-1,103810,96190
5:6:3,0,-1,103811,96189
4:1:6,0,-1,103812,96188
1:1:4,0,-1,103813,96187
4:6:2,1,1,103812,96188
1:5:5,0,-1,103813,96187
6:5:3,0,-1,103814,96186
3:6:2,1,1,103813,96187
5:6:1,0,-1,103814,96186
1:1:5,0,-1,103815,96185
6:1:6,0,-1,103816,96184
6:4:6,0,-1,103817,96183
3:5:4,0,-1,103818,96182
4:1:3,0,-1,103819,96181
3:4:5,0,-1,103820,96180
1:2:2,2,2,103818,96182
3:4:6,0,-1,103819,96181
2:3:4,1,1,103818,96182
6:5:5,0,-1,103819,96181
6:5:4,0,-1,103820,96180
2:3:5,1,1,103819,96181
6:6:5,0,-1,103820,96180
3:2:6,1,1,103819,96181
1:5:3,0,-1,103820,96180
4:3:3,0,-1,103821,96179
1:5:4,0,-1,103822,96178
6:2:4,1,1,103821,96179
3:5:4,0,-1,103822,96178
2:3:6,1,1,103821,96179
4:5:1,0,-1,103822,96178
3:3:6,0,-1,103823,96177
2:4:5,1,1,103822,96178
3:2:1,1,1,103821,96179
5:6:2,1,1,103820,96180
4:6:1,0,-1,103821,96179
6:4:1,0,-1,103822,96178
1:5:2,1,1,103821,96179
2:6:5,1,1,103820,96180
5:1:4,0,-1,103821,96179
4:2:4,1,1,103820,96180
3:3:4,0,-1,103821,96179
2:6:4,1,1,103820,96180
2:3:4,1,1,103819,96181
5:3:4,0,-1,103820,96180
1:1:2,1,1,103819,96181
4:4:4,0,-1,103820,96180
2:5:1,1,1,103819,96181
5:5:6,0,-1,103820,96180
6:6:5,0,-1,103821,96179
1:5:6,0,-1,103822,96178
5:2:5,1,1,103821,96179
4:3:4,0,-1,103822,96178
5:2:1,1,1,103821,96179
1:4:6,0,-1,103822,96178
4:6:4,0,-1,103823,96177
1:5:2,1,1,103822,96178
3:1:2,1,1,103821,96179
4:4:2,1,1,103820,96180
5:5:4,0,-1,103821,96179
1:6:3,0,-1,103822,96178
2:1:6,1,1,103821,96179
5:6:1,0,-1,103822,96178
3:3:1,0,-1,103823,96177
6:1:2,1,1,103822,96178
3:5:5,0,-1,103823,96177
1:5:4,0,-1,103824,96176
1:6:1,0,-1,103825,96175
6:1:2,1,1,103824,96176
4:6:6,0,-1,103825,96175
2:3:1,1,1,103824,96176
3:2:1,1,1,103823,96177
5:4:3,0,-1,103824,96176
6:1:6,0,-1,103825,96175
6:4:3,0,-1,103826,96174
5:4:5,0,-1,103827,96173
3:5:3,0,-1,103828,96172
6:6:2,1,1,103827,96173
6:5:6,0,-1,103828,96172
4:6:6,0,-1,103829,96171
5:4:4,0,-1,103830,96170
2:3:5,1,1,103829,96171
5:1:1,0,-1,103830,96170
6:4:6,0,-1,103831,96169
2:2:2,3,3,103828,96172
4:3:3,0,-1,103829,96171
3:6:5,0,-1,103830,96170
6:6:6,0,-1,103831,96169
2:4:3,1,1,103830,96170
5:1:1,0,-1,103831,96169
1:6:3,0,-1,103832,96168
5:2:2,2,2,103830,96170
4:2:5,1,1,103829,96171
3:5:5,0,-1,103830,96170
1:1:5,0,-1,103831,96169
5:5:4,0,-1,103832,96168
3:4:2,1,1,103831,96169
4:4:2,1,1,103830,96170
2:4:4,1,1,103829,96171
1:4:5,0,-1,103830,96170
5:4:5,0,-1,103831,96169
6:6:3,0,-1,103832,96168
4:4:3,0,-1,103833,96167
3:2:4,1,1,103832,96168
1:6:1,0,-1,103833,96167
4:5:5,0,-1,103834,96166
5:5:3,0,-1,103835,96165
2:2:3,2,2,103833,96167
1:6:2,1,1,103832,96168
4:4:3,0,-1,103833,96167
6:6:2,1,1,103832,96168
6:6:1,0,-1,103833,96167
1:6:3,0,-1,103834,96166
4:2:5,1,1,103833,96167
4:2:5,1,1,103832,96168
3:6:1,0,-1,103833,96167
5:1:5,0,-1,103834,96166
1:2:2,2,2,103832,96168
3:5:6,0,-1,103833,96167
2:1:2,2,2,103831,96169
3:5:1,0,-1,103832,96168
1:1:3,0,-1,103833,96167
1:3:2,1,1,103832,96168
6:2:3,1,1,103831,96169
6:6:3,0,-1,103832,96168
4:2:5,1,1,103831,96169
1:2:3,1,1,103830,96170
2:2:2,3,3,103827,96173
4:1:3,0,-1,103828,96172
3:5:4,0,-1,103829,96171
4:4:4,0,-1,103830,96170
3:6:3,0,-1,103831,96169
4:5:3,0,-1,103832,96168
5:5:5,0,-1,103833,96167
2:4:5,1,1,103832,96168
2:4:3,1,1,103831,96169
3:1:4,0,-1,103832,96168
5:4:3,0,-1,103833,96167
1:5:6,0,-1,103834,96166
5:1:6,0,-1,103835,96165
2:1:3,1,1,103834,96166
4:5:3,0,-1,103835,96165
3:4:3,0,-1,103836,96164
4:2:2,2,2,103834,96166
2:3:3,1,1,103833,96167
4:5:5,0,-1,103834,96166
1:6:1,0,-1,103835,96165
4:2:6,1,1,103834,96166
3:2:5,1,1,103833,96167
2:3:4,1,1,103832,96168
2:4:2,2,2,103830,96170
6:5:6,0,-1,103831,96169
3:3:1,0,-1,103832,96168
2:5:2,2,2,103830,96170
5:2:2,2,2,103828,96172
4:6:5,0,-1,103829,96171
4:2:4,1,1,103828,96172
5:4:1,0,-1,103829,96171
6:4:1,0,-1,103830,96170
1:6:6,0,-1,103831,96169
5:3:3,0,-1,103832,96168
1:4:5,0,-1,103833,96167
3:4:2,1,1,103832,96168
6:5:1,0,-1,103833,96167
1:5:2,1,1,103832,96168
4:3:4,0,-1,103833,96167
4:3:2,1,1,103832,96168
2:3:6,1,1,103831,96169
4:1:4,0,-1,103832,96168
6:4:5,0,-1,103833,96167
2:6:4,1,1,103832,96168
4:2:6,1,1,103831,96169
3:6:5,0,-1,103832,96168
5:4:6,0,-1,103833,96167
4:3:6,0,-1,103834,96166
6:6:4,0,-1,103835,96165
6:4:5,0,-1,103836,96164
6:6:1,0,-1,103837,96163
1:6:1,0,-1,103838,96162
5:5:1,0,-1,103839,96161
4:2:4,1,1,103838,96162
5:1:5,0,-1,103839,96161
6:6:2,1,1,103838,96162
2:5:3,1,1,103837,96163
3:1:6,0,-1,103838,96162
3:3:2,1,1,103837,96163
3:3:4,0,-1,103838,96162
5:4:5,0,-1,103839,96161
4:1:3,0,-1,103840,96160
3:1:5,0,-1,103841,96159
4:4:6,0,-1,103842,96158
3:2:4,1,1,103841,96159
6:3:2,1,1,103840,96160
4:6:1,0,-1,103841,96159
5:6:1,0,-1,103842,96158
4:6:1,0,-1,103843,96157
6:3:6,0,-1,103844,96156
6:6:1,0,-1,103845,96155
2:1:5,1,1,103844,96156
2:1:3,1,1,103843,96157
4:6:6,0,-1,103844,96156
4:2:6,1,1,103843,96157
1:1:5,0,-1,103844,96156
4:4:1,0,-1,103845,96155
4:2:5,1,1,103844,96156
3:5:2,1,1,103843,96157
6:6:5,0,-1,103844,96156
5:2:2,2,2,103842,96158
2:2:6,2,2,103840,96160
5:3:2,1,1,103839,96161
6:3:3,0,-1,103840,96160
3:4:2,1,1,103839,96161
2:2:4,2,2,103837,96163
6:2:6,1,1,103836,96164
5:1:2,1,1,103835,96165
5:5:3,0,-1,103836,96164
5:2:4,1,1,103835,96165
3:2:3,1,1,103834,96166
3:4:5,0,-1,103835,96165
6:3:3,0,-1,103836,96164
3:5:2,1,1,103835,96165
3:4:6,0,-1,103836,96164
4:3:5,0,-1,103837,96163
6:5:4,0,-1,103838,96162
1:3:4,0,-1,103839,96161
5:2:4,1,1,103838,96162
5:4:3,0,-1,103839,96161
6:1:4,0,-1,103840,96160
3:5:6,0,-1,103841,96159
2:5:2,2,2,103839,96161
3:5:5,0,-1,103840,96160
4:1:2,1,1,103839,96161
2:5:5,1,1,103838,96162
5:6:4,0,-1,103839,96161
3:4:3,0,-1,103840,96160
6:3:6,0,-1,103841,96159
4:1:2,1,1,103840,96160
4:2:3,1,1,103839,96161
1:1:2,1,1,103838,96162
3:2:5,1,1,103837,96163
6:1:1,0,-1,103838,96162
4:1:6,0,-1,103839,96161
3:4:1,0,-1,103840,96160
6:6:3,0,-1,103841,96159
4:5:6,0,-1,103842,96158
5:4:4,0,-1,103843,96157
5:4:4,0,-1,103844,96156
5:3:3,0,-1,103845,96155
6:3:2,1,1,103844,96156
3:5:4,0,-1,103845,96155
5:2:1,1,1,103844,96156
3:1:1,0,-1,103845,96155
2:3:6,1,1,103844,96156
5:4:5,0,-1,103845,96155
6:2:5,1,1,103844,96156
4:1:1,0,-1,103845,96155
1:3:4,0,-1,103846,96154
4:5:3,0,-1,103847,96153
5:5:6,0,-1,103848,96152
3:6:3,0,-1,103849,96151
1:5:6,0,-1,103850,96150
6:6:4,0,-1,103851,96149
4:6:3,0,-1,103852,96148
5:4:2,1,1,103851,96149
3:1:6,0,-1,103852,96148
5:6:3,0,-1,103853,96147
4:1:3,0,-1,103854,96146
5:6:2,1,1,103853,96147
6:5:5,0,-1,103854,96146
2:1:4,1,1,103853,96147
5:3:4,0,-1,103854,96146
4:6:1,0,-1,103855,96145
5:3:2,1,1,103854,96146
6:1:2,1,1,103853,96147
6:6:4,0,-1,103854,96146
1:4:2,1,1,103853,96147
2:5:5,1,1,103852,96148
1:2:3,1,1,103851,96149
5:2:2,2,2,103849,96151
2:2:2,3,3,103846,96154
4:2:4,1,1,103845,96155
1:4:5,0,-1,103846,96154
2:3:1,1,1,103845,96155
5:2:2,2,2,103843,96157
2:4:4,1,1,103842,96158
4:4:1,0,-1,103843,96157
4:6:3,0,-1,103844,96156
6:5:3,0,-1,103845,96155
4:1:4,0,-1,103846,96154
2:6:1,1,1,103845,96155
3:1:6,0,-1,103846,96154
4:4:4,0,-1,103847,96153
2:3:5,1,1,103846,96154
6:6:1,0,-1,103847,96153
2:5:2,2,2,103845,96155
4:3:6,0,-1,103846,96154
3:5:2,1,1,103845,96155
6:5:2,1,1,103844,96156
2:6:4,1,1,103843,96157
2:6:2,2,2,103841,96159
4:2:2,2,2,103839,96161
6:2:5,1,1,103838,96162
3:4:5,0,-1,103839,96161
1:5:3,0,-1,103840,96160
3:2:6,1,1,103839,96161
1:1:2,1,1,103838,96162
2:1:2,2,2,103836,96164
5:3:6,0,-1,103837,96163
5:5:4,0,-1,103838,96162
5:6:2,1,1,103837,96163
4:1:6,0,-1,103838,96162
6:3:3,0,-1,103839,96161
2:1:6,1,1,103838,96162
5:2:4,1,1,103837,96163
2:5:1,1,1,103836,96164
2:5:1,1,1,103835,96165
3:2:3,1,1,103834,96166
2:6:2,2,2,103832,96168
1:5:5,0,-1,103833,96167
1:1:2,1,1,103832,96168
1:2:6,1,1,103831,96169
1:4:6,0,-1,103832,96168
1:2:4,1,1,103831,96169
6:3:6,0,-1,103832,96168
2:1:3,1,1,103831,96169
5:3:3,0,-1,103832,96168
3:2:5,1,1,103831,96169
6:6:2,1,1,103830,96170
5:5:1,0,-1,103831,96169
4:6:4,0,-1,103832,96168
3:2:3,1,1,103831,96169
1:6:6,0,-1,103832,96168
2:1:2,2,2,103830,96170
3:5:6,0,-1,103831,96169
5:2:1,1,1,103830,96170
2:5:3,1,1,103829,96171
4:6:6,0,-1,103830,96170
5:6:2,1,1,103829,96171
6:1:1,0,-1,103830,96170
5:5:2,1,1,103829,96171
3:2:2,2,2,103827,96173
5:1:3,0,-1,103828,96172
3:3:1,0,-1,103829,96171
5:4:6,0,-1,103830,96170
2:5:1,1,1,103829,96171
6:6:3,0,-1,103830,96170
1:4:2,1,1,103829,96171
5:1:5,0,-1,103830,96170
1:1:6,0,-1,103831,96169
3:4:6,0,-1,103832,96168
6:3:3,0,-1,103833,96167
1:6:6,0,-1,103834,96166
5:2:6,1,1,103833,96167
2:2:2,3,3,103830,96170
1:2:5,1,1,103829,96171
3:6:6,0,-1,103830,96170
3:6:6,0,-1,103831,96169
2:5:6,1,1,103830,96170
2:3:1,1,1,103829,96171
3:5:6,0,-1,103830,96170
4:2:2,2,2,103828,96172
2:6:2,2,2,103826,96174
6:5:2,1,1,103825,96175
6:4:3,0,-1,103826,96174
1:4:2,1,1,103825,96175
1:4:4,0,-1,103826,96174
3:2:3,1,1,103825,96175
1:1:4,0,-1,103826,96174
5:1:2,1,1,103825,96175
4:4:4,0,-1,103826,96174
5:6:3,0,-1,103827,96173
3:2:2,2,2,103825,96175
2:1:6,1,1,103824,96176
1:6:6,0,-1,103825,96175
6:2:3,1,1,103824,96176
5:6:2,1,1,103823,96177
1:1:4,0,-1,103824,96176
3:3:2,1,1,103823,96177
4:2:6,1,1,103822,96178
3:5:6,0,-1,103823,96177
2:3:2,2,2,103821,96179
4:4:1,0,-1,103822,96178
2:6:2,2,2,103820,96180
1:2:2,2,2,103818,96182
4:3:4,0,-1,103819,96181
1:2:3,1,1,103818,96182
1:5:2,1,1,103817,96183
2:4:1,1,1,103816,96184
5:1:5,0,-1,103817,96183
1:4:5,0,-1,103818,96182
4:6:6,0,-1,103819,96181
5:1:1,0,-1,103820,96180
1:1:1,0,-1,103821,96179
6:2:1,1,1,103820,96180
2:1:2,2,2,103818,96182
5:1:4,0,-1,103819,96181
3:1:2,1,1,103818,96182
1:2:3,1,1,103817,96183
3:5:5,0,-1,103818,96182
3:6:5,0,-1,103819,96181
4:1:3,0,-1,103820,96180
5:3:1,0,-1,103821,96179
4:3:5,0,-1,103822,96178
6:3:3,0,-1,103823,96177
5:4:5,0,-1,103824,96176
3:3:6,0,-1,103825,96175
6:6:1,0,-1,103826,96174
2:2:2,3,3,103823,96177
4:5:2,1,1,103822,96178
2:3:1,1,1,103821,96179
1:4:1,0,-1,103822,96178
2:2:3,2,2,103820,96180
6:6:6,0,-1,103821,96179
5:2:3,1,1,103820,96180
2:6:4,1,1,103819,96181
4:3:3,0,-1,103820,96180
3:3:1,0,-1,103821,96179
1:3:3,0,-1,103822,96178
4:1:5,0,-1,103823,96177
2:5:4,1,1,103822,96178
1:2:5,1,1,103821,96179
3:2:5,1,1,103820,96180
3:4:6,0,-1,103821,96179
6:2:6,1,1,103820,96180
6:6:6,0,-1,103821,96179
1:2:3,1,1,103820,96180
5:1:5,0,-1,103821,96179
1:3:6,0,-1,103822,96178
5:5:3,0,-1,103823,96177
1:4:1,0,-1,103824,96176
6:5:5,0,-1,103825,96175
2:3:2,2,2,103823,96177
4:5:5,0,-1,103824,96176
3:4:2,1,1,103823,96177
4:6:4,0,-1,103824,96176
1:3:3,0,-1,103825,96175
4:6:4,0,-1,103826,96174
5:3:3,0,-1,103827,96173
3:3:1,0,-1,103828,96172
6:6:4,0,-1,103829,96171
5:2:2,2,2,103827,96173
6:2:2,2,2,103825,96175
4:5:1,0,-1,103826,96174
5:4:2,1,1,103825,96175
4:4:2,1,1,103824,96176
3:3:6,0,-1,103825,96175
3:4:3,0,-1,103826,96174
6:6:3,0,-1,103827,96173
3:4:6,0,-1,103828,96172
6:4:6,0,-1,103829,96171
3:6:1,0,-1,103830,96170
1:6:4,0,-1,103831,96169
6:1:1,0,-1,103832,96168
6:5:4,0,-1,103833,96167
3:1:5,0,-1,103834,96166
3:1:4,0,-1,103835,96165
4:3:2,1,1,103834,96166
4:6:1,0,-1,103835,96165
4:2:3,1,1,103834,96166
1:3:5,0,-1,103835,96165
2:3:2,2,2,103833,96167
6:5:3,0,-1,103834,96166
4:1:1,0,-1,103835,96165
5:3:5,0,-1,103836,96164
3:2:5,1,1,103835,96165
2:1:1,1,1,103834,96166
4:5:4,0,-1,103835,96165
6:1:1,0,-1,103836,96164
5:4:4,0,-1,103837,96163
5:4:2,1,1,103836,96164
4:6:2,1,1,103835,96165
5:3:5,0,-1,103836,96164
2:4:5,1,1,103835,96165
5:5:1,0,-1,103836,96164
2:6:5,1,1,103835,96165
3:6:1,0,-1,103836,96164
6:4:1,0,-1,103837,96163
1:3:3,0,-1,103838,96162
2:2:6,2,2,103836,96164
4:3:6,0,-1,103837,96163
3:2:2,2,2,103835,96165
6:5:4,0,-1,103836,96164
5:1:6,0,-1,103837,96163
1:5:3,0,-1,103838,96162
1:2:5,1,1,103837,96163
1:2:1,1,1,103836,96164
1:6:3,0,-1,103837,96163
6:2:1,1,1,103836,96164
4:5:5,0,-1,103837,96163
3:5:6,0,-1,103838,96162
4:4:2,1,1,103837,96163
4:6:4,0,-1,103838,96162
2:6:3,1,1,103837,96163
2:2:2,3,3,103834,96166
3:6:1,0,-1,103835,96165
6:4:4,0,-1,103836,96164
6:4:5,0,-1,103837,96163
4:3:3,0,-1,103838,96162
4:3:2,1,1,103837,96163
6:5:3,0,-1,103838,96162
3:1:1,0,-1,103839,96161
3:3:5,0,-1,103840,96160
3:4:2,1,1,103839,96161
6:2:2,2,2,103837,96163
5:3:6,0,-1,103838,96162
2:2:3,2,2,103836,96164
4:1:5,0,-1,103837,96163
3:2:4,1,1,103836,96164
1:3:4,0,-1,103837,96163
5:4:5,0,-1,103838,96162
1:5:4,0,-1,103839,96161
2:6:5,1,1,103838,96162
5:5:5,0,-1,103839,96161
4:4:2,1,1,103838,96162
2:1:5,1,1,103837,96163
6:5:5,0,-1,103838,96162
5:2:6,1,1,103837,96163
6:2:1,1,1,103836,96164
5:6:1,0,-1,103837,96163
6:1:3,0,-1,103838,96162
6:3:4,0,-1,103839,96161
6:2:5,1,1,103838,96162
5:1:3,0,-1,103839,96161
4:6:2,1,1,103838,96162
5:4:4,0,-1,103839,96161
6:6:3,0,-1,103840,96160
5:1:5,0,-1,103841,96159
1:5:6,0,-1,103842,96158
1:2:2,2,2,103840,96160
6:6:3,0,-1,103841,96159
4:1:5,0,-1,103842,96158
2:6:2,2,2,103840,96160
1:5:6,0,-1,103841,96159
5:2:1,1,1,103840,96160
6:4:3,0,-1,103841,96159
6:1:2,1,1,103840,96160
4:6:4,0,-1,103841,96159
2:6:4,1,1,103840,96160
5:2:3,1,1,103839,96161
1:4:5,0,-1,103840,96160
6:6:4,0,-1,103841,96159
3:1:6,0,-1,103842,96158
2:1:4,1,1,103841,96159
3:4:5,0,-1,103842,96158
6:3:1,0,-1,103843,96157
4:4:5,0,-1,103844,96156
3:2:3,1,1,103843,96157
5:6:5,0,-1,103844,96156
1:4:6,0,-1,103845,96155
1:4:5,0,-1,103846,96154
6:4:5,0,-1,103847,96153
3:3:6,0,-1,103848,96152
6:3:1,0,-1,103849,96151
3:6:4,0,-1,103850,96150
3:5:3,0,-1,103851,96149
5:3:2,1,1,103850,96150
6:1:2,1,1,103849,96151
6:5:2,1,1,103848,96152
6:3:4,0,-1,103849,96151
3:4:2,1,1,103848,96152
6:5:2,1,1,103847,96153
4:5:3,0,-1,103848,96152
3:1:1,0,-1,103849,96151
6:2:1,1,1,103848,96152
5:6:6,0,-1,103849,96151
1:4:4,0,-1,103850,96150
2:6:2,2,2,103848,96152
1:5:5,0,-1,103849,96151
2:5:1,1,1,103848,96152
2:4:6,1,1,103847,96153
5:4:5,0,-1,103848,96152
2:2:6,2,2,103846,96154
3:1:6,0,-1,103847,96153
6:6:2,1,1,103846,96154
5:2:1,1,1,103845,96155
6:5:4,0,-1,103846,96154
1:1:1,0,-1,103847,96153
3:2:3,1,1,103846,96154
1:1:6,0,-1,103847,96153
6:3:1,0,-1,103848,96152
1:1:1,0,-1,103849,96151
4:4:5,0,-1,103850,96150
6:1:3,0,-1,103851,96149
5:5:5,0,-1,103852,96148
2:4:5,1,1,103851,96149
3:4:4,0,-1,103852,96148
1:5:6,0,-1,103853,96147
1:3:3,0,-1,103854,96146
5:4:4,0,-1,103855,96145
5:3:3,0,-1,103856,96144
4:5:4,0,-1,103857,96143
5:5:3,0,-1,103858,96142
3:4:5,0,-1,103859,96141
3:3:3,0,-1,103860,96140
2:6:5,1,1,103859,96141
4:3:5,0,-1,103860,96140
1:1:4,0,-1,103861,96139
6:4:1,0,-1,103862,96138
4:1:6,0,-1,103863,96137
3:2:4,1,1,103862,96138
1:6:4,0,-1,103863,96137
5:1:3,0,-1,103864,96136
1:3:3,0,-1,103865,96135
1:4:6,0,-1,103866,96134
2:3:6,1,1,103865,96135
4:4:3,0,-1,103866,96134
3:5:5,0,-1,103867,96133
2:1:1,1,1,103866,96134
5:3:2,1,1,103865,96135
5:1:6,0,-1,103866,96134
1:4:5,0,-1,103867,96133
5:4:3,0,-1,103868,96132
2:4:3,1,1,103867,96133
2:1:3,1,1,103866,96134
3:1:4,0,-1,103867,96133
6:6:5,0,-1,103868,96132
2:1:4,1,1,103867,96133
2:5:3,1,1,103866,96134
1:6:6,0,-1,103867,96133
4:3:6,0,-1,103868,96132
5:2:3,1,1,103867,96133
6:2:4,1,1,103866,96134
2:5:2,2,2,103864,96136
3:1:6,0,-1,103865,96135
4:4:3,0,-1,103866,96134
2:2:3,2,2,103864,96136
1:4:3,0,-1,103865,96135
2:6:2,2,2,103863,96137
5:5:6,0,-1,103864,96136
1:2:5,1,1,103863,96137
4:1:5,0,-1,103864,96136
1:2:2,2,2,103862,96138
3:6:3,0,-1,103863,96137
4:1:5,0,-1,103864,96136
6:6:4,0,-1,103865,96135
2:3:3,1,1,103864,96136
2:2:4,2,2,103862,96138
5:4:5,0,-1,103863,96137
2:4:3,1,1,103862,96138
4:3:4,0,-1,103863,96137
2:4:6,1,1,103862,96138
4:5:6,0,-1,103863,96137
3:2:1,1,1,103862,96138
4:5:4,0,-1,103863,96137
3:6:6,0,-1,103864,96136
1:6:2,1,1,103863,96137
4:5:1,0,-1,103864,96136
4:6:4,0,-1,103865,96135
6:6:1,0,-1,103866,96134
6:4:4,0,-1,103867,96133
4:5:6,0,-1,103868,96132
3:2:1,1,1,103867,96133
1:6:4,0,-1,103868,96132
1:5:6,0,-1,103869,96131
5:2:5,1,1,103868,96132
5:2:2,2,2,103866,96134
2:6:1,1,1,103865,96135
5:6:4,0,-1,103866,96134
4:3:2,1,1,103865,96135
4:2:2,2,2,103863,96137
6:6:6,0,-1,103864,96136
5:6:1,0,-1,103865,96135
3:5:5,0,-1,103866,96134
1:4:4,0,-1,103867,96133
5:6:3,0,-1,103868,96132
2:3:2,2,2,103866,96134
4:1:1,0,-1,103867,96133
6:1:6,0,-1,103868,96132
6:2:4,1,1,103867,96133
1:3:4,0,-1,103868,96132
3:1:6,0,-1,103869,96131
3:2:1,1,1,103868,96132
3:5:6,0,-1,103869,96131
5:4:3,0,-1,103870,96130
6:4:1,0,-1,103871,96129
2:4:2,2,2,103869,96131
4:5:5,0,-1,103870,96130
5:6:6,0,-1,103871,96129
2:1:3,1,1,103870,96130
5:2:6,1,1,103869,96131
1:5:3,0,-1,103870,96130
4:5:6,0,-1,103871,96129
3:3:1,0,-1,103872,96128
5:4:1,0,-1,103873,96127
2:4:4,1,1,103872,96128
5:4:2,1,1,103871,96129
1:1:5,0,-1,103872,96128
1:1:3,0,-1,103873,96127
1:4:6,0,-1,103874,96126
2:6:5,1,1,103873,96127
1:5:6,0,-1,103874,96126
2:4:5,1,1,103873,96127
2:6:5,1,1,103872,96128
5:3:5,0,-1,103873,96127
4:1:1,0,-1,103874,96126
6:4:3,0,-1,103875,96125
5:5:6,0,-1,103876,96124
3:1:3,0,-1,103877,96123
5:3:5,0,-1,103878,96122
2:3:4,1,1,103877,96123
4:1:5,0,-1,103878,96122
2:4:5,1,1,103877,96123
5:4:6,0,-1,103878,96122
4:5:6,0,-1,103879,96121
3:5:1,0,-1,103880,96120
1:6:1,0,-1,103881,96119
1:5:5,0,-1,103882,96118
6:6:2,1,1,103881,96119
2:1:4,1,1,103880,96120
3:1:6,0,-1,103881,96119
4:3:5,0,-1,103882,96118
3:2:1,1,1,103881,96119
5:1:6,0,-1,103882,96118
5:2:4,1,1,103881,96119
1:5:2,1,1,103880,96120
6:2:5,1,1,103879,96121
6:6:1,0,-1,103880,96120
2:1:2,2,2,103878,96122
6:2:3,1,1,103877,96123
5:1:1,0,-1,103878,96122
2:5:5,1,1,103877,96123
1:4:6,0,-1,103878,96122
1:6:6,0,-1,103879,96121
6:5:2,1,1,103878,96122
1:1:1,0,-1,103879,96121
2:6:1,1,1,103878,96122
6:4:4,0,-1,103879,96121
2:3:4,1,1,103878,96122
1:4:1,0,-1,103879,96121
6:1:2,1,1,103878,96122
6:2:5,1,1,103877,96123
6:2:6,1,1,103876,96124
1:3:5,0,-1,103877,96123
4:3:1,0,-1,103878,96122
2:6:1,1,1,103877,96123
1:4:1,0,-1,103878,96122
2:2:5,2,2,103876,96124
5:1:6,0,-1,103877,96123
3:6:3,0,-1,103878,96122
3:5:6,0,-1,103879,96121
6:5:5,0,-1,103880,96120
5:5:1,0,-1,103881,96119
4:3:6,0,-1,103882,96118
6:5:3,0,-1,103883,96117
6:5:5,0,-1,103884,96116
6:1:4,0,-1,103885,96115
4:5:1,0,-1,103886,96114
5:5:3,0,-1,103887,96113
6:2:3,1,1,103886,96114
5:1:6,0,-1,103887,96113
3:1:3,0,-1,103888,96112
2:3:5,1,1,103887,96113
6:2:3,1,1,103886,96114
5:1:5,0,-1,103887,96113
2:3:4,1,1,103886,96114
6:2:5,1,1,103885,96115
1:6:6,0,-1,103886,96114
2:2:5,2,2,103884,96116
6:3:4,0,-1,103885,96115
2:6:5,1,1,103884,96116
2:1:4,1,1,103883,96117
6:4:2,1,1,103882,96118
6:2:6,1,1,103881,96119
1:6:1,0,-1,103882,96118
6:3:6,0,-1,103883,96117
5:4:4,0,-1,103884,96116
4:6:6,0,-1,103885,96115
5:6:6,0,-1,103886,96114
2:1:3,1,1,103885,96115
2:3:5,1,1,103884,96116
2:3:3,1,1,103883,96117
4:6:2,1,1,103882,96118
3:3:3,0,-1,103883,96117
6:6:2,1,1,103882,96118
5:1:1,0,-1,103883,96117
6:2:4,1,1,103882,96118
3:3:2,1,1,103881,96119
1:2:1,1,1,103880,96120
6:6:5,0,-1,103881,96119
5:1:2,1,1,103880,96120
5:6:6,0,-1,103881,96119
5:1:4,0,-1,103882,96118
3:1:1,0,-1,103883,96117
4:2:3,1,1,103882,96118
2:6:5,1,1,103881,96119
1:6:4,0,-1,103882,96118
1:2:4,1,1,103881,96119
6:3:1,0,-1,103882,96118
6:5:4,0,-1,103883,96117
3:5:5,0,-1,103884,96116
1:2:5,1,1,103883,96117
3:4:6,0,-1,103884,96116
5:5:3,0,-1,103885,96115
4:6:6,0,-1,103886,96114
1:2:6,1,1,103885,96115
5:3:3,0,-1,103886,96114
5:4:6,0,-1,103887,96113
3:4:1,0,-1,103888,96112
3:3:1,0,-1,103889,96111
1:6:3,0,-1,103890,96110
4:4:5,0,-1,103891,96109
4:1:1,0,-1,103892,96108
6:1:6,0,-1,103893,96107
6:2:6,1,1,103892,96108
5:3:5,0,-1,103893,96107
4:6:4,0,-1,103894,96106
2:6:6,1,1,103893,96107
5:4:6,0,-1,103894,96106
1:5:1,0,-1,103895,96105
3:3:5,0,-1,103896,96104
4:4:3,0,-1,103897,96103
5:5:5,0,-1,103898,96102
3:4:2,1,1,103897,96103
1:5:6,0,-1,103898,96102
4:1:1,0,-1,103899,96101
2:4:3,1,1,103898,96102
4:1:3,0,-1,103899,96101
5:6:3,0,-1,103900,96100
2:4:6,1,1,103899,96101
1:1:5,0,-1,103900,96100
4:4:5,0,-1,103901,96099
6:4:3,0,-1,103902,96098
6:1:2,1,1,103901,96099
5:1:6,0,-1,103902,96098
3:2:3,1,1,103901,96099
4:1:2,1,1,103900,96100
2:6:5,1,1,103899,96101
3:2:2,2,2,103897,96103
3:1:1,0,-1,103898,96102
6:5:3,0,-1,103899,96101
5:3:3,0,-1,103900,96100
4:5:1,0,-1,103901,96099
4:5:3,0,-1,103902,96098
3:6:4,0,-1,103903,96097
4:2:3,1,1,103902,96098
4:2:4,1,1,103901,96099
6:4:3,0,-1,103902,96098
1:4:5,0,-1,103903,96097
2:4:4,1,1,103902,96098
4:2:3,1,1,103901,96099
1:4:5,0,-1,103902,96098
5:4:1,0,-1,103903,96097
4:4:3,0,-1,103904,96096
3:2:4,1,1,103903,96097
1:2:4,1,1,103902,96098
1:4:1,0,-1,103903,96097
2:6:1,1,1,103902,96098
3:6:1,0,-1,103903,96097
6:4:4,0,-1,103904,96096
5:6:3,0,-1,103905,96095
1:5:5,0,-1,103906,96094
3:4:5,0,-1,103907,96093
5:6:1,0,-1,103908,96092
4:3:6,0,-1,103909,96091
3:2:5,1,1,103908,96092
2:3:5,1,1,103907,96093
4:1:5,0,-1,103908,96092
6:6:4,0,-1,103909,96091
4:5:2,1,1,103908,96092
5:6:1,0,-1,103909,96091
5:1:4,0,-1,103910,96090
3:5:5,0,-1,103911,96089
3:2:2,2,2,103909,96091
6:2:4,1,1,103908,96092
1:6:3,0,-1,103909,96091
5:4:2,1,1,103908,96092
3:5:4,0,-1,103909,96091
4:5:2,1,1,103908,96092
2:3:2,2,2,103906,96094
5:5:1,0,-1,103907,96093
5:5:2,1,1,103906,96094
6:2:4,1,1,103905,96095
3:4:6,0,-1,103906,96094
6:5:1,0,-1,103907,96093
6:2:2,2,2,103905,96095
2:5:2,2,2,103903,96097
4:6:3,0,-1,103904,96096
3:3:4,0,-1,103905,96095
4:1:1,0,-1,103906,96094
4:3:1,0,-1,103907,96093
1:6:4,0,-1,103908,96092
1:5:3,0,-1,103909,96091
1:3:6,0,-1,103910,96090
5:1:4,0,-1,103911,96089
6:6:3,0,-1,103912,96088
1:3:2,1,1,103911,96089
4:3:3,0,-1,103912,96088
1:1:1,0,-1,103913,96087
6:2:5,1,1,103912,96088
4:3:5,0,-1,103913,96087
6:1:5,0,-1,103914,96086
1:4:6,0,-1,103915,96085
3:2:4,1,1,103914,96086
6:4:2,1,1,103913,96087
3:5:1,0,-1,103914,96086
5:5:2,1,1,103913,96087
4:2:5,1,1,103912,96088
1:2:3,1,1,103911,96089
5:3:4,0,-1,103912,96088
5:1:1,0,-1,103913,96087
1:1:1,0,-1,103914,96086
1:5:4,0,-1,103915,96085
1:3:2,1,1,103914,96086
4:5:2,1,1,103913,96087
3:2:6,1,1,103912,96088
2:2:2,3,3,103909,96091
2:1:6,1,1,103908,96092
4:5:6,0,-1,103909,96091
3:5:2,1,1,103908,96092
6:6:3,0,-1,103909,96091
5:3:6,0,-1,103910,96090
3:2:3,1,1,103909,96091
6:3:6,0,-1,103910,96090
3:1:4,0,-1,103911,96089
5:1:1,0,-1,103912,96088
3:5:4,0,-1,103913,96087
3:5:1,0,-1,103914,96086
1:2:5,1,1,103913,96087
2:5:4,1,1,103912,96088
5:3:6,0,-1,103913,96087
3:6:1,0,-1,103914,96086
4:6:5,0,-1,103915,96085
4:1:2,1,1,103914,96086
5:6:4,0,-1,103915,96085
5:2:1,1,1,103914,96086
6:5:4,0,-1,103915,96085
3:1:1,0,-1,103916,96084
4:4:5,0,-1,103917,96083
3:6:5,0,-1,103918,96082
3:1:4,0,-1,103919,96081
4:4:3,0,-1,103920,96080
6:3:1,0,-1,103921,96079
3:6:3,0,-1,103922,96078
4:5:1,0,-1,103923,96077
2:6:4,1,1,103922,96078
1:3:1,0,-1,103923,96077
6:5:4,0,-1,103924,96076
2:5:1,1,1,103923,96077
1:4:2,1,1,103922,96078
6:1:1,0,-1,103923,96077
3:2:5,1,1,103922,96078
1:2:1,1,1,103921,96079
2:6:5,1,1,103920,96080
5:2:6,1,1,103919,96081
4:5:2,1,1,103918,96082
6:2:5,1,1,103917,96083
2:5:6,1,1,103916,96084
4:1:2,1,1,103915,96085
2:4:1,1,1,103914,96086
5:3:2,1,1,103913,96087
1:6:4,0,-1,103914,96086
5:1:5,0,-1,103915,96085
6:1:3,0,-1,103916,96084
5:3:5,0,-1,103917,96083
5:5:4,0,-1,103918,96082
4:3:2,1,1,103917,96083
3:4:2,1,1,103916,96084
6:4:4,0,-1,103917,96083
4:3:2,1,1,103916,96084
3:3:5,0,-1,103917,96083
1:4:5,0,-1,103918,96082
6:2:4,1,1,103917,96083
4:5:3,0,-1,103918,96082
6:5:4,0,-1,103919,96081
4:5:3,0,-1,103920,96080
1:6:4,0,-1,103921,96079
6:1:1,0,-1,103922,96078
5:5:3,0,-1,103923,96077
2:4:6,1,1,103922,96078
3:6:4,0,-1,103923,96077
4:4:6,0,-1,103924,96076
4:2:1,1,1,103923,96077
2:3:4,1,1,103922,96078
5:4:1,0,-1,103923,96077
4:4:6,0,-1,103924,96076
2:3:6,1,1,103923,96077
1:1:3,0,-1,103924,96076
4:3:2,1,1,103923,96077
2:3:3,1,1,103922,96078
4:1:1,0,-1,103923,96077
5:6:6,0,-1,103924,96076
2:4:4,1,1,103923,96077
3:5:1,0,-1,103924,96076
4:6:6,0,-1,103925,96075
2:1:1,1,1,103924,96076
3:4:5,0,-1,103925,96075
1:2:2,2,2,103923,96077
1:3:1,0,-1,103924,96076
3:4:1,0,-1,103925,96075
2:1:3,1,1,103924,96076
1:6:3,0,-1,103925,96075
5:4:2,1,1,103924,96076
6:2:6,1,1,103923,96077
6:4:2,1,1,103922,96078
1:6:6,0,-1,103923,96077
5:1:6,0,-1,103924,96076
4:3:3,0,-1,103925,96075
2:1:6,1,1,103924,96076
4:2:4,1,1,103923,96077
2:5:2,2,2,103921,96079
3:1:2,1,1,103920,96080
6:6:6,0,-1,103921,96079
4:1:1,0,-1,103922,96078
2:4:1,1,1,103921,96079
2:2:4,2,2,103919,96081
3:5:5,0,-1,103920,96080
5:3:4,0,-1,103921,96079
2:6:3,1,1,103920,96080
2:3:3,1,1,103919,96081
3:2:4,1,1,103918,96082
4:1:1,0,-1,103919,96081
4:1:5,0,-1,103920,96080
1:5:2,1,1,103919,96081
2:2:2,3,3,103916,96084
5:4:3,0,-1,103917,96083
2:2:1,2,2,103915,96085
4:6:1,0,-1,103916,96084
5:4:4,0,-1,103917,96083
6:3:4,0,-1,103918,96082
5:5:6,0,-1,103919,96081
6:3:6,0,-1,103920,96080
5:3:4,0,-1,103921,96079
6:1:1,0,-1,103922,96078
4:2:3,1,1,103921,96079
4:2:1,1,1,103920,96080
1:6:3,0,-1,103921,96079
5:1:5,0,-1,103922,96078
5:3:4,0,-1,103923,96077
5:1:1,0,-1,103924,96076
3:4:3,0,-1,103925,96075
6:1:6,0,-1,103926,96074
1:5:1,0,-1,103927,96073
4:3:1,0,-1,103928,96072
4:1:3,0,-1,103929,96071
5:1:3,0,-1,103930,96070
4:1:2,1,1,103929,96071
6:6:4,0,-1,103930,96070
1:2:2,2,2,103928,96072
6:1:1,0,-1,103929,96071
6:3:3,0,-1,103930,96070
2:3:6,1,1,103929,96071
6:2:2,2,2,103927,96073
6:5:5,0,-1,103928,96072
4:3:2,1,1,103927,96073
3:6:3,0,-1,103928,96072
6:2:3,1,1,103927,96073
2:4:1,1,1,103926,96074
5:3:2,1,1,103925,96075
1:5:1,0,-1,103926,96074
5:5:4,0,-1,103927,96073
4:3:2,1,1,103926,96074
4:5:2,1,1,103925,96075
4:2:3,1,1,103924,96076
3:2:3,1,1,103923,96077
5:4:6,0,-1,103924,96076
6:4:1,0,-1,103925,96075
6:6:4,0,-1,103926,96074
4:1:1,0,-1,103927,96073
3:1:2,1,1,103926,96074
4:3:3,0,-1,103927,96073
4:1:3,0,-1,103928,96072
2:4:5,1,1,103927,96073
5:6:4,0,-1,103928,96072
2:4:5,1,1,103927,96073
2:1:4,1,1,103926,96074
5:5:2,1,1,103925,96075
1:2:4,1,1,103924,96076
1:4:1,0,-1,103925,96075
5:4:5,0,-1,103926,96074
1:2:1,1,1,103925,96075
4:1:4,0,-1,103926,96074
2:4:6,1,1,103925,96075
5:2:5,1,1,103924,96076
4:2:3,1,1,103923,96077
3:2:1,1,1,103922,96078
5:4:2,1,1,103921,96079
5:2:6,1,1,103920,96080
3:1:5,0,-1,103921,96079
5:2:3,1,1,103920,96080
5:4:3,0,-1,103921,96079
3:5:5,0,-1,103922,96078
2:1:1,1,1,103921,96079
4:5:3,0,-1,103922,96078
6:2:1,1,1,103921,96079
1:2:5,1,1,103920,96080
5:5:1,0,-1,103921,96079
2:5:2,2,2,103919,96081
1:5:1,0,-1,103920,96080
4:6:5,0,-1,103921,96079
3:6:6,0,-1,103922,96078
4:2:1,1,1,103921,96079
1:2:5,1,1,103920,96080
4:3:5,0,-1,103921,96079
6:1:3,0,-1,103922,96078
3:6:5,0,-1,103923,96077
2:5:3,1,1,103922,96078
5:2:5,1,1,103921,96079
1:3:1,0,-1,103922,96078
5:2:5,1,1,103921,96079
3:3:1,0,-1,103922,96078
3:3:1,0,-1,103923,96077
1:1:5,0,-1,103924,96076
3:3:3,0,-1,103925,96075
6:5:6,0,-1,103926,96074
6:2:4,1,1,103925,96075
1:5:5,0,-1,103926,96074
3:6:6,0,-1,103927,96073
4:5:2,1,1,103926,96074
2:5:6,1,1,103925,96075
1:4:1,0,-1,103926,96074
3:2:4,1,1,103925,96075
4:3:5,0,-1,103926,96074
6:4:1,0,-1,103927,96073
2:4:4,1,1,103926,96074
5:3:5,0,-1,103927,96073
6:3:1,0,-1,103928,96072
2:3:6,1,1,103927,96073
3:4:6,0,-1,103928,96072
6:4:2,1,1,103927,96073
4:3:3,0,-1,103928,96072
2:3:1,1,1,103927,96073
2:2:2,3,3,103924,96076
2:4:3,1,1,103923,96077
1:3:4,0,-1,103924,96076
3:1:2,1,1,103923,96077
4:3:3,0,-1,103924,96076
5:4:2,1,1,103923,96077
4:6:6,0,-1,103924,96076
5:2:5,1,1,103923,96077
6:1:1,0,-1,103924,96076
1:5:2,1,1,103923,96077
6:2:3,1,1,103922,96078
3:2:4,1,1,103921,96079
1:4:3,0,-1,103922,96078
1:4:2,1,1,103921,96079
4:6:2,1,1,103920,96080
5:5:4,0,-1,103921,96079
3:2:4,1,1,103920,96080
5:2:5,1,1,103919,96081
5:6:6,0,-1,103920,96080
4:4:3,0,-1,103921,96079
2:1:4,1,1,103920,96080
5:6:6,0,-1,103921,96079
4:3:1,0,-1,103922,96078
5:2:1,1,1,103921,96079
2:5:1,1,1,103920,96080
5:6:6,0,-1,103921,96079
3:1:5,0,-1,103922,96078
2:5:5,1,1,103921,96079
4:2:4,1,1,103920,96080
1:1:5,0,-1,103921,96079
5:2:2,2,2,103919,96081
1:2:3,1,1,103918,96082
1:1:5,0,-1,103919,96081
2:5:1,1,1,103918,96082
2:5:3,1,1,103917,96083
6:4:3,0,-1,103918,96082
5:6:3,0,-1,103919,96081
3:4:5,0,-1,103920,96080
2:4:5,1,1,103919,96081
6:5:2,1,1,103918,96082
6:1:5,0,-1,103919,96081
5:1:3,0,-1,103920,96080
6:1:5,0,-1,103921,96079
6:1:3,0,-1,103922,96078
2:1:4,1,1,103921,96079
1:5:3,0,-1,103922,96078
1:1:1,0,-1,103923,96077
6:1:5,0,-1,103924,96076
4:4:5,0,-1,103925,96075
1:2:2,2,2,103923,96077
1:5:3,0,-1,103924,96076
5:6:4,0,-1,103925,96075
5:4:3,0,-1,103926,96074
5:6:2,1,1,103925,96075
1:6:3,0,-1,103926,96074
1:6:2,1,1,103925,96075
1:5:4,0,-1,103926,96074
6:5:4,0,-1,103927,96073
1:2:6,1,1,103926,96074
1:5:2,1,1,103925,96075
4:6:6,0,-1,103926,96074
5:1:2,1,1,103925,96075
6:3:3,0,-1,103926,96074
3:6:1,0,-1,103927,96073
5:1:4,0,-1,103928,96072
3:4:2,1,1,103927,96073
5:4:2,1,1,103926,96074
5:5:4,0,-1,103927,96073
3:4:3,0,-1,103928,96072
3:4:5,0,-1,103929,96071
2:3:5,1,1,103928,96072
5:5:6,0,-1,103929,96071
6:1:6,0,-1,103930,96070
5:4:6,0,-1,103931,96069
6:1:2,1,1,103930,96070
1:4:1,0,-1,103931,96069
1:4:1,0,-1,103932,96068
6:6:2,1,1,103931,96069
2:1:2,2,2,103929,96071
5:3:6,0,-1,103930,96070
3:4:1,0,-1,103931,96069
5:2:6,1,1,103930,96070
6:2:6,1,1,103929,96071
1:1:3,0,-1,103930,96070
3:4:4,0,-1,103931,96069
1:5:4,0,-1,103932,96068
3:3:3,0,-1,103933,96067
3:1:1,0,-1,103934,96066
2:1:4,1,1,103933,96067
1:2:3,1,1,103932,96068
1:1:3,0,-1,103933,96067
2:2:4,2,2,103931,96069
4:2:2,2,2,103929,96071
2:4:2,2,2,103927,96073
4:6:4,0,-1,103928,96072
4:5:3,0,-1,103929,96071
3:5:5,0,-1,103930,96070
2:6:1,1,1,103929,96071
6:2:1,1,1,103928,96072
3:5:6,0,-1,103929,96071
6:1:3,0,-1,103930,96070
2:6:1,1,1,103929,96071
5:6:3,0,-1,103930,96070
6:1:5,0,-1,103931,96069
3:3:1,0,-1,103932,96068
6:5:5,0,-1,103933,96067
6:2:6,1,1,103932,96068
3:1:1,0,-1,103933,96067
3:1:4,0,-1,103934,96066
1:5:2,1,1,103933,96067
2:2:3,2,2,103931,96069
6:1:6,0,-1,103932,96068
6:3:2,1,1,103931,96069
4:3:4,0,-1,103932,96068
1:3:4,0,-1,103933,96067
1:5:5,0,-1,103934,96066
1:4:6,0,-1,103935,96065
6:3:3,0,-1,103936,96064
3:1:2,1,1,103935,96065
2:4:1,1,1,103934,96066
1:6:4,0,-1,103935,96065
6:4:6,0,-1,103936,96064
3:6:3,0,-1,103937,96063
6:2:3,1,1,103936,96064
4:2:3,1,1,103935,96065
5:5:1,0,-1,103936,96064
2:4:4,1,1,103935,96065
2:4:6,1,1,103934,96066
6:3:2,1,1,103933,96067
5:6:6,0,-1,103934,96066
2:1:3,1,1,103933,96067
6:4:1,0,-1,103934,96066
3:6:6,0,-1,103935,96065
4:5:6,0,-1,103936,96064
3:6:1,0,-1,103937,96063
1:3:2,1,1,103936,96064
2:4:2,2,2,103934,96066
3:5:1,0,-1,103935,96065
1:3:1,0,-1,103936,96064
5:1:5,0,-1,103937,96063
4:5:1,0,-1,103938,96062
3:5:4,0,-1,103939,96061
2:1:1,1,1,103938,96062
6:1:5,0,-1,103939,96061
6:2:4,1,1,103938,96062
1:2:3,1,1,103937,96063
1:2:2,2,2,103935,96065
2:3:6,1,1,103934,96066
5:2:2,2,2,103932,96068
5:1:6,0,-1,103933,96067
5:5:6,0,-1,103934,96066
4:1:1,0,-1,103935,96065
6:3:1,0,-1,103936,96064
4:6:2,1,1,103935,96065
5:6:6,0,-1,103936,96064
3:3:1,0,-1,103937,96063
6:5:5,0,-1,103938,96062
5:2:3,1,1,103937,96063
4:6:5,0,-1,103938,96062
6:2:1,1,1,103937,96063
2:1:3,1,1,103936,96064
1:2:5,1,1,103935,96065
6:4:6,0,-1,103936,96064
4:3:6,0,-1,103937,96063
5:6:6,0,-1,103938,96062
3:1:1,0,-1,103939,96061
2:6:3,1,1,103938,96062
5:6:6,0,-1,103939,96061
2:6:1,1,1,103938,96062
6:1:1,0,-1,103939,96061
2:2:1,2,2,103937,96063
4:2:3,1,1,103936,96064
4:5:3,0,-1,103937,96063
4:1:3,0,-1,103938,96062
4:6:4,0,-1,103939,96061
6:2:3,1,1,103938,96062
4:2:6,1,1,103937,96063
3:2:6,1,1,103936,96064
1:3:1,0,-1,103937,96063
1:4:6,0,-1,103938,96062
1:3:6,0,-1,103939,96061
3:6:6,0,-1,103940,96060
6:6:6,0,-1,103941,96059
5:2:1,1,1,103940,96060
2:3:6,1,1,103939,96061
1:1:1,0,-1,103940,96060
1:5:5,0,-1,103941,96059
3:6:6,0,-1,103942,96058
1:3:6,0,-1,103943,96057
4:3:3,0,-1,103944,96056
2:2:6,2,2,103942,96058
3:6:5,0,-1,103943,96057
5:1:1,0,-1,103944,96056
4:6:2,1,1,103943,96057
5:5:3,0,-1,103944,96056
2:1:6,1,1,103943,96057
2:2:2,3,3,103940,96060
2:6:6,1,1,103939,96061
1:4:1,0,-1,103940,96060
6:1:1,0,-1,103941,96059
1:3:1,0,-1,103942,96058
4:1:5,0,-1,103943,96057
5:4:3,0,-1,103944,96056
4:5:3,0,-1,103945,96055
4:5:2,1,1,103944,96056
6:5:4,0,-1,103945,96055
4:4:4,0,-1,103946,96054
4:5:6,0,-1,103947,96053
1:4:6,0,-1,103948,96052
6:4:6,0,-1,103949,96051
6:4:3,0,-1,103950,96050
4:5:5,0,-1,103951,96049
5:3:4,0,-1,103952,96048
3:4:1,0,-1,103953,96047
6:4:6,0,-1,103954,96046
3:2:6,1,1,103953,96047
2:2:3,2,2,103951,96049
1:2:4,1,1,103950,96050
1:6:3,0,-1,103951,96049
3:5:5,0,-1,103952,96048
3:6:1,0,-1,103953,96047
2:5:2,2,2,103951,96049
1:4:3,0,-1,103952,96048
5:5:2,1,1,103951,96049
5:1:6,0,-1,103952,96048
2:2:2,3,3,103949,96051
6:2:1,1,1,103948,96052
4:3:4,0,-1,103949,96051
5:3:6,0,-1,103950,96050
5:5:2,1,1,103949,96051
3:4:3,0,-1,103950,96050
1:4:1,0,-1,103951,96049
1:4:5,0,-1,103952,96048
1:5:1,0,-1,103953,96047
3:5:4,0,-1,103954,96046
2:3:4,1,1,103953,96047
5:1:6,0,-1,103954,96046
2:5:5,1,1,103953,96047
6:5:1,0,-1,103954,96046
2:3:2,2,2,103952,96048
2:2:4,2,2,103950,96050
4:6:6,0,-1,103951,96049
6:3:1,0,-1,103952,96048
6:1:3,0,-1,103953,96047
1:2:5,1,1,103952,96048
3:2:1,1,1,103951,96049
2:5:6,1,1,103950,96050
3:3:4,0,-1,103951,96049
6:6:5,0,-1,103952,96048
4:4:4,0,-1,103953,96047
2:3:2,2,2,103951,96049
4:5:3,0,-1,103952,96048
2:2:5,2,2,103950,96050
3:6:5,0,-1,103951,96049
5:3:3,0,-1,103952,96048
3:6:5,0,-1,103953,96047
2:3:6,1,1,103952,96048
4:4:2,1,1,103951,96049
6:1:3,0,-1,103952,96048
5:2:1,1,1,103951,96049
4:3:1,0,-1,103952,96048
3:5:2,1,1,103951,96049
3:3:6,0,-1,103952,96048
1:4:5,0,-1,103953,96047
1:2:2,2,2,103951,96049
1:6:3,0,-1,103952,96048
3:4:3,0,-1,103953,96047
2:6:5,1,1,103952,96048
2:4:3,1,1,103951,96049
3:6:6,0,-1,103952,96048
4:5:3,0,-1,103953,96047
1:3:4,0,-1,103954,96046
5:4:3,0,-1,103955,96045
5:3:2,1,1,103954,96046
6:3:4,0,-1,103955,96045
2:2:6,2,2,103953,96047
3:2:4,1,1,103952,96048
4:5:3,0,-1,103953,96047
1:5:3,0,-1,103954,96046
5:6:5,0,-1,103955,96045
2:1:2,2,2,103953,96047
1:4:2,1,1,103952,96048
5:3:6,0,-1,103953,96047
3:6:2,1,1,103952,96048
4:1:5,0,-1,103953,96047
6:3:3,0,-1,103954,96046
6:1:2,1,1,103953,96047
2:3:4,1,1,103952,96048
6:1:6,0,-1,103953,96047
4:3:2,1,1,103952,96048
6:5:2,1,1,103951,96049
6:2:1,1,1,103950,96050
1:3:3,0,-1,103951,96049
3:3:6,0,-1,103952,96048
5:1:5,0,-1,103953,96047
5:2:6,1,1,103952,96048
1:4:1,0,-1,103953,96047
1:1:3,0,-1,103954,96046
1:2:6,1,1,103953,96047
1:5:4,0,-1,103954,96046
6:6:1,0,-1,103955,96045
2:3:3,1,1,103954,96046
2:6:5,1,1,103953,96047
3:5:5,0,-1,103954,96046
2:4:5,1,1,103953,96047
6:4:5,0,-1,103954,96046
4:5:5,0,-1,103955,96045
2:6:2,2,2,103953,96047
2:4:1,1,1,103952,96048
4:3:3,0,-1,103953,96047
4:3:6,0,-1,103954,96046
6:2:1,1,1,103953,96047
4:6:1,0,-1,103954,96046
4:2:5,1,1,103953,96047
2:2:6,2,2,103951,96049
6:1:4,0,-1,103952,96048
2:6:3,1,1,103951,96049
4:2:4,1,1,103950,96050
3:3:6,0,-1,103951,96049
3:6:1,0,-1,103952,96048
1:3:5,0,-1,103953,96047
2:3:6,1,1,103952,96048
3:6:1,0,-1,103953,96047
5:3:6,0,-1,103954,96046
1:2:1,1,1,103953,96047
6:3:6,0,-1,103954,96046
6:5:2,1,1,103953,96047
3:6:4,0,-1,103954,96046
1:2:3,1,1,103953,96047
5:3:2,1,1,103952,96048
4:3:4,0,-1,103953,96047
4:4:5,0,-1,103954,96046
2:3:3,1,1,103953,96047
1:1:3,0,-1,103954,96046
4:1:3,0,-1,103955,96045
3:6:4,0,-1,103956,96044
1:5:1,0,-1,103957,96043
4:2:4,1,1,103956,96044
5:6:3,0,-1,103957,96043
3:2:1,1,1,103956,96044
4:6:5,0,-1,103957,96043
4:3:4,0,-1,103958,96042
5:4:6,0,-1,103959,96041
3:4:2,1,1,103958,96042
3:4:6,0,-1,103959,96041
2:2:6,2,2,103957,96043
5:4:6,0,-1,103958,96042
5:2:5,1,1,103957,96043
1:1:5,0,-1,103958,96042
1:1:6,0,-1,103959,96041
6:3:1,0,-1,103960,96040
3:6:2,1,1,103959,96041
5:6:2,1,1,103958,96042
2:2:2,3,3,103955,96045
1:2:1,1,1,103954,96046
2:1:4,1,1,103953,96047
5:6:4,0,-1,103954,96046
5:6:5,0,-1,103955,96045
2:4:4,1,1,103954,96046
4:3:6,0,-1,103955,96045
2:1:5,1,1,103954,96046
4:3:4,0,-1,103955,96045
2:5:2,2,2,103953,96047
4:5:6,0,-1,103954,96046
1:1:4,0,-1,103955,96045
1:3:3,0,-1,103956,96044
5:4:5,0,-1,103957,96043
2:4:5,1,1,103956,96044
5:4:5,0,-1,103957,96043
3:4:1,0,-1,103958,96042
5:2:2,2,2,103956,96044
2:2:2,3,3,103953,96047
3:4:1,0,-1,103954,96046
5:2:2,2,2,103952,96048
4:1:5,0,-1,103953,96047
2:1:4,1,1,103952,96048
4:3:1,0,-1,103953,96047
4:4:1,0,-1,103954,96046
4:3:2,1,1,103953,96047
3:6:3,0,-1,103954,96046
2:3:5,1,1,103953,96047
2:3:4,1,1,103952,96048
2:4:3,1,1,103951,96049
2:1:2,2,2,103949,96051
5:2:3,1,1,103948,96052
6:1:3,0,-1,103949,96051
3:3:6,0,-1,103950,96050
2:2:1,2,2,103948,96052
2:1:4,1,1,103947,96053
2:1:4,1,1,103946,96054
5:6:1,0,-1,103947,96053
2:6:1,1,1,103946,96054
3:5:2,1,1,103945,96055
4:2:3,1,1,103944,96056
1:6:4,0,-1,103945,96055
1:2:1,1,1,103944,96056
6:4:4,0,-1,103945,96055
5:2:5,1,1,103944,96056
4:3:6,0,-1,103945,96055
3:2:4,1,1,103944,96056
5:2:1,1,1,103943,96057
1:5:3,0,-1,103944,96056
5:4:5,0,-1,103945,96055
6:2:6,1,1,103944,96056
2:5:4,1,1,103943,96057
6:6:5,0,-1,103944,96056
1:2:3,1,1,103943,96057
5:4:5,0,-1,103944,96056
1:5:2,1,1,103943,96057
6:5:4,0,-1,103944,96056
6:2:1,1,1,103943,96057
5:6:5,0,-1,103944,96056
5:4:1,0,-1,103945,96055
5:5:5,0,-1,103946,96054
4:4:2,1,1,103945,96055
1:3:4,0,-1,103946,96054
5:5:5,0,-1,103947,96053
5:3:1,0,-1,103948,96052
2:1:6,1,1,103947,96053
3:3:6,0,-1,103948,96052
1:5:1,0,-1,103949,96051
5:1:1,0,-1,103950,96050
5:6:6,0,-1,103951,96049
5:4:3,0,-1,103952,96048
4:3:2,1,1,103951,96049
2:6:4,1,1,103950,96050
3:3:2,1,1,103949,96051
6:2:1,1,1,103948,96052
5:4:3,0,-1,103949,96051
6:6:2,1,1,103948,96052
1:5:2,1,1,103947,96053
5:4:5,0,-1,103948,96052
5:6:3,0,-1,103949,96051
5:2:5,1,1,103948,96052
5:6:2,1,1,103947,96053
4:2:1,1,1,103946,96054
6:4:2,1,1,103945,96055
4:6:6,0,-1,103946,96054
5:1:2,1,1,103945,96055
6:5:5,0,-1,103946,96054
2:6:5,1,1,103945,96055
3:3:1,0,-1,103946,96054
1:3:6,0,-1,103947,96053
3:5:4,0,-1,103948,96052
6:2:5,1,1,103947,96053
2:1:3,1,1,103946,96054
5:1:6,0,-1,103947,96053
5:5:3,0,-1,103948,96052
1:6:3,0,-1,103949,96051
4:3:6,0,-1,103950,96050
3:4:3,0,-1,103951,96049
1:6:2,1,1,103950,96050
5:5:3,0,-1,103951,96049
1:2:4,1,1,103950,96050
6:5:3,0,-1,103951,96049
2:1:5,1,1,103950,96050
4:2:3,1,1,103949,96051
3:3:6,0,-1,103950,96050
2:5:1,1,1,103949,96051
3:5:4,0,-1,103950,96050
2:4:1,1,1,103949,96051
2:2:5,2,2,103947,96053
3:4:3,0,-1,103948,96052
5:3:6,0,-1,103949,96051
4:5:1,0,-1,103950,96050
6:2:1,1,1,103949,96051
4:2:4,1,1,103948,96052
4:2:1,1,1,103947,96053
3:6:5,0,-1,103948,96052
4:5:2,1,1,103947,96053
5:6:4,0,-1,103948,96052
1:4:2,1,1,103947,96053
1:1:1,0,-1,103948,96052
1:2:2,2,2,103946,96054
4:3:6,0,-1,103947,96053
1:4:6,0,-1,103948,96052
3:2:6,1,1,103947,96053
3:1:3,0,-1,103948,96052
2:3:6,1,1,103947,96053
4:5:5,0,-1,103948,96052
5:4:6,0,-1,103949,96051
1:2:2,2,2,103947,96053
6:2:6,1,1,103946,96054
1:1:1,0,-1,103947,96053
6:6:2,1,1,103946,96054
4:4:4,0,-1,103947,96053
5:2:5,1,1,103946,96054
3:3:4,0,-1,103947,96053
3:4:3,0,-1,103948,96052
1:3:4,0,-1,103949,96051
1:4:5,0,-1,103950,96050
1:3:1,0,-1,103951,96049
3:5:4,0,-1,103952,96048
2:2:4,2,2,103950,96050
1:2:6,1,1,103949,96051
4:3:6,0,-1,103950,96050
1:6:5,0,-1,103951,96049
2:4:6,1,1,103950,96050
4:3:2,1,1,103949,96051
6:5:3,0,-1,103950,96050
5:6:4,0,-1,103951,96049
3:5:4,0,-1,103952,96048
4:4:4,0,-1,103953,96047
3:4:5,0,-1,103954,96046
4:4:3,0,-1,103955,96045
2:1:1,1,1,103954,96046
2:5:4,1,1,103953,96047
1:6:6,0,-1,103954,96046
3:4:4,0,-1,103955,96045
5:6:1,0,-1,103956,96044
4:3:5,0,-1,103957,96043
6:4:2,1,1,103956,96044
1:6:2,1,1,103955,96045
4:6:2,1,1,103954,96046
3:6:4,0,-1,103955,96045
3:1:4,0,-1,103956,96044
1:4:6,0,-1,103957,96043
5:1:3,0,-1,103958,96042
1:5:1,0,-1,103959,96041
3:4:4,0,-1,103960,96040
4:3:1,0,-1,103961,96039
1:1:3,0,-1,103962,96038
3:4:2,1,1,103961,96039
3:3:4,0,-1,103962,96038
4:5:6,0,-1,103963,96037
5:6:1,0,-1,103964,96036
5:5:4,0,-1,103965,96035
2:2:3,2,2,103963,96037
2:6:3,1,1,103962,96038
3:5:2,1,1,103961,96039
6:1:4,0,-1,103962,96038
1:3:6,0,-1,103963,96037
1:5:3,0,-1,103964,96036
5:2:5,1,1,103963,96037
2:6:2,2,2,103961,96039
1:2:5,1,1,103960,96040
4:2:5,1,1,103959,96041
6:3:6,0,-1,103960,96040
6:2:3,1,1,103959,96041
5:5:1,0,-1,103960,96040
5:6:1,0,-1,103961,96039
4:3:2,1,1,103960,96040
5:3:1,0,-1,103961,96039
3:1:6,0,-1,103962,96038
2:1:6,1,1,103961,96039
5:6:4,0,-1,103962,96038
2:5:1,1,1,103961,96039
6:6:3,0,-1,103962,96038
4:2:4,1,1,103961,96039
2:2:1,2,2,103959,96041
6:3:6,0,-1,103960,96040
4:4:1,0,-1,103961,96039
5:4:3,0,-1,103962,96038
3:4:4,0,-1,103963,96037
1:6:2,1,1,103962,96038
2:2:2,3,3,103959,96041
3:2:2,2,2,103957,96043
3:6:1,0,-1,103958,96042
3:4:4,0,-1,103959,96041
1:3:6,0,-1,103960,96040
4:3:6,0,-1,103961,96039
5:1:4,0,-1,103962,96038
1:5:4,0,-1,103963,96037
3:4:2,1,1,103962,96038
4:2:4,1,1,103961,96039
3:1:4,0,-1,103962,96038
3:1:3,0,-1,103963,96037
3:5:3,0,-1,103964,96036
3:1:1,0,-1,103965,96035
1:6:3,0,-1,103966,96034
1:6:5,0,-1,103967,96033
2:3:5,1,1,103966,96034
3:5:5,0,-1,103967,96033
3:1:5,0,-1,103968,96032
6:4:2,1,1,103967,96033
3:4:4,0,-1,103968,96032
4:1:1,0,-1,103969,96031
5:4:5,0,-1,103970,96030
4:4:6,0,-1,103971,96029
2:1:5,1,1,103970,96030
2:4:4,1,1,103969,96031
3:5:4,0,-1,103970,96030
1:3:4,0,-1,103971,96029
3:3:2,1,1,103970,96030
5:6:4,0,-1,103971,96029
3:3:1,0,-1,103972,96028
4:3:2,1,1,103971,96029
2:2:6,2,2,103969,96031
3:1:1,0,-1,103970,96030
3:2:4,1,1,103969,96031
5:4:3,0,-1,103970,96030
4:6:3,0,-1,103971,96029
4:3:5,0,-1,103972,96028
1:5:6,0,-1,103973,96027
4:5:5,0,-1,103974,96026
4:1:5,0,-1,103975,96025
5:2:2,2,2,103973,96027
3:6:4,0,-1,103974,96026
4:5:4,0,-1,103975,96025
6:5:6,0,-1,103976,96024
6:4:1,0,-1,103977,96023
2:4:4,1,1,103976,96024
4:2:4,1,1,103975,96025
2:6:6,1,1,103974,96026
1:3:2,1,1,103973,96027
4:3:3,0,-1,103974,96026
4:3:2,1,1,103973,96027
3:3:1,0,-1,103974,96026
6:3:4,0,-1,103975,96025
2:2:3,2,2,103973,96027
3:4:6,0,-1,103974,96026
3:1:4,0,-1,103975,96025
3:3:4,0,-1,103976,96024
5:6:6,0,-1,103977,96023
4:4:5,0,-1,103978,96022
6:1:6,0,-1,103979,96021
5:5:1,0,-1,103980,96020
3:3:1,0,-1,103981,96019
2:6:2,2,2,103979,96021
6:3:5,0,-1,103980,96020
3:3:5,0,-1,103981,96019
3:5:6,0,-1,103982,96018
2:3:3,1,1,103981,96019
2:1:2,2,2,103979,96021
2:1:5,1,1,103978,96022
5:5:1,0,-1,103979,96021
1:5:1,0,-1,103980,96020
5:4:6,0,-1,103981,96019
3:2:5,1,1,103980,96020
6:3:1,0,-1,103981,96019
5:1:2,1,1,103980,96020
1:3:3,0,-1,103981,96019
2:5:4,1,1,103980,96020
6:1:1,0,-1,103981,96019
3:5:6,0,-1,103982,96018
4:4:2,1,1,103981,96019
4:1:4,0,-1,103982,96018
5:4:5,0,-1,103983,96017
1:2:3,1,1,103982,96018
5:5:2,1,1,103981,96019
4:3:3,0,-1,103982,96018
4:1:5,0,-1,103983,96017
5:3:3,0,-1,103984,96016
4:3:5,0,-1,103985,96015
4:3:4,0,-1,103986,96014
6:6:6,0,-1,103987,96013
4:5:6,0,-1,103988,96012
2:2:3,2,2,103986,96014
5:6:3,0,-1,103987,96013
4:5:2,1,1,103986,96014
3:2:6,1,1,103985,96015
1:2:2,2,2,103983,96017
6:1:5,0,-1,103984,96016
6:1:3,0,-1,103985,96015
4:4:5,0,-1,103986,96014
3:3:2,1,1,103985,96015
4:4:1,0,-1,103986,96014
3:1:5,0,-1,103987,96013
6:4:2,1,1,103986,96014
1:3:1,0,-1,103987,96013
3:6:4,0,-1,103988,96012
2:1:5,1,1,103987,96013
2:2:5,2,2,103985,96015
3:4:2,1,1,103984,96016
1:4:6,0,-1,103985,96015
3:4:2,1,1,103984,96016
6:5:6,0,-1,103985,96015
5:5:3,0,-1,103986,96014
3:2:5,1,1,103985,96015
2:4:4,1,1,103984,96016
4:6:3,0,-1,103985,96015
2:5:2,2,2,103983,96017
1:3:2,1,1,103982,96018
6:6:2,1,1,103981,96019
4:4:2,1,1,103980,96020
3:3:1,0,-1,103981,96019
4:5:3,0,-1,103982,96018
3:2:3,1,1,103981,96019
3:3:6,0,-1,103982,96018
1:1:4,0,-1,103983,96017
4:1:6,0,-1,103984,96016
6:2:4,1,1,103983,96017
6:4:6,0,-1,103984,96016
4:1:6,0,-1,103985,96015
4:2:4,1,1,103984,96016
2:3:2,2,2,103982,96018
5:6:2,1,1,103981,96019
1:4:5,0,-1,103982,96018
3:3:6,0,-1,103983,96017
1:3:1,0,-1,103984,96016
1:3:1,0,-1,103985,96015
5:5:6,0,-1,103986,96014
6:4:1,0,-1,103987,96013
4:2:2,2,2,103985,96015
1:1:4,0,-1,103986,96014
6:6:5,0,-1,103987,96013
5:1:2,1,1,103986,96014
5:5:6,0,-1,103987,96013
6:3:2,1,1,103986,96014
4:3:4,0,-1,103987,96013
3:6:2,1,1,103986,96014
4:2:2,2,2,103984,96016
2:4:5,1,1,103983,96017
2:2:6,2,2,103981,96019
5:6:3,0,-1,103982,96018
2:4:3,1,1,103981,96019
5:1:3,0,-1,103982,96018
6:6:2,1,1,103981,96019
1:2:3,1,1,103980,96020
3:4:4,0,-1,103981,96019
6:1:1,0,-1,103982,96018
1:5:4,0,-1,103983,96017
6:6:3,0,-1,103984,96016
4:6:3,0,-1,103985,96015
2:2:6,2,2,103983,96017
2:2:6,2,2,103981,96019
4:3:5,0,-1,103982,96018
6:4:4,0,-1,103983,96017
1:1:1,0,-1,103984,96016
6:3:1,0,-1,103985,96015
5:4:6,0,-1,103986,96014
5:3:1,0,-1,103987,96013
2:5:6,1,1,103986,96014
3:2:5,1,1,103985,96015
3:5:1,0,-1,103986,96014
6:1:3,0,-1,103987,96013
1:4:6,0,-1,103988,96012
5:5:3,0,-1,103989,96011
6:6:5,0,-1,103990,96010
3:4:2,1,1,103989,96011
4:4:2,1,1,103988,96012
4:6:4,0,-1,103989,96011
4:6:4,0,-1,103990,96010
6:6:3,0,-1,103991,96009
4:4:3,0,-1,103992,96008
2:6:1,1,1,103991,96009
5:1:2,1,1,103990,96010
6:6:5,0,-1,103991,96009
4:5:6,0,-1,103992,96008
2:2:4,2,2,103990,96010
6:1:5,0,-1,103991,96009
4:3:2,1,1,103990,96010
1:3:4,0,-1,103991,96009
5:5:1,0,-1,103992,96008
3:4:6,0,-1,103993,96007
3:4:3,0,-1,103994,96006
2:6:6,1,1,103993,96007
6:3:5,0,-1,103994,96006
6:2:6,1,1,103993,96007
4:3:2,1,1,103992,96008
6:2:5,1,1,103991,96009
6:6:6,0,-1,103992,96008
5:3:3,0,-1,103993,96007
1:5:4,0,-1,103994,96006
3:1:3,0,-1,103995,96005
3:5:5,0,-1,103996,96004
5:4:2,1,1,103995,96005
2:2:4,2,2,103993,96007
5:2:1,1,1,103992,96008
6:1:4,0,-1,103993,96007
3:2:6,1,1,103992,96008
1:5:6,0,-1,103993,96007
5:6:3,0,-1,103994,96006
1:2:1,1,1,103993,96007
3:3:5,0,-1,103994,96006
2:1:5,1,1,103993,96007
1:4:5,0,-1,103994,96006
2:1:5,1,1,103993,96007
5:2:5,1,1,103992,96008
3:1:3,0,-1,103993,96007
1:6:5,0,-1,103994,96006
2:3:4,1,1,103993,96007
6:3:1,0,-1,103994,96006
3:5:1,0,-1,103995,96005
5:6:5,0,-1,103996,96004
4:1:3,0,-1,103997,96003
6:5:2,1,1,103996,96004
3:2:5,1,1,103995,96005
1:4:4,0,-1,103996,96004
6:1:3,0,-1,103997,96003
1:3:3,0,-1,103998,96002
3:4:1,0,-1,103999,96001
2:5:5,1,1,103998,96002
6:2:5,1,1,103997,96003
3:2:1,1,1,103996,96004
4:4:6,0,-1,103997,96003
5:5:6,0,-1,103998,96002
1:3:3,0,-1,103999,96001
5:6:1,0,-1,104000,96000
3:4:1,0,-1,104001,95999
3:6:2,1,1,104000,96000
1:6:1,0,-1,104001,95999
6:2:3,1,1,104000,96000
2:5:1,1,1,103999,96001
6:3:1,0,-1,104000,96000
5:3:2,1,1,103999,96001
2:1:1,1,1,103998,96002
3:4:4,0,-1,103999,96001
1:5:5,0,-1,104000,96000
4:6:4,0,-1,104001,95999
3:5:4,0,-1,104002,95998
5:2:1,1,1,104001,95999
2:3:4,1,1,104000,96000
3:5:2,1,1,103999,96001
2:2:2,3,3,103996,96004
1:5:2,1,1,103995,96005
1:1:2,1,1,103994,96006
6:5:1,0,-1,103995,96005
3:6:1,0,-1,103996,96004
4:6:5,0,-1,103997,96003
4:2:4,1,1,103996,96004
5:5:2,1,1,103995,96005
6:5:5,0,-1,103996,96004
5:2:4,1,1,103995,96005
2:5:4,1,1,103994,96006
6:3:4,0,-1,103995,96005
4:3:4,0,-1,103996,96004
5:5:1,0,-1,103997,96003
2:3:1,1,1,103996,96004
5:3:3,0,-1,103997,96003
6:4:4,0,-1,103998,96002
4:2:3,1,1,103997,96003
1:1:4,0,-1,103998,96002
4:4:6,0,-1,103999,96001
4:1:6,0,-1,104000,96000
3:1:2,1,1,103999,96001
1:6:2,1,1,103998,96002
5:6:5,0,-1,103999,96001
4:2:4,1,1,103998,96002
5:4:6,0,-1,103999,96001
4:1:3,0,-1,104000,96000
3:2:3,1,1,103999,96001
1:6:1,0,-1,104000,96000
3:2:6,1,1,103999,96001
4:4:3,0,-1,104000,96000
6:5:6,0,-1,104001,95999
6:2:3,1,1,104000,96000
6:2:5,1,1,103999,96001
6:5:4,0,-1,104000,96000
2:4:1,1,1,103999,96001
3:1:6,0,-1,104000,96000
6:2:6,1,1,103999,96001
6:4:6,0,-1,104000,96000
6:6:3,0,-1,104001,95999
6:6:2,1,1,104000,96000
5:4:4,0,-1,104001,95999
3:5:2,1,1,104000,96000
5:6:4,0,-1,104001,95999
2:4:1,1,1,104000,96000
4:3:4,0,-1,104001,95999
2:4:4,1,1,104000,96000
2:3:4,1,1,103999,96001
3:1:4,0,-1,104000,96000
5:2:6,1,1,103999,96001
2:1:4,1,1,103998,96002
6:4:5,0,-1,103999,96001
6:3:1,0,-1,104000,96000
6:4:1,0,-1,104001,95999
4:4:2,1,1,104000,96000
5:4:6,0,-1,104001,95999
6:4:5,0,-1,104002,95998
3:3:6,0,-1,104003,95997
1:6:6,0,-1,104004,95996
4:3:1,0,-1,104005,95995
6:1:1,0,-1,104006,95994
4:4:6,0,-1,104007,95993
4:6:6,0,-1,104008,95992
1:4:4,0,-1,104009,95991
4:3:2,1,1,104008,95992
6:1:3,0,-1,104009,95991
6:2:5,1,1,104008,95992
5:1:6,0,-1,104009,95991
3:5:2,1,1,104008,95992
4:5:3,0,-1,104009,95991
1:3:2,1,1,104008,95992
3:3:4,0,-1,104009,95991
4:6:3,0,-1,104010,95990
5:1:4,0,-1,104011,95989
1:5:2,1,1,104010,95990
2:6:3,1,1,104009,95991
5:6:1,0,-1,104010,95990
3:2:2,2,2,104008,95992
5:5:2,1,1,104007,95993
4:6:1,0,-1,104008,95992
3:5:2,1,1,104007,95993
3:4:6,0,-1,104008,95992
6:3:6,0,-1,104009,95991
1:6:6,0,-1,104010,95990
4:2:6,1,1,104009,95991
4:5:1,0,-1,104010,95990
6:4:5,0,-1,104011,95989
6:6:1,0,-1,104012,95988
5:3:4,0,-1,104013,95987
1:3:5,0,-1,104014,95986
2:3:4,1,1,104013,95987
4:5:3,0,-1,104014,95986
5:2:5,1,1,104013,95987
6:1:4,0,-1,104014,95986
4:4:3,0,-1,104015,95985
3:1:1,0,-1,104016,95984
6:1:3,0,-1,104017,95983
2:5:2,2,2,104015,95985
2:2:4,2,2,104013,95987
2:2:3,2,2,104011,95989
3:5:2,1,1,104010,95990
4:3:1,0,-1,104011,95989
4:6:3,0,-1,104012,95988
6:4:6,0,-1,104013,95987
2:2:2,3,3,104010,95990
2:1:3,1,1,104009,95991
5:4:2,1,1,104008,95992
6:1:1,0,-1,104009,95991
4:1:6,0,-1,104010,95990
1:5:2,1,1,104009,95991
3:3:3,0,-1,104010,95990
6:6:5,0,-1,104011,95989
3:3:6,0,-1,104012,95988
6:1:5,0,-1,104013,95987
5:4:1,0,-1,104014,95986
2:3:6,1,1,104013,95987
6:2:5,1,1,104012,95988
1:3:4,0,-1,104013,95987
5:4:2,1,1,104012,95988
6:2:3,1,1,104011,95989
2:1:5,1,1,104010,95990
1:1:2,1,1,104009,95991
1:3:3,0,-1,104010,95990
1:1:3,0,-1,104011,95989
5:6:6,0,-1,104012,95988
5:3:5,0,-1,104013,95987
3:5:4,0,-1,104014,95986
2:6:5,1,1,104013,95987
6:6:1,0,-1,104014,95986
6:5:3,0,-1,104015,95985
6:5:6,0,-1,104016,95984
6:6:1,0,-1,104017,95983
4:3:4,0,-1,104018,95982
3:1:4,0,-1,104019,95981
4:6:2,1,1,104018,95982
6:5:4,0,-1,104019,95981
6:5:3,0,-1,104020,95980
6:6:1,0,-1,104021,95979
4:3:5,0,-1,104022,95978
3:6:6,0,-1,104023,95977
6:3:1,0,-1,104024,95976
2:1:4,1,1,104023,95977
4:6:2,1,1,104022,95978
6:4:4,0,-1,104023,95977
4:2:2,2,2,104021,95979
2:2:5,2,2,104019,95981
1:3:4,0,-1,104020,95980
1:4:1,0,-1,104021,95979
4:1:4,0,-1,104022,95978
3:5:5,0,-1,104023,95977
6:4:2,1,1,104022,95978
2:3:2,2,2,104020,95980
5:4:4,0,-1,104021,95979
1:6:3,0,-1,104022,95978
3:1:1,0,-1,104023,95977
1:6:5,0,-1,104024,95976
1:4:1,0,-1,104025,95975
1:3:5,0,-1,104026,95974
1:1:3,0,-1,104027,95973
1:1:5,0,-1,104028,95972
1:3:4,0,-1,104029,95971
2:1:2,2,2,104027,95973
3:3:3,0,-1,104028,95972
1:5:6,0,-1,104029,95971
5:6:5,0,-1,104030,95970
4:1:6,0,-1,104031,95969
3:1:4,0,-1,104032,95968
2:1:1,1,1,104031,95969
2:2:6,2,2,104029,95971
5:4:2,1,1,104028,95972
3:2:5,1,1,104027,95973
4:3:1,0,-1,104028,95972
4:2:5,1,1,104027,95973
6:1:1,0,-1,104028,95972
5:6:2,1,1,104027,95973
3:5:2,1,1,104026,95974
5:2:3,1,1,104025,95975
5:1:6,0,-1,104026,95974
6:6:4,0,-1,104027,95973
5:1:1,0,-1,104028,95972
4:5:5,0,-1,104029,95971
6:4:5,0,-1,104030,95970
3:2:4,1,1,104029,95971
5:1:1,0,-1,104030,95970
2:1:4,1,1,104029,95971
1:5:1,0,-1,104030,95970
3:3:5,0,-1,104031,95969
3:3:6,0,-1,104032,95968
5:1:5,0,-1,104033,95967
5:1:6,0,-1,104034,95966
6:5:3,0,-1,104035,95965
2:5:5,1,1,104034,95966
4:3:4,0,-1,104035,95965
5:4:2,1,1,104034,95966
2:4:4,1,1,104033,95967
5:4:2,1,1,104032,95968
6:6:1,0,-1,104033,95967
4:3:3,0,-1,104034,95966
4:6:5,0,-1,104035,95965
6:6:2,1,1,104034,95966
2:4:5,1,1,104033,95967
5:2:2,2,2,104031,95969
3:1:6,0,-1,104032,95968
5:5:6,0,-1,104033,95967
1:6:2,1,1,104032,95968
5:2:4,1,1,104031,95969
6:2:5,1,1,104030,95970
4:3:3,0,-1,104031,95969
3:3:1,0,-1,104032,95968
6:4:3,0,-1,104033,95967
2:5:2,2,2,104031,95969
5:2:5,1,1,104030,95970
1:1:2,1,1,104029,95971
3:3:4,0,-1,104030,95970
2:5:1,1,1,104029,95971
5:6:5,0,-1,104030,95970
2:6:1,1,1,104029,95971
3:5:3,0,-1,104030,95970
6:4:3,0,-1,104031,95969
1:2:4,1,1,104030,95970
6:2:3,1,1,104029,95971
6:1:3,0,-1,104030,95970
5:2:2,2,2,104028,95972
6:2:1,1,1,104027,95973
6:3:3,0,-1,104028,95972
1:3:2,1,1,104027,95973
6:5:2,1,1,104026,95974
2:2:6,2,2,104024,95976
3:4:5,0,-1,104025,95975
4:3:1,0,-1,104026,95974
2:4:2,2,2,104024,95976
3:1:2,1,1,104023,95977
6:2:6,1,1,104022,95978
5:5:2,1,1,104021,95979
4:6:6,0,-1,104022,95978
5:5:4,0,-1,104023,95977
3:5:3,0,-1,104024,95976
4:1:3,0,-1,104025,95975
5:6:4,0,-1,104026,95974
6:6:6,0,-1,104027,95973
6:1:4,0,-1,104028,95972
1:4:6,0,-1,104029,95971
4:4:6,0,-1,104030,95970
5:4:4,0,-1,104031,95969
3:3:1,0,-1,104032,95968
5:5:4,0,-1,104033,95967
4:6:6,0,-1,104034,95966
5:6:5,0,-1,104035,95965
3:5:1,0,-1,104036,95964
1:4:3,0,-1,104037,95963
6:4:2,1,1,104036,95964
2:2:2,3,3,104033,95967
3:2:5,1,1,104032,95968
3:3:6,0,-1,104033,95967
6:5:4,0,-1,104034,95966
2:5:5,1,1,104033,95967
4:1:4,0,-1,104034,95966
6:6:4,0,-1,104035,95965
5:2:3,1,1,104034,95966
1:6:5,0,-1,104035,95965
1:1:6,0,-1,104036,95964
2:1:4,1,1,104035,95965
1:1:5,0,-1,104036,95964
5:6:3,0,-1,104037,95963
5:4:6,0,-1,104038,95962
3:6:3,0,-1,104039,95961
6:3:4,0,-1,104040,95960
1:1:5,0,-1,104041,95959
6:2:4,1,1,104040,95960
2:4:4,1,1,104039,95961
4:2:2,2,2,104037,95963
1:2:6,1,1,104036,95964
6:1:2,1,1,104035,95965
3:6:5,0,-1,104036,95964
6:5:2,1,1,104035,95965
6:2:6,1,1,104034,95966
2:3:6,1,1,104033,95967
1:4:6,0,-1,104034,95966
4:5:2,1,1,104033,95967
3:4:3,0,-1,104034,95966
6:4:5,0,-1,104035,95965
1:1:1,0,-1,104036,95964
6:4:1,0,-1,104037,95963
4:2:5,1,1,104036,95964
1:3:6,0,-1,104037,95963
3:1:1,0,-1,104038,95962
3:3:1,0,-1,104039,95961
1:1:4,0,-1,104040,95960
2:2:3,2,2,104038,95962
6:5:5,0,-1,104039,95961
4:3:6,0,-1,104040,95960
1:3:1,0,-1,104041,95959
3:3:6,0,-1,104042,95958
1:6:3,0,-1,104043,95957
6:4:2,1,1,104042,95958
5:4:5,0,-1,104043,95957
5:3:5,0,-1,104044,95956
5:4:2,1,1,104043,95957
1:1:4,0,-1,104044,95956
1:1:6,0,-1,104045,95955
1:2:1,1,1,104044,95956
3:1:6,0,-1,104045,95955
4:1:1,0,-1,104046,95954
4:4:6,0,-1,104047,95953
2:5:3,1,1,104046,95954
1:6:5,0,-1,104047,95953
1:2:1,1,1,104046,95954
3:4:3,0,-1,104047,95953
4:6:3,0,-1,104048,95952
6:4:4,0,-1,104049,95951
2:4:5,1,1,104048,95952
3:5:5,0,-1,104049,95951
6:5:3,0,-1,104050,95950
3:3:3,0,-1,104051,95949
5:5:1,0,-1,104052,95948
3:3:2,1,1,104051,95949
1:5:2,1,1,104050,95950
5:2:3,1,1,104049,95951
2:4:6,1,1,104048,95952
1:6:4,0,-1,104049,95951
6:4:4,0,-1,104050,95950
3:3:6,0,-1,104051,95949
2:6:3,1,1,104050,95950
6:3:3,0,-1,104051,95949
4:5:1,0,-1,104052,95948
2:4:6,1,1,104051,95949
6:1:4,0,-1,104052,95948
4:2:2,2,2,104050,95950
2:1:3,1,1,104049,95951
1:1:6,0,-1,104050,95950
6:6:4,0,-1,104051,95949
6:1:1,0,-1,104052,95948
2:6:6,1,1,104051,95949
2:4:4,1,1,104050,95950
3:4:1,0,-1,104051,95949
5:2:5,1,1,104050,95950
2:3:5,1,1,104049,95951
2:3:1,1,1,104048,95952
4:3:4,0,-1,104049,95951
3:4:6,0,-1,104050,95950
6:1:2,1,1,104049,95951
1:4:5,0,-1,104050,95950
1:6:3,0,-1,104051,95949
2:3:1,1,1,104050,95950
5:5:3,0,-1,104051,95949
2:5:5,1,1,104050,95950
2:3:6,1,1,104049,95951
2:1:2,2,2,104047,95953
3:6:5,0,-1,104048,95952
2:2:2,3,3,104045,95955
1:4:3,0,-1,104046,95954
4:2:3,1,1,104045,95955
5:4:1,0,-1,104046,95954
4:2:5,1,1,104045,95955
6:2:3,1,1,104044,95956
2:5:5,1,1,104043,95957
2:4:3,1,1,104042,95958
3:1:4,0,-1,104043,95957
3:5:2,1,1,104042,95958
4:6:4,0,-1,104043,95957
3:1:4,0,-1,104044,95956
4:2:2,2,2,104042,95958
4:3:2,1,1,104041,95959
1:6:6,0,-1,104042,95958
1:4:6,0,-1,104043,95957
6:5:3,0,-1,104044,95956
5:5:2,1,1,104043,95957
3:1:3,0,-1,104044,95956
5:6:5,0,-1,104045,95955
5:5:4,0,-1,104046,95954
2:5:1,1,1,104045,95955
1:6:5,0,-1,104046,95954
6:5:6,0,-1,104047,95953
5:3:6,0,-1,104048,95952
2:2:6,2,2,104046,95954
2:5:6,1,1,104045,95955
1:1:6,0,-1,104046,95954
2:1:6,1,1,104045,95955
1:6:5,0,-1,104046,95954
6:3:3,0,-1,104047,95953
4:6:2,1,1,104046,95954
4:3:1,0,-1,104047,95953
5:3:6,0,-1,104048,95952
6:3:1,0,-1,104049,95951
5:2:6,1,1,104048,95952
5:4:4,0,-1,104049,95951
4:6:6,0,-1,104050,95950
4:1:4,0,-1,104051,95949
4:1:6,0,-1,104052,95948
3:4:3,0,-1,104053,95947
4:5:4,0,-1,104054,95946
6:3:4,0,-1,104055,95945
2:5:4,1,1,104054,95946
5:3:5,0,-1,104055,95945
4:5:6,0,-1,104056,95944
1:1:3,0,-1,104057,95943
3:4:1,0,-1,104058,95942
3:1:2,1,1,104057,95943
3:5:5,0,-1,104058,95942
2:6:4,1,1,104057,95943
5:5:4,0,-1,104058,95942
5:1:5,0,-1,104059,95941
2:4:4,1,1,104058,95942
4:4:2,1,1,104057,95943
2:3:3,1,1,104056,95944
2:2:3,2,2,104054,95946
5:1:6,0,-1,104055,95945
6:3:4,0,-1,104056,95944
4:1:1,0,-1,104057,95943
5:4:4,0,-1,104058,95942
1:1:6,0,-1,104059,95941
6:3:4,0,-1,104060,95940
5:3:5,0,-1,104061,95939
3:1:3,0,-1,104062,95938
5:3:6,0,-1,104063,95937
6:2:1,1,1,104062,95938
3:5:4,0,-1,104063,95937
1:4:2,1,1,104062,95938
3:1:2,1,1,104061,95939
1:2:5,1,1,104060,95940
1:5:4,0,-1,104061,95939
1:5:2,1,1,104060,95940
2:6:5,1,1,104059,95941
4:6:3,0,-1,104060,95940
4:3:2,1,1,104059,95941
4:3:4,0,-1,104060,95940
4:6:5,0,-1,104061,95939
3:5:4,0,-1,104062,95938
5:4:2,1,1,104061,95939
2:2:6,2,2,104059,95941
2:2:1,2,2,104057,95943
6:6:2,1,1,104056,95944
6:1:2,1,1,104055,95945
5:6:5,0,-1,104056,95944
5:2:2,2,2,104054,95946
3:5:6,0,-1,104055,95945
4:3:2,1,1,104054,95946
3:4:6,0,-1,104055,95945
6:4:6,0,-1,104056,95944
3:3:5,0,-1,104057,95943
4:3:1,0,-1,104058,95942
4:4:5,0,-1,104059,95941
1:5:5,0,-1,104060,95940
6:5:2,1,1,104059,95941
1:3:2,1,1,104058,95942
6:1:2,1,1,104057,95943
3:1:3,0,-1,104058,95942
5:4:2,1,1,104057,95943
6:4:1,0,-1,104058,95942
5:5:5,0,-1,104059,95941
2:2:3,2,2,104057,95943
3:5:4,0,-1,104058,95942
2:3:2,2,2,104056,95944
2:4:1,1,1,104055,95945
4:3:4,0,-1,104056,95944
1:2:3,1,1,104055,95945
6:6:1,0,-1,104056,95944
6:4:2,1,1,104055,95945
6:6:1,0,-1,104056,95944
3:2:6,1,1,104055,95945
2:2:5,2,2,104053,95947
1:1:3,0,-1,104054,95946
5:1:5,0,-1,104055,95945
3:2:3,1,1,104054,95946
5:1:6,0,-1,104055,95945
5:3:2,1,1,104054,95946
6:5:4,0,-1,104055,95945
3:4:5,0,-1,104056,95944
2:3:4,1,1,104055,95945
5:5:4,0,-1,104056,95944
1:5:1,0,-1,104057,95943
2:4:4,1,1,104056,95944
4:5:3,0,-1,104057,95943
6:1:3,0,-1,104058,95942
5:3:1,0,-1,104059,95941
1:4:4,0,-1,104060,95940
1:1:3,0,-1,104061,95939
1:1:4,0,-1,104062,95938
2:5:1,1,1,104061,95939
4:1:2,1,1,104060,95940
6:6:3,0,-1,104061,95939
4:4:2,1,1,104060,95940
4:4:5,0,-1,104061,95939
1:4:2,1,1,104060,95940
3:5:3,0,-1,104061,95939
6:2:4,1,1,104060,95940
1:1:1,0,-1,104061,95939
3:1:4,0,-1,104062,95938
4:5:4,0,-1,104063,95937
3:4:1,0,-1,104064,95936
2:2:1,2,2,104062,95938
2:1:2,2,2,104060,95940
3:5:4,0,-1,104061,95939
3:5:5,0,-1,104062,95938
5:5:1,0,-1,104063,95937
4:6:1,0,-1,104064,95936
2:4:3,1,1,104063,95937
6:4:3,0,-1,104064,95936
4:1:3,0,-1,104065,95935
1:3:4,0,-1,104066,95934
2:5:5,1,1,104065,95935
6:6:3,0,-1,104066,95934
2:3:4,1,1,104065,95935
6:5:3,0,-1,104066,95934
1:5:1,0,-1,104067,95933
5:2:2,2,2,104065,95935
4:1:5,0,-1,104066,95934
3:4:5,0,-1,104067,95933
5:5:6,0,-1,104068,95932
4:6:6,0,-1,104069,95931
2:5:6,1,1,104068,95932
2:1:1,1,1,104067,95933
4:5:6,0,-1,104068,95932
6:6:6,0,-1,104069,95931
5:1:5,0,-1,104070,95930
2:3:2,2,2,104068,95932
5:4:6,0,-1,104069,95931
1:1:5,0,-1,104070,95930
4:1:2,1,1,104069,95931
2:2:1,2,2,104067,95933
5:5:4,0,-1,104068,95932
5:2:2,2,2,104066,95934
1:5:4,0,-1,104067,95933
5:5:4,0,-1,104068,95932
6:5:3,0,-1,104069,95931
6:5:4,0,-1,104070,95930
4:2:6,1,1,104069,95931
6:5:1,0,-1,104070,95930
6:3:6,0,-1,104071,95929
2:2:4,2,2,104069,95931
3:3:1,0,-1,104070,95930
1:4:6,0,-1,104071,95929
3:5:1,0,-1,104072,95928
3:3:2,1,1,104071,95929
1:6:2,1,1,104070,95930
6:1:1,0,-1,104071,95929
6:5:5,0,-1,104072,95928
5:3:3,0,-1,104073,95927
2:2:5,2,2,104071,95929
1:2:5,1,1,104070,95930
6:2:5,1,1,104069,95931
2:3:6,1,1,104068,95932
6:5:1,0,-1,104069,95931
2:5:4,1,1,104068,95932
3:1:1,0,-1,104069,95931
1:6:6,0,-1,104070,95930
5:5:5,0,-1,104071,95929
6:3:1,0,-1,104072,95928
5:1:5,0,-1,104073,95927
3:1:2,1,1,104072,95928
5:6:4,0,-1,104073,95927
3:4:6,0,-1,104074,95926
3:6:3,0,-1,104075,95925
3:4:6,0,-1,104076,95924
1:3:3,0,-1,104077,95923
5:5:4,0,-1,104078,95922
3:4:6,0,-1,104079,95921
5:2:4,1,1,104078,95922
2:2:4,2,2,104076,95924
6:3:5,0,-1,104077,95923
5:2:3,1,1,104076,95924
6:2:4,1,1,104075,95925
4:2:5,1,1,104074,95926
3:4:1,0,-1,104075,95925
6:2:3,1,1,104074,95926
1:2:1,1,1,104073,95927
1:5:2,1,1,104072,95928
3:6:6,0,-1,104073,95927
2:3:4,1,1,104072,95928
2:1:6,1,1,104071,95929
6:6:4,0,-1,104072,95928
5:6:2,1,1,104071,95929
2:5:6,1,1,104070,95930
6:4:2,1,1,104069,95931
3:1:5,0,-1,104070,95930
5:3:1,0,-1,104071,95929
5:6:2,1,1,104070,95930
5:3:1,0,-1,104071,95929
5:2:2,2,2,104069,95931
2:2:3,2,2,104067,95933
6:5:3,0,-1,104068,95932
6:1:3,0,-1,104069,95931
1:3:4,0,-1,104070,95930
6:4:6,0,-1,104071,95929
6:4:4,0,-1,104072,95928
6:6:3,0,-1,104073,95927
3:5:1,0,-1,104074,95926
1:2:6,1,1,104073,95927
3:3:4,0,-1,104074,95926
6:5:2,1,1,104073,95927
5:1:6,0,-1,104074,95926
5:5:2,1,1,104073,95927
6:1:2,1,1,104072,95928
6:6:6,0,-1,104073,95927
5:1:2,1,1,104072,95928
2:3:6,1,1,104071,95929
5:4:6,0,-1,104072,95928
4:3:5,0,-1,104073,95927
2:2:3,2,2,104071,95929
5:4:6,0,-1,104072,95928
3:5:2,1,1,104071,95929
6:2:1,1,1,104070,95930
4:1:2,1,1,104069,95931
4:4:3,0,-1,104070,95930
2:6:6,1,1,104069,95931
6:2:5,1,1,104068,95932
4:2:4,1,1,104067,95933
2:4:6,1,1,104066,95934
4:6:5,0,-1,104067,95933
6:2:5,1,1,104066,95934
4:1:6,0,-1,104067,95933
5:5:6,0,-1,104068,95932
1:5:5,0,-1,104069,95931
1:3:1,0,-1,104070,95930
1:6:5,0,-1,104071,95929
2:3:4,1,1,104070,95930
3:5:4,0,-1,104071,95929
5:3:2,1,1,104070,95930
6:3:4,0,-1,104071,95929
5:6:2,1,1,104070,95930
5:3:6,0,-1,104071,95929
4:4:3,0,-1,104072,95928
4:3:5,0,-1,104073,95927
5:4:6,0,-1,104074,95926
1:5:5,0,-1,104075,95925
6:2:6,1,1,104074,95926
3:3:1,0,-1,104075,95925
5:1:4,0,-1,104076,95924
6:5:6,0,-1,104077,95923
2:6:4,1,1,104076,95924
1:6:2,1,1,104075,95925
2:6:1,1,1,104074,95926
3:2:1,1,1,104073,95927
4:1:2,1,1,104072,95928
3:6:5,0,-1,104073,95927
2:6:6,1,1,104072,95928
1:1:3,0,-1,104073,95927
1:4:4,0,-1,104074,95926
3:4:4,0,-1,104075,95925
1:4:4,0,-1,104076,95924
2:5:5,1,1,104075,95925
4:4:6,0,-1,104076,95924
5:2:3,1,1,104075,95925
2:6:6,1,1,104074,95926
4:2:5,1,1,104073,95927
1:5:5,0,-1,104074,95926
6:5:4,0,-1,104075,95925
4:2:6,1,1,104074,95926
4:2:6,1,1,104073,95927
5:3:3,0,-1,104074,95926
6:1:6,0,-1,104075,95925
1:4:2,1,1,104074,95926
6:2:4,1,1,104073,95927
6:3:1,0,-1,104074,95926
2:1:3,1,1,104073,95927
4:4:5,0,-1,104074,95926
5:4:5,0,-1,104075,95925
1:5:3,0,-1,104076,95924
5:6:4,0,-1,104077,95923
1:6:6,0,-1,104078,95922
2:6:5,1,1,104077,95923
2:5:3,1,1,104076,95924
2:5:4,1,1,104075,95925
2:6:3,1,1,104074,95926
5:4:2,1,1,104073,95927
2:3:4,1,1,104072,95928
6:6:2,1,1,104071,95929
3:5:1,0,-1,104072,95928
1:6:1,0,-1,104073,95927
5:3:5,0,-1,104074,95926
1:6:5,0,-1,104075,95925
1:1:1,0,-1,104076,95924
2:4:5,1,1,104075,95925
4:5:4,0,-1,104076,95924
3:4:3,0,-1,104077,95923
1:1:4,0,-1,104078,95922
6:2:2,2,2,104076,95924
4:2:6,1,1,104075,95925
1:1:6,0,-1,104076,95924
6:5:3,0,-1,104077,95923
5:2:1,1,1,104076,95924
6:3:6,0,-1,104077,95923
3:4:3,0,-1,104078,95922
5:6:1,0,-1,104079,95921
4:1:1,0,-1,104080,95920
4:2:3,1,1,104079,95921
3:4:2,1,1,104078,95922
2:5:5,1,1,104077,95923
4:4:6,0,-1,104078,95922
5:2:3,1,1,104077,95923
6:4:4,0,-1,104078,95922
5:3:2,1,1,104077,95923
6:4:3,0,-1,104078,95922
3:6:6,0,-1,104079,95921
4:6:3,0,-1,104080,95920
4:4:2,1,1,104079,95921
4:5:1,0,-1,104080,95920
4:3:4,0,-1,104081,95919
2:2:1,2,2,104079,95921
1:4:2,1,1,104078,95922
5:5:4,0,-1,104079,95921
5:2:5,1,1,104078,95922
6:5:6,0,-1,104079,95921
4:2:1,1,1,104078,95922
5:4:4,0,-1,104079,95921
3:4:5,0,-1,104080,95920
1:4:1,0,-1,104081,95919
2:6:3,1,1,104080,95920
6:3:1,0,-1,104081,95919
1:1:3,0,-1,104082,95918
4:2:2,2,2,104080,95920
1:5:3,0,-1,104081,95919
2:3:6,1,1,104080,95920
6:6:4,0,-1,104081,95919
5:1:1,0,-1,104082,95918
2:1:1,1,1,104081,95919
2:2:6,2,2,104079,95921
1:3:3,0,-1,104080,95920
1:6:3,0,-1,104081,95919
4:5:3,0,-1,104082,95918
2:6:6,1,1,104081,95919
2:1:1,1,1,104080,95920
5:1:6,0,-1,104081,95919
1:6:2,1,1,104080,95920
2:5:3,1,1,104079,95921
4:2:5,1,1,104078,95922
3:2:4,1,1,104077,95923
4:2:4,1,1,104076,95924
4:4:6,0,-1,104077,95923
4:3:2,1,1,104076,95924
3:4:5,0,-1,104077,95923
2:3:4,1,1,104076,95924
2:3:3,1,1,104075,95925
3:4:4,0,-1,104076,95924
6:6:3,0,-1,104077,95923
5:4:3,0,-1,104078,95922
4:2:1,1,1,104077,95923
6:6:5,0,-1,104078,95922
1:2:2,2,2,104076,95924
5:4:2,1,1,104075,95925
2:3:6,1,1,104074,95926
4:6:1,0,-1,104075,95925
2:6:3,1,1,104074,95926
2:6:4,1,1,104073,95927
4:5:1,0,-1,104074,95926
3:5:3,0,-1,104075,95925
5:1:6,0,-1,104076,95924
1:4:2,1,1,104075,95925
2:3:3,1,1,104074,95926
5:4:5,0,-1,104075,95925
3:4:1,0,-1,104076,95924
1:4:1,0,-1,104077,95923
4:3:4,0,-1,104078,95922
3:5:2,1,1,104077,95923
2:2:1,2,2,104075,95925
2:5:3,1,1,104074,95926
1:6:2,1,1,104073,95927
6:3:3,0,-1,104074,95926
5:3:1,0,-1,104075,95925
1:6:5,0,-1,104076,95924
5:4:5,0,-1,104077,95923
5:4:1,0,-1,104078,95922
6:2:4,1,1,104077,95923
2:6:5,1,1,104076,95924
2:5:6,1,1,104075,95925
1:4:5,0,-1,104076,95924
3:4:6,0,-1,104077,95923
5:2:5,1,1,104076,95924
4:3:2,1,1,104075,95925
5:1:4,0,-1,104076,95924
1:4:6,0,-1,104077,95923
2:4:3,1,1,104076,95924
4:2:5,1,1,104075,95925
5:5:1,0,-1,104076,95924
1:5:3,0,-1,104077,95923
4:3:3,0,-1,104078,95922
1:6:1,0,-1,104079,95921
6:1:6,0,-1,104080,95920
1:1:2,1,1,104079,95921
1:5:5,0,-1,104080,95920
2:1:6,1,1,104079,95921
6:1:3,0,-1,104080,95920
5:4:1,0,-1,104081,95919
2:6:6,1,1,104080,95920
2:6:1,1,1,104079,95921
4:6:6,0,-1,104080,95920
6:5:3,0,-1,104081,95919
3:2:4,1,1,104080,95920
2:2:2,3,3,104077,95923
5:4:1,0,-1,104078,95922
2:1:4,1,1,104077,95923
2:4:3,1,1,104076,95924
2:3:3,1,1,104075,95925
5:6:4,0,-1,104076,95924
1:1:2,1,1,104075,95925
5:1:5,0,-1,104076,95924
4:1:3,0,-1,104077,95923
3:5:1,0,-1,104078,95922
2:2:6,2,2,104076,95924
4:1:3,0,-1,104077,95923
1:3:6,0,-1,104078,95922
1:3:1,0,-1,104079,95921
2:2:5,2,2,104077,95923
1:3:5,0,-1,104078,95922
5:1:5,0,-1,104079,95921
5:1:1,0,-1,104080,95920
4:3:4,0,-1,104081,95919
2:1:4,1,1,104080,95920
5:4:3,0,-1,104081,95919
3:6:4,0,-1,104082,95918
2:4:6,1,1,104081,95919
1:3:2,1,1,104080,95920
4:6:6,0,-1,104081,95919
6:1:1,0,-1,104082,95918
3:4:6,0,-1,104083,95917
5:2:6,1,1,104082,95918
5:2:3,1,1,104081,95919
6:5:4,0,-1,104082,95918
5:1:5,0,-1,104083,95917
5:2:5,1,1,104082,95918
6:2:2,2,2,104080,95920
3:5:4,0,-1,104081,95919
1:1:4,0,-1,104082,95918
4:6:4,0,-1,104083,95917
4:6:6,0,-1,104084,95916
3:4:2,1,1,104083,95917
6:1:4,0,-1,104084,95916
3:4:2,1,1,104083,95917
6:5:5,0,-1,104084,95916
4:2:4,1,1,104083,95917
2:6:6,1,1,104082,95918
1:3:2,1,1,104081,95919
1:3:6,0,-1,104082,95918
4:2:2,2,2,104080,95920
4:3:2,1,1,104079,95921
3:2:4,1,1,104078,95922
5:6:1,0,-1,104079,95921
6:2:4,1,1,104078,95922
3:5:5,0,-1,104079,95921
5:5:3,0,-1,104080,95920
3:6:4,0,-1,104081,95919
1:1:1,0,-1,104082,95918
5:1:2,1,1,104081,95919
1:1:4,0,-1,104082,95918
5:5:3,0,-1,104083,95917
6:1:1,0,-1,104084,95916
3:5:2,1,1,104083,95917
3:6:1,0,-1,104084,95916
6:4:6,0,-1,104085,95915
6:2:1,1,1,104084,95916
3:3:2,1,1,104083,95917
1:1:6,0,-1,104084,95916
4:1:3,0,-1,104085,95915
2:1:2,2,2,104083,95917
4:5:1,0,-1,104084,95916
6:2:6,1,1,104083,95917
6:2:6,1,1,104082,95918
2:1:3,1,1,104081,95919
1:2:1,1,1,104080,95920
3:4:2,1,1,104079,95921
6:6:2,1,1,104078,95922
3:6:4,0,-1,104079,95921
2:6:3,1,1,104078,95922
6:1:3,0,-1,104079,95921
3:3:1,0,-1,104080,95920
4:4:4,0,-1,104081,95919
1:5:5,0,-1,104082,95918
2:5:4,1,1,104081,95919
1:5:6,0,-1,104082,95918
5:6:5,0,-1,104083,95917
4:5:5,0,-1,104084,95916
3:3:2,1,1,104083,95917
1:4:5,0,-1,104084,95916
6:2:3,1,1,104083,95917
4:2:4,1,1,104082,95918
1:3:5,0,-1,104083,95917
3:1:3,0,-1,104084,95916
3:5:2,1,1,104083,95917
3:6:3,0,-1,104084,95916
1:2:6,1,1,104083,95917
3:2:6,1,1,104082,95918
4:2:6,1,1,104081,95919
2:6:6,1,1,104080,95920
3:4:3,0,-1,104081,95919
4:6:5,0,-1,104082,95918
5:3:2,1,1,104081,95919
6:3:1,0,-1,104082,95918
4:6:3,0,-1,104083,95917
3:5:4,0,-1,104084,95916
5:3:3,0,-1,104085,95915
5:1:2,1,1,104084,95916
6:2:4,1,1,104083,95917
2:2:1,2,2,104081,95919
2:1:1,1,1,104080,95920
6:2:2,2,2,104078,95922
3:4:3,0,-1,104079,95921
6:1:3,0,-1,104080,95920
3:4:1,0,-1,104081,95919
5:2:3,1,1,104080,95920
6:1:4,0,-1,104081,95919
2:1:6,1,1,104080,95920
6:1:1,0,-1,104081,95919
3:1:3,0,-1,104082,95918
2:3:1,1,1,104081,95919
1:2:3,1,1,104080,95920
4:5:2,1,1,104079,95921
6:6:5,0,-1,104080,95920
6:6:5,0,-1,104081,95919
3:4:4,0,-1,104082,95918
6:3:3,0,-1,104083,95917
6:1:6,0,-1,104084,95916
3:1:4,0,-1,104085,95915
2:1:5,1,1,104084,95916
2:1:3,1,1,104083,95917
2:3:5,1,1,104082,95918
4:3:1,0,-1,104083,95917
6:3:2,1,1,104082,95918
5:4:1,0,-1,104083,95917
6:6:5,0,-1,104084,95916
6:1:2,1,1,104083,95917
4:3:5,0,-1,104084,95916
2:1:2,2,2,104082,95918
4:5:5,0,-1,104083,95917
6:4:6,0,-1,104084,95916
3:6:3,0,-1,104085,95915
3:6:5,0,-1,104086,95914
6:4:5,0,-1,104087,95913
5:1:1,0,-1,104088,95912
4:6:1,0,-1,104089,95911
4:3:1,0,-1,104090,95910
4:4:1,0,-1,104091,95909
6:1:1,0,-1,104092,95908
4:5:3,0,-1,104093,95907
4:1:3,0,-1,104094,95906
2:1:6,1,1,104093,95907
6:6:2,1,1,104092,95908
1:6:6,0,-1,104093,95907
6:1:2,1,1,104092,95908
1:2:4,1,1,104091,95909
5:1:4,0,-1,104092,95908
4:2:6,1,1,104091,95909
5:6:6,0,-1,104092,95908
2:6:2,2,2,104090,95910
1:4:5,0,-1,104091,95909
4:2:2,2,2,104089,95911
2:5:4,1,1,104088,95912
5:3:5,0,-1,104089,95911
3:6:6,0,-1,104090,95910
3:5:2,1,1,104089,95911
1:6:4,0,-1,104090,95910
2:3:6,1,1,104089,95911
1:3:4,0,-1,104090,95910
5:5:3,0,-1,104091,95909
3:3:2,1,1,104090,95910
4:3:6,0,-1,104091,95909
5:6:6,0,-1,104092,95908
6:2:5,1,1,104091,95909
4:6:4,0,-1,104092,95908
3:1:2,1,1,104091,95909
1:2:2,2,2,104089,95911
4:1:3,0,-1,104090,95910
6:1:5,0,-1,104091,95909
5:1:5,0,-1,104092,95908
4:3:5,0,-1,104093,95907
1:3:6,0,-1,104094,95906
1:3:6,0,-1,104095,95905
6:2:6,1,1,104094,95906
1:5:3,0,-1,104095,95905
5:4:6,0,-1,104096,95904
2:6:1,1,1,104095,95905
1:3:2,1,1,104094,95906
1:4:2,1,1,104093,95907
4:5:5,0,-1,104094,95906
3:5:5,0,-1,104095,95905
4:1:3,0,-1,104096,95904
1:2:1,1,1,104095,95905
5:5:1,0,-1,104096,95904
5:4:5,0,-1,104097,95903
5:3:1,0,-1,104098,95902
6:1:3,0,-1,104099,95901
5:1:2,1,1,104098,95902
1:1:5,0,-1,104099,95901
6:3:3,0,-1,104100,95900
5:3:5,0,-1,104101,95899
4:5:1,0,-1,104102,95898
2:5:2,2,2,104100,95900
2:4:3,1,1,104099,95901
2:6:2,2,2,104097,95903
5:3:4,0,-1,104098,95902
5:6:5,0,-1,104099,95901
3:4:1,0,-1,104100,95900
3:3:4,0,-1,104101,95899
5:6:6,0,-1,104102,95898
3:6:2,1,1,104101,95899
6:6:4,0,-1,104102,95898
3:1:2,1,1,104101,95899
3:5:6,0,-1,104102,95898
3:5:4,0,-1,104103,95897
6:6:4,0,-1,104104,95896
6:3:5,0,-1,104105,95895
2:2:3,2,2,104103,95897
2:3:1,1,1,104102,95898
5:4:4,0,-1,104103,95897
1:1:2,1,1,104102,95898
2:2:3,2,2,104100,95900
1:2:6,1,1,104099,95901
3:4:3,0,-1,104100,95900
6:6:1,0,-1,104101,95899
2:5:6,1,1,104100,95900
6:5:1,0,-1,104101,95899
6:4:2,1,1,104100,95900
2:6:5,1,1,104099,95901
5:6:3,0,-1,104100,95900
1:5:1,0,-1,104101,95899
6:1:3,0,-1,104102,95898
5:6:6,0,-1,104103,95897
5:6:1,0,-1,104104,95896
2:6:2,2,2,104102,95898
3:2:2,2,2,104100,95900
2:3:1,1,1,104099,95901
1:2:4,1,1,104098,95902
1:4:5,0,-1,104099,95901
5:6:6,0,-1,104100,95900
4:3:6,0,-1,104101,95899
2:5:3,1,1,104100,95900
4:6:5,0,-1,104101,95899
5:3:1,0,-1,104102,95898
3:2:6,1,1,104101,95899
5:2:5,1,1,104100,95900
2:5:5,1,1,104099,95901
2:2:4,2,2,104097,95903
3:5:4,0,-1,104098,95902
4:2:2,2,2,104096,95904
5:5:2,1,1,104095,95905
5:2:6,1,1,104094,95906
2:2:2,3,3,104091,95909
1:2:4,1,1,104090,95910
2:5:4,1,1,104089,95911
6:2:5,1,1,104088,95912
2:6:3,1,1,104087,95913
4:3:4,0,-1,104088,95912
1:6:3,0,-1,104089,95911
2:5:5,1,1,104088,95912
2:6:1,1,1,104087,95913
5:2:4,1,1,104086,95914
3:1:1,0,-1,104087,95913
1:5:1,0,-1,104088,95912
6:5:4,0,-1,104089,95911
1:4:5,0,-1,104090,95910
2:3:6,1,1,104089,95911
3:6:2,1,1,104088,95912
3:6:6,0,-1,104089,95911
3:3:3,0,-1,104090,95910
2:5:2,2,2,104088,95912
5:3:4,0,-1,104089,95911
5:2:1,1,1,104088,95912
1:3:6,0,-1,104089,95911
4:4:1,0,-1,104090,95910
4:6:5,0,-1,104091,95909
1:2:5,1,1,104090,95910
2:2:3,2,2,104088,95912
1:4:6,0,-1,104089,95911
3:6:4,0,-1,104090,95910
5:2:6,1,1,104089,95911
5:3:2,1,1,104088,95912
3:6:1,0,-1,104089,95911
2:4:1,1,1,104088,95912
1:5:4,0,-1,104089,95911
4:2:5,1,1,104088,95912
4:3:1,0,-1,104089,95911
4:4:5,0,-1,104090,95910
4:4:4,0,-1,104091,95909
3:6:3,0,-1,104092,95908
4:2:2,2,2,104090,95910
5:2:4,1,1,104089,95911
4:6:2,1,1,104088,95912
5:4:5,0,-1,104089,95911
2:4:3,1,1,104088,95912
1:2:1,1,1,104087,95913
4:5:3,0,-1,104088,95912
6:6:4,0,-1,104089,95911
6:2:2,2,2,104087,95913
2:6:1,1,1,104086,95914
3:6:1,0,-1,104087,95913
5:3:6,0,-1,104088,95912
5:1:4,0,-1,104089,95911
3:2:4,1,1,104088,95912
3:5:5,0,-1,104089,95911
4:6:1,0,-1,104090,95910
6:5:6,0,-1,104091,95909
1:1:2,1,1,104090,95910
2:5:3,1,1,104089,95911
5:2:6,1,1,104088,95912
3:3:6,0,-1,104089,95911
4:1:4,0,-1,104090,95910
1:6:1,0,-1,104091,95909
5:1:3,0,-1,104092,95908
1:2:5,1,1,104091,95909
4:4:1,0,-1,104092,95908
3:5:2,1,1,104091,95909
6:5:1,0,-1,104092,95908
5:4:4,0,-1,104093,95907
2:1:3,1,1,104092,95908
3:5:3,0,-1,104093,95907
3:2:5,1,1,104092,95908
3:1:1,0,-1,104093,95907
1:2:5,1,1,104092,95908
3:6:2,1,1,104091,95909
6:4:1,0,-1,104092,95908
4:5:2,1,1,104091,95909
3:6:2,1,1,104090,95910
2:5:4,1,1,104089,95911
6:2:3,1,1,104088,95912
3:6:2,1,1,104087,95913
6:5:6,0,-1,104088,95912
2:3:3,1,1,104087,95913
4:4:5,0,-1,104088,95912
5:5:2,1,1,104087,95913
4:1:5,0,-1,104088,95912
2:4:4,1,1,104087,95913
5:4:5,0,-1,104088,95912
1:3:6,0,-1,104089,95911
4:1:3,0,-1,104090,95910
1:3:1,0,-1,104091,95909
2:6:5,1,1,104090,95910
1:2:4,1,1,104089,95911
5:1:4,0,-1,104090,95910
3:5:2,1,1,104089,95911
3:2:2,2,2,104087,95913
5:1:1,0,-1,104088,95912
5:3:1,0,-1,104089,95911
4:1:5,0,-1,104090,95910
1:5:2,1,1,104089,95911
2:2:5,2,2,104087,95913
4:1:3,0,-1,104088,95912
3:2:5,1,1,104087,95913
3:2:4,1,1,104086,95914
3:4:1,0,-1,104087,95913
4:1:2,1,1,104086,95914
6:1:5,0,-1,104087,95913
6:6:6,0,-1,104088,95912
3:6:5,0,-1,104089,95911
4:5:2,1,1,104088,95912
6:2:2,2,2,104086,95914
1:6:2,1,1,104085,95915
4:4:5,0,-1,104086,95914
3:3:5,0,-1,104087,95913
5:6:5,0,-1,104088,95912
3:6:1,0,-1,104089,95911
3:5:3,0,-1,104090,95910
5:2:4,1,1,104089,95911
4:2:4,1,1,104088,95912
5:2:2,2,2,104086,95914
6:6:2,1,1,104085,95915
2:5:2,2,2,104083,95917
1:2:6,1,1,104082,95918
6:2:6,1,1,104081,95919
1:4:3,0,-1,104082,95918
4:2:2,2,2,104080,95920
1:3:1,0,-1,104081,95919
2:5:2,2,2,104079,95921
4:3:3,0,-1,104080,95920
4:2:6,1,1,104079,95921
1:6:1,0,-1,104080,95920
3:3:6,0,-1,104081,95919
2:1:1,1,1,104080,95920
2:3:1,1,1,104079,95921
6:5:3,0,-1,104080,95920
5:5:3,0,-1,104081,95919
3:1:4,0,-1,104082,95918
1:4:4,0,-1,104083,95917
3:4:4,0,-1,104084,95916
6:3:2,1,1,104083,95917
3:6:5,0,-1,104084,95916
6:2:4,1,1,104083,95917
1:4:5,0,-1,104084,95916
5:6:5,0,-1,104085,95915
1:6:3,0,-1,104086,95914
6:6:1,0,-1,104087,95913
6:3:6,0,-1,104088,95912
1:6:2,1,1,104087,95913
4:2:1,1,1,104086,95914
2:2:6,2,2,104084,95916
5:5:3,0,-1,104085,95915
3:5:3,0,-1,104086,95914
3:5:3,0,-1,104087,95913
3:6:3,0,-1,104088,95912
4:5:2,1,1,104087,95913
6:2:3,1,1,104086,95914
5:6:6,0,-1,104087,95913
6:6:1,0,-1,104088,95912
2:5:4,1,1,104087,95913
5:5:1,0,-1,104088,95912
3:6:4,0,-1,104089,95911
5:4:1,0,-1,104090,95910
6:6:2,1,1,104089,95911
2:2:6,2,2,104087,95913
2:5:1,1,1,104086,95914
1:6:6,0,-1,104087,95913
6:4:6,0,-1,104088,95912
3:2:1,1,1,104087,95913
6:4:3,0,-1,104088,95912
2:5:4,1,1,104087,95913
1:6:5,0,-1,104088,95912
1:2:4,1,1,104087,95913
5:2:1,1,1,104086,95914
4:2:4,1,1,104085,95915
4:1:5,0,-1,104086,95914
1:4:2,1,1,104085,95915
1:4:4,0,-1,104086,95914
2:3:5,1,1,104085,95915
6:3:5,0,-1,104086,95914
4:1:4,0,-1,104087,95913
3:1:5,0,-1,104088,95912
1:4:2,1,1,104087,95913
4:3:5,0,-1,104088,95912
5:3:4,0,-1,104089,95911
4:6:5,0,-1,104090,95910
6:6:1,0,-1,104091,95909
2:6:1,1,1,104090,95910
6:6:5,0,-1,104091,95909
2:1:1,1,1,104090,95910
5:3:1,0,-1,104091,95909
4:1:5,0,-1,104092,95908
5:1:6,0,-1,104093,95907
5:6:6,0,-1,104094,95906
5:2:4,1,1,104093,95907
3:6:6,0,-1,104094,95906
2:5:5,1,1,104093,95907
2:5:1,1,1,104092,95908
3:4:1,0,-1,104093,95907
3:5:5,0,-1,104094,95906
4:6:4,0,-1,104095,95905
1:4:3,0,-1,104096,95904
2:3:6,1,1,104095,95905
1:3:3,0,-1,104096,95904
5:5:4,0,-1,104097,95903
2:2:4,2,2,104095,95905
4:5:3,0,-1,104096,95904
4:6:6,0,-1,104097,95903
5:4:4,0,-1,104098,95902
5:6:1,0,-1,104099,95901
6:6:5,0,-1,104100,95900
4:1:2,1,1,104099,95901
5:3:1,0,-1,104100,95900
5:6:6,0,-1,104101,95899
4:3:5,0,-1,104102,95898
3:5:1,0,-1,104103,95897
4:2:1,1,1,104102,95898
1:5:2,1,1,104101,95899
1:2:6,1,1,104100,95900
5:3:1,0,-1,104101,95899
5:2:6,1,1,104100,95900
5:3:5,0,-1,104101,95899
1:5:3,0,-1,104102,95898
1:4:4,0,-1,104103,95897
5:6:2,1,1,104102,95898
1:1:2,1,1,104101,95899
1:6:3,0,-1,104102,95898
2:1:1,1,1,104101,95899
5:2:4,1,1,104100,95900
3:1:3,0,-1,104101,95899
6:4:4,0,-1,104102,95898
2:1:2,2,2,104100,95900
6:2:6,1,1,104099,95901
5:2:3,1,1,104098,95902
6:2:2,2,2,104096,95904
2:5:4,1,1,104095,95905
4:4:3,0,-1,104096,95904
6:3:3,0,-1,104097,95903
6:1:4,0,-1,104098,95902
2:4:4,1,1,104097,95903
6:3:2,1,1,104096,95904
1:5:5,0,-1,104097,95903
2:4:2,2,2,104095,95905
1:5:2,1,1,104094,95906
5:4:4,0,-1,104095,95905
2:4:3,1,1,104094,95906
3:2:6,1,1,104093,95907
4:3:3,0,-1,104094,95906
6:1:3,0,-1,104095,95905
2:4:6,1,1,104094,95906
1:6:5,0,-1,104095,95905
1:6:6,0,-1,104096,95904
5:5:1,0,-1,104097,95903
6:6:2,1,1,104096,95904
3:6:1,0,-1,104097,95903
1:4:5,0,-1,104098,95902
5:3:1,0,-1,104099,95901
5:3:2,1,1,104098,95902
4:3:1,0,-1,104099,95901
4:3:6,0,-1,104100,95900
4:4:2,1,1,104099,95901
5:2:6,1,1,104098,95902
4:3:2,1,1,104097,95903
1:4:3,0,-1,104098,95902
1:4:1,0,-1,104099,95901
4:6:5,0,-1,104100,95900
3:3:5,0,-1,104101,95899
1:3:3,0,-1,104102,95898
6:6:1,0,-1,104103,95897
3:2:5,1,1,104102,95898
4:4:3,0,-1,104103,95897
5:3:2,1,1,104102,95898
3:2:1,1,1,104101,95899
1:3:3,0,-1,104102,95898
3:3:6,0,-1,104103,95897
6:4:2,1,1,104102,95898
3:6:4,0,-1,104103,95897
1:5:4,0,-1,104104,95896
5:2:6,1,1,104103,95897
4:5:6,0,-1,104104,95896
4:6:3,0,-1,104105,95895
1:5:1,0,-1,104106,95894
2:5:4,1,1,104105,95895
1:5:4,0,-1,104106,95894
2:4:4,1,1,104105,95895
2:2:6,2,2,104103,95897
1:5:2,1,1,104102,95898
1:1:5,0,-1,104103,95897
2:4:5,1,1,104102,95898
6:1:6,0,-1,104103,95897
4:3:3,0,-1,104104,95896
4:4:4,0,-1,104105,95895
2:3:6,1,1,104104,95896
3:6:6,0,-1,104105,95895
2:6:6,1,1,104104,95896
1:4:4,0,-1,104105,95895
4:4:1,0,-1,104106,95894
5:5:6,0,-1,104107,95893
1:5:6,0,-1,104108,95892
6:4:2,1,1,104107,95893
3:5:4,0,-1,104108,95892
6:5:3,0,-1,104109,95891
6:6:1,0,-1,104110,95890
4:4:5,0,-1,104111,95889
3:4:3,0,-1,104112,95888
2:3:3,1,1,104111,95889
5:4:2,1,1,104110,95890
3:6:5,0,-1,104111,95889
1:5:4,0,-1,104112,95888
5:4:3,0,-1,104113,95887
3:2:4,1,1,104112,95888
2:3:4,1,1,104111,95889
5:5:5,0,-1,104112,95888
2:2:6,2,2,104110,95890
1:6:6,0,-1,104111,95889
3:6:3,0,-1,104112,95888
5:4:6,0,-1,104113,95887
5:6:5,0,-1,104114,95886
5:5:6,0,-1,104115,95885
5:5:5,0,-1,104116,95884
4:6:1,0,-1,104117,95883
2:1:4,1,1,104116,95884
6:1:3,0,-1,104117,95883
1:2:3,1,1,104116,95884
6:5:5,0,-1,104117,95883
4:6:1,0,-1,104118,95882
4:4:2,1,1,104117,95883
5:2:6,1,1,104116,95884
1:3:3,0,-1,104117,95883
3:6:5,0,-1,104118,95882
5:3:2,1,1,104117,95883
2:1:5,1,1,104116,95884
2:2:6,2,2,104114,95886
5:3:3,0,-1,104115,95885
5:1:3,0,-1,104116,95884
4:3:2,1,1,104115,95885
6:4:2,1,1,104114,95886
4:4:2,1,1,104113,95887
1:6:3,0,-1,104114,95886
2:4:1,1,1,104113,95887
6:1:1,0,-1,104114,95886
3:4:2,1,1,104113,95887
3:2:3,1,1,104112,95888
4:5:2,1,1,104111,95889
3:1:3,0,-1,104112,95888
4:2:3,1,1,104111,95889
5:4:3,0,-1,104112,95888
6:2:3,1,1,104111,95889
2:4:2,2,2,104109,95891
1:3:6,0,-1,104110,95890
4:4:5,0,-1,104111,95889
3:6:1,0,-1,104112,95888
3:5:5,0,-1,104113,95887
4:4:4,0,-1,104114,95886
6:3:1,0,-1,104115,95885
6:2:5,1,1,104114,95886
1:1:5,0,-1,104115,95885
5:6:2,1,1,104114,95886
4:5:5,0,-1,104115,95885
1:1:4,0,-1,104116,95884
5:2:4,1,1,104115,95885
2:5:1,1,1,104114,95886
3:5:5,0,-1,104115,95885
4:4:6,0,-1,104116,95884
2:1:4,1,1,104115,95885
5:2:2,2,2,104113,95887
1:1:6,0,-1,104114,95886
6:2:4,1,1,104113,95887
1:6:4,0,-1,104114,95886
1:4:6,0,-1,104115,95885
1:2:3,1,1,104114,95886
6:3:2,1,1,104113,95887
1:3:5,0,-1,104114,95886
2:2:5,2,2,104112,95888
5:6:6,0,-1,104113,95887
5:4:4,0,-1,104114,95886
5:5:4,0,-1,104115,95885
2:5:5,1,1,104114,95886
2:4:3,1,1,104113,95887
5:3:5,0,-1,104114,95886
2:5:1,1,1,104113,95887
6:4:3,0,-1,104114,95886
2:1:2,2,2,104112,95888
1:2:1,1,1,104111,95889
5:5:6,0,-1,104112,95888
5:3:5,0,-1,104113,95887
4:5:4,0,-1,104114,95886
2:1:5,1,1,104113,95887
3:1:1,0,-1,104114,95886
5:6:2,1,1,104113,95887
4:1:6,0,-1,104114,95886
5:4:1,0,-1,104115,95885
5:4:4,0,-1,104116,95884
2:4:2,2,2,104114,95886
6:1:3,0,-1,104115,95885
1:4:1,0,-1,104116,95884
5:5:6,0,-1,104117,95883
5:3:3,0,-1,104118,95882
6:6:2,1,1,104117,95883
3:5:3,0,-1,104118,95882
5:5:5,0,-1,104119,95881
1:6:3,0,-1,104120,95880
6:3:4,0,-1,104121,95879
4:2:6,1,1,104120,95880
1:1:2,1,1,104119,95881
2:2:3,2,2,104117,95883
1:2:4,1,1,104116,95884
1:3:5,0,-1,104117,95883
2:5:4,1,1,104116,95884
5:2:4,1,1,104115,95885
1:6:6,0,-1,104116,95884
6:4:5,0,-1,104117,95883
3:5:4,0,-1,104118,95882
2:2:5,2,2,104116,95884
2:4:6,1,1,104115,95885
2:3:6,1,1,104114,95886
3:5:6,0,-1,104115,95885
4:4:6,0,-1,104116,95884
3:2:3,1,1,104115,95885
1:4:1,0,-1,104116,95884
1:1:6,0,-1,104117,95883
1:6:1,0,-1,104118,95882
2:5:4,1,1,104117,95883
3:4:1,0,-1,104118,95882
6:4:6,0,-1,104119,95881
5:2:2,2,2,104117,95883
6:6:4,0,-1,104118,95882
3:6:3,0,-1,104119,95881
5:4:4,0,-1,104120,95880
6:1:5,0,-1,104121,95879
1:5:2,1,1,104120,95880
4:5:3,0,-1,104121,95879
6:6:4,0,-1,104122,95878
4:4:5,0,-1,104123,95877
5:2:3,1,1,104122,95878
4:4:6,0,-1,104123,95877
3:2:5,1,1,104122,95878
6:4:4,0,-1,104123,95877
5:5:3,0,-1,104124,95876
4:6:5,0,-1,104125,95875
1:6:4,0,-1,104126,95874
6:6:1,0,-1,104127,95873
5:5:6,0,-1,104128,95872
3:1:2,1,1,104127,95873
5:5:1,0,-1,104128,95872
5:4:3,0,-1,104129,95871
3:2:6,1,1,104128,95872
6:3:3,0,-1,104129,95871
4:1:4,0,-1,104130,95870
5:3:6,0,-1,104131,95869
6:2:2,2,2,104129,95871
6:6:6,0,-1,104130,95870
6:1:4,0,-1,104131,95869
6:2:4,1,1,104130,95870
5:6:1,0,-1,104131,95869
1:6:6,0,-1,104132,95868
5:3:3,0,-1,104133,95867
6:6:6,0,-1,104134,95866
6:5:6,0,-1,104135,95865
6:3:1,0,-1,104136,95864
6:2:2,2,2,104134,95866
3:6:2,1,1,104133,95867
4:5:2,1,1,104132,95868
2:4:5,1,1,104131,95869
6:3:6,0,-1,104132,95868
1:4:6,0,-1,104133,95867
5:2:6,1,1,104132,95868
4:1:1,0,-1,104133,95867
6:4:3,0,-1,104134,95866
3:2:1,1,1,104133,95867
4:5:6,0,-1,104134,95866
2:5:3,1,1,104133,95867
3:1:5,0,-1,104134,95866
6:4:5,0,-1,104135,95865
5:1:6,0,-1,104136,95864
4:1:4,0,-1,104137,95863
3:3:3,0,-1,104138,95862
2:5:5,1,1,104137,95863
2:6:4,1,1,104136,95864
6:4:1,0,-1,104137,95863
3:3:5,0,-1,104138,95862
5:1:3,0,-1,104139,95861
1:2:6,1,1,104138,95862
2:4:1,1,1,104137,95863
1:5:2,1,1,104136,95864
4:6:2,1,1,104135,95865
6:1:5,0,-1,104136,95864
5:2:1,1,1,104135,95865
6:1:5,0,-1,104136,95864
4:4:3,0,-1,104137,95863
4:5:4,0,-1,104138,95862
3:3:4,0,-1,104139,95861
5:5:3,0,-1,104140,95860
6:5:2,1,1,104139,95861
2:3:2,2,2,104137,95863
6:2:1,1,1,104136,95864
6:6:5,0,-1,104137,95863
2:5:3,1,1,104136,95864
1:6:6,0,-1,104137,95863
2:2:4,2,2,104135,95865
6:6:1,0,-1,104136,95864
5:2:2,2,2,104134,95866
6:1:1,0,-1,104135,95865
4:4:6,0,-1,104136,95864
6:5:6,0,-1,104137,95863
6:5:2,1,1,104136,95864
1:4:2,1,1,104135,95865
4:2:6,1,1,104134,95866
3:3:6,0,-1,104135,95865
4:1:3,0,-1,104136,95864
4:6:2,1,1,104135,95865
1:6:4,0,-1,104136,95864
2:4:4,1,1,104135,95865
5:5:6,0,-1,104136,95864
3:3:1,0,-1,104137,95863
3:5:4,0,-1,104138,95862
4:1:4,0,-1,104139,95861
6:3:1,0,-1,104140,95860
2:5:6,1,1,104139,95861
6:5:3,0,-1,104140,95860
4:3:3,0,-1,104141,95859
4:1:6,0,-1,104142,95858
6:4:2,1,1,104141,95859
2:5:2,2,2,104139,95861
4:4:4,0,-1,104140,95860
1:1:3,0,-1,104141,95859
6:4:4,0,-1,104142,95858
3:5:2,1,1,104141,95859
3:2:4,1,1,104140,95860
3:5:3,0,-1,104141,95859
6:6:6,0,-1,104142,95858
1:2:6,1,1,104141,95859
2:6:1,1,1,104140,95860
4:4:1,0,-1,104141,95859
2:3:4,1,1,104140,95860
2:1:3,1,1,104139,95861
2:2:3,2,2,104137,95863
2:3:4,1,1,104136,95864
4:1:5,0,-1,104137,95863
3:5:4,0,-1,104138,95862
6:6:3,0,-1,104139,95861
6:4:1,0,-1,104140,95860
3:3:6,0,-1,104141,95859
2:1:1,1,1,104140,95860
3:1:4,0,-1,104141,95859
5:1:5,0,-1,104142,95858
6:4:4,0,-1,104143,95857
3:1:5,0,-1,104144,95856
6:5:5,0,-1,104145,95855
2:4:1,1,1,104144,95856
6:2:4,1,1,104143,95857
6:6:4,0,-1,104144,95856
6:6:5,0,-1,104145,95855
6:3:2,1,1,104144,95856
1:4:5,0,-1,104145,95855
2:1:6,1,1,104144,95856
4:4:2,1,1,104143,95857
3:6:2,1,1,104142,95858
5:6:6,0,-1,104143,95857
3:3:1,0,-1,104144,95856
4:4:2,1,1,104143,95857
1:4:5,0,-1,104144,95856
6:4:2,1,1,104143,95857
6:5:4,0,-1,104144,95856
1:5:2,1,1,104143,95857
1:4:3,0,-1,104144,95856
2:5:2,2,2,104142,95858
4:6:5,0,-1,104143,95857
2:2:5,2,2,104141,95859
5:3:5,0,-1,104142,95858
1:1:6,0,-1,104143,95857
2:3:5,1,1,104142,95858
5:6:3,0,-1,104143,95857
6:5:2,1,1,104142,95858
3:1:6,0,-1,104143,95857
1:4:2,1,1,104142,95858
6:3:2,1,1,104141,95859
6:4:6,0,-1,104142,95858
5:4:1,0,-1,104143,95857
5:6:3,0,-1,104144,95856
5:4:4,0,-1,104145,95855
6:2:5,1,1,104144,95856
4:1:4,0,-1,104145,95855
3:4:6,0,-1,104146,95854
1:4:2,1,1,104145,95855
1:5:2,1,1,104144,95856
6:5:3,0,-1,104145,95855
4:6:3,0,-1,104146,95854
2:4:6,1,1,104145,95855
5:4:4,0,-1,104146,95854
6:2:2,2,2,104144,95856
5:6:2,1,1,104143,95857
3:1:2,1,1,104142,95858
4:3:1,0,-1,104143,95857
4:5:3,0,-1,104144,95856
5:6:3,0,-1,104145,95855
6:2:4,1,1,104144,95856
3:6:5,0,-1,104145,95855
5:4:4,0,-1,104146,95854
6:2:1,1,1,104145,95855
3:3:1,0,-1,104146,95854
6:3:5,0,-1,104147,95853
3:2:4,1,1,104146,95854
5:2:3,1,1,104145,95855
6:6:2,1,1,104144,95856
3:2:2,2,2,104142,95858
6:3:3,0,-1,104143,95857
4:5:3,0,-1,104144,95856
4:2:3,1,1,104143,95857
1:4:6,0,-1,104144,95856
4:3:1,0,-1,104145,95855
3:5:3,0,-1,104146,95854
3:5:5,0,-1,104147,95853
5:4:3,0,-1,104148,95852
2:6:5,1,1,104147,95853
4:2:5,1,1,104146,95854
1:3:3,0,-1,104147,95853
5:1:3,0,-1,104148,95852
4:1:3,0,-1,104149,95851
2:3:5,1,1,104148,95852
1:2:3,1,1,104147,95853
6:3:2,1,1,104146,95854
3:4:4,0,-1,104147,95853
5:3:2,1,1,104146,95854
6:3:2,1,1,104145,95855
6:3:5,0,-1,104146,95854
2:6:4,1,1,104145,95855
6:3:5,0,-1,104146,95854
2:5:5,1,1,104145,95855
5:6:5,0,-1,104146,95854
3:3:6,0,-1,104147,95853
4:6:5,0,-1,104148,95852
3:3:1,0,-1,104149,95851
6:4:5,0,-1,104150,95850
1:6:5,0,-1,104151,95849
1:2:2,2,2,104149,95851
3:3:3,0,-1,104150,95850
2:5:5,1,1,104149,95851
2:3:5,1,1,104148,95852
6:6:3,0,-1,104149,95851
4:1:5,0,-1,104150,95850
4:3:1,0,-1,104151,95849
5:1:4,0,-1,104152,95848
3:3:4,0,-1,104153,95847
4:3:3,0,-1,104154,95846
4:2:4,1,1,104153,95847
6:3:4,0,-1,104154,95846
6:3:1,0,-1,104155,95845
1:3:1,0,-1,104156,95844
6:5:4,0,-1,104157,95843
3:2:3,1,1,104156,95844
3:5:5,0,-1,104157,95843
3:1:5,0,-1,104158,95842
1:5:6,0,-1,104159,95841
1:1:6,0,-1,104160,95840
2:5:1,1,1,104159,95841
5:3:4,0,-1,104160,95840
5:3:1,0,-1,104161,95839
2:1:2,2,2,104159,95841
3:2:6,1,1,104158,95842
2:4:1,1,1,104157,95843
3:6:2,1,1,104156,95844
3:6:3,0,-1,104157,95843
3:4:6,0,-1,104158,95842
2:3:5,1,1,104157,95843
5:5:5,0,-1,104158,95842
6:1:4,0,-1,104159,95841
5:5:3,0,-1,104160,95840
5:5:3,0,-1,104161,95839
1:2:2,2,2,104159,95841
6:4:2,1,1,104158,95842
1:2:4,1,1,104157,95843
2:4:1,1,1,104156,95844
5:3:6,0,-1,104157,95843
2:4:3,1,1,104156,95844
1:1:6,0,-1,104157,95843
6:4:4,0,-1,104158,95842
4:1:1,0,-1,104159,95841
5:6:1,0,-1,104160,95840
4:5:3,0,-1,104161,95839
3:2:5,1,1,104160,95840
4:1:6,0,-1,104161,95839
3:5:5,0,-1,104162,95838
3:3:1,0,-1,104163,95837
5:5:3,0,-1,104164,95836
5:6:2,1,1,104163,95837
2:1:1,1,1,104162,95838
6:4:6,0,-1,104163,95837
6:2:6,1,1,104162,95838
4:1:3,0,-1,104163,95837
6:4:5,0,-1,104164,95836
5:6:2,1,1,104163,95837
2:2:5,2,2,104161,95839
1:1:5,0,-1,104162,95838
5:4:1,0,-1,104163,95837
2:6:6,1,1,104162,95838
3:6:4,0,-1,104163,95837
3:2:3,1,1,104162,95838
3:4:6,0,-1,104163,95837
3:3:1,0,-1,104164,95836
6:6:5,0,-1,104165,95835
6:2:5,1,1,104164,95836
1:1:2,1,1,104163,95837
6:6:1,0,-1,104164,95836
3:1:1,0,-1,104165,95835
5:4:2,1,1,104164,95836
5:1:3,0,-1,104165,95835
3:2:6,1,1,104164,95836
4:4:4,0,-1,104165,95835
6:2:3,1,1,104164,95836
2:6:2,2,2,104162,95838
3:6:6,0,-1,104163,95837
2:2:1,2,2,104161,95839
4:2:3,1,1,104160,95840
2:4:6,1,1,104159,95841
5:6:4,0,-1,104160,95840
1:6:6,0,-1,104161,95839
3:6:2,1,1,104160,95840
5:4:4,0,-1,104161,95839
4:3:5,0,-1,104162,95838
5:1:2,1,1,104161,95839
2:2:1,2,2,104159,95841
3:4:6,0,-1,104160,95840
2:6:1,1,1,104159,95841
2:5:4,1,1,104158,95842
1:4:4,0,-1,104159,95841
5:4:4,0,-1,104160,95840
1:5:2,1,1,104159,95841
1:5:4,0,-1,104160,95840
6:4:1,0,-1,104161,95839
3:2:6,1,1,104160,95840
3:5:2,1,1,104159,95841
6:2:6,1,1,104158,95842
4:5:6,0,-1,104159,95841
5:3:6,0,-1,104160,95840
4:4:5,0,-1,104161,95839
2:3:4,1,1,104160,95840
1:4:3,0,-1,104161,95839
4:2:1,1,1,104160,95840
4:3:2,1,1,104159,95841
2:2:4,2,2,104157,95843
2:3:2,2,2,104155,95845
6:4:4,0,-1,104156,95844
5:5:6,0,-1,104157,95843
2:2:6,2,2,104155,95845
1:6:6,0,-1,104156,95844
1:5:2,1,1,104155,95845
6:5:1,0,-1,104156,95844
6:6:1,0,-1,104157,95843
4:3:4,0,-1,104158,95842
1:6:2,1,1,104157,95843
5:1:3,0,-1,104158,95842
6:5:3,0,-1,104159,95841
6:6:1,0,-1,104160,95840
6:4:4,0,-1,104161,95839
5:4:5,0,-1,104162,95838
5:5:4,0,-1,104163,95837
1:6:5,0,-1,104164,95836
1:6:3,0,-1,104165,95835
1:6:6,0,-1,104166,95834
4:2:5,1,1,104165,95835
4:5:1,0,-1,104166,95834
2:2:5,2,2,104164,95836
6:2:6,1,1,104163,95837
3:3:5,0,-1,104164,95836
1:4:1,0,-1,104165,95835
6:6:3,0,-1,104166,95834
6:6:5,0,-1,104167,95833
5:2:4,1,1,104166,95834
1:1:1,0,-1,104167,95833
4:4:3,0,-1,104168,95832
2:4:4,1,1,104167,95833
1:2:4,1,1,104166,95834
3:2:3,1,1,104165,95835
3:6:4,0,-1,104166,95834
6:1:4,0,-1,104167,95833
2:1:3,1,1,104166,95834
5:4:4,0,-1,104167,95833
3:4:5,0,-1,104168,95832
5:2:6,1,1,104167,95833
3:1:6,0,-1,104168,95832
1:3:2,1,1,104167,95833
2:5:4,1,1,104166,95834
2:6:5,1,1,104165,95835
6:4:2,1,1,104164,95836
5:5:2,1,1,104163,95837
3:4:4,0,-1,104164,95836
4:1:5,0,-1,104165,95835
1:3:2,1,1,104164,95836
5:2:3,1,1,104163,95837
1:6:5,0,-1,104164,95836
3:4:5,0,-1,104165,95835
2:3:2,2,2,104163,95837
5:5:2,1,1,104162,95838
5:1:6,0,-1,104163,95837
3:2:5,1,1,104162,95838
2:2:4,2,2,104160,95840
1:4:3,0,-1,104161,95839
4:3:3,0,-1,104162,95838
5:1:3,0,-1,104163,95837
2:2:4,2,2,104161,95839
1:3:5,0,-1,104162,95838
2:2:3,2,2,104160,95840
6:2:1,1,1,104159,95841
5:3:4,0,-1,104160,95840
5:5:3,0,-1,104161,95839
4:6:5,0,-1,104162,95838
4:3:5,0,-1,104163,95837
5:4:4,0,-1,104164,95836
1:4:2,1,1,104163,95837
2:6:1,1,1,104162,95838
6:6:1,0,-1,104163,95837
3:2:5,1,1,104162,95838
2:5:6,1,1,104161,95839
3:4:4,0,-1,104162,95838
3:5:5,0,-1,104163,95837
4:4:6,0,-1,104164,95836
5:6:6,0,-1,104165,95835
4:6:1,0,-1,104166,95834
4:1:4,0,-1,104167,95833
5:3:2,1,1,104166,95834
3:5:3,0,-1,104167,95833
2:5:1,1,1,104166,95834
1:2:4,1,1,104165,95835
5:5:1,0,-1,104166,95834
4:4:1,0,-1,104167,95833
3:3:4,0,-1,104168,95832
5:1:2,1,1,104167,95833
1:4:1,0,-1,104168,95832
2:4:1,1,1,104167,95833
6:3:4,0,-1,104168,95832
2:3:5,1,1,104167,95833
1:6:5,0,-1,104168,95832
4:3:6,0,-1,104169,95831
3:4:3,0,-1,104170,95830
2:4:3,1,1,104169,95831
1:6:2,1,1,104168,95832
3:3:5,0,-1,104169,95831
5:1:1,0,-1,104170,95830
2:2:1,2,2,104168,95832
6:3:5,0,-1,104169,95831
5:4:6,0,-1,104170,95830
6:1:3,0,-1,104171,95829
6:1:3,0,-1,104172,95828
4:5:6,0,-1,104173,95827
2:6:5,1,1,104172,95828
4:2:3,1,1,104171,95829
2:1:2,2,2,104169,95831
2:2:6,2,2,104167,95833
3:5:5,0,-1,104168,95832
3:5:1,0,-1,104169,95831
2:6:1,1,1,104168,95832
1:5:3,0,-1,104169,95831
2:3:3,1,1,104168,95832
3:3:2,1,1,104167,95833
3:2:1,1,1,104166,95834
5:2:6,1,1,104165,95835
3:3:6,0,-1,104166,95834
5:5:3,0,-1,104167,95833
1:5:4,0,-1,104168,95832
1:6:6,0,-1,104169,95831
5:6:5,0,-1,104170,95830
1:5:1,0,-1,104171,95829
4:4:6,0,-1,104172,95828
6:4:4,0,-1,104173,95827
3:5:3,0,-1,104174,95826
2:6:1,1,1,104173,95827
6:1:4,0,-1,104174,95826
2:6:2,2,2,104172,95828
1:1:2,1,1,104171,95829
2:4:5,1,1,104170,95830
6:4:1,0,-1,104171,95829
1:2:4,1,1,104170,95830
6:4:2,1,1,104169,95831
2:1:3,1,1,104168,95832
6:2:1,1,1,104167,95833
6:1:6,0,-1,104168,95832
2:2:3,2,2,104166,95834
4:4:3,0,-1,104167,95833
4:1:5,0,-1,104168,95832
1:1:6,0,-1,104169,95831
4:3:6,0,-1,104170,95830
3:1:1,0,-1,104171,95829
5:4:4,0,-1,104172,95828
6:4:2,1,1,104171,95829
4:5:3,0,-1,104172,95828
1:2:5,1,1,104171,95829
3:1:3,0,-1,104172,95828
5:2:2,2,2,104170,95830
4:3:4,0,-1,104171,95829
6:1:4,0,-1,104172,95828
5:6:3,0,-1,104173,95827
5:4:3,0,-1,104174,95826
6:4:1,0,-1,104175,95825
5:3:3,0,-1,104176,95824
3:5:5,0,-1,104177,95823
2:3:4,1,1,104176,95824
1:6:4,0,-1,104177,95823
5:3:3,0,-1,104178,95822
4:1:4,0,-1,104179,95821
2:3:2,2,2,104177,95823
5:2:1,1,1,104176,95824
1:5:2,1,1,104175,95825
4:2:5,1,1,104174,95826
3:6:3,0,-1,104175,95825
6:1:3,0,-1,104176,95824
2:2:5,2,2,104174,95826
4:2:1,1,1,104173,95827
1:6:2,1,1,104172,95828
2:6:1,1,1,104171,95829
1:2:5,1,1,104170,95830
2:2:4,2,2,104168,95832
3:2:3,1,1,104167,95833
1:6:4,0,-1,104168,95832
1:5:5,0,-1,104169,95831
6:4:1,0,-1,104170,95830
5:1:4,0,-1,104171,95829
1:2:1,1,1,104170,95830
3:2:1,1,1,104169,95831
4:5:3,0,-1,104170,95830
3:5:6,0,-1,104171,95829
2:5:3,1,1,104170,95830
3:6:5,0,-1,104171,95829
2:4:2,2,2,104169,95831
6:2:2,2,2,104167,95833
3:6:3,0,-1,104168,95832
3:3:4,0,-1,104169,95831
2:1:1,1,1,104168,95832
1:1:2,1,1,104167,95833
4:6:6,0,-1,104168,95832
2:1:3,1,1,104167,95833
5:1:4,0,-1,104168,95832
5:2:3,1,1,104167,95833
3:6:5,0,-1,104168,95832
1:2:2,2,2,104166,95834
3:4:5,0,-1,104167,95833
4:1:3,0,-1,104168,95832
6:4:2,1,1,104167,95833
2:6:1,1,1,104166,95834
5:6:1,0,-1,104167,95833
1:6:2,1,1,104166,95834
3:1:2,1,1,104165,95835
5:5:2,1,1,104164,95836
2:5:6,1,1,104163,95837
2:2:5,2,2,104161,95839
5:4:6,0,-1,104162,95838
1:3:3,0,-1,104163,95837
1:2:2,2,2,104161,95839
5:1:6,0,-1,104162,95838
5:2:5,1,1,104161,95839
4:5:4,0,-1,104162,95838
3:2:2,2,2,104160,95840
3:6:4,0,-1,104161,95839
5:5:1,0,-1,104162,95838
5:2:4,1,1,104161,95839
1:2:2,2,2,104159,95841
5:5:1,0,-1,104160,95840
5:2:4,1,1,104159,95841
3:6:1,0,-1,104160,95840
5:2:2,2,2,104158,95842
2:1:6,1,1,104157,95843
6:2:2,2,2,104155,95845
6:2:1,1,1,104154,95846
1:1:5,0,-1,104155,95845
4:6:2,1,1,104154,95846
5:5:2,1,1,104153,95847
4:5:6,0,-1,104154,95846
1:6:2,1,1,104153,95847
3:2:2,2,2,104151,95849
1:5:4,0,-1,104152,95848
4:6:4,0,-1,104153,95847
5:5:6,0,-1,104154,95846
5:5:6,0,-1,104155,95845
3:4:1,0,-1,104156,95844
1:3:4,0,-1,104157,95843
5:6:4,0,-1,104158,95842
3:1:5,0,-1,104159,95841
3:4:6,0,-1,104160,95840
5:6:4,0,-1,104161,95839
5:5:4,0,-1,104162,95838
6:2:3,1,1,104161,95839
3:3:2,1,1,104160,95840
1:2:4,1,1,104159,95841
4:6:6,0,-1,104160,95840
2:2:3,2,2,104158,95842
3:1:3,0,-1,104159,95841
5:2:2,2,2,104157,95843
2:3:6,1,1,104156,95844
6:3:3,0,-1,104157,95843
2:4:6,1,1,104156,95844
5:2:1,1,1,104155,95845
3:5:4,0,-1,104156,95844
5:3:2,1,1,104155,95845
4:3:5,0,-1,104156,95844
5:2:6,1,1,104155,95845
3:6:5,0,-1,104156,95844
2:2:5,2,2,104154,95846
1:2:2,2,2,104152,95848
6:2:3,1,1,104151,95849
1:4:4,0,-1,104152,95848
5:2:1,1,1,104151,95849
3:2:6,1,1,104150,95850
5:3:1,0,-1,104151,95849
3:1:4,0,-1,104152,95848
1:5:5,0,-1,104153,95847
2:5:4,1,1,104152,95848
6:1:2,1,1,104151,95849
5:1:2,1,1,104150,95850
4:5:6,0,-1,104151,95849
5:5:6,0,-1,104152,95848
5:6:6,0,-1,104153,95847
1:4:3,0,-1,104154,95846
5:3:4,0,-1,104155,95845
5:4:1,0,-1,104156,95844
6:5:3,0,-1,104157,95843
5:3:5,0,-1,104158,95842
3:3:1,0,-1,104159,95841
3:2:1,1,1,104158,95842
1:3:3,0,-1,104159,95841
3:5:3,0,-1,104160,95840
2:2:5,2,2,104158,95842
5:1:5,0,-1,104159,95841
2:2:4,2,2,104157,95843
1:6:3,0,-1,104158,95842
1:1:1,0,-1,104159,95841
2:3:3,1,1,104158,95842
1:6:6,0,-1,104159,95841
2:1:2,2,2,104157,95843
5:3:5,0,-1,104158,95842
5:5:1,0,-1,104159,95841
3:4:4,0,-1,104160,95840
1:4:6,0,-1,104161,95839
3:4:6,0,-1,104162,95838
5:3:5,0,-1,104163,95837
5:6:3,0,-1,104164,95836
5:2:6,1,1,104163,95837
4:2:2,2,2,104161,95839
6:4:5,0,-1,104162,95838
3:3:6,0,-1,104163,95837
2:5:5,1,1,104162,95838
4:3:1,0,-1,104163,95837
5:1:3,0,-1,104164,95836
2:4:1,1,1,104163,95837
4:2:6,1,1,104162,95838
6:4:2,1,1,104161,95839
4:1:2,1,1,104160,95840
4:5:4,0,-1,104161,95839
4:3:4,0,-1,104162,95838
3:6:6,0,-1,104163,95837
4:4:2,1,1,104162,95838
3:6:2,1,1,104161,95839
5:5:4,0,-1,104162,95838
2:4:1,1,1,104161,95839
6:5:3,0,-1,104162,95838
1:3:1,0,-1,104163,95837
1:3:1,0,-1,104164,95836
2:4:3,1,1,104163,95837
6:1:6,0,-1,104164,95836
3:5:3,0,-1,104165,95835
6:2:1,1,1,104164,95836
6:5:2,1,1,104163,95837
1:3:1,0,-1,104164,95836
1:5:6,0,-1,104165,95835
4:6:1,0,-1,104166,95834
1:5:3,0,-1,104167,95833
6:2:6,1,1,104166,95834
3:5:5,0,-1,104167,95833
2:5:2,2,2,104165,95835
1:6:4,0,-1,104166,95834
6:4:1,0,-1,104167,95833
5:2:5,1,1,104166,95834
3:3:2,1,1,104165,95835
1:1:1,0,-1,104166,95834
3:4:1,0,-1,104167,95833
2:5:4,1,1,104166,95834
3:5:2,1,1,104165,95835
6:2:3,1,1,104164,95836
1:4:3,0,-1,104165,95835
1:6:6,0,-1,104166,95834
1:6:4,0,-1,104167,95833
4:2:6,1,1,104166,95834
1:5:1,0,-1,104167,95833
2:6:3,1,1,104166,95834
5:2:2,2,2,104164,95836
4:2:1,1,1,104163,95837
6:6:6,0,-1,104164,95836
4:5:6,0,-1,104165,95835
4:2:5,1,1,104164,95836
4:3:3,0,-1,104165,95835
3:1:3,0,-1,104166,95834
6:2:6,1,1,104165,95835
6:2:1,1,1,104164,95836
6:6:5,0,-1,104165,95835
4:5:3,0,-1,104166,95834
5:4:2,1,1,104165,95835
1:6:2,1,1,104164,95836
1:1:4,0,-1,104165,95835
6:5:5,0,-1,104166,95834
4:4:3,0,-1,104167,95833
3:1:3,0,-1,104168,95832
1:6:1,0,-1,104169,95831
3:4:1,0,-1,104170,95830
6:3:2,1,1,104169,95831
2:6:2,2,2,104167,95833
3:3:6,0,-1,104168,95832
3:1:3,0,-1,104169,95831
5:5:3,0,-1,104170,95830
6:6:4,0,-1,104171,95829
1:2:4,1,1,104170,95830
5:4:1,0,-1,104171,95829
3:3:6,0,-1,104172,95828
6:4:2,1,1,104171,95829
2:3:5,1,1,104170,95830
3:1:4,0,-1,104171,95829
4:6:2,1,1,104170,95830
5:1:3,0,-1,104171,95829
3:5:1,0,-1,104172,95828
4:3:2,1,1,104171,95829
1:6:6,0,-1,104172,95828
4:5:3,0,-1,104173,95827
1:5:5,0,-1,104174,95826
5:6:4,0,-1,104175,95825
3:2:4,1,1,104174,95826
3:3:4,0,-1,104175,95825
3:2:1,1,1,104174,95826
2:2:5,2,2,104172,95828
4:4:3,0,-1,104173,95827
5:4:4,0,-1,104174,95826
3:5:4,0,-1,104175,95825
4:3:2,1,1,104174,95826
5:2:3,1,1,104173,95827
3:4:3,0,-1,104174,95826
2:5:1,1,1,104173,95827
6:1:2,1,1,104172,95828
4:5:6,0,-1,104173,95827
5:2:3,1,1,104172,95828
6:5:1,0,-1,104173,95827
3:4:1,0,-1,104174,95826
1:6:4,0,-1,104175,95825
1:5:2,1,1,104174,95826
3:3:1,0,-1,104175,95825
2:3:5,1,1,104174,95826
2:6:3,1,1,104173,95827
5:2:2,2,2,104171,95829
2:2:4,2,2,104169,95831
5:1:3,0,-1,104170,95830
6:5:6,0,-1,104171,95829
3:5:3,0,-1,104172,95828
2:4:4,1,1,104171,95829
4:1:2,1,1,104170,95830
4:4:4,0,-1,104171,95829
5:5:2,1,1,104170,95830
5:6:6,0,-1,104171,95829
5:3:1,0,-1,104172,95828
1:1:1,0,-1,104173,95827
2:6:1,1,1,104172,95828
6:4:1,0,-1,104173,95827
4:6:6,0,-1,104174,95826
4:3:3,0,-1,104175,95825
1:2:1,1,1,104174,95826
1:5:6,0,-1,104175,95825
3:4:6,0,-1,104176,95824
2:1:5,1,1,104175,95825
3:1:6,0,-1,104176,95824
3:6:3,0,-1,104177,95823
2:1:6,1,1,104176,95824
1:4:1,0,-1,104177,95823
4:5:4,0,-1,104178,95822
6:5:2,1,1,104177,95823
4:6:4,0,-1,104178,95822
1:1:3,0,-1,104179,95821
3:5:1,0,-1,104180,95820
1:1:1,0,-1,104181,95819
1:1:1,0,-1,104182,95818
1:3:2,1,1,104181,95819
6:5:2,1,1,104180,95820
2:3:3,1,1,104179,95821
2:6:6,1,1,104178,95822
1:3:1,0,-1,104179,95821
6:6:4,0,-1,104180,95820
6:5:6,0,-1,104181,95819
3:3:1,0,-1,104182,95818
3:5:2,1,1,104181,95819
2:3:4,1,1,104180,95820
1:1:4,0,-1,104181,95819
1:6:2,1,1,104180,95820
4:3:2,1,1,104179,95821
4:3:1,0,-1,104180,95820
3:3:6,0,-1,104181,95819
6:1:6,0,-1,104182,95818
5:6:3,0,-1,104183,95817
4:4:6,0,-1,104184,95816
5:6:2,1,1,104183,95817
3:4:3,0,-1,104184,95816
3:1:2,1,1,104183,95817
2:6:1,1,1,104182,95818
6:6:6,0,-1,104183,95817
5:5:4,0,-1,104184,95816
6:6:1,0,-1,104185,95815
2:4:1,1,1,104184,95816
5:4:3,0,-1,104185,95815
1:2:4,1,1,104184,95816
6:5:1,0,-1,104185,95815
1:6:4,0,-1,104186,95814
1:5:1,0,-1,104187,95813
5:6:2,1,1,104186,95814
2:6:2,2,2,104184,95816
4:1:4,0,-1,104185,95815
6:3:2,1,1,104184,95816
1:5:6,0,-1,104185,95815
3:5:1,0,-1,104186,95814
2:6:5,1,1,104185,95815
5:4:5,0,-1,104186,95814
1:3:1,0,-1,104187,95813
2:4:6,1,1,104186,95814
3:5:2,1,1,104185,95815
4:5:1,0,-1,104186,95814
2:6:6,1,1,104185,95815
6:1:6,0,-1,104186,95814
4:3:2,1,1,104185,95815
1:6:3,0,-1,104186,95814
2:6:1,1,1,104185,95815
6:3:2,1,1,104184,95816
6:6:3,0,-1,104185,95815
6:4:4,0,-1,104186,95814
1:1:2,1,1,104185,95815
3:6:6,0,-1,104186,95814
2:3:2,2,2,104184,95816
1:6:4,0,-1,104185,95815
3:2:3,1,1,104184,95816
1:2:4,1,1,104183,95817
3:4:1,0,-1,104184,95816
4:3:1,0,-1,104185,95815
1:5:3,0,-1,104186,95814
1:6:1,0,-1,104187,95813
4:1:4,0,-1,104188,95812
4:3:2,1,1,104187,95813
5:6:6,0,-1,104188,95812
2:2:5,2,2,104186,95814
2:2:6,2,2,104184,95816
4:2:3,1,1,104183,95817
1:2:2,2,2,104181,95819
5:3:6,0,-1,104182,95818
4:5:6,0,-1,104183,95817
1:1:4,0,-1,104184,95816
2:4:3,1,1,104183,95817
5:6:2,1,1,104182,95818
5:6:5,0,-1,104183,95817
1:5:2,1,1,104182,95818
6:2:5,1,1,104181,95819
4:3:5,0,-1,104182,95818
4:3:3,0,-1,104183,95817
2:6:5,1,1,104182,95818
1:1:4,0,-1,104183,95817
6:1:2,1,1,104182,95818
3:3:4,0,-1,104183,95817
5:3:4,0,-1,104184,95816
1:2:4,1,1,104183,95817
2:6:4,1,1,104182,95818
1:1:3,0,-1,104183,95817
6:4:1,0,-1,104184,95816
1:5:4,0,-1,104185,95815
6:1:3,0,-1,104186,95814
1:1:5,0,-1,104187,95813
2:4:4,1,1,104186,95814
1:4:1,0,-1,104187,95813
4:3:4,0,-1,104188,95812
3:4:2,1,1,104187,95813
2:4:4,1,1,104186,95814
3:3:1,0,-1,104187,95813
6:2:3,1,1,104186,95814
4:2:2,2,2,104184,95816
2:3:6,1,1,104183,95817
6:3:5,0,-1,104184,95816
2:3:2,2,2,104182,95818
2:1:6,1,1,104181,95819
1:4:2,1,1,104180,95820
2:2:2,3,3,104177,95823
4:4:5,0,-1,104178,95822
4:3:2,1,1,104177,95823
5:1:3,0,-1,104178,95822
6:2:6,1,1,104177,95823
4:2:5,1,1,104176,95824
1:1:2,1,1,104175,95825
2:2:2,3,3,104172,95828
6:5:4,0,-1,104173,95827
3:6:2,1,1,104172,95828
5:4:4,0,-1,104173,95827
2:3:1,1,1,104172,95828
3:4:5,0,-1,104173,95827
1:3:3,0,-1,104174,95826
4:4:6,0,-1,104175,95825
2:4:3,1,1,104174,95826
6:3:6,0,-1,104175,95825
1:1:2,1,1,104174,95826
3:6:6,0,-1,104175,95825
6:5:6,0,-1,104176,95824
4:2:1,1,1,104175,95825
6:2:6,1,1,104174,95826
1:1:3,0,-1,104175,95825
4:6:1,0,-1,104176,95824
1:6:1,0,-1,104177,95823
2:1:1,1,1,104176,95824
5:3:2,1,1,104175,95825
1:4:4,0,-1,104176,95824
6:1:2,1,1,104175,95825
5:5:6,0,-1,104176,95824
4:2:6,1,1,104175,95825
1:1:1,0,-1,104176,95824
3:6:2,1,1,104175,95825
2:2:6,2,2,104173,95827
6:4:2,1,1,104172,95828
1:3:1,0,-1,104173,95827
4:5:3,0,-1,104174,95826
2:4:6,1,1,104173,95827
1:3:6,0,-1,104174,95826
1:1:1,0,-1,104175,95825
2:3:3,1,1,104174,95826
5:4:5,0,-1,104175,95825
6:4:2,1,1,104174,95826
2:4:6,1,1,104173,95827
6:3:2,1,1,104172,95828
5:1:1,0,-1,104173,95827
3:3:2,1,1,104172,95828
2:2:3,2,2,104170,95830
3:3:4,0,-1,104171,95829
5:1:2,1,1,104170,95830
6:5:1,0,-1,104171,95829
2:6:3,1,1,104170,95830
4:3:2,1,1,104169,95831
4:2:6,1,1,104168,95832
6:2:3,1,1,104167,95833
3:6:3,0,-1,104168,95832
4:1:6,0,-1,104169,95831
4:5:6,0,-1,104170,95830
1:4:3,0,-1,104171,95829
2:3:4,1,1,104170,95830
3:2:2,2,2,104168,95832
2:6:6,1,1,104167,95833
5:3:6,0,-1,104168,95832
6:2:5,1,1,104167,95833
3:1:5,0,-1,104168,95832
6:1:5,0,-1,104169,95831
1:3:1,0,-1,104170,95830
5:1:4,0,-1,104171,95829
3:5:6,0,-1,104172,95828
5:4:2,1,1,104171,95829
6:4:6,0,-1,104172,95828
1:4:6,0,-1,104173,95827
3:2:6,1,1,104172,95828
6:2:2,2,2,104170,95830
1:6:3,0,-1,104171,95829
5:3:2,1,1,104170,95830
6:5:1,0,-1,104171,95829
4:4:1,0,-1,104172,95828
3:1:4,0,-1,104173,95827
5:1:1,0,-1,104174,95826
6:6:2,1,1,104173,95827
6:6:1,0,-1,104174,95826
4:2:5,1,1,104173,95827
1:5:5,0,-1,104174,95826
4:1:2,1,1,104173,95827
6:6:1,0,-1,104174,95826
1:6:4,0,-1,104175,95825
5:5:6,0,-1,104176,95824
5:6:1,0,-1,104177,95823
5:2:1,1,1,104176,95824
6:1:3,0,-1,104177,95823
1:5:5,0,-1,104178,95822
2:1:4,1,1,104177,95823
5:4:2,1,1,104176,95824
1:5:3,0,-1,104177,95823
1:3:1,0,-1,104178,95822
2:1:5,1,1,104177,95823
6:6:3,0,-1,104178,95822
4:2:5,1,1,104177,95823
3:5:6,0,-1,104178,95822
4:1:6,0,-1,104179,95821
3:2:1,1,1,104178,95822
6:4:3,0,-1,104179,95821
6:6:2,1,1,104178,95822
4:5:4,0,-1,104179,95821
2:3:3,1,1,104178,95822
1:3:1,0,-1,104179,95821
3:6:1,0,-1,104180,95820
2:4:3,1,1,104179,95821
4:5:1,0,-1,104180,95820
5:3:4,0,-1,104181,95819
3:1:4,0,-1,104182,95818
6:2:5,1,1,104181,95819
2:1:4,1,1,104180,95820
2:2:6,2,2,104178,95822
4:3:5,0,-1,104179,95821
4:3:4,0,-1,104180,95820
2:2:2,3,3,104177,95823
4:1:2,1,1,104176,95824
3:3:3,0,-1,104177,95823
5:4:5,0,-1,104178,95822
1:6:5,0,-1,104179,95821
5:1:1,0,-1,104180,95820
6:3:2,1,1,104179,95821
2:5:6,1,1,104178,95822
2:6:4,1,1,104177,95823
2:3:6,1,1,104176,95824
1:4:2,1,1,104175,95825
3:2:4,1,1,104174,95826
6:2:1,1,1,104173,95827
5:2:6,1,1,104172,95828
5:4:2,1,1,104171,95829
4:5:6,0,-1,104172,95828
4:1:3,0,-1,104173,95827
5:3:4,0,-1,104174,95826
1:3:5,0,-1,104175,95825
5:1:6,0,-1,104176,95824
3:3:3,0,-1,104177,95823
1:1:4,0,-1,104178,95822
4:1:2,1,1,104177,95823
5:5:1,0,-1,104178,95822
5:5:1,0,-1,104179,95821
1:1:1,0,-1,104180,95820
6:4:5,0,-1,104181,95819
5:6:3,0,-1,104182,95818
4:2:2,2,2,104180,95820
3:1:6,0,-1,104181,95819
6:2:5,1,1,104180,95820
2:3:6,1,1,104179,95821
1:1:4,0,-1,104180,95820
4:1:5,0,-1,104181,95819
5:6:4,0,-1,104182,95818
1:3:4,0,-1,104183,95817
2:1:1,1,1,104182,95818
5:1:6,0,-1,104183,95817
6:2:1,1,1,104182,95818
4:2:5,1,1,104181,95819
3:1:5,0,-1,104182,95818
4:5:2,1,1,104181,95819
4:4:3,0,-1,104182,95818
6:6:2,1,1,104181,95819
3:6:2,1,1,104180,95820
1:1:4,0,-1,104181,95819
1:1:6,0,-1,104182,95818
2:2:4,2,2,104180,95820
1:4:3,0,-1,104181,95819
1:5:5,0,-1,104182,95818
4:6:1,0,-1,104183,95817
2:3:1,1,1,104182,95818
2:6:2,2,2,104180,95820
2:4:1,1,1,104179,95821
1:2:5,1,1,104178,95822
4:3:2,1,1,104177,95823
3:1:6,0,-1,104178,95822
6:4:3,0,-1,104179,95821
1:2:2,2,2,104177,95823
1:6:3,0,-1,104178,95822
5:1:6,0,-1,104179,95821
3:1:5,0,-1,104180,95820
4:1:6,0,-1,104181,95819
1:5:3,0,-1,104182,95818
1:1:5,0,-1,104183,95817
5:5:1,0,-1,104184,95816
6:3:3,0,-1,104185,95815
4:4:4,0,-1,104186,95814
5:1:4,0,-1,104187,95813
5:4:5,0,-1,104188,95812
5:5:1,0,-1,104189,95811
5:6:2,1,1,104188,95812
3:4:5,0,-1,104189,95811
4:1:4,0,-1,104190,95810
5:2:2,2,2,104188,95812
6:4:1,0,-1,104189,95811
5:6:5,0,-1,104190,95810
5:3:2,1,1,104189,95811
1:2:3,1,1,104188,95812
1:4:6,0,-1,104189,95811
6:3:2,1,1,104188,95812
1:3:2,1,1,104187,95813
6:4:5,0,-1,104188,95812
6:6:1,0,-1,104189,95811
5:4:2,1,1,104188,95812
5:1:1,0,-1,104189,95811
2:2:6,2,2,104187,95813
3:6:5,0,-1,104188,95812
4:4:2,1,1,104187,95813
6:3:5,0,-1,104188,95812
3:4:3,0,-1,104189,95811
2:3:6,1,1,104188,95812
3:4:2,1,1,104187,95813
5:5:4,0,-1,104188,95812
1:1:6,0,-1,104189,95811
2:4:4,1,1,104188,95812
4:6:3,0,-1,104189,95811
3:3:6,0,-1,104190,95810
1:2:2,2,2,104188,95812
5:2:4,1,1,104187,95813
2:1:5,1,1,104186,95814
3:2:2,2,2,104184,95816
5:3:2,1,1,104183,95817
2:6:4,1,1,104182,95818
2:6:1,1,1,104181,95819
4:5:6,0,-1,104182,95818
1:6:5,0,-1,104183,95817
6:5:2,1,1,104182,95818
5:1:4,0,-1,104183,95817
2:2:5,2,2,104181,95819
5:2:2,2,2,104179,95821
2:5:2,2,2,104177,95823
3:6:1,0,-1,104178,95822
4:3:4,0,-1,104179,95821
6:6:3,0,-1,104180,95820
4:5:2,1,1,104179,95821
5:6:4,0,-1,104180,95820
1:6:5,0,-1,104181,95819
5:5:1,0,-1,104182,95818
5:6:1,0,-1,104183,95817
4:5:6,0,-1,104184,95816
1:6:5,0,-1,104185,95815
4:3:3,0,-1,104186,95814
3:3:6,0,-1,104187,95813
6:2:1,1,1,104186,95814
1:6:3,0,-1,104187,95813
3:2:4,1,1,104186,95814
5:6:1,0,-1,104187,95813
1:5:3,0,-1,104188,95812
6:4:5,0,-1,104189,95811
2:1:6,1,1,104188,95812
5:5:2,1,1,104187,95813
3:2:1,1,1,104186,95814
5:2:3,1,1,104185,95815
4:2:2,2,2,104183,95817
2:4:6,1,1,104182,95818
1:3:4,0,-1,104183,95817
2:4:6,1,1,104182,95818
5:5:6,0,-1,104183,95817
3:1:1,0,-1,104184,95816
4:1:1,0,-1,104185,95815
2:1:4,1,1,104184,95816
4:2:4,1,1,104183,95817
3:3:1,0,-1,104184,95816
1:2:4,1,1,104183,95817
5:6:4,0,-1,104184,95816
6:6:3,0,-1,104185,95815
3:6:1,0,-1,104186,95814
2:6:5,1,1,104185,95815
5:6:4,0,-1,104186,95814
1:1:3,0,-1,104187,95813
1:6:1,0,-1,104188,95812
5:4:6,0,-1,104189,95811
6:5:3,0,-1,104190,95810
2:5:2,2,2,104188,95812
4:2:4,1,1,104187,95813
3:5:4,0,-1,104188,95812
6:6:5,0,-1,104189,95811
4:4:6,0,-1,104190,95810
3:6:2,1,1,104189,95811
5:3:4,0,-1,104190,95810
3:2:2,2,2,104188,95812
6:6:6,0,-1,104189,95811
6:3:1,0,-1,104190,95810
1:1:1,0,-1,104191,95809
6:1:1,0,-1,104192,95808
5:1:3,0,-1,104193,95807
4:1:3,0,-1,104194,95806
4:3:4,0,-1,104195,95805
6:3:6,0,-1,104196,95804
3:2:4,1,1,104195,95805
3:1:5,0,-1,104196,95804
5:5:1,0,-1,104197,95803
5:6:3,0,-1,104198,95802
3:3:6,0,-1,104199,95801
5:3:5,0,-1,104200,95800
3:3:6,0,-1,104201,95799
4:6:1,0,-1,104202,95798
3:4:4,0,-1,104203,95797
4:5:3,0,-1,104204,95796
2:4:2,2,2,104202,95798
3:4:4,0,-1,104203,95797
4:6:1,0,-1,104204,95796
3:5:2,1,1,104203,95797
5:2:1,1,1,104202,95798
4:1:4,0,-1,104203,95797
5:1:3,0,-1,104204,95796
3:4:6,0,-1,104205,95795
1:3:5,0,-1,104206,95794
6:3:2,1,1,104205,95795
1:4:2,1,1,104204,95796
1:6:3,0,-1,104205,95795
5:4:1,0,-1,104206,95794
1:4:2,1,1,104205,95795
5:4:6,0,-1,104206,95794
6:4:6,0,-1,104207,95793
5:3:1,0,-1,104208,95792
1:4:1,0,-1,104209,95791
2:3:3,1,1,104208,95792
6:4:3,0,-1,104209,95791
1:4:6,0,-1,104210,95790
1:2:4,1,1,104209,95791
5:6:4,0,-1,104210,95790
4:2:1,1,1,104209,95791
3:6:4,0,-1,104210,95790
6:1:2,1,1,104209,95791
5:3:3,0,-1,104210,95790
4:1:1,0,-1,104211,95789
1:6:2,1,1,104210,95790
1:2:5,1,1,104209,95791
3:4:1,0,-1,104210,95790
1:3:1,0,-1,104211,95789
1:6:2,1,1,104210,95790
3:6:5,0,-1,104211,95789
1:1:3,0,-1,104212,95788
4:5:2,1,1,104211,95789
5:4:2,1,1,104210,95790
2:4:1,1,1,104209,95791
6:6:2,1,1,104208,95792
2:4:5,1,1,104207,95793
5:3:3,0,-1,104208,95792
4:1:2,1,1,104207,95793
3:3:6,0,-1,104208,95792
3:6:1,0,-1,104209,95791
6:1:6,0,-1,104210,95790
6:3:3,0,-1,104211,95789
2:1:2,2,2,104209,95791
2:5:3,1,1,104208,95792
3:3:5,0,-1,104209,95791
6:2:1,1,1,104208,95792
4:1:6,0,-1,104209,95791
6:2:3,1,1,104208,95792
2:5:6,1,1,104207,95793
2:4:3,1,1,104206,95794
2:5:5,1,1,104205,95795
5:1:6,0,-1,104206,95794
2:4:1,1,1,104205,95795
6:4:5,0,-1,104206,95794
3:3:2,1,1,104205,95795
4:4:3,0,-1,104206,95794
6:6:1,0,-1,104207,95793
4:6:4,0,-1,104208,95792
2:4:6,1,1,104207,95793
5:4:6,0,-1,104208,95792
5:6:6,0,-1,104209,95791
6:2:4,1,1,104208,95792
1:2:1,1,1,104207,95793
2:6:6,1,1,104206,95794
2:1:2,2,2,104204,95796
1:3:6,0,-1,104205,95795
2:3:6,1,1,104204,95796
3:3:6,0,-1,104205,95795
5:1:3,0,-1,104206,95794
2:5:4,1,1,104205,95795
1:4:4,0,-1,104206,95794
6:6:6,0,-1,104207,95793
1:3:4,0,-1,104208,95792
1:4:2,1,1,104207,95793
6:2:1,1,1,104206,95794
1:2:6,1,1,104205,95795
1:1:4,0,-1,104206,95794
3:1:6,0,-1,104207,95793
6:3:2,1,1,104206,95794
5:4:4,0,-1,104207,95793
5:4:1,0,-1,104208,95792
2:2:4,2,2,104206,95794
5:4:2,1,1,104205,95795
6:2:4,1,1,104204,95796
5:6:3,0,-1,104205,95795
5:3:1,0,-1,104206,95794
1:3:1,0,-1,104207,95793
2:5:4,1,1,104206,95794
5:4:1,0,-1,104207,95793
3:1:2,1,1,104206,95794
6:5:2,1,1,104205,95795
6:2:6,1,1,104204,95796
2:3:4,1,1,104203,95797
6:5:1,0,-1,104204,95796
1:2:1,1,1,104203,95797
6:4:6,0,-1,104204,95796
6:3:6,0,-1,104205,95795
6:3:3,0,-1,104206,95794
6:3:2,1,1,104205,95795
3:1:3,0,-1,104206,95794
1:4:4,0,-1,104207,95793
6:4:6,0,-1,104208,95792
1:1:1,0,-1,104209,95791
3:4:5,0,-1,104210,95790
4:1:3,0,-1,104211,95789
5:5:1,0,-1,104212,95788
5:5:6,0,-1,104213,95787
4:1:1,0,-1,104214,95786
3:2:6,1,1,104213,95787
1:6:3,0,-1,104214,95786
1:5:6,0,-1,104215,95785
6:1:1,0,-1,104216,95784
1:1:2,1,1,104215,95785
2:4:6,1,1,104214,95786
2:3:1,1,1,104213,95787
1:3:1,0,-1,104214,95786
5:4:3,0,-1,104215,95785
2:1:3,1,1,104214,95786
1:6:4,0,-1,104215,95785
5:5:3,0,-1,104216,95784
5:2:2,2,2,104214,95786
3:1:1,0,-1,104215,95785
2:6:2,2,2,104213,95787
3:1:6,0,-1,104214,95786
2:1:6,1,1,104213,95787
1:5:6,0,-1,104214,95786
5:6:5,0,-1,104215,95785
3:5:3,0,-1,104216,95784
5:2:2,2,2,104214,95786
2:3:5,1,1,104213,95787
1:5:4,0,-1,104214,95786
3:6:1,0,-1,104215,95785
1:2:1,1,1,104214,95786
3:2:3,1,1,104213,95787
2:2:5,2,2,104211,95789
3:4:6,0,-1,104212,95788
1:6:5,0,-1,104213,95787
3:6:6,0,-1,104214,95786
4:5:5,0,-1,104215,95785
1:6:1,0,-1,104216,95784
1:6:6,0,-1,104217,95783
2:4:4,1,1,104216,95784
6:3:4,0,-1,104217,95783
4:6:1,0,-1,104218,95782
4:2:4,1,1,104217,95783
2:2:3,2,2,104215,95785
1:3:2,1,1,104214,95786
4:6:3,0,-1,104215,95785
3:1:5,0,-1,104216,95784
4:1:4,0,-1,104217,95783
6:4:2,1,1,104216,95784
5:5:6,0,-1,104217,95783
5:4:4,0,-1,104218,95782
3:2:2,2,2,104216,95784
3:5:4,0,-1,104217,95783
5:2:3,1,1,104216,95784
3:3:2,1,1,104215,95785
4:6:4,0,-1,104216,95784
1:2:1,1,1,104215,95785
4:5:4,0,-1,104216,95784
5:5:2,1,1,104215,95785
1:5:5,0,-1,104216,95784
5:6:4,0,-1,104217,95783
2:4:6,1,1,104216,95784
2:6:4,1,1,104215,95785
6:5:3,0,-1,104216,95784
1:6:3,0,-1,104217,95783
1:2:3,1,1,104216,95784
5:4:2,1,1,104215,95785
2:2:6,2,2,104213,95787
2:5:3,1,1,104212,95788
3:2:4,1,1,104211,95789
6:2:3,1,1,104210,95790
1:4:2,1,1,104209,95791
4:3:3,0,-1,104210,95790
1:1:2,1,1,104209,95791
2:6:4,1,1,104208,95792
2:6:1,1,1,104207,95793
6:5:2,1,1,104206,95794
2:5:6,1,1,104205,95795
2:4:6,1,1,104204,95796
4:4:1,0,-1,104205,95795
1:5:2,1,1,104204,95796
3:6:4,0,-1,104205,95795
3:3:1,0,-1,104206,95794
1:3:5,0,-1,104207,95793
5:2:5,1,1,104206,95794
6:5:1,0,-1,104207,95793
4:6:6,0,-1,104208,95792
1:2:6,1,1,104207,95793
6:5:3,0,-1,104208,95792
5:5:6,0,-1,104209,95791
4:1:6,0,-1,104210,95790
3:1:4,0,-1,104211,95789
2:5:1,1,1,104210,95790
6:5:4,0,-1,104211,95789
4:3:1,0,-1,104212,95788
1:2:6,1,1,104211,95789
3:3:5,0,-1,104212,95788
4:5:1,0,-1,104213,95787
1:5:2,1,1,104212,95788
3:3:2,1,1,104211,95789
2:1:6,1,1,104210,95790
3:5:2,1,1,104209,95791
4:4:4,0,-1,104210,95790
4:4:4,0,-1,104211,95789
1:2:2,2,2,104209,95791
1:1:2,1,1,104208,95792
1:2:1,1,1,104207,95793
6:4:3,0,-1,104208,95792
3:4:2,1,1,104207,95793
5:1:2,1,1,104206,95794
1:6:5,0,-1,104207,95793
3:4:5,0,-1,104208,95792
6:4:2,1,1,104207,95793
4:3:6,0,-1,104208,95792
5:1:4,0,-1,104209,95791
2:3:4,1,1,104208,95792
1:5:2,1,1,104207,95793
3:3:2,1,1,104206,95794
4:3:4,0,-1,104207,95793
5:4:1,0,-1,104208,95792
2:3:6,1,1,104207,95793
2:4:3,1,1,104206,95794
1:5:1,0,-1,104207,95793
3:5:2,1,1,104206,95794
4:6:1,0,-1,104207,95793
5:5:6,0,-1,104208,95792
5:5:2,1,1,104207,95793
6:1:1,0,-1,104208,95792
5:3:3,0,-1,104209,95791
1:1:3,0,-1,104210,95790
1:1:3,0,-1,104211,95789
5:4:6,0,-1,104212,95788
3:6:5,0,-1,104213,95787
1:5:6,0,-1,104214,95786
5:6:4,0,-1,104215,95785
6:4:4,0,-1,104216,95784
6:1:2,1,1,104215,95785
4:2:1,1,1,104214,95786
5:5:1,0,-1,104215,95785
1:1:4,0,-1,104216,95784
2:2:1,2,2,104214,95786
1:3:6,0,-1,104215,95785
1:3:1,0,-1,104216,95784
2:5:6,1,1,104215,95785
4:3:3,0,-1,104216,95784
4:3:5,0,-1,104217,95783
1:1:2,1,1,104216,95784
5:2:2,2,2,104214,95786
1:2:4,1,1,104213,95787
4:2:2,2,2,104211,95789
2:4:3,1,1,104210,95790
4:4:2,1,1,104209,95791
5:4:6,0,-1,104210,95790
4:1:5,0,-1,104211,95789
3:5:1,0,-1,104212,95788
6:4:6,0,-1,104213,95787
3:3:4,0,-1,104214,95786
3:4:1,0,-1,104215,95785
5:1:3,0,-1,104216,95784
4:4:3,0,-1,104217,95783
6:4:3,0,-1,104218,95782
5:3:6,0,-1,104219,95781
4:2:3,1,1,104218,95782
3:4:5,0,-1,104219,95781
1:3:5,0,-1,104220,95780
3:1:5,0,-1,104221,95779
4:1:1,0,-1,104222,95778
2:4:1,1,1,104221,95779
2:3:2,2,2,104219,95781
6:2:5,1,1,104218,95782
3:6:2,1,1,104217,95783
4:1:3,0,-1,104218,95782
4:3:4,0,-1,104219,95781
1:4:2,1,1,104218,95782
4:1:6,0,-1,104219,95781
6:2:6,1,1,104218,95782
3:4:5,0,-1,104219,95781
3:3:1,0,-1,104220,95780
5:1:3,0,-1,104221,95779
6:2:3,1,1,104220,95780
4:4:5,0,-1,104221,95779
3:4:3,0,-1,104222,95778
5:2:6,1,1,104221,95779
1:1:1,0,-1,104222,95778
6:5:5,0,-1,104223,95777
2:1:1,1,1,104222,95778
4:1:5,0,-1,104223,95777
3:6:3,0,-1,104224,95776
3:5:4,0,-1,104225,95775
6:3:5,0,-1,104226,95774
6:5:1,0,-1,104227,95773
2:6:4,1,1,104226,95774
5:3:1,0,-1,104227,95773
1:4:5,0,-1,104228,95772
2:2:4,2,2,104226,95774
4:4:6,0,-1,104227,95773
1:5:5,0,-1,104228,95772
1:1:5,0,-1,104229,95771
6:4:2,1,1,104228,95772
5:2:4,1,1,104227,95773
4:6:5,0,-1,104228,95772
2:5:3,1,1,104227,95773
1:4:5,0,-1,104228,95772
1:6:1,0,-1,104229,95771
2:4:4,1,1,104228,95772
5:1:6,0,-1,104229,95771
2:5:3,1,1,104228,95772
2:5:1,1,1,104227,95773
1:2:3,1,1,104226,95774
5:5:4,0,-1,104227,95773
4:2:6,1,1,104226,95774
4:3:1,0,-1,104227,95773
4:1:3,0,-1,104228,95772
1:2:3,1,1,104227,95773
2:5:4,1,1,104226,95774
2:4:6,1,1,104225,95775
3:3:6,0,-1,104226,95774
2:3:6,1,1,104225,95775
6:3:5,0,-1,104226,95774
5:4:1,0,-1,104227,95773
2:5:1,1,1,104226,95774
5:3:6,0,-1,104227,95773
2:3:4,1,1,104226,95774
5:6:5,0,-1,104227,95773
2:4:5,1,1,104226,95774
2:1:6,1,1,104225,95775
1:1:6,0,-1,104226,95774
6:4:3,0,-1,104227,95773
1:1:5,0,-1,104228,95772
2:3:2,2,2,104226,95774
4:1:4,0,-1,104227,95773
2:2:6,2,2,104225,95775
4:2:3,1,1,104224,95776
2:1:3,1,1,104223,95777
4:3:2,1,1,104222,95778
4:1:5,0,-1,104223,95777
1:1:1,0,-1,104224,95776
6:4:6,0,-1,104225,95775
6:5:3,0,-1,104226,95774
3:2:4,1,1,104225,95775
6:6:1,0,-1,104226,95774
2:6:4,1,1,104225,95775
5:5:1,0,-1,104226,95774
1:3:1,0,-1,104227,95773
4:2:5,1,1,104226,95774
1:2:4,1,1,104225,95775
3:4:2,1,1,104224,95776
2:3:1,1,1,104223,95777
3:3:5,0,-1,104224,95776
2:3:2,2,2,104222,95778
2:4:4,1,1,104221,95779
3:6:5,0,-1,104222,95778
2:4:6,1,1,104221,95779
5:2:2,2,2,104219,95781
5:2:3,1,1,104218,95782
1:1:2,1,1,104217,95783
2:1:4,1,1,104216,95784
4:4:1,0,-1,104217,95783
4:5:5,0,-1,104218,95782
3:5:1,0,-1,104219,95781
5:1:4,0,-1,104220,95780
6:4:4,0,-1,104221,95779
2:2:4,2,2,104219,95781
4:1:1,0,-1,104220,95780
6:1:4,0,-1,104221,95779
4:3:1,0,-1,104222,95778
6:3:2,1,1,104221,95779
3:4:5,0,-1,104222,95778
5:5:4,0,-1,104223,95777
3:1:1,0,-1,104224,95776
1:6:3,0,-1,104225,95775
5:5:4,0,-1,104226,95774
2:2:2,3,3,104223,95777
2:1:5,1,1,104222,95778
1:2:6,1,1,104221,95779
4:1:3,0,-1,104222,95778
4:4:4,0,-1,104223,95777
6:5:3,0,-1,104224,95776
1:6:2,1,1,104223,95777
1:3:5,0,-1,104224,95776
3:4:5,0,-1,104225,95775
6:6:2,1,1,104224,95776
1:1:1,0,-1,104225,95775
2:2:1,2,2,104223,95777
6:3:2,1,1,104222,95778
2:3:6,1,1,104221,95779
2:2:3,2,2,104219,95781
3:5:3,0,-1,104220,95780
4:2:4,1,1,104219,95781
1:5:2,1,1,104218,95782
5:3:6,0,-1,104219,95781
3:2:1,1,1,104218,95782
5:2:1,1,1,104217,95783
2:2:6,2,2,104215,95785
1:5:5,0,-1,104216,95784
4:1:5,0,-1,104217,95783
4:4:6,0,-1,104218,95782
6:5:2,1,1,104217,95783
2:4:4,1,1,104216,95784
1:5:5,0,-1,104217,95783
5:6:2,1,1,104216,95784
1:5:2,1,1,104215,95785
3:1:3,0,-1,104216,95784
3:6:5,0,-1,104217,95783
3:5:5,0,-1,104218,95782
3:5:3,0,-1,104219,95781
6:1:1,0,-1,104220,95780
4:1:4,0,-1,104221,95779
2:3:3,1,1,104220,95780
2:3:4,1,1,104219,95781
5:3:1,0,-1,104220,95780
4:1:3,0,-1,104221,95779
5:3:2,1,1,104220,95780
5:3:1,0,-1,104221,95779
2:6:6,1,1,104220,95780
4:5:2,1,1,104219,95781
4:2:4,1,1,104218,95782
3:4:5,0,-1,104219,95781
5:3:6,0,-1,104220,95780
5:2:2,2,2,104218,95782
1:3:6,0,-1,104219,95781
1:4:6,0,-1,104220,95780
2:5:6,1,1,104219,95781
4:1:3,0,-1,104220,95780
5:5:3,0,-1,104221,95779
3:5:3,0,-1,104222,95778
1:3:1,0,-1,104223,95777
6:3:6,0,-1,104224,95776
4:3:6,0,-1,104225,95775
5:4:2,1,1,104224,95776
2:2:2,3,3,104221,95779
4:4:2,1,1,104220,95780
2:1:1,1,1,104219,95781
3:6:1,0,-1,104220,95780
6:5:4,0,-1,104221,95779
3:3:2,1,1,104220,95780
6:1:6,0,-1,104221,95779
5:1:2,1,1,104220,95780
4:2:4,1,1,104219,95781
3:4:5,0,-1,104220,95780
3:4:3,0,-1,104221,95779
3:1:3,0,-1,104222,95778
5:5:2,1,1,104221,95779
2:6:6,1,1,104220,95780
4:1:4,0,-1,104221,95779
3:6:1,0,-1,104222,95778
1:4:1,0,-1,104223,95777
5:6:4,0,-1,104224,95776
1:4:1,0,-1,104225,95775
3:3:5,0,-1,104226,95774
2:4:2,2,2,104224,95776
1:1:4,0,-1,104225,95775
4:5:3,0,-1,104226,95774
4:5:3,0,-1,104227,95773
4:1:6,0,-1,104228,95772
3:4:2,1,1,104227,95773
2:2:4,2,2,104225,95775
5:5:3,0,-1,104226,95774
6:1:5,0,-1,104227,95773
4:2:2,2,2,104225,95775
5:2:3,1,1,104224,95776
4:4:5,0,-1,104225,95775
5:1:2,1,1,104224,95776
1:4:5,0,-1,104225,95775
2:3:3,1,1,104224,95776
6:1:2,1,1,104223,95777
2:2:3,2,2,104221,95779
6:4:1,0,-1,104222,95778
4:6:1,0,-1,104223,95777
5:6:1,0,-1,104224,95776
2:4:6,1,1,104223,95777
3:4:1,0,-1,104224,95776
5:6:1,0,-1,104225,95775
3:3:1,0,-1,104226,95774
6:5:5,0,-1,104227,95773
5:3:2,1,1,104226,95774
1:1:6,0,-1,104227,95773
3:2:2,2,2,104225,95775
4:3:3,0,-1,104226,95774
5:5:6,0,-1,104227,95773
3:5:2,1,1,104226,95774
1:6:4,0,-1,104227,95773
6:1:3,0,-1,104228,95772
2:6:6,1,1,104227,95773
3:3:2,1,1,104226,95774
2:4:1,1,1,104225,95775
5:2:3,1,1,104224,95776
5:5:6,0,-1,104225,95775
5:3:4,0,-1,104226,95774
3:3:1,0,-1,104227,95773
4:3:3,0,-1,104228,95772
3:2:6,1,1,104227,95773
2:3:6,1,1,104226,95774
2:3:4,1,1,104225,95775
3:1:3,0,-1,104226,95774
1:1:6,0,-1,104227,95773
6:5:5,0,-1,104228,95772
6:4:4,0,-1,104229,95771
5:5:2,1,1,104228,95772
5:1:5,0,-1,104229,95771
3:4:3,0,-1,104230,95770
4:1:1,0,-1,104231,95769
5:1:4,0,-1,104232,95768
6:3:2,1,1,104231,95769
1:4:6,0,-1,104232,95768
6:5:5,0,-1,104233,95767
6:6:2,1,1,104232,95768
6:2:1,1,1,104231,95769
3:1:4,0,-1,104232,95768
1:1:6,0,-1,104233,95767
3:1:4,0,-1,104234,95766
3:3:2,1,1,104233,95767
2:5:4,1,1,104232,95768
1:2:5,1,1,104231,95769
6:2:5,1,1,104230,95770
1:6:4,0,-1,104231,95769
3:2:5,1,1,104230,95770
5:5:1,0,-1,104231,95769
2:6:1,1,1,104230,95770
6:5:2,1,1,104229,95771
1:1:4,0,-1,104230,95770
3:2:1,1,1,104229,95771
1:3:6,0,-1,104230,95770
6:4:4,0,-1,104231,95769
6:6:4,0,-1,104232,95768
4:4:4,0,-1,104233,95767
2:3:5,1,1,104232,95768
3:2:4,1,1,104231,95769
5:5:3,0,-1,104232,95768
6:2:2,2,2,104230,95770
1:6:1,0,-1,104231,95769
3:2:4,1,1,104230,95770
3:3:2,1,1,104229,95771
2:5:6,1,1,104228,95772
4:4:4,0,-1,104229,95771
3:3:6,0,-1,104230,95770
6:3:5,0,-1,104231,95769
1:4:5,0,-1,104232,95768
5:2:2,2,2,104230,95770
5:6:3,0,-1,104231,95769
5:1:5,0,-1,104232,95768
3:4:2,1,1,104231,95769
6:4:2,1,1,104230,95770
5:5:6,0,-1,104231,95769
4:2:4,1,1,104230,95770
4:3:4,0,-1,104231,95769
5:6:5,0,-1,104232,95768
3:6:6,0,-1,104233,95767
2:2:4,2,2,104231,95769
1:5:5,0,-1,104232,95768
1:3:6,0,-1,104233,95767
2:6:4,1,1,104232,95768
5:6:1,0,-1,104233,95767
2:5:5,1,1,104232,95768
5:3:5,0,-1,104233,95767
2:5:2,2,2,104231,95769
1:4:2,1,1,104230,95770
2:3:6,1,1,104229,95771
5:5:1,0,-1,104230,95770
5:1:5,0,-1,104231,95769
4:5:4,0,-1,104232,95768
1:6:1,0,-1,104233,95767
6:1:2,1,1,104232,95768
4:3:5,0,-1,104233,95767
4:3:4,0,-1,104234,95766
1:1:3,0,-1,104235,95765
4:3:5,0,-1,104236,95764
2:6:3,1,1,104235,95765
2:1:3,1,1,104234,95766
3:3:1,0,-1,104235,95765
2:4:5,1,1,104234,95766
1:6:6,0,-1,104235,95765
2:4:4,1,1,104234,95766
1:4:3,0,-1,104235,95765
2:3:2,2,2,104233,95767
2:4:4,1,1,104232,95768
1:2:4,1,1,104231,95769
5:6:4,0,-1,104232,95768
4:1:2,1,1,104231,95769
2:6:6,1,1,104230,95770
1:3:1,0,-1,104231,95769
1:4:4,0,-1,104232,95768
2:2:6,2,2,104230,95770
4:1:6,0,-1,104231,95769
1:5:5,0,-1,104232,95768
6:1:6,0,-1,104233,95767
2:4:6,1,1,104232,95768
4:1:6,0,-1,104233,95767
3:5:3,0,-1,104234,95766
6:6:3,0,-1,104235,95765
6:3:2,1,1,104234,95766
2:5:4,1,1,104233,95767
1:3:4,0,-1,104234,95766
2:6:4,1,1,104233,95767
1:3:1,0,-1,104234,95766
1:6:5,0,-1,104235,95765
3:3:2,1,1,104234,95766
1:6:1,0,-1,104235,95765
6:3:6,0,-1,104236,95764
4:1:1,0,-1,104237,95763
2:3:3,1,1,104236,95764
1:1:4,0,-1,104237,95763
4:3:4,0,-1,104238,95762
2:3:3,1,1,104237,95763
3:2:1,1,1,104236,95764
3:3:3,0,-1,104237,95763
2:3:1,1,1,104236,95764
6:2:5,1,1,104235,95765
2:5:6,1,1,104234,95766
6:1:2,1,1,104233,95767
4:3:2,1,1,104232,95768
2:4:4,1,1,104231,95769
3:3:2,1,1,104230,95770
4:4:1,0,-1,104231,95769
5:5:2,1,1,104230,95770
6:1:5,0,-1,104231,95769
4:6:1,0,-1,104232,95768
2:3:4,1,1,104231,95769
5:6:2,1,1,104230,95770
2:4:6,1,1,104229,95771
2:5:5,1,1,104228,95772
5:5:4,0,-1,104229,95771
3:6:4,0,-1,104230,95770
2:4:6,1,1,104229,95771
1:2:1,1,1,104228,95772
5:1:1,0,-1,104229,95771
6:3:4,0,-1,104230,95770
6:1:6,0,-1,104231,95769
4:2:1,1,1,104230,95770
1:1:6,0,-1,104231,95769
4:4:6,0,-1,104232,95768
1:2:4,1,1,104231,95769
1:3:2,1,1,104230,95770
4:6:6,0,-1,104231,95769
5:6:4,0,-1,104232,95768
4:2:2,2,2,104230,95770
3:2:4,1,1,104229,95771
2:6:3,1,1,104228,95772
3:4:1,0,-1,104229,95771
6:1:6,0,-1,104230,95770
6:4:6,0,-1,104231,95769
5:2:6,1,1,104230,95770
5:1:6,0,-1,104231,95769
5:3:5,0,-1,104232,95768
6:2:3,1,1,104231,95769
4:5:2,1,1,104230,95770
2:4:1,1,1,104229,95771
1:2:2,2,2,104227,95773
6:4:5,0,-1,104228,95772
6:6:4,0,-1,104229,95771
1:6:3,0,-1,104230,95770
4:3:4,0,-1,104231,95769
1:6:2,1,1,104230,95770
6:1:5,0,-1,104231,95769
2:5:2,2,2,104229,95771
2:4:2,2,2,104227,95773
2:4:1,1,1,104226,95774
1:4:1,0,-1,104227,95773
5:3:6,0,-1,104228,95772
3:2:6,1,1,104227,95773
1:6:3,0,-1,104228,95772
3:1:5,0,-1,104229,95771
5:6:1,0,-1,104230,95770
6:2:1,1,1,104229,95771
6:1:3,0,-1,104230,95770
6:3:4,0,-1,104231,95769
2:2:6,2,2,104229,95771
5:3:4,0,-1,104230,95770
5:3:2,1,1,104229,95771
2:3:5,1,1,104228,95772
1:1:6,0,-1,104229,95771
1:2:4,1,1,104228,95772
5:1:6,0,-1,104229,95771
5:2:1,1,1,104228,95772
5:1:4,0,-1,104229,95771
5:6:3,0,-1,104230,95770
3:5:4,0,-1,104231,95769
5:2:6,1,1,104230,95770
5:3:2,1,1,104229,95771
4:2:1,1,1,104228,95772
4:4:2,1,1,104227,95773
4:3:6,0,-1,104228,95772
3:4:6,0,-1,104229,95771
4:1:2,1,1,104228,95772
4:1:2,1,1,104227,95773
5:2:2,2,2,104225,95775
3:6:3,0,-1,104226,95774
3:2:3,1,1,104225,95775
6:3:4,0,-1,104226,95774
4:6:6,0,-1,104227,95773
1:5:3,0,-1,104228,95772
2:5:5,1,1,104227,95773
2:4:4,1,1,104226,95774
2:4:4,1,1,104225,95775
2:5:6,1,1,104224,95776
5:5:3,0,-1,104225,95775
3:3:2,1,1,104224,95776
5:5:4,0,-1,104225,95775
6:4:1,0,-1,104226,95774
4:6:6,0,-1,104227,95773
6:4:6,0,-1,104228,95772
3:3:2,1,1,104227,95773
1:3:3,0,-1,104228,95772
1:4:1,0,-1,104229,95771
3:3:4,0,-1,104230,95770
2:5:1,1,1,104229,95771
5:1:4,0,-1,104230,95770
6:2:6,1,1,104229,95771
1:1:3,0,-1,104230,95770
3:6:4,0,-1,104231,95769
6:3:6,0,-1,104232,95768
1:3:4,0,-1,104233,95767
2:3:3,1,1,104232,95768
2:5:1,1,1,104231,95769
5:6:2,1,1,104230,95770
1:3:5,0,-1,104231,95769
6:5:3,0,-1,104232,95768
3:4:1,0,-1,104233,95767
4:4:4,0,-1,104234,95766
3:6:3,0,-1,104235,95765
2:2:6,2,2,104233,95767
2:2:2,3,3,104230,95770
4:1:4,0,-1,104231,95769
6:5:2,1,1,104230,95770
2:1:4,1,1,104229,95771
4:5:2,1,1,104228,95772
5:4:4,0,-1,104229,95771
2:4:5,1,1,104228,95772
5:1:5,0,-1,104229,95771
5:5:5,0,-1,104230,95770
2:4:5,1,1,104229,95771
2:2:3,2,2,104227,95773
5:6:5,0,-1,104228,95772
4:3:5,0,-1,104229,95771
1:1:2,1,1,104228,95772
4:1:1,0,-1,104229,95771
6:4:1,0,-1,104230,95770
2:3:5,1,1,104229,95771
2:5:2,2,2,104227,95773
6:5:6,0,-1,104228,95772
2:5:5,1,1,104227,95773
4:2:5,1,1,104226,95774
3:4:4,0,-1,104227,95773
4:1:1,0,-1,104228,95772
4:5:5,0,-1,104229,95771
1:4:1,0,-1,104230,95770
5:4:2,1,1,104229,95771
4:1:6,0,-1,104230,95770
1:3:1,0,-1,104231,95769
2:5:6,1,1,104230,95770
2:2:2,3,3,104227,95773
4:3:5,0,-1,104228,95772
2:6:5,1,1,104227,95773
6:5:3,0,-1,104228,95772
3:5:6,0,-1,104229,95771
4:6:3,0,-1,104230,95770
4:3:3,0,-1,104231,95769
5:5:2,1,1,104230,95770
4:3:2,1,1,104229,95771
4:3:4,0,-1,104230,95770
3:4:3,0,-1,104231,95769
1:1:2,1,1,104230,95770
6:3:6,0,-1,104231,95769
4:2:6,1,1,104230,95770
3:3:5,0,-1,104231,95769
3:4:2,1,1,104230,95770
5:3:6,0,-1,104231,95769
2:2:1,2,2,104229,95771
4:2:6,1,1,104228,95772
4:6:4,0,-1,104229,95771
5:1:1,0,-1,104230,95770
6:3:4,0,-1,104231,95769
2:5:5,1,1,104230,95770
6:1:5,0,-1,104231,95769
3:2:5,1,1,104230,95770
5:6:3,0,-1,104231,95769
2:3:3,1,1,104230,95770
5:2:4,1,1,104229,95771
2:1:6,1,1,104228,95772
2:6:3,1,1,104227,95773
6:3:1,0,-1,104228,95772
6:6:4,0,-1,104229,95771
4:4:4,0,-1,104230,95770
3:2:1,1,1,104229,95771
3:5:5,0,-1,104230,95770
2:1:1,1,1,104229,95771
4:3:1,0,-1,104230,95770
1:6:5,0,-1,104231,95769
2:6:2,2,2,104229,95771
3:6:6,0,-1,104230,95770
6:6:6,0,-1,104231,95769
2:5:3,1,1,104230,95770
3:1:3,0,-1,104231,95769
2:3:2,2,2,104229,95771
2:3:6,1,1,104228,95772
5:5:5,0,-1,104229,95771
5:4:3,0,-1,104230,95770
5:3:6,0,-1,104231,95769
3:3:4,0,-1,104232,95768
3:3:5,0,-1,104233,95767
4:1:3,0,-1,104234,95766
2:6:6,1,1,104233,95767
6:1:1,0,-1,104234,95766
4:2:2,2,2,104232,95768
1:5:4,0,-1,104233,95767
1:5:2,1,1,104232,95768
2:5:4,1,1,104231,95769
5:1:3,0,-1,104232,95768
4:2:6,1,1,104231,95769
1:3:4,0,-1,104232,95768
2:6:3,1,1,104231,95769
3:3:5,0,-1,104232,95768
2:2:6,2,2,104230,95770
1:2:1,1,1,104229,95771
1:2:1,1,1,104228,95772
6:5:4,0,-1,104229,95771
2:5:4,1,1,104228,95772
6:3:6,0,-1,104229,95771
5:3:5,0,-1,104230,95770
4:3:2,1,1,104229,95771
2:3:2,2,2,104227,95773
5:5:3,0,-1,104228,95772
5:4:3,0,-1,104229,95771
6:5:6,0,-1,104230,95770
1:1:4,0,-1,104231,95769
4:4:6,0,-1,104232,95768
4:4:3,0,-1,104233,95767
2:3:1,1,1,104232,95768
6:2:2,2,2,104230,95770
1:5:3,0,-1,104231,95769
2:3:2,2,2,104229,95771
5:4:1,0,-1,104230,95770
2:4:5,1,1,104229,95771
5:6:2,1,1,104228,95772
3:2:4,1,1,104227,95773
1:3:5,0,-1,104228,95772
2:1:3,1,1,104227,95773
2:3:5,1,1,104226,95774
6:2:3,1,1,104225,95775
6:4:3,0,-1,104226,95774
6:2:3,1,1,104225,95775
2:1:2,2,2,104223,95777
1:4:5,0,-1,104224,95776
3:2:3,1,1,104223,95777
3:2:1,1,1,104222,95778
2:4:5,1,1,104221,95779
6:6:1,0,-1,104222,95778
2:4:2,2,2,104220,95780
3:3:5,0,-1,104221,95779
2:6:4,1,1,104220,95780
4:5:4,0,-1,104221,95779
4:2:4,1,1,104220,95780
2:4:1,1,1,104219,95781
1:3:6,0,-1,104220,95780
4:6:1,0,-1,104221,95779
5:5:3,0,-1,104222,95778
4:1:5,0,-1,104223,95777
2:6:1,1,1,104222,95778
3:3:1,0,-1,104223,95777
3:2:6,1,1,104222,95778
2:2:5,2,2,104220,95780
3:2:5,1,1,104219,95781
4:2:3,1,1,104218,95782
3:5:1,0,-1,104219,95781
2:6:4,1,1,104218,95782
3:6:3,0,-1,104219,95781
4:1:4,0,-1,104220,95780
6:1:5,0,-1,104221,95779
4:2:5,1,1,104220,95780
5:6:6,0,-1,104221,95779
6:2:5,1,1,104220,95780
4:1:2,1,1,104219,95781
6:3:3,0,-1,104220,95780
1:2:4,1,1,104219,95781
5:6:5,0,-1,104220,95780
5:3:3,0,-1,104221,95779
4:1:2,1,1,104220,95780
4:3:4,0,-1,104221,95779
2:6:5,1,1,104220,95780
3:4:3,0,-1,104221,95779
6:5:2,1,1,104220,95780
2:6:4,1,1,104219,95781
6:2:4,1,1,104218,95782
6:5:2,1,1,104217,95783
1:3:3,0,-1,104218,95782
2:2:1,2,2,104216,95784
5:6:6,0,-1,104217,95783
4:3:3,0,-1,104218,95782
5:2:1,1,1,104217,95783
1:4:5,0,-1,104218,95782
6:3:5,0,-1,104219,95781
6:6:4,0,-1,104220,95780
5:6:4,0,-1,104221,95779
1:5:3,0,-1,104222,95778
1:6:2,1,1,104221,95779
1:2:4,1,1,104220,95780
6:5:6,0,-1,104221,95779
3:2:6,1,1,104220,95780
5:2:4,1,1,104219,95781
3:5:4,0,-1,104220,95780
2:4:3,1,1,104219,95781
6:6:6,0,-1,104220,95780
2:4:3,1,1,104219,95781
6:1:1,0,-1,104220,95780
4:5:3,0,-1,104221,95779
1:3:5,0,-1,104222,95778
4:6:2,1,1,104221,95779
2:4:6,1,1,104220,95780
6:4:5,0,-1,104221,95779
5:6:3,0,-1,104222,95778
2:3:6,1,1,104221,95779
3:6:3,0,-1,104222,95778
1:6:1,0,-1,104223,95777
3:3:5,0,-1,104224,95776
2:5:3,1,1,104223,95777
6:5:1,0,-1,104224,95776
4:3:3,0,-1,104225,95775
2:1:6,1,1,104224,95776
5:4:4,0,-1,104225,95775
4:3:2,1,1,104224,95776
1:4:3,0,-1,104225,95775
3:5:4,0,-1,104226,95774
6:3:1,0,-1,104227,95773
6:3:1,0,-1,104228,95772
6:5:1,0,-1,104229,95771
2:4:4,1,1,104228,95772
1:3:4,0,-1,104229,95771
4:3:6,0,-1,104230,95770
6:6:1,0,-1,104231,95769
2:2:4,2,2,104229,95771
6:6:5,0,-1,104230,95770
4:2:1,1,1,104229,95771
1:4:6,0,-1,104230,95770
3:5:2,1,1,104229,95771
6:2:4,1,1,104228,95772
4:3:3,0,-1,104229,95771
3:3:5,0,-1,104230,95770
4:3:1,0,-1,104231,95769
4:5:3,0,-1,104232,95768
3:3:4,0,-1,104233,95767
3:4:6,0,-1,104234,95766
4:2:4,1,1,104233,95767
2:1:1,1,1,104232,95768
6:3:1,0,-1,104233,95767
2:3:5,1,1,104232,95768
3:6:5,0,-1,104233,95767
4:1:6,0,-1,104234,95766
1:3:1,0,-1,104235,95765
6:4:2,1,1,104234,95766
2:2:4,2,2,104232,95768
4:3:6,0,-1,104233,95767
5:5:6,0,-1,104234,95766
4:5:1,0,-1,104235,95765
5:2:4,1,1,104234,95766
3:3:3,0,-1,104235,95765
5:4:3,0,-1,104236,95764
6:3:2,1,1,104235,95765
5:6:1,0,-1,104236,95764
1:1:4,0,-1,104237,95763
6:2:3,1,1,104236,95764
2:3:4,1,1,104235,95765
2:4:6,1,1,104234,95766
2:5:2,2,2,104232,95768
3:3:1,0,-1,104233,95767
1:1:2,1,1,104232,95768
3:2:3,1,1,104231,95769
6:5:3,0,-1,104232,95768
2:3:1,1,1,104231,95769
1:4:3,0,-1,104232,95768
4:1:1,0,-1,104233,95767
3:1:6,0,-1,104234,95766
1:1:2,1,1,104233,95767
5:3:3,0,-1,104234,95766
2:4:1,1,1,104233,95767
1:2:5,1,1,104232,95768
5:5:5,0,-1,104233,95767
2:1:4,1,1,104232,95768
6:5:2,1,1,104231,95769
5:3:5,0,-1,104232,95768
1:1:1,0,-1,104233,95767
6:2:1,1,1,104232,95768
6:5:3,0,-1,104233,95767
2:1:4,1,1,104232,95768
6:3:3,0,-1,104233,95767
2:6:1,1,1,104232,95768
6:4:4,0,-1,104233,95767
3:1:6,0,-1,104234,95766
3:1:1,0,-1,104235,95765
2:3:6,1,1,104234,95766
4:1:5,0,-1,104235,95765
1:5:2,1,1,104234,95766
6:3:5,0,-1,104235,95765
1:2:1,1,1,104234,95766
2:1:3,1,1,104233,95767
2:4:2,2,2,104231,95769
2:3:1,1,1,104230,95770
5:2:6,1,1,104229,95771
5:1:2,1,1,104228,95772
4:4:2,1,1,104227,95773
5:1:4,0,-1,104228,95772
2:4:1,1,1,104227,95773
4:1:3,0,-1,104228,95772
2:3:6,1,1,104227,95773
4:5:1,0,-1,104228,95772
1:6:2,1,1,104227,95773
4:4:2,1,1,104226,95774
4:6:5,0,-1,104227,95773
2:5:6,1,1,104226,95774
2:4:2,2,2,104224,95776
3:5:1,0,-1,104225,95775
2:5:6,1,1,104224,95776
5:6:1,0,-1,104225,95775
2:3:1,1,1,104224,95776
2:2:6,2,2,104222,95778
2:1:4,1,1,104221,95779
3:2:4,1,1,104220,95780
4:3:2,1,1,104219,95781
2:5:6,1,1,104218,95782
6:1:3,0,-1,104219,95781
6:3:6,0,-1,104220,95780
5:1:4,0,-1,104221,95779
3:1:2,1,1,104220,95780
3:6:5,0,-1,104221,95779
2:1:5,1,1,104220,95780
6:4:2,1,1,104219,95781
5:6:6,0,-1,104220,95780
3:1:2,1,1,104219,95781
5:5:5,0,-1,104220,95780
6:3:6,0,-1,104221,95779
6:1:6,0,-1,104222,95778
3:3:4,0,-1,104223,95777
6:3:6,0,-1,104224,95776
2:2:2,3,3,104221,95779
6:2:2,2,2,104219,95781
2:1:4,1,1,104218,95782
2:1:4,1,1,104217,95783
2:3:5,1,1,104216,95784
4:2:3,1,1,104215,95785
4:2:2,2,2,104213,95787
1:1:3,0,-1,104214,95786
2:5:3,1,1,104213,95787
6:6:5,0,-1,104214,95786
1:3:1,0,-1,104215,95785
2:4:2,2,2,104213,95787
3:2:6,1,1,104212,95788
3:1:2,1,1,104211,95789
3:4:4,0,-1,104212,95788
4:3:2,1,1,104211,95789
6:3:6,0,-1,104212,95788
2:4:4,1,1,104211,95789
1:3:1,0,-1,104212,95788
5:2:2,2,2,104210,95790
3:2:6,1,1,104209,95791
6:6:2,1,1,104208,95792
1:6:3,0,-1,104209,95791
2:4:1,1,1,104208,95792
1:6:2,1,1,104207,95793
3:4:2,1,1,104206,95794
3:1:1,0,-1,104207,95793
3:3:1,0,-1,104208,95792
6:1:3,0,-1,104209,95791
1:6:1,0,-1,104210,95790
5:4:3,0,-1,104211,95789
1:1:2,1,1,104210,95790
1:6:2,1,1,104209,95791
1:1:4,0,-1,104210,95790
4:2:4,1,1,104209,95791
6:4:6,0,-1,104210,95790
4:3:4,0,-1,104211,95789
5:3:4,0,-1,104212,95788
1:5:6,0,-1,104213,95787
2:5:2,2,2,104211,95789
6:2:1,1,1,104210,95790
5:5:4,0,-1,104211,95789
5:3:4,0,-1,104212,95788
1:3:5,0,-1,104213,95787
3:5:3,0,-1,104214,95786
5:5:5,0,-1,104215,95785
3:1:4,0,-1,104216,95784
1:6:3,0,-1,104217,95783
5:1:1,0,-1,104218,95782
1:5:6,0,-1,104219,95781
6:1:3,0,-1,104220,95780
3:1:6,0,-1,104221,95779
1:3:4,0,-1,104222,95778
2:5:3,1,1,104221,95779
3:5:1,0,-1,104222,95778
1:3:2,1,1,104221,95779
4:5:2,1,1,104220,95780
4:1:1,0,-1,104221,95779
6:1:3,0,-1,104222,95778
3:4:4,0,-1,104223,95777
5:3:1,0,-1,104224,95776
3:2:4,1,1,104223,95777
6:2:3,1,1,104222,95778
2:3:2,2,2,104220,95780
2:1:5,1,1,104219,95781
6:5:3,0,-1,104220,95780
4:4:6,0,-1,104221,95779
4:2:3,1,1,104220,95780
5:4:6,0,-1,104221,95779
5:1:4,0,-1,104222,95778
6:6:2,1,1,104221,95779
3:2:1,1,1,104220,95780
3:4:5,0,-1,104221,95779
6:1:2,1,1,104220,95780
5:5:2,1,1,104219,95781
4:5:4,0,-1,104220,95780
3:1:2,1,1,104219,95781
6:6:6,0,-1,104220,95780
5:1:1,0,-1,104221,95779
4:4:2,1,1,104220,95780
4:2:5,1,1,104219,95781
3:4:2,1,1,104218,95782
4:2:4,1,1,104217,95783
6:1:3,0,-1,104218,95782
4:3:2,1,1,104217,95783
1:4:5,0,-1,104218,95782
3:4:3,0,-1,104219,95781
6:1:2,1,1,104218,95782
4:6:6,0,-1,104219,95781
5:6:1,0,-1,104220,95780
6:1:5,0,-1,104221,95779
4:1:5,0,-1,104222,95778
2:1:2,2,2,104220,95780
6:2:2,2,2,104218,95782
6:1:5,0,-1,104219,95781
6:5:2,1,1,104218,95782
2:3:4,1,1,104217,95783
3:6:1,0,-1,104218,95782
4:1:3,0,-1,104219,95781
6:2:4,1,1,104218,95782
2:5:6,1,1,104217,95783
5:4:6,0,-1,104218,95782
5:3:3,0,-1,104219,95781
2:2:3,2,2,104217,95783
5:6:4,0,-1,104218,95782
3:6:1,0,-1,104219,95781
3:3:5,0,-1,104220,95780
2:4:6,1,1,104219,95781
6:2:3,1,1,104218,95782
4:5:4,0,-1,104219,95781
1:5:4,0,-1,104220,95780
4:5:6,0,-1,104221,95779
2:5:2,2,2,104219,95781
6:5:5,0,-1,104220,95780
6:1:4,0,-1,104221,95779
1:5:1,0,-1,104222,95778
2:3:3,1,1,104221,95779
1:1:2,1,1,104220,95780
2:4:4,1,1,104219,95781
5:1:1,0,-1,104220,95780
5:1:3,0,-1,104221,95779
6:3:4,0,-1,104222,95778
2:2:1,2,2,104220,95780
1:5:4,0,-1,104221,95779
5:4:5,0,-1,104222,95778
6:1:2,1,1,104221,95779
6:2:1,1,1,104220,95780
1:1:5,0,-1,104221,95779
5:1:5,0,-1,104222,95778
1:4:4,0,-1,104223,95777
3:2:6,1,1,104222,95778
6:5:6,0,-1,104223,95777
2:6:1,1,1,104222,95778
2:2:1,2,2,104220,95780
3:1:4,0,-1,104221,95779
2:1:1,1,1,104220,95780
6:3:4,0,-1,104221,95779
3:3:1,0,-1,104222,95778
4:4:1,0,-1,104223,95777
6:4:5,0,-1,104224,95776
3:2:4,1,1,104223,95777
5:2:6,1,1,104222,95778
6:6:3,0,-1,104223,95777
5:1:3,0,-1,104224,95776
5:6:4,0,-1,104225,95775
4:6:4,0,-1,104226,95774
1:2:6,1,1,104225,95775
6:6:4,0,-1,104226,95774
4:3:5,0,-1,104227,95773
1:4:1,0,-1,104228,95772
2:1:3,1,1,104227,95773
2:5:2,2,2,104225,95775
2:4:2,2,2,104223,95777
6:1:5,0,-1,104224,95776
5:3:1,0,-1,104225,95775
1:5:6,0,-1,104226,95774
3:5:5,0,-1,104227,95773
2:3:2,2,2,104225,95775
5:3:1,0,-1,104226,95774
6:3:4,0,-1,104227,95773
4:1:2,1,1,104226,95774
4:5:6,0,-1,104227,95773
5:3:4,0,-1,104228,95772
6:3:6,0,-1,104229,95771
2:1:6,1,1,104228,95772
1:5:5,0,-1,104229,95771
3:4:4,0,-1,104230,95770
1:3:6,0,-1,104231,95769
6:3:5,0,-1,104232,95768
4:5:4,0,-1,104233,95767
4:3:3,0,-1,104234,95766
3:2:1,1,1,104233,95767
4:4:2,1,1,104232,95768
3:2:6,1,1,104231,95769
5:6:6,0,-1,104232,95768
1:4:2,1,1,104231,95769
5:4:2,1,1,104230,95770
6:5:6,0,-1,104231,95769
6:1:3,0,-1,104232,95768
1:4:3,0,-1,104233,95767
4:4:1,0,-1,104234,95766
3:4:3,0,-1,104235,95765
5:6:6,0,-1,104236,95764
1:5:3,0,-1,104237,95763
3:1:1,0,-1,104238,95762
3:1:5,0,-1,104239,95761
2:4:6,1,1,104238,95762
2:3:5,1,1,104237,95763
6:2:5,1,1,104236,95764
6:6:2,1,1,104235,95765
1:4:6,0,-1,104236,95764
5:6:4,0,-1,104237,95763
5:5:5,0,-1,104238,95762
2:1:6,1,1,104237,95763
3:3:4,0,-1,104238,95762
5:2:1,1,1,104237,95763
5:4:3,0,-1,104238,95762
4:6:2,1,1,104237,95763
2:6:3,1,1,104236,95764
1:3:5,0,-1,104237,95763
3:5:6,0,-1,104238,95762
5:2:5,1,1,104237,95763
3:4:4,0,-1,104238,95762
5:3:6,0,-1,104239,95761
6:5:1,0,-1,104240,95760
5:6:5,0,-1,104241,95759
1:3:1,0,-1,104242,95758
3:5:1,0,-1,104243,95757
5:3:1,0,-1,104244,95756
1:3:6,0,-1,104245,95755
3:2:3,1,1,104244,95756
4:3:4,0,-1,104245,95755
4:5:5,0,-1,104246,95754
1:2:5,1,1,104245,95755
3:5:1,0,-1,104246,95754
5:2:1,1,1,104245,95755
4:4:1,0,-1,104246,95754
6:1:5,0,-1,104247,95753
4:6:5,0,-1,104248,95752
2:2:3,2,2,104246,95754
1:4:2,1,1,104245,95755
1:3:4,0,-1,104246,95754
1:5:1,0,-1,104247,95753
5:6:6,0,-1,104248,95752
1:2:3,1,1,104247,95753
5:2:2,2,2,104245,95755
2:1:6,1,1,104244,95756
3:2:5,1,1,104243,95757
4:3:3,0,-1,104244,95756
2:3:5,1,1,104243,95757
3:2:3,1,1,104242,95758
2:5:5,1,1,104241,95759
1:6:1,0,-1,104242,95758
4:3:6,0,-1,104243,95757
6:5:2,1,1,104242,95758
5:1:3,0,-1,104243,95757
2:6:3,1,1,104242,95758
2:4:4,1,1,104241,95759
6:1:1,0,-1,104242,95758
4:1:6,0,-1,104243,95757
1:1:1,0,-1,104244,95756
2:6:4,1,1,104243,95757
2:3:6,1,1,104242,95758
3:3:4,0,-1,104243,95757
3:1:6,0,-1,104244,95756
4:4:5,0,-1,104245,95755
5:3:2,1,1,104244,95756
3:2:5,1,1,104243,95757
2:3:4,1,1,104242,95758
1:4:4,0,-1,104243,95757
4:5:3,0,-1,104244,95756
6:2:6,1,1,104243,95757
1:4:5,0,-1,104244,95756
5:5:2,1,1,104243,95757
3:3:6,0,-1,104244,95756
1:2:2,2,2,104242,95758
6:4:5,0,-1,104243,95757
6:4:5,0,-1,104244,95756
6:1:5,0,-1,104245,95755
1:6:2,1,1,104244,95756
2:6:6,1,1,104243,95757
4:3:6,0,-1,104244,95756
1:5:5,0,-1,104245,95755
4:3:5,0,-1,104246,95754
1:4:3,0,-1,104247,95753
3:2:2,2,2,104245,95755
5:1:1,0,-1,104246,95754
4:2:2,2,2,104244,95756
3:2:5,1,1,104243,95757
4:1:3,0,-1,104244,95756
4:3:2,1,1,104243,95757
6:5:6,0,-1,104244,95756
2:1:3,1,1,104243,95757
4:2:4,1,1,104242,95758
6:3:3,0,-1,104243,95757
1:6:2,1,1,104242,95758
5:6:4,0,-1,104243,95757
5:1:3,0,-1,104244,95756
6:4:1,0,-1,104245,95755
5:4:2,1,1,104244,95756
6:1:2,1,1,104243,95757
4:4:5,0,-1,104244,95756
6:2:2,2,2,104242,95758
3:1:5,0,-1,104243,95757
4:3:1,0,-1,104244,95756
1:3:2,1,1,104243,95757
3:3:6,0,-1,104244,95756
2:3:6,1,1,104243,95757
4:4:6,0,-1,104244,95756
2:3:1,1,1,104243,95757
2:4:4,1,1,104242,95758
5:1:1,0,-1,104243,95757
4:6:1,0,-1,104244,95756
6:5:4,0,-1,104245,95755
2:6:1,1,1,104244,95756
1:4:4,0,-1,104245,95755
3:1:2,1,1,104244,95756
5:3:1,0,-1,104245,95755
5:5:1,0,-1,104246,95754
1:1:4,0,-1,104247,95753
1:5:1,0,-1,104248,95752
4:5:2,1,1,104247,95753
5:1:5,0,-1,104248,95752
4:3:5,0,-1,104249,95751
5:6:6,0,-1,104250,95750
3:6:5,0,-1,104251,95749
5:1:4,0,-1,104252,95748
6:2:5,1,1,104251,95749
1:4:5,0,-1,104252,95748
2:5:6,1,1,104251,95749
1:6:6,0,-1,104252,95748
2:4:2,2,2,104250,95750
3:5:2,1,1,104249,95751
1:1:1,0,-1,104250,95750
3:2:2,2,2,104248,95752
5:1:3,0,-1,104249,95751
6:1:1,0,-1,104250,95750
2:5:1,1,1,104249,95751
2:4:5,1,1,104248,95752
1:3:6,0,-1,104249,95751
3:4:2,1,1,104248,95752
3:4:4,0,-1,104249,95751
6:3:2,1,1,104248,95752
5:1:6,0,-1,104249,95751
1:5:1,0,-1,104250,95750
5:4:3,0,-1,104251,95749
1:2:1,1,1,104250,95750
2:4:5,1,1,104249,95751
1:3:3,0,-1,104250,95750
5:2:1,1,1,104249,95751
4:3:5,0,-1,104250,95750
2:4:2,2,2,104248,95752
6:5:2,1,1,104247,95753
3:4:1,0,-1,104248,95752
6:1:1,0,-1,104249,95751
1:1:3,0,-1,104250,95750
4:1:6,0,-1,104251,95749
4:2:6,1,1,104250,95750
2:5:1,1,1,104249,95751
4:1:4,0,-1,104250,95750
6:2:4,1,1,104249,95751
4:2:4,1,1,104248,95752
2:1:4,1,1,104247,95753
4:5:2,1,1,104246,95754
2:6:1,1,1,104245,95755
1:3:6,0,-1,104246,95754
1:3:6,0,-1,104247,95753
1:2:4,1,1,104246,95754
3:6:6,0,-1,104247,95753
1:4:5,0,-1,104248,95752
3:1:4,0,-1,104249,95751
4:5:6,0,-1,104250,95750
1:6:1,0,-1,104251,95749
1:5:4,0,-1,104252,95748
3:1:6,0,-1,104253,95747
2:1:1,1,1,104252,95748
4:4:2,1,1,104251,95749
4:6:4,0,-1,104252,95748
4:5:1,0,-1,104253,95747
4:6:6,0,-1,104254,95746
5:3:3,0,-1,104255,95745
4:1:2,1,1,104254,95746
2:5:3,1,1,104253,95747
5:5:6,0,-1,104254,95746
1:5:4,0,-1,104255,95745
5:4:5,0,-1,104256,95744
6:4:4,0,-1,104257,95743
2:6:4,1,1,104256,95744
3:2:2,2,2,104254,95746
2:6:1,1,1,104253,95747
6:3:1,0,-1,104254,95746
5:4:5,0,-1,104255,95745
5:6:5,0,-1,104256,95744
1:2:4,1,1,104255,95745
4:3:1,0,-1,104256,95744
1:6:2,1,1,104255,95745
3:4:3,0,-1,104256,95744
2:5:4,1,1,104255,95745
4:4:3,0,-1,104256,95744
5:3:1,0,-1,104257,95743
2:5:1,1,1,104256,95744
1:5:4,0,-1,104257,95743
6:1:6,0,-1,104258,95742
1:3:5,0,-1,104259,95741
3:4:5,0,-1,104260,95740
5:1:4,0,-1,104261,95739
3:3:2,1,1,104260,95740
1:1:1,0,-1,104261,95739
2:6:3,1,1,104260,95740
6:2:2,2,2,104258,95742
5:1:5,0,-1,104259,95741
2:4:4,1,1,104258,95742
4:3:6,0,-1,104259,95741
5:6:4,0,-1,104260,95740
1:4:5,0,-1,104261,95739
4:4:5,0,-1,104262,95738
6:2:6,1,1,104261,95739
6:6:2,1,1,104260,95740
4:4:4,0,-1,104261,95739
1:6:1,0,-1,104262,95738
2:5:6,1,1,104261,95739
1:2:5,1,1,104260,95740
4:3:6,0,-1,104261,95739
3:6:5,0,-1,104262,95738
2:2:5,2,2,104260,95740
2:6:1,1,1,104259,95741
4:1:5,0,-1,104260,95740
1:5:6,0,-1,104261,95739
3:6:1,0,-1,104262,95738
4:4:6,0,-1,104263,95737
1:1:1,0,-1,104264,95736
6:3:3,0,-1,104265,95735
1:5:6,0,-1,104266,95734
6:4:3,0,-1,104267,95733
2:2:6,2,2,104265,95735
5:2:6,1,1,104264,95736
6:5:5,0,-1,104265,95735
4:6:1,0,-1,104266,95734
5:4:2,1,1,104265,95735
1:2:5,1,1,104264,95736
4:2:3,1,1,104263,95737
3:3:6,0,-1,104264,95736
2:5:6,1,1,104263,95737
4:2:1,1,1,104262,95738
5:4:4,0,-1,104263,95737
1:2:6,1,1,104262,95738
1:4:1,0,-1,104263,95737
2:2:4,2,2,104261,95739
5:4:6,0,-1,104262,95738
1:3:2,1,1,104261,95739
4:4:6,0,-1,104262,95738
5:2:2,2,2,104260,95740
3:4:1,0,-1,104261,95739
4:2:3,1,1,104260,95740
4:5:6,0,-1,104261,95739
2:4:2,2,2,104259,95741
3:6:4,0,-1,104260,95740
5:5:4,0,-1,104261,95739
5:2:6,1,1,104260,95740
4:5:4,0,-1,104261,95739
5:2:6,1,1,104260,95740
5:3:1,0,-1,104261,95739
4:4:1,0,-1,104262,95738
1:6:3,0,-1,104263,95737
4:6:3,0,-1,104264,95736
4:6:6,0,-1,104265,95735
3:5:2,1,1,104264,95736
2:2:2,3,3,104261,95739
1:6:4,0,-1,104262,95738
5:6:1,0,-1,104263,95737
6:5:3,0,-1,104264,95736
4:6:4,0,-1,104265,95735
2:1:5,1,1,104264,95736
2:4:2,2,2,104262,95738
2:1:2,2,2,104260,95740
5:2:2,2,2,104258,95742
3:6:1,0,-1,104259,95741
2:4:2,2,2,104257,95743
5:6:6,0,-1,104258,95742
5:4:3,0,-1,104259,95741
1:1:5,0,-1,104260,95740
2:6:4,1,1,104259,95741
6:1:6,0,-1,104260,95740
1:5:5,0,-1,104261,95739
3:5:4,0,-1,104262,95738
2:3:6,1,1,104261,95739
3:3:3,0,-1,104262,95738
5:5:2,1,1,104261,95739
3:4:1,0,-1,104262,95738
1:5:5,0,-1,104263,95737
5:3:4,0,-1,104264,95736
6:3:6,0,-1,104265,95735
3:2:2,2,2,104263,95737
1:3:1,0,-1,104264,95736
1:3:1,0,-1,104265,95735
4:2:4,1,1,104264,95736
1:5:3,0,-1,104265,95735
5:5:5,0,-1,104266,95734
1:5:6,0,-1,104267,95733
4:4:1,0,-1,104268,95732
6:5:3,0,-1,104269,95731
5:5:3,0,-1,104270,95730
5:5:6,0,-1,104271,95729
6:2:5,1,1,104270,95730
2:1:3,1,1,104269,95731
5:4:3,0,-1,104270,95730
1:3:2,1,1,104269,95731
2:6:4,1,1,104268,95732
2:6:1,1,1,104267,95733
1:2:5,1,1,104266,95734
5:4:1,0,-1,104267,95733
4:2:1,1,1,104266,95734
4:6:6,0,-1,104267,95733
1:4:6,0,-1,104268,95732
1:1:4,0,-1,104269,95731
1:3:1,0,-1,104270,95730
5:4:5,0,-1,104271,95729
1:2:2,2,2,104269,95731
4:6:4,0,-1,104270,95730
3:5:6,0,-1,104271,95729
3:3:5,0,-1,104272,95728
4:6:1,0,-1,104273,95727
4:6:5,0,-1,104274,95726
3:1:3,0,-1,104275,95725
5:1:6,0,-1,104276,95724
1:2:5,1,1,104275,95725
2:4:6,1,1,104274,95726
3:6:6,0,-1,104275,95725
3:5:3,0,-1,104276,95724
5:2:1,1,1,104275,95725
5:6:1,0,-1,104276,95724
3:1:1,0,-1,104277,95723
3:4:4,0,-1,104278,95722
4:4:1,0,-1,104279,95721
2:1:5,1,1,104278,95722
2:6:3,1,1,104277,95723
4:5:2,1,1,104276,95724
1:3:2,1,1,104275,95725
3:2:2,2,2,104273,95727
2:3:2,2,2,104271,95729
6:3:2,1,1,104270,95730
1:5:4,0,-1,104271,95729
5:4:4,0,-1,104272,95728
1:5:2,1,1,104271,95729
1:1:3,0,-1,104272,95728
3:3:5,0,-1,104273,95727
5:6:3,0,-1,104274,95726
2:5:5,1,1,104273,95727
3:3:5,0,-1,104274,95726
1:4:5,0,-1,104275,95725
1:4:2,1,1,104274,95726
2:1:2,2,2,104272,95728
3:2:1,1,1,104271,95729
4:1:2,1,1,104270,95730
3:2:3,1,1,104269,95731
5:6:2,1,1,104268,95732
4:5:1,0,-1,104269,95731
6:6:6,0,-1,104270,95730
6:6:2,1,1,104269,95731
4:3:6,0,-1,104270,95730
5:4:1,0,-1,104271,95729
3:5:2,1,1,104270,95730
2:3:1,1,1,104269,95731
1:5:6,0,-1,104270,95730
1:6:3,0,-1,104271,95729
5:4:4,0,-1,104272,95728
5:6:5,0,-1,104273,95727
1:1:6,0,-1,104274,95726
1:5:4,0,-1,104275,95725
2:3:4,1,1,104274,95726
2:1:1,1,1,104273,95727
6:2:6,1,1,104272,95728
1:1:6,0,-1,104273,95727
6:6:4,0,-1,104274,95726
1:2:6,1,1,104273,95727
4:5:4,0,-1,104274,95726
2:6:2,2,2,104272,95728
4:4:6,0,-1,104273,95727
2:1:4,1,1,104272,95728
1:6:4,0,-1,104273,95727
6:4:2,1,1,104272,95728
4:3:2,1,1,104271,95729
1:4:6,0,-1,104272,95728
3:3:6,0,-1,104273,95727
4:1:2,1,1,104272,95728
1:5:1,0,-1,104273,95727
5:6:6,0,-1,104274,95726
4:5:3,0,-1,104275,95725
6:4:5,0,-1,104276,95724
3:2:1,1,1,104275,95725
2:5:1,1,1,104274,95726
5:2:2,2,2,104272,95728
2:4:2,2,2,104270,95730
6:5:1,0,-1,104271,95729
3:6:5,0,-1,104272,95728
1:4:6,0,-1,104273,95727
6:2:6,1,1,104272,95728
2:6:4,1,1,104271,95729
2:2:6,2,2,104269,95731
5:6:3,0,-1,104270,95730
2:1:1,1,1,104269,95731
2:5:6,1,1,104268,95732
3:5:1,0,-1,104269,95731
4:2:2,2,2,104267,95733
6:1:4,0,-1,104268,95732
4:4:4,0,-1,104269,95731
3:4:5,0,-1,104270,95730
5:4:6,0,-1,104271,95729
2:2:4,2,2,104269,95731
1:1:2,1,1,104268,95732
1:3:3,0,-1,104269,95731
6:3:4,0,-1,104270,95730
1:6:6,0,-1,104271,95729
2:2:1,2,2,104269,95731
3:1:6,0,-1,104270,95730
3:2:4,1,1,104269,95731
4:1:1,0,-1,104270,95730
5:4:4,0,-1,104271,95729
1:6:4,0,-1,104272,95728
4:1:1,0,-1,104273,95727
4:3:6,0,-1,104274,95726
6:3:4,0,-1,104275,95725
3:1:6,0,-1,104276,95724
6:2:2,2,2,104274,95726
5:6:3,0,-1,104275,95725
5:3:3,0,-1,104276,95724
2:6:6,1,1,104275,95725
6:3:6,0,-1,104276,95724
1:1:5,0,-1,104277,95723
5:1:1,0,-1,104278,95722
3:1:2,1,1,104277,95723
6:4:6,0,-1,104278,95722
3:5:6,0,-1,104279,95721
6:5:1,0,-1,104280,95720
3:2:4,1,1,104279,95721
2:4:3,1,1,104278,95722
3:5:2,1,1,104277,95723
6:1:4,0,-1,104278,95722
2:4:4,1,1,104277,95723
3:5:6,0,-1,104278,95722
6:2:2,2,2,104276,95724
1:6:5,0,-1,104277,95723
4:5:3,0,-1,104278,95722
4:5:5,0,-1,104279,95721
5:1:4,0,-1,104280,95720
5:5:6,0,-1,104281,95719
6:3:2,1,1,104280,95720
1:5:6,0,-1,104281,95719
4:3:2,1,1,104280,95720
3:6:3,0,-1,104281,95719
4:3:2,1,1,104280,95720
6:5:1,0,-1,104281,95719
4:4:5,0,-1,104282,95718
4:3:4,0,-1,104283,95717
5:4:1,0,-1,104284,95716
4:4:5,0,-1,104285,95715
4:5:5,0,-1,104286,95714
1:5:5,0,-1,104287,95713
4:6:2,1,1,104286,95714
4:6:2,1,1,104285,95715
4:4:4,0,-1,104286,95714
6:6:1,0,-1,104287,95713
1:6:1,0,-1,104288,95712
4:1:5,0,-1,104289,95711
5:2:1,1,1,104288,95712
1:3:6,0,-1,104289,95711
3:2:4,1,1,104288,95712
6:6:1,0,-1,104289,95711
3:4:6,0,-1,104290,95710
2:2:6,2,2,104288,95712
3:6:5,0,-1,104289,95711
3:2:1,1,1,104288,95712
6:6:3,0,-1,104289,95711
4:6:6,0,-1,104290,95710
3:4:5,0,-1,104291,95709
1:4:5,0,-1,104292,95708
4:4:3,0,-1,104293,95707
6:6:2,1,1,104292,95708
4:5:1,0,-1,104293,95707
4:2:6,1,1,104292,95708
2:5:5,1,1,104291,95709
5:2:5,1,1,104290,95710
4:2:2,2,2,104288,95712
6:4:3,0,-1,104289,95711
4:3:4,0,-1,104290,95710
3:2:2,2,2,104288,95712
2:1:1,1,1,104287,95713
3:2:5,1,1,104286,95714
4:3:2,1,1,104285,95715
3:6:2,1,1,104284,95716
1:4:3,0,-1,104285,95715
2:1:4,1,1,104284,95716
3:6:3,0,-1,104285,95715
5:2:4,1,1,104284,95716
1:1:4,0,-1,104285,95715
2:2:6,2,2,104283,95717
2:6:2,2,2,104281,95719
5:1:5,0,-1,104282,95718
2:2:5,2,2,104280,95720
2:1:6,1,1,104279,95721
2:6:1,1,1,104278,95722
5:2:2,2,2,104276,95724
5:4:5,0,-1,104277,95723
2:5:1,1,1,104276,95724
4:5:6,0,-1,104277,95723
6:2:1,1,1,104276,95724
6:5:6,0,-1,104277,95723
1:5:1,0,-1,104278,95722
4:1:6,0,-1,104279,95721
5:4:4,0,-1,104280,95720
1:2:1,1,1,104279,95721
2:2:3,2,2,104277,95723
1:2:3,1,1,104276,95724
4:5:6,0,-1,104277,95723
4:3:2,1,1,104276,95724
2:2:3,2,2,104274,95726
5:5:2,1,1,104273,95727
3:6:2,1,1,104272,95728
6:4:1,0,-1,104273,95727
2:4:2,2,2,104271,95729
6:4:2,1,1,104270,95730
1:3:6,0,-1,104271,95729
6:2:2,2,2,104269,95731
5:1:5,0,-1,104270,95730
1:6:3,0,-1,104271,95729
4:3:6,0,-1,104272,95728
2:5:6,1,1,104271,95729
5:2:2,2,2,104269,95731
5:5:2,1,1,104268,95732
5:2:4,1,1,104267,95733
3:5:2,1,1,104266,95734
6:4:5,0,-1,104267,95733
1:4:3,0,-1,104268,95732
4:6:5,0,-1,104269,95731
6:2:6,1,1,104268,95732
4:5:2,1,1,104267,95733
3:2:5,1,1,104266,95734
6:1:2,1,1,104265,95735
2:2:2,3,3,104262,95738
3:2:2,2,2,104260,95740
5:5:3,0,-1,104261,95739
5:6:3,0,-1,104262,95738
4:6:6,0,-1,104263,95737
5:5:6,0,-1,104264,95736
4:6:4,0,-1,104265,95735
2:2:1,2,2,104263,95737
4:6:4,0,-1,104264,95736
5:3:2,1,1,104263,95737
2:6:3,1,1,104262,95738
4:3:4,0,-1,104263,95737
3:4:3,0,-1,104264,95736
4:3:4,0,-1,104265,95735
3:1:2,1,1,104264,95736
6:3:5,0,-1,104265,95735
4:2:6,1,1,104264,95736
2:4:3,1,1,104263,95737
2:1:5,1,1,104262,95738
4:6:6,0,-1,104263,95737
3:6:4,0,-1,104264,95736
1:6:1,0,-1,104265,95735
2:4:6,1,1,104264,95736
1:4:4,0,-1,104265,95735
4:5:6,0,-1,104266,95734
2:3:4,1,1,104265,95735
4:6:4,0,-1,104266,95734
3:5:6,0,-1,104267,95733
6:4:3,0,-1,104268,95732
6:2:5,1,1,104267,95733
5:2:4,1,1,104266,95734
5:6:3,0,-1,104267,95733
4:6:4,0,-1,104268,95732
3:4:4,0,-1,104269,95731
6:2:5,1,1,104268,95732
4:2:6,1,1,104267,95733
5:1:1,0,-1,104268,95732
4:4:3,0,-1,104269,95731
6:4:2,1,1,104268,95732
2:3:3,1,1,104267,95733
6:5:4,0,-1,104268,95732
5:3:3,0,-1,104269,95731
6:2:6,1,1,104268,95732
3:4:4,0,-1,104269,95731
2:4:1,1,1,104268,95732
1:5:2,1,1,104267,95733
1:1:3,0,-1,104268,95732
4:3:2,1,1,104267,95733
1:3:6,0,-1,104268,95732
5:3:6,0,-1,104269,95731
3:1:4,0,-1,104270,95730
3:2:3,1,1,104269,95731
4:6:6,0,-1,104270,95730
1:4:3,0,-1,104271,95729
5:1:6,0,-1,104272,95728
1:2:4,1,1,104271,95729
2:2:6,2,2,104269,95731
5:2:1,1,1,104268,95732
5:1:3,0,-1,104269,95731
3:5:3,0,-1,104270,95730
6:3:6,0,-1,104271,95729
2:5:2,2,2,104269,95731
5:5:6,0,-1,104270,95730
4:4:3,0,-1,104271,95729
1:2:6,1,1,104270,95730
4:2:1,1,1,104269,95731
1:1:6,0,-1,104270,95730
3:4:2,1,1,104269,95731
6:6:6,0,-1,104270,95730
6:1:4,0,-1,104271,95729
5:5:3,0,-1,104272,95728
4:4:4,0,-1,104273,95727
5:3:4,0,-1,104274,95726
1:4:5,0,-1,104275,95725
2:6:1,1,1,104274,95726
2:2:2,3,3,104271,95729
3:2:1,1,1,104270,95730
6:3:6,0,-1,104271,95729
3:1:3,0,-1,104272,95728
2:5:5,1,1,104271,95729
2:1:1,1,1,104270,95730
1:3:1,0,-1,104271,95729
6:1:1,0,-1,104272,95728
4:5:1,0,-1,104273,95727
5:3:5,0,-1,104274,95726
2:6:5,1,1,104273,95727
1:5:1,0,-1,104274,95726
1:6:6,0,-1,104275,95725
3:6:3,0,-1,104276,95724
3:1:4,0,-1,104277,95723
4:3:6,0,-1,104278,95722
4:2:4,1,1,104277,95723
6:5:4,0,-1,104278,95722
2:2:5,2,2,104276,95724
4:3:3,0,-1,104277,95723
5:5:1,0,-1,104278,95722
4:5:4,0,-1,104279,95721
5:5:1,0,-1,104280,95720
3:1:2,1,1,104279,95721
2:2:5,2,2,104277,95723
2:5:3,1,1,104276,95724
4:3:1,0,-1,104277,95723
5:2:3,1,1,104276,95724
6:3:6,0,-1,104277,95723
3:2:3,1,1,104276,95724
5:1:4,0,-1,104277,95723
2:6:6,1,1,104276,95724
1:6:5,0,-1,104277,95723
1:2:1,1,1,104276,95724
4:6:1,0,-1,104277,95723
1:1:6,0,-1,104278,95722
5:5:5,0,-1,104279,95721
5:4:5,0,-1,104280,95720
6:6:5,0,-1,104281,95719
6:6:3,0,-1,104282,95718
2:3:2,2,2,104280,95720
2:1:4,1,1,104279,95721
2:6:2,2,2,104277,95723
6:4:1,0,-1,104278,95722
5:4:6,0,-1,104279,95721
4:5:1,0,-1,104280,95720
4:2:1,1,1,104279,95721
4:2:6,1,1,104278,95722
6:5:3,0,-1,104279,95721
4:3:3,0,-1,104280,95720
4:5:4,0,-1,104281,95719
1:5:6,0,-1,104282,95718
4:5:3,0,-1,104283,95717
2:5:6,1,1,104282,95718
1:1:1,0,-1,104283,95717
2:2:5,2,2,104281,95719
2:3:3,1,1,104280,95720
1:5:3,0,-1,104281,95719
1:6:6,0,-1,104282,95718
1:2:1,1,1,104281,95719
3:5:6,0,-1,104282,95718
3:4:5,0,-1,104283,95717
6:1:6,0,-1,104284,95716
5:4:2,1,1,104283,95717
4:1:1,0,-1,104284,95716
1:2:4,1,1,104283,95717
1:5:5,0,-1,104284,95716
3:5:5,0,-1,104285,95715
2:1:3,1,1,104284,95716
5:2:6,1,1,104283,95717
1:3:3,0,-1,104284,95716
5:2:2,2,2,104282,95718
4:2:4,1,1,104281,95719
2:6:5,1,1,104280,95720
3:1:4,0,-1,104281,95719
1:1:4,0,-1,104282,95718
5:2:5,1,1,104281,95719
3:5:2,1,1,104280,95720
6:6:6,0,-1,104281,95719
6:2:4,1,1,104280,95720
4:2:2,2,2,104278,95722
5:5:5,0,-1,104279,95721
4:5:2,1,1,104278,95722
1:3:6,0,-1,104279,95721
5:3:5,0,-1,104280,95720
2:4:3,1,1,104279,95721
2:5:6,1,1,104278,95722
4:4:5,0,-1,104279,95721
4:6:5,0,-1,104280,95720
6:4:3,0,-1,104281,95719
6:2:4,1,1,104280,95720
5:6:5,0,-1,104281,95719
1:3:4,0,-1,104282,95718
3:4:5,0,-1,104283,95717
1:6:2,1,1,104282,95718
3:6:1,0,-1,104283,95717
4:5:5,0,-1,104284,95716
5:3:3,0,-1,104285,95715
4:2:5,1,1,104284,95716
1:5:4,0,-1,104285,95715
1:5:5,0,-1,104286,95714
3:3:1,0,-1,104287,95713
1:5:2,1,1,104286,95714
2:6:5,1,1,104285,95715
6:4:6,0,-1,104286,95714
4:5:3,0,-1,104287,95713
6:4:3,0,-1,104288,95712
4:5:3,0,-1,104289,95711
5:6:3,0,-1,104290,95710
3:4:1,0,-1,104291,95709
1:4:4,0,-1,104292,95708
1:5:2,1,1,104291,95709
5:1:5,0,-1,104292,95708
6:6:4,0,-1,104293,95707
5:6:6,0,-1,104294,95706
1:2:6,1,1,104293,95707
4:5:2,1,1,104292,95708
4:6:3,0,-1,104293,95707
5:3:4,0,-1,104294,95706
2:2:2,3,3,104291,95709
1:6:4,0,-1,104292,95708
6:5:2,1,1,104291,95709
4:4:2,1,1,104290,95710
1:4:2,1,1,104289,95711
4:2:1,1,1,104288,95712
3:5:3,0,-1,104289,95711
4:3:2,1,1,104288,95712
1:6:5,0,-1,104289,95711
2:5:4,1,1,104288,95712
1:2:1,1,1,104287,95713
6:1:4,0,-1,104288,95712
2:3:4,1,1,104287,95713
1:2:1,1,1,104286,95714
6:2:1,1,1,104285,95715
3:4:6,0,-1,104286,95714
6:4:3,0,-1,104287,95713
5:3:1,0,-1,104288,95712
2:6:2,2,2,104286,95714
3:6:6,0,-1,104287,95713
2:1:4,1,1,104286,95714
3:4:1,0,-1,104287,95713
3:5:4,0,-1,104288,95712
4:1:2,1,1,104287,95713
1:3:2,1,1,104286,95714
6:6:6,0,-1,104287,95713
5:5:3,0,-1,104288,95712
4:5:2,1,1,104287,95713
5:5:4,0,-1,104288,95712
3:3:3,0,-1,104289,95711
5:5:4,0,-1,104290,95710
6:1:2,1,1,104289,95711
2:6:2,2,2,104287,95713
4:1:4,0,-1,104288,95712
5:2:6,1,1,104287,95713
4:1:1,0,-1,104288,95712
2:3:6,1,1,104287,95713
6:4:6,0,-1,104288,95712
1:6:2,1,1,104287,95713
4:5:2,1,1,104286,95714
5:5:3,0,-1,104287,95713
3:2:2,2,2,104285,95715
6:2:3,1,1,104284,95716
2:4:1,1,1,104283,95717
1:4:2,1,1,104282,95718
1:5:6,0,-1,104283,95717
5:2:4,1,1,104282,95718
2:5:1,1,1,104281,95719
5:2:4,1,1,104280,95720
6:3:5,0,-1,104281,95719
6:6:3,0,-1,104282,95718
4:3:6,0,-1,104283,95717
2:4:6,1,1,104282,95718
4:6:2,1,1,104281,95719
6:2:4,1,1,104280,95720
3:2:5,1,1,104279,95721
2:2:1,2,2,104277,95723
3:1:2,1,1,104276,95724
6:1:5,0,-1,104277,95723
5:2:1,1,1,104276,95724
5:1:2,1,1,104275,95725
2:2:1,2,2,104273,95727
2:4:2,2,2,104271,95729
1:3:4,0,-1,104272,95728
4:2:3,1,1,104271,95729
4:3:3,0,-1,104272,95728
6:2:1,1,1,104271,95729
3:2:5,1,1,104270,95730
4:6:6,0,-1,104271,95729
4:1:6,0,-1,104272,95728
3:5:5,0,-1,104273,95727
6:5:6,0,-1,104274,95726
5:6:3,0,-1,104275,95725
5:2:6,1,1,104274,95726
4:1:2,1,1,104273,95727
3:3:6,0,-1,104274,95726
6:1:4,0,-1,104275,95725
5:3:1,0,-1,104276,95724
5:6:3,0,-1,104277,95723
2:5:1,1,1,104276,95724
1:2:5,1,1,104275,95725
3:4:2,1,1,104274,95726
2:2:3,2,2,104272,95728
1:5:1,0,-1,104273,95727
5:5:4,0,-1,104274,95726
5:4:2,1,1,104273,95727
2:1:3,1,1,104272,95728
2:5:1,1,1,104271,95729
6:4:2,1,1,104270,95730
5:4:6,0,-1,104271,95729
1:6:5,0,-1,104272,95728
4:1:5,0,-1,104273,95727
1:3:6,0,-1,104274,95726
5:1:6,0,-1,104275,95725
4:3:2,1,1,104274,95726
6:4:2,1,1,104273,95727
1:5:3,0,-1,104274,95726
3:2:3,1,1,104273,95727
6:5:5,0,-1,104274,95726
2:5:5,1,1,104273,95727
3:5:1,0,-1,104274,95726
5:6:1,0,-1,104275,95725
3:1:1,0,-1,104276,95724
4:2:1,1,1,104275,95725
6:2:1,1,1,104274,95726
2:3:2,2,2,104272,95728
4:6:1,0,-1,104273,95727
3:3:4,0,-1,104274,95726
3:4:5,0,-1,104275,95725
5:6:5,0,-1,104276,95724
3:4:3,0,-1,104277,95723
3:3:5,0,-1,104278,95722
1:1:4,0,-1,104279,95721
4:6:1,0,-1,104280,95720
3:5:3,0,-1,104281,95719
6:4:1,0,-1,104282,95718
6:4:5,0,-1,104283,95717
6:6:4,0,-1,104284,95716
1:2:2,2,2,104282,95718
5:3:5,0,-1,104283,95717
1:6:3,0,-1,104284,95716
3:5:4,0,-1,104285,95715
1:1:4,0,-1,104286,95714
3:1:4,0,-1,104287,95713
6:3:1,0,-1,104288,95712
1:3:2,1,1,104287,95713
1:4:1,0,-1,104288,95712
5:2:3,1,1,104287,95713
1:2:3,1,1,104286,95714
6:6:5,0,-1,104287,95713
5:5:2,1,1,104286,95714
2:1:2,2,2,104284,95716
2:2:3,2,2,104282,95718
2:1:1,1,1,104281,95719
1:6:4,0,-1,104282,95718
4:3:6,0,-1,104283,95717
6:2:4,1,1,104282,95718
4:6:6,0,-1,104283,95717
2:2:1,2,2,104281,95719
2:1:3,1,1,104280,95720
4:4:2,1,1,104279,95721
6:1:1,0,-1,104280,95720
3:5:6,0,-1,104281,95719
5:6:1,0,-1,104282,95718
5:3:5,0,-1,104283,95717
5:1:6,0,-1,104284,95716
4:3:3,0,-1,104285,95715
1:4:1,0,-1,104286,95714
4:4:2,1,1,104285,95715
4:4:4,0,-1,104286,95714
1:6:5,0,-1,104287,95713
4:3:2,1,1,104286,95714
1:2:5,1,1,104285,95715
4:3:5,0,-1,104286,95714
6:2:1,1,1,104285,95715
5:5:5,0,-1,104286,95714
2:2:6,2,2,104284,95716
6:5:4,0,-1,104285,95715
6:5:2,1,1,104284,95716
5:1:2,1,1,104283,95717
5:2:5,1,1,104282,95718
3:1:2,1,1,104281,95719
6:1:4,0,-1,104282,95718
5:6:5,0,-1,104283,95717
1:5:6,0,-1,104284,95716
6:3:5,0,-1,104285,95715
2:6:6,1,1,104284,95716
6:2:5,1,1,104283,95717
2:4:4,1,1,104282,95718
5:5:5,0,-1,104283,95717
4:4:4,0,-1,104284,95716
4:1:1,0,-1,104285,95715
2:4:5,1,1,104284,95716
4:1:3,0,-1,104285,95715
1:5:4,0,-1,104286,95714
6:4:1,0,-1,104287,95713
2:4:4,1,1,104286,95714
5:2:1,1,1,104285,95715
1:5:1,0,-1,104286,95714
6:5:6,0,-1,104287,95713
1:3:3,0,-1,104288,95712
4:4:1,0,-1,104289,95711
6:4:1,0,-1,104290,95710
6:3:3,0,-1,104291,95709
6:6:1,0,-1,104292,95708
5:2:2,2,2,104290,95710
5:2:5,1,1,104289,95711
5:5:3,0,-1,104290,95710
2:4:1,1,1,104289,95711
3:6:1,0,-1,104290,95710
5:6:3,0,-1,104291,95709
1:3:5,0,-1,104292,95708
4:4:6,0,-1,104293,95707
4:1:4,0,-1,104294,95706
4:2:6,1,1,104293,95707
5:5:5,0,-1,104294,95706
1:5:2,1,1,104293,95707
1:5:4,0,-1,104294,95706
4:6:6,0,-1,104295,95705
6:6:6,0,-1,104296,95704
3:4:5,0,-1,104297,95703
5:4:5,0,-1,104298,95702
5:4:1,0,-1,104299,95701
6:1:2,1,1,104298,95702
2:6:4,1,1,104297,95703
6:5:4,0,-1,104298,95702
2:4:1,1,1,104297,95703
1:1:4,0,-1,104298,95702
3:2:2,2,2,104296,95704
3:6:5,0,-1,104297,95703
4:3:6,0,-1,104298,95702
3:1:1,0,-1,104299,95701
1:2:2,2,2,104297,95703
3:6:3,0,-1,104298,95702
4:6:4,0,-1,104299,95701
4:5:1,0,-1,104300,95700
5:4:5,0,-1,104301,95699
1:2:4,1,1,104300,95700
3:6:3,0,-1,104301,95699
1:2:5,1,1,104300,95700
2:6:4,1,1,104299,95701
4:6:4,0,-1,104300,95700
1:3:6,0,-1,104301,95699
3:1:2,1,1,104300,95700
2:4:2,2,2,104298,95702
3:5:1,0,-1,104299,95701
1:2:3,1,1,104298,95702
5:6:1,0,-1,104299,95701
2:4:2,2,2,104297,95703
2:6:6,1,1,104296,95704
2:2:5,2,2,104294,95706
6:3:1,0,-1,104295,95705
6:4:2,1,1,104294,95706
4:1:2,1,1,104293,95707
4:6:1,0,-1,104294,95706
5:6:6,0,-1,104295,95705
1:5:3,0,-1,104296,95704
6:4:1,0,-1,104297,95703
3:6:1,0,-1,104298,95702
4:6:1,0,-1,104299,95701
3:1:6,0,-1,104300,95700
2:5:3,1,1,104299,95701
2:2:1,2,2,104297,95703
2:1:6,1,1,104296,95704
4:6:4,0,-1,104297,95703
6:1:5,0,-1,104298,95702
1:3:5,0,-1,104299,95701
1:2:3,1,1,104298,95702
4:5:2,1,1,104297,95703
2:3:4,1,1,104296,95704
6:2:1,1,1,104295,95705
3:1:1,0,-1,104296,95704
1:5:6,0,-1,104297,95703
2:3:3,1,1,104296,95704
4:4:3,0,-1,104297,95703
5:2:4,1,1,104296,95704
2:3:6,1,1,104295,95705
2:6:5,1,1,104294,95706
5:5:2,1,1,104293,95707
2:1:3,1,1,104292,95708
4:2:6,1,1,104291,95709
1:2:3,1,1,104290,95710
5:1:5,0,-1,104291,95709
1:3:2,1,1,104290,95710
3:3:1,0,-1,104291,95709
5:1:1,0,-1,104292,95708
2:1:6,1,1,104291,95709
2:2:2,3,3,104288,95712
5:6:3,0,-1,104289,95711
2:4:3,1,1,104288,95712
6:2:4,1,1,104287,95713
6:4:5,0,-1,104288,95712
2:5:6,1,1,104287,95713
3:5:1,0,-1,104288,95712
6:1:5,0,-1,104289,95711
3:6:5,0,-1,104290,95710
6:3:6,0,-1,104291,95709
2:5:5,1,1,104290,95710
6:4:5,0,-1,104291,95709
6:4:3,0,-1,104292,95708
1:5:5,0,-1,104293,95707
3:1:2,1,1,104292,95708
3:5:2,1,1,104291,95709
6:5:4,0,-1,104292,95708
1:6:5,0,-1,104293,95707
1:2:2,2,2,104291,95709
2:5:1,1,1,104290,95710
3:3:4,0,-1,104291,95709
6:5:5,0,-1,104292,95708
6:5:3,0,-1,104293,95707
2:3:5,1,1,104292,95708
2:6:5,1,1,104291,95709
3:6:2,1,1,104290,95710
6:6:5,0,-1,104291,95709
6:3:6,0,-1,104292,95708
4:1:5,0,-1,104293,95707
2:3:2,2,2,104291,95709
2:1:6,1,1,104290,95710
2:6:3,1,1,104289,95711
5:5:6,0,-1,104290,95710
3:4:3,0,-1,104291,95709
2:6:1,1,1,104290,95710
2:4:5,1,1,104289,95711
5:3:1,0,-1,104290,95710
1:4:3,0,-1,104291,95709
5:5:5,0,-1,104292,95708
4:2:1,1,1,104291,95709
5:6:2,1,1,104290,95710
4:1:4,0,-1,104291,95709
6:6:2,1,1,104290,95710
6:3:2,1,1,104289,95711
2:6:2,2,2,104287,95713
2:2:5,2,2,104285,95715
2:5:3,1,1,104284,95716
4:5:4,0,-1,104285,95715
4:1:2,1,1,104284,95716
4:1:6,0,-1,104285,95715
4:6:3,0,-1,104286,95714
6:4:5,0,-1,104287,95713
4:3:4,0,-1,104288,95712
4:2:6,1,1,104287,95713
2:6:3,1,1,104286,95714
2:1:6,1,1,104285,95715
3:2:5,1,1,104284,95716
4:1:5,0,-1,104285,95715
5:3:4,0,-1,104286,95714
6:2:2,2,2,104284,95716
4:4:2,1,1,104283,95717
3:6:6,0,-1,104284,95716
4:1:6,0,-1,104285,95715
4:3:2,1,1,104284,95716
6:2:2,2,2,104282,95718
6:1:1,0,-1,104283,95717
6:3:4,0,-1,104284,95716
6:3:1,0,-1,104285,95715
5:2:2,2,2,104283,95717
3:5:4,0,-1,104284,95716
1:5:6,0,-1,104285,95715
1:6:2,1,1,104284,95716
4:1:5,0,-1,104285,95715
4:4:5,0,-1,104286,95714
2:5:5,1,1,104285,95715
1:2:2,2,2,104283,95717
6:2:3,1,1,104282,95718
6:4:3,0,-1,104283,95717
5:6:2,1,1,104282,95718
6:3:5,0,-1,104283,95717
3:4:1,0,-1,104284,95716
5:6:1,0,-1,104285,95715
1:6:5,0,-1,104286,95714
6:3:5,0,-1,104287,95713
4:4:1,0,-1,104288,95712
6:4:1,0,-1,104289,95711
5:3:6,0,-1,104290,95710
5:1:1,0,-1,104291,95709
2:1:6,1,1,104290,95710
2:6:5,1,1,104289,95711
2:5:2,2,2,104287,95713
1:5:6,0,-1,104288,95712
2:2:6,2,2,104286,95714
3:6:5,0,-1,104287,95713
5:4:6,0,-1,104288,95712
6:5:1,0,-1,104289,95711
4:4:6,0,-1,104290,95710
6:2:6,1,1,104289,95711
6:2:4,1,1,104288,95712
2:3:5,1,1,104287,95713
1:2:2,2,2,104285,95715
2:2:3,2,2,104283,95717
3:6:1,0,-1,104284,95716
5:1:1,0,-1,104285,95715
4:5:3,0,-1,104286,95714
1:6:4,0,-1,104287,95713
3:2:4,1,1,104286,95714
5:3:5,0,-1,104287,95713
1:4:6,0,-1,104288,95712
3:6:4,0,-1,104289,95711
1:1:2,1,1,104288,95712
1:3:3,0,-1,104289,95711
4:1:3,0,-1,104290,95710
1:1:4,0,-1,104291,95709
5:3:5,0,-1,104292,95708
3:3:1,0,-1,104293,95707
3:6:3,0,-1,104294,95706
5:5:4,0,-1,104295,95705
5:4:4,0,-1,104296,95704
2:5:4,1,1,104295,95705
4:6:5,0,-1,104296,95704
4:1:5,0,-1,104297,95703
4:3:1,0,-1,104298,95702
3:1:6,0,-1,104299,95701
5:4:6,0,-1,104300,95700
2:3:6,1,1,104299,95701
6:6:5,0,-1,104300,95700
1:2:3,1,1,104299,95701
5:1:5,0,-1,104300,95700
5:6:5,0,-1,104301,95699
2:5:6,1,1,104300,95700
2:2:3,2,2,104298,95702
5:3:5,0,-1,104299,95701
1:3:1,0,-1,104300,95700
3:3:6,0,-1,104301,95699
3:6:3,0,-1,104302,95698
1:4:3,0,-1,104303,95697
4:4:6,0,-1,104304,95696
6:1:4,0,-1,104305,95695
1:2:5,1,1,104304,95696
4:5:1,0,-1,104305,95695
6:6:4,0,-1,104306,95694
3:2:3,1,1,104305,95695
2:6:5,1,1,104304,95696
3:1:4,0,-1,104305,95695
4:3:5,0,-1,104306,95694
1:2:5,1,1,104305,95695
4:3:6,0,-1,104306,95694
5:4:1,0,-1,104307,95693
1:6:2,1,1,104306,95694
6:2:5,1,1,104305,95695
5:2:1,1,1,104304,95696
4:5:4,0,-1,104305,95695
1:5:5,0,-1,104306,95694
3:6:1,0,-1,104307,95693
5:3:4,0,-1,104308,95692
5:6:3,0,-1,104309,95691
4:1:2,1,1,104308,95692
5:2:2,2,2,104306,95694
3:2:3,1,1,104305,95695
4:6:5,0,-1,104306,95694
3:3:1,0,-1,104307,95693
1:4:6,0,-1,104308,95692
3:6:2,1,1,104307,95693
1:6:6,0,-1,104308,95692
1:6:1,0,-1,104309,95691
5:5:5,0,-1,104310,95690
2:4:1,1,1,104309,95691
1:1:1,0,-1,104310,95690
6:4:5,0,-1,104311,95689
5:2:6,1,1,104310,95690
1:3:5,0,-1,104311,95689
5:5:4,0,-1,104312,95688
2:3:5,1,1,104311,95689
5:6:5,0,-1,104312,95688
1:1:2,1,1,104311,95689
1:5:6,0,-1,104312,95688
2:4:3,1,1,104311,95689
6:5:4,0,-1,104312,95688
3:4:2,1,1,104311,95689
6:2:3,1,1,104310,95690
4:4:5,0,-1,104311,95689
5:4:4,0,-1,104312,95688
6:2:6,1,1,104311,95689
6:5:4,0,-1,104312,95688
1:4:1,0,-1,104313,95687
2:3:3,1,1,104312,95688
1:1:6,0,-1,104313,95687
4:1:4,0,-1,104314,95686
3:4:4,0,-1,104315,95685
5:4:6,0,-1,104316,95684
6:4:2,1,1,104315,95685
4:2:3,1,1,104314,95686
2:6:5,1,1,104313,95687
2:5:3,1,1,104312,95688
1:2:4,1,1,104311,95689
5:6:2,1,1,104310,95690
4:3:6,0,-1,104311,95689
4:4:1,0,-1,104312,95688
2:6:6,1,1,104311,95689
2:3:6,1,1,104310,95690
4:1:3,0,-1,104311,95689
1:6:2,1,1,104310,95690
3:1:5,0,-1,104311,95689
2:4:1,1,1,104310,95690
3:3:5,0,-1,104311,95689
3:4:2,1,1,104310,95690
4:6:5,0,-1,104311,95689
2:4:3,1,1,104310,95690
5:2:6,1,1,104309,95691
1:6:6,0,-1,104310,95690
1:6:3,0,-1,104311,95689
4:5:4,0,-1,104312,95688
5:6:4,0,-1,104313,95687
2:1:5,1,1,104312,95688
3:6:6,0,-1,104313,95687
1:2:5,1,1,104312,95688
4:5:5,0,-1,104313,95687
5:4:5,0,-1,104314,95686
2:5:3,1,1,104313,95687
5:5:3,0,-1,104314,95686
5:5:3,0,-1,104315,95685
2:2:4,2,2,104313,95687
5:6:2,1,1,104312,95688
3:5:5,0,-1,104313,95687
6:6:3,0,-1,104314,95686
6:3:4,0,-1,104315,95685
6:2:5,1,1,104314,95686
4:4:3,0,-1,104315,95685
5:3:2,1,1,104314,95686
2:5:1,1,1,104313,95687
1:2:4,1,1,104312,95688
6:5:6,0,-1,104313,95687
6:4:3,0,-1,104314,95686
3:1:4,0,-1,104315,95685
6:5:3,0,-1,104316,95684
6:1:3,0,-1,104317,95683
6:2:2,2,2,104315,95685
2:5:3,1,1,104314,95686
5:3:6,0,-1,104315,95685
5:5:4,0,-1,104316,95684
5:1:1,0,-1,104317,95683
6:5:4,0,-1,104318,95682
6:1:1,0,-1,104319,95681
6:1:4,0,-1,104320,95680
4:2:6,1,1,104319,95681
3:6:6,0,-1,104320,95680
5:4:5,0,-1,104321,95679
2:5:4,1,1,104320,95680
2:3:6,1,1,104319,95681
5:4:2,1,1,104318,95682
2:2:5,2,2,104316,95684
3:2:2,2,2,104314,95686
3:1:6,0,-1,104315,95685
1:6:2,1,1,104314,95686
3:6:1,0,-1,104315,95685
4:1:5,0,-1,104316,95684
3:3:6,0,-1,104317,95683
2:1:1,1,1,104316,95684
3:4:1,0,-1,104317,95683
3:5:6,0,-1,104318,95682
2:6:2,2,2,104316,95684
6:2:1,1,1,104315,95685
1:6:1,0,-1,104316,95684
6:5:5,0,-1,104317,95683
2:2:2,3,3,104314,95686
5:6:5,0,-1,104315,95685
3:3:5,0,-1,104316,95684
5:3:3,0,-1,104317,95683
3:3:2,1,1,104316,95684
1:5:2,1,1,104315,95685
1:5:1,0,-1,104316,95684
6:1:3,0,-1,104317,95683
6:3:3,0,-1,104318,95682
4:5:2,1,1,104317,95683
1:5:1,0,-1,104318,95682
6:2:5,1,1,104317,95683
2:6:2,2,2,104315,95685
1:4:4,0,-1,104316,95684
4:3:4,0,-1,104317,95683
6:1:5,0,-1,104318,95682
2:6:4,1,1,104317,95683
6:2:4,1,1,104316,95684
1:6:2,1,1,104315,95685
3:3:4,0,-1,104316,95684
4:2:4,1,1,104315,95685
6:3:5,0,-1,104316,95684
1:5:3,0,-1,104317,95683
1:2:6,1,1,104316,95684
1:4:2,1,1,104315,95685
4:4:6,0,-1,104316,95684
3:5:4,0,-1,104317,95683
6:6:4,0,-1,104318,95682
4:4:2,1,1,104317,95683
1:2:1,1,1,104316,95684
4:1:6,0,-1,104317,95683
2:2:2,3,3,104314,95686
6:3:4,0,-1,104315,95685
5:3:2,1,1,104314,95686
2:4:4,1,1,104313,95687
2:4:3,1,1,104312,95688
5:2:5,1,1,104311,95689
2:6:5,1,1,104310,95690
5:1:2,1,1,104309,95691
2:2:4,2,2,104307,95693
3:4:5,0,-1,104308,95692
3:2:6,1,1,104307,95693
2:5:1,1,1,104306,95694
2:2:1,2,2,104304,95696
3:3:2,1,1,104303,95697
6:6:1,0,-1,104304,95696
1:5:4,0,-1,104305,95695
5:2:3,1,1,104304,95696
1:6:6,0,-1,104305,95695
4:4:4,0,-1,104306,95694
3:4:5,0,-1,104307,95693
3:2:3,1,1,104306,95694
4:4:2,1,1,104305,95695
1:3:3,0,-1,104306,95694
5:1:3,0,-1,104307,95693
4:6:6,0,-1,104308,95692
5:1:1,0,-1,104309,95691
2:2:4,2,2,104307,95693
3:6:3,0,-1,104308,95692
3:6:4,0,-1,104309,95691
3:5:3,0,-1,104310,95690
5:1:4,0,-1,104311,95689
5:3:6,0,-1,104312,95688
6:3:3,0,-1,104313,95687
2:2:3,2,2,104311,95689
5:1:6,0,-1,104312,95688
1:4:4,0,-1,104313,95687
6:3:4,0,-1,104314,95686
6:1:5,0,-1,104315,95685
4:6:2,1,1,104314,95686
1:4:5,0,-1,104315,95685
4:4:3,0,-1,104316,95684
1:6:6,0,-1,104317,95683
2:1:1,1,1,104316,95684
5:4:5,0,-1,104317,95683
5:5:3,0,-1,104318,95682
6:2:2,2,2,104316,95684
3:5:2,1,1,104315,95685
1:3:3,0,-1,104316,95684
3:1:1,0,-1,104317,95683
6:3:1,0,-1,104318,95682
6:3:1,0,-1,104319,95681
1:5:6,0,-1,104320,95680
2:2:5,2,2,104318,95682
3:2:1,1,1,104317,95683
5:4:4,0,-1,104318,95682
6:4:6,0,-1,104319,95681
3:1:6,0,-1,104320,95680
6:1:5,0,-1,104321,95679
4:2:6,1,1,104320,95680
2:5:1,1,1,104319,95681
3:3:1,0,-1,104320,95680
6:4:2,1,1,104319,95681
1:4:6,0,-1,104320,95680
4:5:2,1,1,104319,95681
5:6:5,0,-1,104320,95680
3:2:3,1,1,104319,95681
6:4:6,0,-1,104320,95680
5:5:3,0,-1,104321,95679
2:2:6,2,2,104319,95681
1:5:5,0,-1,104320,95680
2:2:6,2,2,104318,95682
1:2:4,1,1,104317,95683
6:5:5,0,-1,104318,95682
2:2:3,2,2,104316,95684
3:2:4,1,1,104315,95685
4:1:3,0,-1,104316,95684
4:6:6,0,-1,104317,95683
2:6:1,1,1,104316,95684
6:2:5,1,1,104315,95685
3:3:3,0,-1,104316,95684
2:5:1,1,1,104315,95685
1:1:2,1,1,104314,95686
5:6:6,0,-1,104315,95685
3:1:4,0,-1,104316,95684
6:3:5,0,-1,104317,95683
5:2:4,1,1,104316,95684
1:2:6,1,1,104315,95685
5:2:4,1,1,104314,95686
6:4:2,1,1,104313,95687
4:4:3,0,-1,104314,95686
1:1:5,0,-1,104315,95685
1:5:4,0,-1,104316,95684
5:2:4,1,1,104315,95685
1:3:5,0,-1,104316,95684
5:2:6,1,1,104315,95685
3:3:3,0,-1,104316,95684
1:4:3,0,-1,104317,95683
1:2:6,1,1,104316,95684
6:3:1,0,-1,104317,95683
5:5:1,0,-1,104318,95682
5:5:4,0,-1,104319,95681
5:5:1,0,-1,104320,95680
2:5:5,1,1,104319,95681
4:1:4,0,-1,104320,95680
1:2:2,2,2,104318,95682
5:4:4,0,-1,104319,95681
2:6:5,1,1,104318,95682
3:2:1,1,1,104317,95683
3:6:4,0,-1,104318,95682
4:5:3,0,-1,104319,95681
6:2:4,1,1,104318,95682
4:6:6,0,-1,104319,95681
5:3:3,0,-1,104320,95680
3:1:1,0,-1,104321,95679
1:1:2,1,1,104320,95680
2:5:3,1,1,104319,95681
1:2:2,2,2,104317,95683
3:1:2,1,1,104316,95684
6:6:1,0,-1,104317,95683
4:6:2,1,1,104316,95684
6:5:2,1,1,104315,95685
3:1:5,0,-1,104316,95684
5:2:2,2,2,104314,95686
6:5:2,1,1,104313,95687
4:4:4,0,-1,104314,95686
3:4:3,0,-1,104315,95685
5:5:1,0,-1,104316,95684
4:1:3,0,-1,104317,95683
6:4:4,0,-1,104318,95682
4:2:1,1,1,104317,95683
3:5:2,1,1,104316,95684
1:4:1,0,-1,104317,95683
6:6:3,0,-1,104318,95682
2:1:3,1,1,104317,95683
5:6:6,0,-1,104318,95682
6:6:4,0,-1,104319,95681
3:3:2,1,1,104318,95682
6:2:6,1,1,104317,95683
4:4:1,0,-1,104318,95682
5:4:2,1,1,104317,95683
4:4:2,1,1,104316,95684
1:3:4,0,-1,104317,95683
1:4:2,1,1,104316,95684
3:5:2,1,1,104315,95685
3:3:2,1,1,104314,95686
6:6:2,1,1,104313,95687
4:4:4,0,-1,104314,95686
3:4:3,0,-1,104315,95685
4:1:2,1,1,104314,95686
6:1:2,1,1,104313,95687
3:6:2,1,1,104312,95688
3:3:2,1,1,104311,95689
6:4:3,0,-1,104312,95688
3:6:5,0,-1,104313,95687
6:3:5,0,-1,104314,95686
4:1:4,0,-1,104315,95685
2:2:3,2,2,104313,95687
4:6:5,0,-1,104314,95686
5:2:5,1,1,104313,95687
5:5:3,0,-1,104314,95686
3:1:4,0,-1,104315,95685
1:5:4,0,-1,104316,95684
4:4:2,1,1,104315,95685
3:2:1,1,1,104314,95686
6:6:3,0,-1,104315,95685
3:1:1,0,-1,104316,95684
3:4:2,1,1,104315,95685
2:6:6,1,1,104314,95686
5:3:4,0,-1,104315,95685
4:6:5,0,-1,104316,95684
1:4:3,0,-1,104317,95683
3:4:6,0,-1,104318,95682
4:2:5,1,1,104317,95683
2:1:5,1,1,104316,95684
2:3:3,1,1,104315,95685
2:6:1,1,1,104314,95686
6:5:6,0,-1,104315,95685
3:3:4,0,-1,104316,95684
6:2:2,2,2,104314,95686
1:1:3,0,-1,104315,95685
5:1:1,0,-1,104316,95684
5:6:4,0,-1,104317,95683
1:3:5,0,-1,104318,95682
2:1:6,1,1,104317,95683
2:1:1,1,1,104316,95684
3:2:3,1,1,104315,95685
6:1:3,0,-1,104316,95684
4:3:2,1,1,104315,95685
1:3:6,0,-1,104316,95684
2:3:4,1,1,104315,95685
1:4:2,1,1,104314,95686
3:4:3,0,-1,104315,95685
6:5:4,0,-1,104316,95684
4:5:2,1,1,104315,95685
5:3:6,0,-1,104316,95684
3:4:6,0,-1,104317,95683
3:6:2,1,1,104316,95684
3:1:4,0,-1,104317,95683
4:1:5,0,-1,104318,95682
1:4:5,0,-1,104319,95681
2:2:6,2,2,104317,95683
4:4:4,0,-1,104318,95682
5:1:2,1,1,104317,95683
4:1:2,1,1,104316,95684
5:6:4,0,-1,104317,95683
6:3:4,0,-1,104318,95682
6:6:4,0,-1,104319,95681
5:3:2,1,1,104318,95682
3:1:2,1,1,104317,95683
6:4:3,0,-1,104318,95682
4:2:4,1,1,104317,95683
1:5:5,0,-1,104318,95682
5:2:4,1,1,104317,95683
2:6:6,1,1,104316,95684
3:5:5,0,-1,104317,95683
4:3:2,1,1,104316,95684
1:2:3,1,1,104315,95685
5:6:3,0,-1,104316,95684
2:4:4,1,1,104315,95685
1:3:5,0,-1,104316,95684
4:6:6,0,-1,104317,95683
3:1:5,0,-1,104318,95682
2:6:4,1,1,104317,95683
5:4:1,0,-1,104318,95682
1:1:2,1,1,104317,95683
4:1:5,0,-1,104318,95682
1:2:3,1,1,104317,95683
4:2:6,1,1,104316,95684
3:2:5,1,1,104315,95685
4:5:5,0,-1,104316,95684
1:6:6,0,-1,104317,95683
3:5:1,0,-1,104318,95682
5:3:4,0,-1,104319,95681
3:5:5,0,-1,104320,95680
5:2:1,1,1,104319,95681
2:3:4,1,1,104318,95682
2:4:6,1,1,104317,95683
1:1:2,1,1,104316,95684
6:3:2,1,1,104315,95685
5:2:1,1,1,104314,95686
6:3:1,0,-1,104315,95685
2:2:1,2,2,104313,95687
5:4:4,0,-1,104314,95686
2:6:3,1,1,104313,95687
6:1:3,0,-1,104314,95686
1:2:3,1,1,104313,95687
6:3:3,0,-1,104314,95686
6:2:3,1,1,104313,95687
2:6:1,1,1,104312,95688
4:4:2,1,1,104311,95689
6:3:4,0,-1,104312,95688
4:6:3,0,-1,104313,95687
5:6:1,0,-1,104314,95686
2:6:6,1,1,104313,95687
3:4:2,1,1,104312,95688
1:5:1,0,-1,104313,95687
1:6:3,0,-1,104314,95686
5:5:2,1,1,104313,95687
2:3:4,1,1,104312,95688
1:6:6,0,-1,104313,95687
4:3:2,1,1,104312,95688
4:4:4,0,-1,104313,95687
1:4:3,0,-1,104314,95686
5:6:3,0,-1,104315,95685
4:2:2,2,2,104313,95687
5:2:3,1,1,104312,95688
1:4:2,1,1,104311,95689
4:3:4,0,-1,104312,95688
6:6:3,0,-1,104313,95687
1:1:5,0,-1,104314,95686
4:4:3,0,-1,104315,95685
5:1:3,0,-1,104316,95684
2:1:3,1,1,104315,95685
5:1:4,0,-1,104316,95684
2:4:3,1,1,104315,95685
6:2:3,1,1,104314,95686
3:1:5,0,-1,104315,95685
3:1:3,0,-1,104316,95684
6:5:6,0,-1,104317,95683
3:2:5,1,1,104316,95684
3:3:4,0,-1,104317,95683
3:6:2,1,1,104316,95684
4:6:1,0,-1,104317,95683
1:5:1,0,-1,104318,95682
3:4:5,0,-1,104319,95681
1:1:3,0,-1,104320,95680
2:6:2,2,2,104318,95682
5:2:5,1,1,104317,95683
4:1:5,0,-1,104318,95682
4:2:4,1,1,104317,95683
2:5:3,1,1,104316,95684
3:3:2,1,1,104315,95685
6:2:3,1,1,104314,95686
5:4:6,0,-1,104315,95685
3:5:1,0,-1,104316,95684
3:2:1,1,1,104315,95685
5:6:3,0,-1,104316,95684
4:4:5,0,-1,104317,95683
3:1:4,0,-1,104318,95682
3:3:6,0,-1,104319,95681
2:2:5,2,2,104317,95683
6:2:5,1,1,104316,95684
5:4:4,0,-1,104317,95683
4:5:5,0,-1,104318,95682
6:2:4,1,1,104317,95683
2:6:6,1,1,104316,95684
4:3:3,0,-1,104317,95683
2:5:6,1,1,104316,95684
6:6:6,0,-1,104317,95683
2:3:3,1,1,104316,95684
1:1:4,0,-1,104317,95683
1:3:1,0,-1,104318,95682
2:3:1,1,1,104317,95683
1:2:2,2,2,104315,95685
1:1:6,0,-1,104316,95684
4:2:1,1,1,104315,95685
2:1:4,1,1,104314,95686
6:4:6,0,-1,104315,95685
3:4:2,1,1,104314,95686
4:1:4,0,-1,104315,95685
4:6:1,0,-1,104316,95684
4:3:5,0,-1,104317,95683
4:2:3,1,1,104316,95684
1:1:6,0,-1,104317,95683
1:4:2,1,1,104316,95684
4:1:5,0,-1,104317,95683
6:4:3,0,-1,104318,95682
4:4:1,0,-1,104319,95681
1:4:2,1,1,104318,95682
5:6:1,0,-1,104319,95681
1:4:5,0,-1,104320,95680
2:1:6,1,1,104319,95681
3:1:3,0,-1,104320,95680
1:1:4,0,-1,104321,95679
2:6:1,1,1,104320,95680
4:6:1,0,-1,104321,95679
5:2:4,1,1,104320,95680
2:4:2,2,2,104318,95682
3:6:2,1,1,104317,95683
3:1:1,0,-1,104318,95682
5:5:6,0,-1,104319,95681
4:6:4,0,-1,104320,95680
6:2:2,2,2,104318,95682
2:2:2,3,3,104315,95685
5:1:3,0,-1,104316,95684
2:1:6,1,1,104315,95685
4:6:3,0,-1,104316,95684
2:2:4,2,2,104314,95686
1:4:4,0,-1,104315,95685
4:2:5,1,1,104314,95686
2:5:4,1,1,104313,95687
1:4:4,0,-1,104314,95686
5:4:4,0,-1,104315,95685
5:4:3,0,-1,104316,95684
3:4:5,0,-1,104317,95683
5:3:2,1,1,104316,95684
4:5:3,0,-1,104317,95683
1:4:6,0,-1,104318,95682
4:6:5,0,-1,104319,95681
1:2:2,2,2,104317,95683
6:1:2,1,1,104316,95684
6:6:6,0,-1,104317,95683
6:5:3,0,-1,104318,95682
6:6:4,0,-1,104319,95681
4:5:2,1,1,104318,95682
1:4:4,0,-1,104319,95681
3:3:4,0,-1,104320,95680
6:3:6,0,-1,104321,95679
5:2:5,1,1,104320,95680
5:4:4,0,-1,104321,95679
1:1:1,0,-1,104322,95678
1:1:5,0,-1,104323,95677
4:3:4,0,-1,104324,95676
6:6:2,1,1,104323,95677
3:3:4,0,-1,104324,95676
2:3:5,1,1,104323,95677
2:5:1,1,1,104322,95678
1:1:6,0,-1,104323,95677
1:5:1,0,-1,104324,95676
1:3:3,0,-1,104325,95675
5:2:4,1,1,104324,95676
3:5:2,1,1,104323,95677
4:5:6,0,-1,104324,95676
4:5:3,0,-1,104325,95675
3:3:6,0,-1,104326,95674
4:2:3,1,1,104325,95675
6:1:5,0,-1,104326,95674
4:5:2,1,1,104325,95675
1:3:2,1,1,104324,95676
3:5:3,0,-1,104325,95675
1:5:6,0,-1,104326,95674
3:5:4,0,-1,104327,95673
1:5:1,0,-1,104328,95672
6:2:6,1,1,104327,95673
4:6:6,0,-1,104328,95672
1:1:4,0,-1,104329,95671
2:6:6,1,1,104328,95672
5:1:6,0,-1,104329,95671
5:6:3,0,-1,104330,95670
4:5:6,0,-1,104331,95669
6:6:6,0,-1,104332,95668
5:2:1,1,1,104331,95669
2:6:3,1,1,104330,95670
5:2:6,1,1,104329,95671
1:5:6,0,-1,104330,95670
2:6:3,1,1,104329,95671
4:6:2,1,1,104328,95672
3:5:4,0,-1,104329,95671
5:3:1,0,-1,104330,95670
3:2:5,1,1,104329,95671
3:4:3,0,-1,104330,95670
4:4:6,0,-1,104331,95669
6:2:5,1,1,104330,95670
3:2:2,2,2,104328,95672
4:6:4,0,-1,104329,95671
5:6:5,0,-1,104330,95670
2:6:6,1,1,104329,95671
2:2:2,3,3,104326,95674
5:6:4,0,-1,104327,95673
4:2:1,1,1,104326,95674
2:3:3,1,1,104325,95675
2:6:3,1,1,104324,95676
6:1:2,1,1,104323,95677
2:5:1,1,1,104322,95678
2:1:5,1,1,104321,95679
3:4:3,0,-1,104322,95678
3:2:1,1,1,104321,95679
4:4:2,1,1,104320,95680
5:4:6,0,-1,104321,95679
1:2:3,1,1,104320,95680
2:4:3,1,1,104319,95681
2:3:6,1,1,104318,95682
6:4:4,0,-1,104319,95681
2:3:6,1,1,104318,95682
3:6:6,0,-1,104319,95681
4:6:3,0,-1,104320,95680
2:6:5,1,1,104319,95681
3:2:6,1,1,104318,95682
6:4:3,0,-1,104319,95681
5:4:3,0,-1,104320,95680
2:3:3,1,1,104319,95681
6:2:1,1,1,104318,95682
5:2:4,1,1,104317,95683
6:4:3,0,-1,104318,95682
5:5:6,0,-1,104319,95681
2:1:4,1,1,104318,95682
5:4:2,1,1,104317,95683
2:2:2,3,3,104314,95686
6:2:4,1,1,104313,95687
3:4:3,0,-1,104314,95686
6:6:5,0,-1,104315,95685
6:6:2,1,1,104314,95686
4:3:1,0,-1,104315,95685
5:1:2,1,1,104314,95686
3:5:1,0,-1,104315,95685
2:4:6,1,1,104314,95686
6:4:3,0,-1,104315,95685
6:1:3,0,-1,104316,95684
5:6:5,0,-1,104317,95683
2:5:6,1,1,104316,95684
4:2:1,1,1,104315,95685
4:1:5,0,-1,104316,95684
2:1:2,2,2,104314,95686
2:5:4,1,1,104313,95687
6:4:6,0,-1,104314,95686
5:5:6,0,-1,104315,95685
3:1:5,0,-1,104316,95684
3:2:3,1,1,104315,95685
3:2:2,2,2,104313,95687
4:3:1,0,-1,104314,95686
4:4:2,1,1,104313,95687
5:4:4,0,-1,104314,95686
1:4:5,0,-1,104315,95685
4:6:4,0,-1,104316,95684
4:6:1,0,-1,104317,95683
6:2:5,1,1,104316,95684
4:6:2,1,1,104315,95685
3:5:3,0,-1,104316,95684
1:1:2,1,1,104315,95685
5:2:5,1,1,104314,95686
6:2:6,1,1,104313,95687
3:3:5,0,-1,104314,95686
3:6:5,0,-1,104315,95685
5:2:5,1,1,104314,95686
3:3:6,0,-1,104315,95685
2:5:6,1,1,104314,95686
3:2:3,1,1,104313,95687
2:1:4,1,1,104312,95688
5:2:4,1,1,104311,95689
6:6:6,0,-1,104312,95688
2:6:4,1,1,104311,95689
4:6:5,0,-1,104312,95688
3:1:1,0,-1,104313,95687
4:2:3,1,1,104312,95688
4:1:3,0,-1,104313,95687
4:6:4,0,-1,104314,95686
1:4:1,0,-1,104315,95685
1:4:1,0,-1,104316,95684
3:3:1,0,-1,104317,95683
2:3:6,1,1,104316,95684
2:1:4,1,1,104315,95685
2:1:4,1,1,104314,95686
5:3:6,0,-1,104315,95685
6:3:6,0,-1,104316,95684
4:1:3,0,-1,104317,95683
2:3:6,1,1,104316,95684
2:5:4,1,1,104315,95685
3:4:1,0,-1,104316,95684
3:5:4,0,-1,104317,95683
1:6:4,0,-1,104318,95682
1:4:4,0,-1,104319,95681
5:2:3,1,1,104318,95682
6:2:3,1,1,104317,95683
6:2:3,1,1,104316,95684
2:6:6,1,1,104315,95685
2:3:1,1,1,104314,95686
1:5:5,0,-1,104315,95685
4:5:3,0,-1,104316,95684
4:2:4,1,1,104315,95685
2:1:3,1,1,104314,95686
5:3:3,0,-1,104315,95685
3:3:5,0,-1,104316,95684
6:3:3,0,-1,104317,95683
3:6:3,0,-1,104318,95682
6:5:4,0,-1,104319,95681
5:1:6,0,-1,104320,95680
6:4:2,1,1,104319,95681
2:3:1,1,1,104318,95682
1:3:2,1,1,104317,95683
3:3:2,1,1,104316,95684
1:4:1,0,-1,104317,95683
4:1:1,0,-1,104318,95682
1:2:6,1,1,104317,95683
6:3:2,1,1,104316,95684
1:6:5,0,-1,104317,95683
4:1:2,1,1,104316,95684
6:2:2,2,2,104314,95686
1:4:4,0,-1,104315,95685
1:5:5,0,-1,104316,95684
2:2:5,2,2,104314,95686
1:2:5,1,1,104313,95687
2:6:6,1,1,104312,95688
6:1:6,0,-1,104313,95687
3:4:3,0,-1,104314,95686
2:2:6,2,2,104312,95688
5:2:4,1,1,104311,95689
4:5:4,0,-1,104312,95688
3:2:2,2,2,104310,95690
1:2:4,1,1,104309,95691
5:4:1,0,-1,104310,95690
1:3:2,1,1,104309,95691
2:1:3,1,1,104308,95692
4:6:3,0,-1,104309,95691
3:4:6,0,-1,104310,95690
5:5:6,0,-1,104311,95689
2:3:5,1,1,104310,95690
3:3:1,0,-1,104311,95689
4:2:6,1,1,104310,95690
6:3:1,0,-1,104311,95689
2:3:5,1,1,104310,95690
1:2:6,1,1,104309,95691
4:5:1,0,-1,104310,95690
2:6:6,1,1,104309,95691
4:3:3,0,-1,104310,95690
3:1:5,0,-1,104311,95689
4:2:1,1,1,104310,95690
5:1:2,1,1,104309,95691
3:2:5,1,1,104308,95692
2:1:1,1,1,104307,95693
6:5:3,0,-1,104308,95692
3:1:1,0,-1,104309,95691
1:2:1,1,1,104308,95692
6:5:1,0,-1,104309,95691
5:1:6,0,-1,104310,95690
4:4:6,0,-1,104311,95689
5:2:3,1,1,104310,95690
5:4:5,0,-1,104311,95689
4:4:6,0,-1,104312,95688
3:1:5,0,-1,104313,95687
2:1:6,1,1,104312,95688
6:2:4,1,1,104311,95689
5:6:4,0,-1,104312,95688
4:4:6,0,-1,104313,95687
1:5:6,0,-1,104314,95686
4:3:5,0,-1,104315,95685
5:2:1,1,1,104314,95686
5:3:1,0,-1,104315,95685
5:3:5,0,-1,104316,95684
6:6:5,0,-1,104317,95683
1:2:2,2,2,104315,95685
1:4:5,0,-1,104316,95684
4:1:4,0,-1,104317,95683
6:4:3,0,-1,104318,95682
5:5:4,0,-1,104319,95681
3:5:1,0,-1,104320,95680
2:5:3,1,1,104319,95681
2:3:1,1,1,104318,95682
2:5:1,1,1,104317,95683
1:1:5,0,-1,104318,95682
4:5:2,1,1,104317,95683
1:2:5,1,1,104316,95684
2:1:2,2,2,104314,95686
2:5:2,2,2,104312,95688
4:2:4,1,1,104311,95689
5:1:3,0,-1,104312,95688
6:1:1,0,-1,104313,95687
6:1:3,0,-1,104314,95686
5:1:1,0,-1,104315,95685
3:4:6,0,-1,104316,95684
4:3:5,0,-1,104317,95683
2:6:4,1,1,104316,95684
6:5:5,0,-1,104317,95683
2:4:5,1,1,104316,95684
4:6:6,0,-1,104317,95683
3:6:3,0,-1,104318,95682
4:4:5,0,-1,104319,95681
1:2:3,1,1,104318,95682
3:2:4,1,1,104317,95683
2:3:4,1,1,104316,95684
4:4:2,1,1,104315,95685
2:4:3,1,1,104314,95686
2:2:6,2,2,104312,95688
5:5:3,0,-1,104313,95687
3:5:6,0,-1,104314,95686
4:4:4,0,-1,104315,95685
6:1:3,0,-1,104316,95684
3:2:1,1,1,104315,95685
4:6:3,0,-1,104316,95684
6:1:4,0,-1,104317,95683
3:2:6,1,1,104316,95684
5:2:5,1,1,104315,95685
6:2:4,1,1,104314,95686
4:6:5,0,-1,104315,95685
1:6:6,0,-1,104316,95684
4:3:4,0,-1,104317,95683
1:4:2,1,1,104316,95684
5:3:5,0,-1,104317,95683
5:6:5,0,-1,104318,95682
4:2:4,1,1,104317,95683
1:4:2,1,1,104316,95684
5:3:3,0,-1,104317,95683
6:5:4,0,-1,104318,95682
1:1:2,1,1,104317,95683
5:6:1,0,-1,104318,95682
5:3:6,0,-1,104319,95681
1:2:1,1,1,104318,95682
2:1:4,1,1,104317,95683
5:3:2,1,1,104316,95684
1:2:2,2,2,104314,95686
2:1:3,1,1,104313,95687
2:6:3,1,1,104312,95688
6:3:1,0,-1,104313,95687
1:1:6,0,-1,104314,95686
4:5:6,0,-1,104315,95685
2:5:3,1,1,104314,95686
6:4:6,0,-1,104315,95685
5:6:1,0,-1,104316,95684
5:2:1,1,1,104315,95685
4:3:3,0,-1,104316,95684
1:2:3,1,1,104315,95685
5:5:5,0,-1,104316,95684
3:6:4,0,-1,104317,95683
2:6:6,1,1,104316,95684
6:6:5,0,-1,104317,95683
6:3:5,0,-1,104318,95682
4:1:4,0,-1,104319,95681
3:4:2,1,1,104318,95682
6:4:3,0,-1,104319,95681
6:1:5,0,-1,104320,95680
3:6:5,0,-1,104321,95679
3:3:4,0,-1,104322,95678
4:4:6,0,-1,104323,95677
4:2:2,2,2,104321,95679
2:5:1,1,1,104320,95680
4:2:4,1,1,104319,95681
2:6:2,2,2,104317,95683
4:6:2,1,1,104316,95684
3:5:1,0,-1,104317,95683
4:1:5,0,-1,104318,95682
3:3:1,0,-1,104319,95681
6:4:4,0,-1,104320,95680
2:2:1,2,2,104318,95682
5:5:5,0,-1,104319,95681
5:3:3,0,-1,104320,95680
6:4:4,0,-1,104321,95679
5:5:5,0,-1,104322,95678
4:1:2,1,1,104321,95679
4:6:3,0,-1,104322,95678
3:3:4,0,-1,104323,95677
2:5:6,1,1,104322,95678
5:4:4,0,-1,104323,95677
2:2:2,3,3,104320,95680
1:2:2,2,2,104318,95682
5:2:1,1,1,104317,95683
5:4:4,0,-1,104318,95682
5:2:4,1,1,104317,95683
5:4:3,0,-1,104318,95682
6:1:6,0,-1,104319,95681
3:6:1,0,-1,104320,95680
3:6:2,1,1,104319,95681
5:4:5,0,-1,104320,95680
4:3:2,1,1,104319,95681
5:1:5,0,-1,104320,95680
1:6:6,0,-1,104321,95679
6:5:4,0,-1,104322,95678
1:6:3,0,-1,104323,95677
6:3:3,0,-1,104324,95676
5:1:3,0,-1,104325,95675
3:6:5,0,-1,104326,95674
1:4:1,0,-1,104327,95673
5:6:2,1,1,104326,95674
5:6:2,1,1,104325,95675
1:5:2,1,1,104324,95676
6:2:3,1,1,104323,95677
3:5:5,0,-1,104324,95676
5:3:1,0,-1,104325,95675
4:1:2,1,1,104324,95676
6:3:5,0,-1,104325,95675
4:1:4,0,-1,104326,95674
6:5:3,0,-1,104327,95673
2:2:2,3,3,104324,95676
3:6:4,0,-1,104325,95675
2:3:1,1,1,104324,95676
6:6:2,1,1,104323,95677
6:4:5,0,-1,104324,95676
2:5:4,1,1,104323,95677
2:4:2,2,2,104321,95679
4:5:6,0,-1,104322,95678
2:6:1,1,1,104321,95679
6:4:3,0,-1,104322,95678
1:6:1,0,-1,104323,95677
4:5:6,0,-1,104324,95676
5:5:3,0,-1,104325,95675
6:2:4,1,1,104324,95676
1:3:2,1,1,104323,95677
5:5:4,0,-1,104324,95676
5:6:5,0,-1,104325,95675
2:6:6,1,1,104324,95676
6:5:6,0,-1,104325,95675
6:4:3,0,-1,104326,95674
1:4:2,1,1,104325,95675
5:4:5,0,-1,104326,95674
6:1:4,0,-1,104327,95673
1:5:1,0,-1,104328,95672
6:2:4,1,1,104327,95673
5:5:3,0,-1,104328,95672
3:3:3,0,-1,104329,95671
4:6:3,0,-1,104330,95670
4:3:5,0,-1,104331,95669
2:1:3,1,1,104330,95670
2:2:2,3,3,104327,95673
3:3:3,0,-1,104328,95672
2:2:2,3,3,104325,95675
3:5:2,1,1,104324,95676
3:2:1,1,1,104323,95677
1:4:1,0,-1,104324,95676
4:3:1,0,-1,104325,95675
4:1:4,0,-1,104326,95674
1:3:4,0,-1,104327,95673
6:4:5,0,-1,104328,95672
4:1:3,0,-1,104329,95671
1:3:1,0,-1,104330,95670
6:4:4,0,-1,104331,95669
4:1:1,0,-1,104332,95668
4:1:3,0,-1,104333,95667
5:5:4,0,-1,104334,95666
6:1:3,0,-1,104335,95665
2:6:2,2,2,104333,95667
5:4:6,0,-1,104334,95666
1:1:1,0,-1,104335,95665
2:5:1,1,1,104334,95666
1:3:3,0,-1,104335,95665
6:2:3,1,1,104334,95666
1:4:1,0,-1,104335,95665
6:1:3,0,-1,104336,95664
5:1:6,0,-1,104337,95663
4:1:2,1,1,104336,95664
3:1:2,1,1,104335,95665
5:5:2,1,1,104334,95666
2:3:6,1,1,104333,95667
6:1:5,0,-1,104334,95666
2:3:6,1,1,104333,95667
6:1:4,0,-1,104334,95666
5:6:4,0,-1,104335,95665
5:4:1,0,-1,104336,95664
2:5:3,1,1,104335,95665
5:3:3,0,-1,104336,95664
6:2:6,1,1,104335,95665
3:3:3,0,-1,104336,95664
3:5:1,0,-1,104337,95663
4:3:2,1,1,104336,95664
5:5:6,0,-1,104337,95663
6:1:3,0,-1,104338,95662
5:3:6,0,-1,104339,95661
3:4:5,0,-1,104340,95660
1:5:6,0,-1,104341,95659
5:4:3,0,-1,104342,95658
6:6:4,0,-1,104343,95657
5:6:2,1,1,104342,95658
4:3:4,0,-1,104343,95657
2:2:5,2,2,104341,95659
4:3:5,0,-1,104342,95658
1:3:3,0,-1,104343,95657
2:6:4,1,1,104342,95658
4:4:1,0,-1,104343,95657
3:1:2,1,1,104342,95658
2:6:5,1,1,104341,95659
4:1:2,1,1,104340,95660
1:4:3,0,-1,104341,95659
5:2:3,1,1,104340,95660
4:4:3,0,-1,104341,95659
5:2:2,2,2,104339,95661
6:5:2,1,1,104338,95662
3:1:6,0,-1,104339,95661
1:4:4,0,-1,104340,95660
5:3:1,0,-1,104341,95659
4:2:5,1,1,104340,95660
2:2:5,2,2,104338,95662
5:5:2,1,1,104337,95663
6:6:4,0,-1,104338,95662
6:3:3,0,-1,104339,95661
3:5:3,0,-1,104340,95660
6:5:1,0,-1,104341,95659
5:3:5,0,-1,104342,95658
1:2:5,1,1,104341,95659
5:2:6,1,1,104340,95660
2:2:6,2,2,104338,95662
4:4:5,0,-1,104339,95661
4:6:6,0,-1,104340,95660
6:2:6,1,1,104339,95661
3:2:3,1,1,104338,95662
2:2:1,2,2,104336,95664
4:3:4,0,-1,104337,95663
4:3:3,0,-1,104338,95662
4:5:5,0,-1,104339,95661
3:6:3,0,-1,104340,95660
5:1:4,0,-1,104341,95659
3:4:2,1,1,104340,95660
6:1:6,0,-1,104341,95659
4:3:3,0,-1,104342,95658
1:1:2,1,1,104341,95659
2:6:4,1,1,104340,95660
1:1:1,0,-1,104341,95659
5:4:1,0,-1,104342,95658
5:1:4,0,-1,104343,95657
6:1:5,0,-1,104344,95656
1:2:1,1,1,104343,95657
1:1:4,0,-1,104344,95656
1:3:5,0,-1,104345,95655
6:2:1,1,1,104344,95656
1:2:4,1,1,104343,95657
3:6:2,1,1,104342,95658
3:5:6,0,-1,104343,95657
5:5:2,1,1,104342,95658
4:5:6,0,-1,104343,95657
3:1:5,0,-1,104344,95656
5:3:2,1,1,104343,95657
2:5:4,1,1,104342,95658
6:6:4,0,-1,104343,95657
2:3:5,1,1,104342,95658
2:3:3,1,1,104341,95659
2:5:6,1,1,104340,95660
3:6:4,0,-1,104341,95659
3:1:2,1,1,104340,95660
5:4:1,0,-1,104341,95659
3:6:1,0,-1,104342,95658
2:2:6,2,2,104340,95660
5:4:1,0,-1,104341,95659
4:2:4,1,1,104340,95660
5:6:2,1,1,104339,95661
2:3:6,1,1,104338,95662
4:2:4,1,1,104337,95663
5:3:1,0,-1,104338,95662
1:6:4,0,-1,104339,95661
6:5:2,1,1,104338,95662
1:2:5,1,1,104337,95663
5:6:6,0,-1,104338,95662
3:4:6,0,-1,104339,95661
2:1:4,1,1,104338,95662
6:2:3,1,1,104337,95663
6:3:4,0,-1,104338,95662
5:6:3,0,-1,104339,95661
3:5:1,0,-1,104340,95660
6:4:4,0,-1,104341,95659
6:4:6,0,-1,104342,95658
3:4:3,0,-1,104343,95657
5:4:4,0,-1,104344,95656
5:3:2,1,1,104343,95657
5:6:4,0,-1,104344,95656
5:3:5,0,-1,104345,95655
6:1:3,0,-1,104346,95654
5:4:4,0,-1,104347,95653
2:5:3,1,1,104346,95654
4:5:2,1,1,104345,95655
2:1:2,2,2,104343,95657
6:4:6,0,-1,104344,95656
2:2:1,2,2,104342,95658
1:2:3,1,1,104341,95659
2:6:6,1,1,104340,95660
6:3:5,0,-1,104341,95659
2:4:3,1,1,104340,95660
2:3:6,1,1,104339,95661
4:3:4,0,-1,104340,95660
2:2:4,2,2,104338,95662
5:6:4,0,-1,104339,95661
5:5:5,0,-1,104340,95660
5:2:4,1,1,104339,95661
4:5:2,1,1,104338,95662
3:6:2,1,1,104337,95663
5:2:4,1,1,104336,95664
1:1:6,0,-1,104337,95663
3:5:2,1,1,104336,95664
2:2:3,2,2,104334,95666
5:2:3,1,1,104333,95667
6:6:4,0,-1,104334,95666
6:1:1,0,-1,104335,95665
5:4:4,0,-1,104336,95664
1:6:6,0,-1,104337,95663
5:1:2,1,1,104336,95664
3:1:6,0,-1,104337,95663
6:6:6,0,-1,104338,95662
6:5:4,0,-1,104339,95661
1:6:2,1,1,104338,95662
4:2:2,2,2,104336,95664
4:2:4,1,1,104335,95665
4:4:6,0,-1,104336,95664
4:6:3,0,-1,104337,95663
6:5:2,1,1,104336,95664
1:1:1,0,-1,104337,95663
1:4:1,0,-1,104338,95662
4:5:1,0,-1,104339,95661
4:5:2,1,1,104338,95662
2:5:3,1,1,104337,95663
3:3:4,0,-1,104338,95662
6:3:3,0,-1,104339,95661
4:3:2,1,1,104338,95662
6:6:4,0,-1,104339,95661
3:1:1,0,-1,104340,95660
2:4:6,1,1,104339,95661
4:5:6,0,-1,104340,95660
3:3:5,0,-1,104341,95659
1:5:6,0,-1,104342,95658
4:1:1,0,-1,104343,95657
4:4:1,0,-1,104344,95656
4:6:4,0,-1,104345,95655
4:2:4,1,1,104344,95656
6:4:5,0,-1,104345,95655
4:6:3,0,-1,104346,95654
4:4:5,0,-1,104347,95653
6:5:4,0,-1,104348,95652
3:5:3,0,-1,104349,95651
3:6:3,0,-1,104350,95650
1:3:1,0,-1,104351,95649
4:3:2,1,1,104350,95650
2:4:3,1,1,104349,95651
4:5:1,0,-1,104350,95650
2:1:4,1,1,104349,95651
2:1:2,2,2,104347,95653
2:1:4,1,1,104346,95654
4:5:1,0,-1,104347,95653
4:2:4,1,1,104346,95654
3:1:5,0,-1,104347,95653
4:5:6,0,-1,104348,95652
2:3:1,1,1,104347,95653
2:2:6,2,2,104345,95655
3:6:5,0,-1,104346,95654
5:6:2,1,1,104345,95655
3:6:2,1,1,104344,95656
2:2:3,2,2,104342,95658
1:2:3,1,1,104341,95659
1:5:5,0,-1,104342,95658
4:6:5,0,-1,104343,95657
6:2:3,1,1,104342,95658
6:5:6,0,-1,104343,95657
6:2:4,1,1,104342,95658
3:6:5,0,-1,104343,95657
6:4:2,1,1,104342,95658
2:1:3,1,1,104341,95659
2:6:6,1,1,104340,95660
5:6:3,0,-1,104341,95659
3:5:4,0,-1,104342,95658
5:2:5,1,1,104341,95659
5:3:3,0,-1,104342,95658
2:3:1,1,1,104341,95659
1:2:2,2,2,104339,95661
1:2:3,1,1,104338,95662
1:4:3,0,-1,104339,95661
3:4:4,0,-1,104340,95660
4:6:1,0,-1,104341,95659
2:3:6,1,1,104340,95660
5:1:2,1,1,104339,95661
2:3:1,1,1,104338,95662
3:6:6,0,-1,104339,95661
5:6:2,1,1,104338,95662
2:1:5,1,1,104337,95663
3:6:4,0,-1,104338,95662
2:6:4,1,1,104337,95663
1:1:2,1,1,104336,95664
6:1:2,1,1,104335,95665
6:1:1,0,-1,104336,95664
6:5:6,0,-1,104337,95663
6:1:2,1,1,104336,95664
3:3:2,1,1,104335,95665
5:3:2,1,1,104334,95666
2:4:1,1,1,104333,95667
4:5:3,0,-1,104334,95666
5:5:2,1,1,104333,95667
6:5:4,0,-1,104334,95666
5:1:4,0,-1,104335,95665
4:5:3,0,-1,104336,95664
5:6:5,0,-1,104337,95663
5:6:6,0,-1,104338,95662
2:3:4,1,1,104337,95663
5:1:6,0,-1,104338,95662
2:1:1,1,1,104337,95663
3:4:2,1,1,104336,95664
3:2:1,1,1,104335,95665
1:1:2,1,1,104334,95666
5:4:3,0,-1,104335,95665
5:3:2,1,1,104334,95666
3:4:6,0,-1,104335,95665
4:2:1,1,1,104334,95666
1:3:2,1,1,104333,95667
4:4:4,0,-1,104334,95666
6:4:4,0,-1,104335,95665
2:2:2,3,3,104332,95668
4:6:2,1,1,104331,95669
6:4:5,0,-1,104332,95668
3:6:4,0,-1,104333,95667
3:2:3,1,1,104332,95668
4:6:3,0,-1,104333,95667
5:1:3,0,-1,104334,95666
1:5:3,0,-1,104335,95665
2:6:3,1,1,104334,95666
1:3:3,0,-1,104335,95665
5:4:5,0,-1,104336,95664
4:5:6,0,-1,104337,95663
3:2:3,1,1,104336,95664
3:2:5,1,1,104335,95665
5:6:3,0,-1,104336,95664
6:4:6,0,-1,104337,95663
3:4:6,0,-1,104338,95662
2:2:3,2,2,104336,95664
6:6:4,0,-1,104337,95663
3:5:6,0,-1,104338,95662
6:6:4,0,-1,104339,95661
3:5:5,0,-1,104340,95660
1:3:2,1,1,104339,95661
1:3:6,0,-1,104340,95660
1:4:1,0,-1,104341,95659
5:3:3,0,-1,104342,95658
1:5:4,0,-1,104343,95657
5:5:6,0,-1,104344,95656
1:5:6,0,-1,104345,95655
4:2:6,1,1,104344,95656
2:2:3,2,2,104342,95658
1:3:3,0,-1,104343,95657
6:6:3,0,-1,104344,95656
6:1:1,0,-1,104345,95655
2:1:2,2,2,104343,95657
2:5:5,1,1,104342,95658
6:2:2,2,2,104340,95660
5:2:1,1,1,104339,95661
2:1:1,1,1,104338,95662
6:3:5,0,-1,104339,95661
6:4:3,0,-1,104340,95660
6:1:1,0,-1,104341,95659
2:4:3,1,1,104340,95660
5:5:3,0,-1,104341,95659
5:1:2,1,1,104340,95660
6:1:3,0,-1,104341,95659
5:2:6,1,1,104340,95660
2:4:6,1,1,104339,95661
1:5:1,0,-1,104340,95660
2:4:4,1,1,104339,95661
2:5:1,1,1,104338,95662
3:2:3,1,1,104337,95663
2:2:5,2,2,104335,95665
4:4:4,0,-1,104336,95664
6:5:1,0,-1,104337,95663
3:6:5,0,-1,104338,95662
1:1:4,0,-1,104339,95661
6:1:5,0,-1,104340,95660
6:1:1,0,-1,104341,95659
2:3:2,2,2,104339,95661
1:5:2,1,1,104338,95662
2:2:5,2,2,104336,95664
1:4:4,0,-1,104337,95663
4:2:1,1,1,104336,95664
1:6:6,0,-1,104337,95663
4:2:2,2,2,104335,95665
4:5:4,0,-1,104336,95664
4:2:4,1,1,104335,95665
2:1:6,1,1,104334,95666
5:5:3,0,-1,104335,95665
3:5:5,0,-1,104336,95664
2:3:6,1,1,104335,95665
4:6:3,0,-1,104336,95664
6:5:6,0,-1,104337,95663
1:2:6,1,1,104336,95664
4:1:2,1,1,104335,95665
2:1:4,1,1,104334,95666
1:4:6,0,-1,104335,95665
6:3:3,0,-1,104336,95664
2:5:6,1,1,104335,95665
3:2:5,1,1,104334,95666
2:4:3,1,1,104333,95667
4:5:4,0,-1,104334,95666
4:1:4,0,-1,104335,95665
4:3:6,0,-1,104336,95664
6:1:1,0,-1,104337,95663
2:4:2,2,2,104335,95665
2:6:2,2,2,104333,95667
4:1:6,0,-1,104334,95666
1:2:6,1,1,104333,95667
5:2:4,1,1,104332,95668
1:3:6,0,-1,104333,95667
6:4:3,0,-1,104334,95666
5:4:6,0,-1,104335,95665
3:4:5,0,-1,104336,95664
6:2:2,2,2,104334,95666
3:2:1,1,1,104333,95667
3:2:2,2,2,104331,95669
3:4:3,0,-1,104332,95668
1:4:5,0,-1,104333,95667
3:6:4,0,-1,104334,95666
3:2:5,1,1,104333,95667
1:5:1,0,-1,104334,95666
4:4:4,0,-1,104335,95665
2:6:5,1,1,104334,95666
6:4:2,1,1,104333,95667
1:6:1,0,-1,104334,95666
6:2:4,1,1,104333,95667
3:4:4,0,-1,104334,95666
5:1:1,0,-1,104335,95665
3:4:6,0,-1,104336,95664
4:5:6,0,-1,104337,95663
6:1:6,0,-1,104338,95662
2:4:3,1,1,104337,95663
6:6:6,0,-1,104338,95662
6:6:1,0,-1,104339,95661
3:3:2,1,1,104338,95662
4:6:1,0,-1,104339,95661
2:2:2,3,3,104336,95664
3:3:1,0,-1,104337,95663
4:1:3,0,-1,104338,95662
4:1:2,1,1,104337,95663
1:1:2,1,1,104336,95664
3:6:1,0,-1,104337,95663
6:4:1,0,-1,104338,95662
3:6:5,0,-1,104339,95661
1:5:1,0,-1,104340,95660
3:4:3,0,-1,104341,95659
6:5:2,1,1,104340,95660
4:4:2,1,1,104339,95661
1:5:5,0,-1,104340,95660
6:1:4,0,-1,104341,95659
5:1:4,0,-1,104342,95658
2:1:5,1,1,104341,95659
3:1:3,0,-1,104342,95658
1:6:5,0,-1,104343,95657
5:5:5,0,-1,104344,95656
1:3:4,0,-1,104345,95655
3:5:3,0,-1,104346,95654
3:6:4,0,-1,104347,95653
3:5:6,0,-1,104348,95652
3:3:3,0,-1,104349,95651
5:6:2,1,1,104348,95652
1:3:2,1,1,104347,95653
5:6:5,0,-1,104348,95652
1:1:4,0,-1,104349,95651
6:1:6,0,-1,104350,95650
2:2:3,2,2,104348,95652
1:2:6,1,1,104347,95653
3:2:4,1,1,104346,95654
5:3:6,0,-1,104347,95653
5:3:6,0,-1,104348,95652
6:2:5,1,1,104347,95653
1:1:6,0,-1,104348,95652
5:5:6,0,-1,104349,95651
2:1:2,2,2,104347,95653
4:3:6,0,-1,104348,95652
6:6:5,0,-1,104349,95651
1:6:1,0,-1,104350,95650
5:1:1,0,-1,104351,95649
1:2:2,2,2,104349,95651
2:5:1,1,1,104348,95652
1:2:3,1,1,104347,95653
5:2:3,1,1,104346,95654
5:1:4,0,-1,104347,95653
4:6:4,0,-1,104348,95652
3:3:6,0,-1,104349,95651
6:6:3,0,-1,104350,95650
4:4:4,0,-1,104351,95649
5:6:1,0,-1,104352,95648
4:6:4,0,-1,104353,95647
3:4:5,0,-1,104354,95646
4:3:2,1,1,104353,95647
3:5:1,0,-1,104354,95646
5:4:4,0,-1,104355,95645
3:6:1,0,-1,104356,95644
3:5:1,0,-1,104357,95643
3:4:4,0,-1,104358,95642
3:4:6,0,-1,104359,95641
2:4:2,2,2,104357,95643
5:6:5,0,-1,104358,95642
5:4:4,0,-1,104359,95641
3:2:3,1,1,104358,95642
1:3:6,0,-1,104359,95641
3:4:1,0,-1,104360,95640
2:3:4,1,1,104359,95641
4:4:3,0,-1,104360,95640
3:6:2,1,1,104359,95641
2:4:1,1,1,104358,95642
4:4:6,0,-1,104359,95641
2:6:4,1,1,104358,95642
5:1:5,0,-1,104359,95641
3:4:1,0,-1,104360,95640
2:2:6,2,2,104358,95642
4:3:5,0,-1,104359,95641
3:5:2,1,1,104358,95642
4:1:5,0,-1,104359,95641
5:5:2,1,1,104358,95642
1:3:3,0,-1,104359,95641
4:5:3,0,-1,104360,95640
3:2:2,2,2,104358,95642
1:6:3,0,-1,104359,95641
1:3:3,0,-1,104360,95640
1:2:2,2,2,104358,95642
3:6:2,1,1,104357,95643
3:3:1,0,-1,104358,95642
6:1:2,1,1,104357,95643
4:6:1,0,-1,104358,95642
4:2:6,1,1,104357,95643
6:4:1,0,-1,104358,95642
1:4:1,0,-1,104359,95641
2:2:5,2,2,104357,95643
2:1:5,1,1,104356,95644
1:6:3,0,-1,104357,95643
5:2:6,1,1,104356,95644
4:1:1,0,-1,104357,95643
5:6:4,0,-1,104358,95642
5:5:4,0,-1,104359,95641
2:6:1,1,1,104358,95642
5:6:5,0,-1,104359,95641
4:6:3,0,-1,104360,95640
2:2:5,2,2,104358,95642
4:1:5,0,-1,104359,95641
6:4:5,0,-1,104360,95640
1:5:4,0,-1,104361,95639
5:6:6,0,-1,104362,95638
1:2:5,1,1,104361,95639
2:5:5,1,1,104360,95640
5:5:4,0,-1,104361,95639
1:2:5,1,1,104360,95640
4:3:2,1,1,104359,95641
4:1:3,0,-1,104360,95640
1:1:1,0,-1,104361,95639
5:5:3,0,-1,104362,95638
4:6:2,1,1,104361,95639
1:3:3,0,-1,104362,95638
4:3:1,0,-1,104363,95637
1:5:2,1,1,104362,95638
6:6:1,0,-1,104363,95637
3:2:5,1,1,104362,95638
1:3:4,0,-1,104363,95637
1:2:5,1,1,104362,95638
4:5:3,0,-1,104363,95637
6:1:1,0,-1,104364,95636
6:2:2,2,2,104362,95638
5:3:1,0,-1,104363,95637
6:1:1,0,-1,104364,95636
5:3:2,1,1,104363,95637
6:1:6,0,-1,104364,95636
5:5:2,1,1,104363,95637
2:4:1,1,1,104362,95638
4:3:5,0,-1,104363,95637
2:2:1,2,2,104361,95639
3:4:2,1,1,104360,95640
6:5:3,0,-1,104361,95639
2:4:1,1,1,104360,95640
2:1:2,2,2,104358,95642
2:3:2,2,2,104356,95644
3:1:2,1,1,104355,95645
4:2:5,1,1,104354,95646
4:3:2,1,1,104353,95647
2:2:4,2,2,104351,95649
2:4:4,1,1,104350,95650
1:5:3,0,-1,104351,95649
3:6:2,1,1,104350,95650
1:5:2,1,1,104349,95651
6:3:3,0,-1,104350,95650
1:4:2,1,1,104349,95651
5:1:6,0,-1,104350,95650
1:4:5,0,-1,104351,95649
6:2:1,1,1,104350,95650
1:1:6,0,-1,104351,95649
6:4:6,0,-1,104352,95648
4:5:4,0,-1,104353,95647
2:5:3,1,1,104352,95648
1:5:3,0,-1,104353,95647
1:4:5,0,-1,104354,95646
2:3:6,1,1,104353,95647
4:5:1,0,-1,104354,95646
5:6:2,1,1,104353,95647
4:2:5,1,1,104352,95648
3:1:1,0,-1,104353,95647
3:3:3,0,-1,104354,95646
3:1:6,0,-1,104355,95645
1:2:3,1,1,104354,95646
5:2:6,1,1,104353,95647
5:1:4,0,-1,104354,95646
5:4:5,0,-1,104355,95645
5:5:1,0,-1,104356,95644
6:2:5,1,1,104355,95645
5:5:5,0,-1,104356,95644
1:5:6,0,-1,104357,95643
1:1:3,0,-1,104358,95642
3:5:2,1,1,104357,95643
2:6:6,1,1,104356,95644
3:5:4,0,-1,104357,95643
4:1:4,0,-1,104358,95642
4:4:5,0,-1,104359,95641
5:6:5,0,-1,104360,95640
6:4:3,0,-1,104361,95639
5:4:4,0,-1,104362,95638
2:4:1,1,1,104361,95639
1:4:4,0,-1,104362,95638
2:4:5,1,1,104361,95639
5:5:6,0,-1,104362,95638
5:4:2,1,1,104361,95639
4:5:2,1,1,104360,95640
6:5:1,0,-1,104361,95639
2:1:3,1,1,104360,95640
2:3:4,1,1,104359,95641
4:3:3,0,-1,104360,95640
6:2:2,2,2,104358,95642
6:4:6,0,-1,104359,95641
1:6:3,0,-1,104360,95640
1:4:4,0,-1,104361,95639
1:1:5,0,-1,104362,95638
6:6:6,0,-1,104363,95637
6:2:5,1,1,104362,95638
5:3:5,0,-1,104363,95637
5:2:2,2,2,104361,95639
2:5:4,1,1,104360,95640
5:2:3,1,1,104359,95641
3:3:3,0,-1,104360,95640
5:5:2,1,1,104359,95641
1:3:4,0,-1,104360,95640
2:6:1,1,1,104359,95641
3:4:6,0,-1,104360,95640
1:5:2,1,1,104359,95641
3:6:1,0,-1,104360,95640
6:2:2,2,2,104358,95642
6:2:5,1,1,104357,95643
1:6:1,0,-1,104358,95642
4:1:5,0,-1,104359,95641
3:4:3,0,-1,104360,95640
4:1:4,0,-1,104361,95639
6:4:2,1,1,104360,95640
4:5:6,0,-1,104361,95639
4:1:1,0,-1,104362,95638
4:6:5,0,-1,104363,95637
3:4:2,1,1,104362,95638
4:1:4,0,-1,104363,95637
1:2:2,2,2,104361,95639
5:3:2,1,1,104360,95640
2:1:5,1,1,104359,95641
3:1:3,0,-1,104360,95640
6:3:1,0,-1,104361,95639
5:1:5,0,-1,104362,95638
1:3:6,0,-1,104363,95637
4:2:1,1,1,104362,95638
2:2:1,2,2,104360,95640
3:1:4,0,-1,104361,95639
5:5:4,0,-1,104362,95638
2:5:1,1,1,104361,95639
2:6:3,1,1,104360,95640
3:6:5,0,-1,104361,95639
4:4:3,0,-1,104362,95638
1:5:5,0,-1,104363,95637
3:6:2,1,1,104362,95638
3:2:2,2,2,104360,95640
3:5:2,1,1,104359,95641
3:2:4,1,1,104358,95642
5:1:6,0,-1,104359,95641
6:2:3,1,1,104358,95642
2:2:1,2,2,104356,95644
2:5:2,2,2,104354,95646
5:3:2,1,1,104353,95647
4:6:5,0,-1,104354,95646
1:1:6,0,-1,104355,95645
2:4:1,1,1,104354,95646
4:4:2,1,1,104353,95647
3:1:5,0,-1,104354,95646
3:1:6,0,-1,104355,95645
1:3:3,0,-1,104356,95644
5:3:6,0,-1,104357,95643
1:3:5,0,-1,104358,95642
3:6:5,0,-1,104359,95641
2:4:4,1,1,104358,95642
6:1:1,0,-1,104359,95641
1:5:4,0,-1,104360,95640
3:3:5,0,-1,104361,95639
2:1:3,1,1,104360,95640
1:6:2,1,1,104359,95641
4:1:4,0,-1,104360,95640
6:2:2,2,2,104358,95642
6:5:6,0,-1,104359,95641
1:6:3,0,-1,104360,95640
5:2:3,1,1,104359,95641
5:6:1,0,-1,104360,95640
3:6:5,0,-1,104361,95639
3:5:3,0,-1,104362,95638
5:2:5,1,1,104361,95639
6:2:5,1,1,104360,95640
6:1:4,0,-1,104361,95639
3:5:1,0,-1,104362,95638
5:5:2,1,1,104361,95639
1:2:4,1,1,104360,95640
3:2:5,1,1,104359,95641
3:3:2,1,1,104358,95642
6:5:5,0,-1,104359,95641
4:2:4,1,1,104358,95642
4:6:2,1,1,104357,95643
5:1:2,1,1,104356,95644
3:1:2,1,1,104355,95645
3:6:1,0,-1,104356,95644
6:3:1,0,-1,104357,95643
1:1:1,0,-1,104358,95642
4:3:5,0,-1,104359,95641
5:3:3,0,-1,104360,95640
1:1:2,1,1,104359,95641
5:1:4,0,-1,104360,95640
4:1:5,0,-1,104361,95639
3:5:1,0,-1,104362,95638
3:5:1,0,-1,104363,95637
3:4:1,0,-1,104364,95636
3:2:4,1,1,104363,95637
6:2:6,1,1,104362,95638
1:3:2,1,1,104361,95639
2:4:2,2,2,104359,95641
3:4:3,0,-1,104360,95640
3:3:2,1,1,104359,95641
2:6:4,1,1,104358,95642
6:3:2,1,1,104357,95643
4:6:2,1,1,104356,95644
5:6:3,0,-1,104357,95643
1:4:4,0,-1,104358,95642
3:6:2,1,1,104357,95643
2:1:2,2,2,104355,95645
4:1:6,0,-1,104356,95644
3:3:6,0,-1,104357,95643
3:1:2,1,1,104356,95644
2:4:6,1,1,104355,95645
1:4:5,0,-1,104356,95644
5:3:6,0,-1,104357,95643
3:4:3,0,-1,104358,95642
5:5:6,0,-1,104359,95641
3:5:3,0,-1,104360,95640
4:6:6,0,-1,104361,95639
5:4:3,0,-1,104362,95638
4:6:3,0,-1,104363,95637
6:4:1,0,-1,104364,95636
1:2:6,1,1,104363,95637
6:6:2,1,1,104362,95638
2:1:2,2,2,104360,95640
6:5:6,0,-1,104361,95639
1:6:2,1,1,104360,95640
6:5:5,0,-1,104361,95639
6:1:2,1,1,104360,95640
1:1:2,1,1,104359,95641
1:5:5,0,-1,104360,95640
6:1:3,0,-1,104361,95639
1:5:2,1,1,104360,95640
1:3:4,0,-1,104361,95639
3:6:2,1,1,104360,95640
1:2:4,1,1,104359,95641
3:6:6,0,-1,104360,95640
4:4:1,0,-1,104361,95639
2:6:3,1,1,104360,95640
5:6:2,1,1,104359,95641
3:1:1,0,-1,104360,95640
4:3:2,1,1,104359,95641
6:5:6,0,-1,104360,95640
3:6:2,1,1,104359,95641
1:5:3,0,-1,104360,95640
1:4:1,0,-1,104361,95639
5:1:5,0,-1,104362,95638
5:1:5,0,-1,104363,95637
3:4:3,0,-1,104364,95636
1:2:5,1,1,104363,95637
5:4:5,0,-1,104364,95636
4:3:1,0,-1,104365,95635
4:1:1,0,-1,104366,95634
5:5:3,0,-1,104367,95633
1:3:4,0,-1,104368,95632
1:6:3,0,-1,104369,95631
3:5:6,0,-1,104370,95630
6:4:4,0,-1,104371,95629
1:4:4,0,-1,104372,95628
6:2:1,1,1,104371,95629
5:2:1,1,1,104370,95630
6:6:1,0,-1,104371,95629
2:1:2,2,2,104369,95631
5:1:4,0,-1,104370,95630
3:1:3,0,-1,104371,95629
5:5:1,0,-1,104372,95628
6:3:2,1,1,104371,95629
6:1:3,0,-1,104372,95628
4:4:2,1,1,104371,95629
5:3:4,0,-1,104372,95628
5:3:3,0,-1,104373,95627
4:6:5,0,-1,104374,95626
2:6:2,2,2,104372,95628
4:4:3,0,-1,104373,95627
5:1:6,0,-1,104374,95626
4:3:4,0,-1,104375,95625
2:4:6,1,1,104374,95626
2:5:4,1,1,104373,95627
4:1:5,0,-1,104374,95626
5:6:4,0,-1,104375,95625
6:1:2,1,1,104374,95626
4:2:1,1,1,104373,95627
6:1:1,0,-1,104374,95626
1:4:3,0,-1,104375,95625
1:1:5,0,-1,104376,95624
2:6:5,1,1,104375,95625
5:1:4,0,-1,104376,95624
5:2:5,1,1,104375,95625
6:2:2,2,2,104373,95627
1:6:6,0,-1,104374,95626
6:1:3,0,-1,104375,95625
5:5:5,0,-1,104376,95624
2:4:6,1,1,104375,95625
3:4:5,0,-1,104376,95624
4:2:4,1,1,104375,95625
5:1:3,0,-1,104376,95624
5:1:3,0,-1,104377,95623
1:4:5,0,-1,104378,95622
6:5:3,0,-1,104379,95621
1:2:3,1,1,104378,95622
6:6:4,0,-1,104379,95621
2:2:4,2,2,104377,95623
5:4:6,0,-1,104378,95622
4:5:4,0,-1,104379,95621
2:5:1,1,1,104378,95622
5:4:4,0,-1,104379,95621
4:3:1,0,-1,104380,95620
4:2:2,2,2,104378,95622
5:5:5,0,-1,104379,95621
5:2:5,1,1,104378,95622
3:2:2,2,2,104376,95624
5:5:5,0,-1,104377,95623
3:6:5,0,-1,104378,95622
1:4:1,0,-1,104379,95621
6:4:4,0,-1,104380,95620
3:2:6,1,1,104379,95621
1:1:6,0,-1,104380,95620
5:2:3,1,1,104379,95621
3:5:6,0,-1,104380,95620
2:5:5,1,1,104379,95621
6:4:3,0,-1,104380,95620
6:2:1,1,1,104379,95621
3:1:4,0,-1,104380,95620
3:4:5,0,-1,104381,95619
6:1:5,0,-1,104382,95618
4:5:1,0,-1,104383,95617
5:6:6,0,-1,104384,95616
1:3:3,0,-1,104385,95615
5:1:4,0,-1,104386,95614
4:5:3,0,-1,104387,95613
2:3:2,2,2,104385,95615
3:5:4,0,-1,104386,95614
1:5:3,0,-1,104387,95613
2:1:4,1,1,104386,95614
1:5:2,1,1,104385,95615
5:2:4,1,1,104384,95616
4:4:5,0,-1,104385,95615
5:3:4,0,-1,104386,95614
6:5:2,1,1,104385,95615
1:5:3,0,-1,104386,95614
3:3:1,0,-1,104387,95613
5:4:4,0,-1,104388,95612
4:5:5,0,-1,104389,95611
4:1:5,0,-1,104390,95610
2:1:5,1,1,104389,95611
4:2:2,2,2,104387,95613
3:6:5,0,-1,104388,95612
6:6:6,0,-1,104389,95611
3:2:1,1,1,104388,95612
6:4:5,0,-1,104389,95611
5:5:3,0,-1,104390,95610
4:5:6,0,-1,104391,95609
3:3:6,0,-1,104392,95608
2:1:2,2,2,104390,95610
3:2:1,1,1,104389,95611
6:3:6,0,-1,104390,95610
6:6:4,0,-1,104391,95609
5:6:2,1,1,104390,95610
6:5:5,0,-1,104391,95609
4:6:1,0,-1,104392,95608
6:6:1,0,-1,104393,95607
3:5:5,0,-1,104394,95606
3:4:2,1,1,104393,95607
5:6:6,0,-1,104394,95606
3:6:2,1,1,104393,95607
2:5:3,1,1,104392,95608
6:6:5,0,-1,104393,95607
5:3:1,0,-1,104394,95606
5:4:1,0,-1,104395,95605
3:3:2,1,1,104394,95606
5:1:2,1,1,104393,95607
1:6:3,0,-1,104394,95606
4:6:1,0,-1,104395,95605
1:2:2,2,2,104393,95607
2:5:1,1,1,104392,95608
4:3:6,0,-1,104393,95607
3:1:6,0,-1,104394,95606
1:1:6,0,-1,104395,95605
1:4:6,0,-1,104396,95604
1:2:6,1,1,104395,95605
4:3:2,1,1,104394,95606
3:6:5,0,-1,104395,95605
4:5:3,0,-1,104396,95604
3:3:5,0,-1,104397,95603
6:3:1,0,-1,104398,95602
6:2:6,1,1,104397,95603
4:1:4,0,-1,104398,95602
4:2:2,2,2,104396,95604
6:5:4,0,-1,104397,95603
1:2:4,1,1,104396,95604
3:4:4,0,-1,104397,95603
1:1:4,0,-1,104398,95602
2:4:1,1,1,104397,95603
5:1:6,0,-1,104398,95602
4:1:3,0,-1,104399,95601
6:4:2,1,1,104398,95602
2:6:4,1,1,104397,95603
1:6:1,0,-1,104398,95602
2:5:2,2,2,104396,95604
5:6:2,1,1,104395,95605
6:4:4,0,-1,104396,95604
2:5:2,2,2,104394,95606
5:2:6,1,1,104393,95607
6:1:6,0,-1,104394,95606
5:3:2,1,1,104393,95607
3:4:6,0,-1,104394,95606
6:4:5,0,-1,104395,95605
3:4:5,0,-1,104396,95604
5:5:5,0,-1,104397,95603
1:6:4,0,-1,104398,95602
5:6:1,0,-1,104399,95601
2:1:6,1,1,104398,95602
6:5:6,0,-1,104399,95601
1:5:5,0,-1,104400,95600
2:2:6,2,2,104398,95602
5:2:2,2,2,104396,95604
1:2:1,1,1,104395,95605
6:3:4,0,-1,104396,95604
5:6:2,1,1,104395,95605
5:1:6,0,-1,104396,95604
2:6:6,1,1,104395,95605
5:1:4,0,-1,104396,95604
2:6:6,1,1,104395,95605
3:6:1,0,-1,104396,95604
5:2:2,2,2,104394,95606
3:6:3,0,-1,104395,95605
2:6:6,1,1,104394,95606
5:1:3,0,-1,104395,95605
1:2:1,1,1,104394,95606
4:6:3,0,-1,104395,95605
1:4:5,0,-1,104396,95604
3:1:1,0,-1,104397,95603
3:4:6,0,-1,104398,95602
1:2:5,1,1,104397,95603
3:5:6,0,-1,104398,95602
4:5:1,0,-1,104399,95601
2:1:4,1,1,104398,95602
6:1:6,0,-1,104399,95601
5:2:6,1,1,104398,95602
2:2:5,2,2,104396,95604
4:5:3,0,-1,104397,95603
5:3:5,0,-1,104398,95602
2:1:2,2,2,104396,95604
4:6:5,0,-1,104397,95603
6:4:2,1,1,104396,95604
2:4:4,1,1,104395,95605
1:2:6,1,1,104394,95606
3:6:5,0,-1,104395,95605
5:4:1,0,-1,104396,95604
1:3:5,0,-1,104397,95603
6:2:1,1,1,104396,95604
5:3:5,0,-1,104397,95603
4:4:5,0,-1,104398,95602
6:2:2,2,2,104396,95604
6:1:2,1,1,104395,95605
6:2:4,1,1,104394,95606
5:6:3,0,-1,104395,95605
3:6:2,1,1,104394,95606
5:2:6,1,1,104393,95607
5:3:6,0,-1,104394,95606
5:4:5,0,-1,104395,95605
1:6:3,0,-1,104396,95604
2:1:4,1,1,104395,95605
5:2:1,1,1,104394,95606
6:3:6,0,-1,104395,95605
3:6:3,0,-1,104396,95604
2:2:3,2,2,104394,95606
5:1:2,1,1,104393,95607
1:2:4,1,1,104392,95608
4:5:3,0,-1,104393,95607
4:3:1,0,-1,104394,95606
3:3:3,0,-1,104395,95605
2:4:3,1,1,104394,95606
3:4:5,0,-1,104395,95605
1:5:2,1,1,104394,95606
5:1:6,0,-1,104395,95605
4:4:2,1,1,104394,95606
6:3:3,0,-1,104395,95605
6:3:5,0,-1,104396,95604
6:4:1,0,-1,104397,95603
1:1:2,1,1,104396,95604
5:6:4,0,-1,104397,95603
3:4:6,0,-1,104398,95602
2:3:4,1,1,104397,95603
3:5:1,0,-1,104398,95602
5:2:2,2,2,104396,95604
2:1:6,1,1,104395,95605
6:4:1,0,-1,104396,95604
6:3:1,0,-1,104397,95603
2:3:2,2,2,104395,95605
6:1:4,0,-1,104396,95604
3:6:5,0,-1,104397,95603
1:3:4,0,-1,104398,95602
2:5:4,1,1,104397,95603
2:5:4,1,1,104396,95604
3:3:5,0,-1,104397,95603
3:5:3,0,-1,104398,95602
2:5:1,1,1,104397,95603
1:5:5,0,-1,104398,95602
1:2:2,2,2,104396,95604
5:6:2,1,1,104395,95605
3:3:1,0,-1,104396,95604
4:4:1,0,-1,104397,95603
3:4:5,0,-1,104398,95602
6:4:4,0,-1,104399,95601
2:4:5,1,1,104398,95602
3:2:4,1,1,104397,95603
4:2:3,1,1,104396,95604
1:3:3,0,-1,104397,95603
1:2:6,1,1,104396,95604
5:6:2,1,1,104395,95605
4:5:2,1,1,104394,95606
4:3:5,0,-1,104395,95605
4:1:2,1,1,104394,95606
3:1:5,0,-1,104395,95605
3:2:2,2,2,104393,95607
4:2:4,1,1,104392,95608
3:6:1,0,-1,104393,95607
2:6:3,1,1,104392,95608
3:4:2,1,1,104391,95609
5:5:1,0,-1,104392,95608
5:2:3,1,1,104391,95609
2:5:4,1,1,104390,95610
1:1:4,0,-1,104391,95609
1:1:1,0,-1,104392,95608
5:2:2,2,2,104390,95610
3:1:5,0,-1,104391,95609
5:2:1,1,1,104390,95610
1:1:6,0,-1,104391,95609
3:5:1,0,-1,104392,95608
3:3:1,0,-1,104393,95607
3:6:2,1,1,104392,95608
2:2:2,3,3,104389,95611
2:1:2,2,2,104387,95613
4:4:5,0,-1,104388,95612
5:5:4,0,-1,104389,95611
5:2:5,1,1,104388,95612
2:1:2,2,2,104386,95614
1:6:3,0,-1,104387,95613
3:5:3,0,-1,104388,95612
2:5:1,1,1,104387,95613
1:3:5,0,-1,104388,95612
6:5:4,0,-1,104389,95611
6:3:4,0,-1,104390,95610
2:4:4,1,1,104389,95611
6:1:2,1,1,104388,95612
2:1:6,1,1,104387,95613
2:4:2,2,2,104385,95615
4:6:6,0,-1,104386,95614
2:4:2,2,2,104384,95616
2:5:5,1,1,104383,95617
2:6:6,1,1,104382,95618
3:3:4,0,-1,104383,95617
4:4:6,0,-1,104384,95616
2:1:4,1,1,104383,95617
6:1:6,0,-1,104384,95616
3:2:5,1,1,104383,95617
2:6:3,1,1,104382,95618
4:2:1,1,1,104381,95619
6:5:6,0,-1,104382,95618
6:2:6,1,1,104381,95619
5:2:2,2,2,104379,95621
3:5:2,1,1,104378,95622
1:5:1,0,-1,104379,95621
3:2:1,1,1,104378,95622
5:5:1,0,-1,104379,95621
5:2:1,1,1,104378,95622
5:2:5,1,1,104377,95623
2:2:4,2,2,104375,95625
3:1:3,0,-1,104376,95624
5:5:5,0,-1,104377,95623
4:2:6,1,1,104376,95624
6:6:4,0,-1,104377,95623
3:4:1,0,-1,104378,95622
3:3:6,0,-1,104379,95621
2:3:2,2,2,104377,95623
1:5:6,0,-1,104378,95622
3:4:1,0,-1,104379,95621
3:6:3,0,-1,104380,95620
3:1:2,1,1,104379,95621
4:3:4,0,-1,104380,95620
1:1:5,0,-1,104381,95619
5:2:4,1,1,104380,95620
1:3:2,1,1,104379,95621
1:3:2,1,1,104378,95622
1:6:5,0,-1,104379,95621
2:2:6,2,2,104377,95623
1:3:6,0,-1,104378,95622
4:6:5,0,-1,104379,95621
6:4:3,0,-1,104380,95620
3:6:2,1,1,104379,95621
1:6:3,0,-1,104380,95620
6:1:1,0,-1,104381,95619
1:1:1,0,-1,104382,95618
6:5:6,0,-1,104383,95617
6:1:3,0,-1,104384,95616
3:4:4,0,-1,104385,95615
6:1:1,0,-1,104386,95614
4:2:6,1,1,104385,95615
4:2:2,2,2,104383,95617
6:6:2,1,1,104382,95618
6:6:5,0,-1,104383,95617
2:3:4,1,1,104382,95618
3:6:4,0,-1,104383,95617
5:5:3,0,-1,104384,95616
1:2:2,2,2,104382,95618
6:1:4,0,-1,104383,95617
2:3:4,1,1,104382,95618
3:1:4,0,-1,104383,95617
5:4:1,0,-1,104384,95616
6:6:5,0,-1,104385,95615
6:2:1,1,1,104384,95616
5:6:4,0,-1,104385,95615
2:2:5,2,2,104383,95617
2:2:6,2,2,104381,95619
6:2:5,1,1,104380,95620
5:5:1,0,-1,104381,95619
4:4:6,0,-1,104382,95618
4:5:6,0,-1,104383,95617
2:6:2,2,2,104381,95619
6:4:5,0,-1,104382,95618
6:6:4,0,-1,104383,95617
6:1:3,0,-1,104384,95616
3:5:4,0,-1,104385,95615
3:5:5,0,-1,104386,95614
1:3:5,0,-1,104387,95613
3:5:2,1,1,104386,95614
5:1:4,0,-1,104387,95613
4:3:5,0,-1,104388,95612
5:6:5,0,-1,104389,95611
5:3:2,1,1,104388,95612
3:3:5,0,-1,104389,95611
6:2:3,1,1,104388,95612
5:4:5,0,-1,104389,95611
1:1:2,1,1,104388,95612
5:5:4,0,-1,104389,95611
2:2:3,2,2,104387,95613
5:6:1,0,-1,104388,95612
5:6:5,0,-1,104389,95611
4:3:3,0,-1,104390,95610
2:5:4,1,1,104389,95611
6:2:4,1,1,104388,95612
1:4:2,1,1,104387,95613
5:6:1,0,-1,104388,95612
2:6:3,1,1,104387,95613
5:2:4,1,1,104386,95614
4:4:3,0,-1,104387,95613
2:6:4,1,1,104386,95614
5:5:6,0,-1,104387,95613
5:3:4,0,-1,104388,95612
2:6:3,1,1,104387,95613
2:3:2,2,2,104385,95615
1:6:2,1,1,104384,95616
6:3:2,1,1,104383,95617
5:5:3,0,-1,104384,95616
6:6:6,0,-1,104385,95615
2:5:3,1,1,104384,95616
4:2:3,1,1,104383,95617
1:3:3,0,-1,104384,95616
4:3:2,1,1,104383,95617
1:4:4,0,-1,104384,95616
1:3:2,1,1,104383,95617
1:5:4,0,-1,104384,95616
3:6:3,0,-1,104385,95615
3:5:1,0,-1,104386,95614
3:3:4,0,-1,104387,95613
3:3:2,1,1,104386,95614
2:2:5,2,2,104384,95616
5:3:5,0,-1,104385,95615
5:4:5,0,-1,104386,95614
2:1:5,1,1,104385,95615
3:2:1,1,1,104384,95616
1:2:1,1,1,104383,95617
4:5:4,0,-1,104384,95616
6:3:2,1,1,104383,95617
2:4:4,1,1,104382,95618
6:4:5,0,-1,104383,95617
2:1:4,1,1,104382,95618
5:4:1,0,-1,104383,95617
3:5:2,1,1,104382,95618
6:2:1,1,1,104381,95619
4:6:5,0,-1,104382,95618
4:3:5,0,-1,104383,95617
3:5:5,0,-1,104384,95616
3:5:4,0,-1,104385,95615
6:6:1,0,-1,104386,95614
6:4:1,0,-1,104387,95613
3:4:1,0,-1,104388,95612
1:3:3,0,-1,104389,95611
1:4:4,0,-1,104390,95610
1:4:2,1,1,104389,95611
6:6:5,0,-1,104390,95610
5:1:5,0,-1,104391,95609
4:6:6,0,-1,104392,95608
1:3:3,0,-1,104393,95607
2:1:5,1,1,104392,95608
5:3:5,0,-1,104393,95607
3:6:6,0,-1,104394,95606
5:5:5,0,-1,104395,95605
5:4:3,0,-1,104396,95604
6:1:1,0,-1,104397,95603
2:3:3,1,1,104396,95604
1:2:6,1,1,104395,95605
3:1:1,0,-1,104396,95604
6:2:1,1,1,104395,95605
4:6:6,0,-1,104396,95604
2:3:4,1,1,104395,95605
5:1:3,0,-1,104396,95604
1:2:2,2,2,104394,95606
2:3:3,1,1,104393,95607
4:4:3,0,-1,104394,95606
6:6:1,0,-1,104395,95605
3:2:1,1,1,104394,95606
3:3:1,0,-1,104395,95605
5:5:4,0,-1,104396,95604
3:1:2,1,1,104395,95605
4:5:4,0,-1,104396,95604
3:6:5,0,-1,104397,95603
6:5:3,0,-1,104398,95602
3:5:3,0,-1,104399,95601
4:2:3,1,1,104398,95602
1:6:1,0,-1,104399,95601
4:4:2,1,1,104398,95602
5:3:3,0,-1,104399,95601
5:3:4,0,-1,104400,95600
6:3:1,0,-1,104401,95599
5:3:3,0,-1,104402,95598
4:4:4,0,-1,104403,95597
6:5:5,0,-1,104404,95596
3:3:6,0,-1,104405,95595
4:4:5,0,-1,104406,95594
2:3:5,1,1,104405,95595
5:5:3,0,-1,104406,95594
4:5:6,0,-1,104407,95593
6:6:4,0,-1,104408,95592
4:3:6,0,-1,104409,95591
2:2:2,3,3,104406,95594
6:2:3,1,1,104405,95595
3:2:6,1,1,104404,95596
6:4:1,0,-1,104405,95595
5:1:4,0,-1,104406,95594
3:5:3,0,-1,104407,95593
3:1:2,1,1,104406,95594
1:5:2,1,1,104405,95595
5:1:1,0,-1,104406,95594
5:6:5,0,-1,104407,95593
5:3:6,0,-1,104408,95592
3:5:5,0,-1,104409,95591
1:2:2,2,2,104407,95593
3:6:4,0,-1,104408,95592
1:4:2,1,1,104407,95593
1:1:5,0,-1,104408,95592
3:4:6,0,-1,104409,95591
4:5:1,0,-1,104410,95590
1:4:2,1,1,104409,95591
6:5:1,0,-1,104410,95590
3:2:6,1,1,104409,95591
5:4:3,0,-1,104410,95590
3:3:1,0,-1,104411,95589
3:3:4,0,-1,104412,95588
6:1:6,0,-1,104413,95587
5:1:1,0,-1,104414,95586
3:4:1,0,-1,104415,95585
3:3:5,0,-1,104416,95584
3:5:1,0,-1,104417,95583
6:1:1,0,-1,104418,95582
1:5:3,0,-1,104419,95581
6:4:4,0,-1,104420,95580
1:5:4,0,-1,104421,95579
2:5:5,1,1,104420,95580
1:2:5,1,1,104419,95581
4:3:6,0,-1,104420,95580
2:4:3,1,1,104419,95581
2:5:4,1,1,104418,95582
6:6:4,0,-1,104419,95581
1:2:4,1,1,104418,95582
6:3:3,0,-1,104419,95581
4:1:1,0,-1,104420,95580
2:5:6,1,1,104419,95581
1:6:4,0,-1,104420,95580
3:4:3,0,-1,104421,95579
4:4:3,0,-1,104422,95578
6:3:3,0,-1,104423,95577
4:1:4,0,-1,104424,95576
3:6:3,0,-1,104425,95575
3:2:3,1,1,104424,95576
5:2:1,1,1,104423,95577
1:2:2,2,2,104421,95579
4:4:3,0,-1,104422,95578
2:6:6,1,1,104421,95579
5:3:1,0,-1,104422,95578
6:5:4,0,-1,104423,95577
6:1:1,0,-1,104424,95576
3:1:1,0,-1,104425,95575
5:2:1,1,1,104424,95576
5:5:4,0,-1,104425,95575
6:3:6,0,-1,104426,95574
5:1:6,0,-1,104427,95573
4:2:4,1,1,104426,95574
3:5:1,0,-1,104427,95573
4:3:2,1,1,104426,95574
6:1:3,0,-1,104427,95573
2:5:3,1,1,104426,95574
1:3:2,1,1,104425,95575
1:4:5,0,-1,104426,95574
3:2:6,1,1,104425,95575
3:2:5,1,1,104424,95576
4:1:5,0,-1,104425,95575
5:3:5,0,-1,104426,95574
2:6:1,1,1,104425,95575
3:3:3,0,-1,104426,95574
5:6:5,0,-1,104427,95573
2:2:5,2,2,104425,95575
4:1:1,0,-1,104426,95574
2:4:6,1,1,104425,95575
3:1:1,0,-1,104426,95574
2:6:3,1,1,104425,95575
1:4:4,0,-1,104426,95574
3:1:6,0,-1,104427,95573
1:5:1,0,-1,104428,95572
2:6:3,1,1,104427,95573
1:3:2,1,1,104426,95574
2:4:1,1,1,104425,95575
3:3:4,0,-1,104426,95574
3:4:6,0,-1,104427,95573
3:6:3,0,-1,104428,95572
4:5:5,0,-1,104429,95571
5:3:5,0,-1,104430,95570
4:2:3,1,1,104429,95571
3:3:2,1,1,104428,95572
2:5:6,1,1,104427,95573
5:6:5,0,-1,104428,95572
6:3:1,0,-1,104429,95571
4:1:1,0,-1,104430,95570
5:6:6,0,-1,104431,95569
1:4:2,1,1,104430,95570
1:2:5,1,1,104429,95571
4:4:3,0,-1,104430,95570
3:4:3,0,-1,104431,95569
5:1:6,0,-1,104432,95568
2:1:6,1,1,104431,95569
1:6:3,0,-1,104432,95568
1:4:4,0,-1,104433,95567
1:2:3,1,1,104432,95568
1:2:1,1,1,104431,95569
5:2:5,1,1,104430,95570
1:4:2,1,1,104429,95571
4:4:4,0,-1,104430,95570
4:6:1,0,-1,104431,95569
5:2:3,1,1,104430,95570
5:2:4,1,1,104429,95571
1:2:5,1,1,104428,95572
6:4:3,0,-1,104429,95571
6:2:1,1,1,104428,95572
6:2:5,1,1,104427,95573
3:4:1,0,-1,104428,95572
5:3:4,0,-1,104429,95571
2:1:1,1,1,104428,95572
4:6:1,0,-1,104429,95571
2:3:4,1,1,104428,95572
2:5:3,1,1,104427,95573
5:1:6,0,-1,104428,95572
3:2:2,2,2,104426,95574
2:4:1,1,1,104425,95575
2:6:5,1,1,104424,95576
1:3:3,0,-1,104425,95575
1:6:2,1,1,104424,95576
4:6:6,0,-1,104425,95575
4:5:6,0,-1,104426,95574
4:6:2,1,1,104425,95575
3:4:1,0,-1,104426,95574
4:6:2,1,1,104425,95575
2:6:3,1,1,104424,95576
3:6:6,0,-1,104425,95575
3:6:5,0,-1,104426,95574
6:3:2,1,1,104425,95575
6:2:5,1,1,104424,95576
4:5:5,0,-1,104425,95575
5:1:3,0,-1,104426,95574
5:1:1,0,-1,104427,95573
5:2:4,1,1,104426,95574
2:2:3,2,2,104424,95576
2:3:5,1,1,104423,95577
2:2:1,2,2,104421,95579
1:5:5,0,-1,104422,95578
4:6:5,0,-1,104423,95577
6:5:5,0,-1,104424,95576
4:4:1,0,-1,104425,95575
1:3:1,0,-1,104426,95574
3:1:1,0,-1,104427,95573
4:3:4,0,-1,104428,95572
4:4:1,0,-1,104429,95571
5:1:5,0,-1,104430,95570
5:6:5,0,-1,104431,95569
1:3:2,1,1,104430,95570
4:5:1,0,-1,104431,95569
3:4:1,0,-1,104432,95568
4:5:1,0,-1,104433,95567
4:4:4,0,-1,104434,95566
1:5:2,1,1,104433,95567
4:5:1,0,-1,104434,95566
1:5:1,0,-1,104435,95565
5:1:3,0,-1,104436,95564
5:2:4,1,1,104435,95565
6:3:2,1,1,104434,95566
5:2:5,1,1,104433,95567
5:3:1,0,-1,104434,95566
1:6:3,0,-1,104435,95565
6:5:4,0,-1,104436,95564
5:1:6,0,-1,104437,95563
1:5:5,0,-1,104438,95562
6:3:6,0,-1,104439,95561
5:5:6,0,-1,104440,95560
3:3:4,0,-1,104441,95559
3:6:1,0,-1,104442,95558
6:6:5,0,-1,104443,95557
6:5:1,0,-1,104444,95556
1:6:6,0,-1,104445,95555
4:1:6,0,-1,104446,95554
6:1:3,0,-1,104447,95553
5:1:2,1,1,104446,95554
1:4:6,0,-1,104447,95553
2:1:5,1,1,104446,95554
4:1:2,1,1,104445,95555
1:2:2,2,2,104443,95557
4:3:2,1,1,104442,95558
4:6:3,0,-1,104443,95557
6:1:3,0,-1,104444,95556
3:3:2,1,1,104443,95557
2:2:3,2,2,104441,95559
2:2:5,2,2,104439,95561
2:3:5,1,1,104438,95562
1:2:5,1,1,104437,95563
4:3:4,0,-1,104438,95562
3:5:2,1,1,104437,95563
6:6:2,1,1,104436,95564
4:1:5,0,-1,104437,95563
2:4:4,1,1,104436,95564
6:2:3,1,1,104435,95565
1:5:6,0,-1,104436,95564
3:5:6,0,-1,104437,95563
5:6:4,0,-1,104438,95562
6:4:1,0,-1,104439,95561
4:3:5,0,-1,104440,95560
5:1:6,0,-1,104441,95559
2:4:1,1,1,104440,95560
3:2:3,1,1,104439,95561
6:1:5,0,-1,104440,95560
4:4:3,0,-1,104441,95559
2:6:2,2,2,104439,95561
4:3:2,1,1,104438,95562
2:3:1,1,1,104437,95563
4:4:4,0,-1,104438,95562
4:1:2,1,1,104437,95563
2:2:1,2,2,104435,95565
4:1:6,0,-1,104436,95564
6:3:5,0,-1,104437,95563
1:5:3,0,-1,104438,95562
1:2:1,1,1,104437,95563
4:3:3,0,-1,104438,95562
1:2:1,1,1,104437,95563
4:4:1,0,-1,104438,95562
2:3:1,1,1,104437,95563
5:6:1,0,-1,104438,95562
5:4:2,1,1,104437,95563
4:1:6,0,-1,104438,95562
2:5:4,1,1,104437,95563
2:2:3,2,2,104435,95565
4:6:5,0,-1,104436,95564
1:3:4,0,-1,104437,95563
4:6:4,0,-1,104438,95562
5:6:6,0,-1,104439,95561
4:1:2,1,1,104438,95562
3:3:2,1,1,104437,95563
5:2:2,2,2,104435,95565
3:4:6,0,-1,104436,95564
5:1:3,0,-1,104437,95563
5:5:2,1,1,104436,95564
1:3:1,0,-1,104437,95563
3:1:4,0,-1,104438,95562
6:6:4,0,-1,104439,95561
2:3:3,1,1,104438,95562
5:6:3,0,-1,104439,95561
2:4:1,1,1,104438,95562
4:6:2,1,1,104437,95563
5:1:1,0,-1,104438,95562
2:3:1,1,1,104437,95563
3:5:1,0,-1,104438,95562
6:5:2,1,1,104437,95563
3:6:2,1,1,104436,95564
4:5:1,0,-1,104437,95563
2:3:5,1,1,104436,95564
2:2:1,2,2,104434,95566
3:6:6,0,-1,104435,95565
3:1:3,0,-1,104436,95564
6:2:4,1,1,104435,95565
3:6:1,0,-1,104436,95564
1:4:6,0,-1,104437,95563
5:6:2,1,1,104436,95564
6:6:6,0,-1,104437,95563
1:3:5,0,-1,104438,95562
3:6:4,0,-1,104439,95561
1:4:1,0,-1,104440,95560
6:5:1,0,-1,104441,95559
4:3:1,0,-1,104442,95558
1:3:5,0,-1,104443,95557
5:6:1,0,-1,104444,95556
5:3:1,0,-1,104445,95555
5:1:5,0,-1,104446,95554
4:2:6,1,1,104445,95555
5:2:4,1,1,104444,95556
4:4:4,0,-1,104445,95555
4:5:2,1,1,104444,95556
3:1:4,0,-1,104445,95555
3:4:5,0,-1,104446,95554
3:1:4,0,-1,104447,95553
3:4:2,1,1,104446,95554
4:6:6,0,-1,104447,95553
4:6:3,0,-1,104448,95552
6:1:5,0,-1,104449,95551
2:1:3,1,1,104448,95552
2:6:6,1,1,104447,95553
3:1:3,0,-1,104448,95552
2:1:1,1,1,104447,95553
6:1:5,0,-1,104448,95552
3:1:6,0,-1,104449,95551
3:6:6,0,-1,104450,95550
1:1:5,0,-1,104451,95549
1:3:1,0,-1,104452,95548
3:3:5,0,-1,104453,95547
3:2:5,1,1,104452,95548
6:1:2,1,1,104451,95549
3:3:4,0,-1,104452,95548
2:5:1,1,1,104451,95549
3:6:4,0,-1,104452,95548
4:1:2,1,1,104451,95549
6:4:6,0,-1,104452,95548
1:1:2,1,1,104451,95549
3:3:1,0,-1,104452,95548
1:3:3,0,-1,104453,95547
2:1:2,2,2,104451,95549
4:4:4,0,-1,104452,95548
6:3:4,0,-1,104453,95547
4:4:3,0,-1,104454,95546
6:6:5,0,-1,104455,95545
2:1:6,1,1,104454,95546
6:5:3,0,-1,104455,95545
1:3:4,0,-1,104456,95544
3:3:4,0,-1,104457,95543
4:1:5,0,-1,104458,95542
6:1:4,0,-1,104459,95541
6:3:5,0,-1,104460,95540
2:1:1,1,1,104459,95541
3:4:5,0,-1,104460,95540
5:4:2,1,1,104459,95541
1:5:1,0,-1,104460,95540
6:2:5,1,1,104459,95541
2:6:5,1,1,104458,95542
5:3:3,0,-1,104459,95541
2:1:2,2,2,104457,95543
3:5:4,0,-1,104458,95542
4:3:2,1,1,104457,95543
6:5:3,0,-1,104458,95542
3:6:4,0,-1,104459,95541
1:1:6,0,-1,104460,95540
4:2:2,2,2,104458,95542
5:2:6,1,1,104457,95543
2:6:4,1,1,104456,95544
6:6:6,0,-1,104457,95543
6:1:2,1,1,104456,95544
1:1:6,0,-1,104457,95543
4:4:3,0,-1,104458,95542
5:5:6,0,-1,104459,95541
1:2:2,2,2,104457,95543
1:3:2,1,1,104456,95544
6:1:2,1,1,104455,95545
6:6:4,0,-1,104456,95544
2:6:6,1,1,104455,95545
6:4:3,0,-1,104456,95544
5:1:4,0,-1,104457,95543
1:3:3,0,-1,104458,95542
6:4:1,0,-1,104459,95541
1:5:4,0,-1,104460,95540
6:2:4,1,1,104459,95541
4:4:1,0,-1,104460,95540
4:1:3,0,-1,104461,95539
1:1:5,0,-1,104462,95538
1:2:5,1,1,104461,95539
5:5:5,0,-1,104462,95538
1:3:3,0,-1,104463,95537
1:1:6,0,-1,104464,95536
3:6:4,0,-1,104465,95535
6:1:5,0,-1,104466,95534
2:6:5,1,1,104465,95535
5:4:2,1,1,104464,95536
5:2:5,1,1,104463,95537
6:4:3,0,-1,104464,95536
1:5:4,0,-1,104465,95535
6:4:2,1,1,104464,95536
5:1:5,0,-1,104465,95535
1:3:4,0,-1,104466,95534
5:3:5,0,-1,104467,95533
2:1:5,1,1,104466,95534
4:2:1,1,1,104465,95535
4:3:6,0,-1,104466,95534
3:2:3,1,1,104465,95535
3:1:2,1,1,104464,95536
5:3:2,1,1,104463,95537
5:3:1,0,-1,104464,95536
3:5:2,1,1,104463,95537
2:4:3,1,1,104462,95538
3:4:3,0,-1,104463,95537
3:5:1,0,-1,104464,95536
1:5:3,0,-1,104465,95535
2:5:4,1,1,104464,95536
3:4:4,0,-1,104465,95535
2:3:5,1,1,104464,95536
5:1:4,0,-1,104465,95535
6:5:6,0,-1,104466,95534
4:6:2,1,1,104465,95535
3:1:1,0,-1,104466,95534
6:4:1,0,-1,104467,95533
2:2:3,2,2,104465,95535
2:3:1,1,1,104464,95536
5:2:6,1,1,104463,95537
1:3:6,0,-1,104464,95536
1:2:4,1,1,104463,95537
5:6:3,0,-1,104464,95536
2:6:5,1,1,104463,95537
4:3:3,0,-1,104464,95536
4:5:4,0,-1,104465,95535
4:5:1,0,-1,104466,95534
4:6:6,0,-1,104467,95533
1:6:2,1,1,104466,95534
1:4:4,0,-1,104467,95533
4:4:1,0,-1,104468,95532
5:2:2,2,2,104466,95534
6:4:6,0,-1,104467,95533
5:3:2,1,1,104466,95534
4:5:4,0,-1,104467,95533
5:1:5,0,-1,104468,95532
2:4:1,1,1,104467,95533
6:6:6,0,-1,104468,95532
1:2:4,1,1,104467,95533
1:3:6,0,-1,104468,95532
4:3:4,0,-1,104469,95531
3:6:4,0,-1,104470,95530
2:6:5,1,1,104469,95531
4:1:3,0,-1,104470,95530
3:5:5,0,-1,104471,95529
4:2:6,1,1,104470,95530
2:3:4,1,1,104469,95531
6:2:6,1,1,104468,95532
5:4:5,0,-1,104469,95531
3:5:4,0,-1,104470,95530
3:6:4,0,-1,104471,95529
5:1:3,0,-1,104472,95528
5:4:3,0,-1,104473,95527
2:6:5,1,1,104472,95528
4:5:2,1,1,104471,95529
4:6:6,0,-1,104472,95528
6:3:1,0,-1,104473,95527
1:3:3,0,-1,104474,95526
2:5:2,2,2,104472,95528
4:5:5,0,-1,104473,95527
5:2:1,1,1,104472,95528
2:1:3,1,1,104471,95529
2:3:2,2,2,104469,95531
6:6:5,0,-1,104470,95530
5:6:4,0,-1,104471,95529
2:2:6,2,2,104469,95531
2:2:3,2,2,104467,95533
4:5:5,0,-1,104468,95532
6:5:1,0,-1,104469,95531
5:1:2,1,1,104468,95532
5:6:1,0,-1,104469,95531
3:6:2,1,1,104468,95532
1:1:1,0,-1,104469,95531
4:6:2,1,1,104468,95532
4:4:3,0,-1,104469,95531
5:4:6,0,-1,104470,95530
2:2:3,2,2,104468,95532
4:2:1,1,1,104467,95533
6:2:3,1,1,104466,95534
5:6:4,0,-1,104467,95533
6:2:5,1,1,104466,95534
5:2:6,1,1,104465,95535
2:5:2,2,2,104463,95537
2:3:6,1,1,104462,95538
4:1:4,0,-1,104463,95537
1:4:5,0,-1,104464,95536
2:3:4,1,1,104463,95537
6:5:3,0,-1,104464,95536
2:5:4,1,1,104463,95537
3:4:4,0,-1,104464,95536
6:3:4,0,-1,104465,95535
6:5:3,0,-1,104466,95534
5:1:6,0,-1,104467,95533
4:3:3,0,-1,104468,95532
3:3:1,0,-1,104469,95531
1:5:6,0,-1,104470,95530
4:6:5,0,-1,104471,95529
5:1:2,1,1,104470,95530
2:4:1,1,1,104469,95531
4:1:4,0,-1,104470,95530
2:5:5,1,1,104469,95531
4:2:2,2,2,104467,95533
5:5:3,0,-1,104468,95532
1:1:4,0,-1,104469,95531
5:1:3,0,-1,104470,95530
4:2:1,1,1,104469,95531
4:5:6,0,-1,104470,95530
6:5:2,1,1,104469,95531
5:3:2,1,1,104468,95532
2:4:2,2,2,104466,95534
1:3:1,0,-1,104467,95533
6:2:1,1,1,104466,95534
2:1:5,1,1,104465,95535
1:6:4,0,-1,104466,95534
3:6:2,1,1,104465,95535
6:4:1,0,-1,104466,95534
1:5:3,0,-1,104467,95533
2:6:1,1,1,104466,95534
4:3:3,0,-1,104467,95533
1:4:5,0,-1,104468,95532
2:5:1,1,1,104467,95533
3:6:3,0,-1,104468,95532
4:2:6,1,1,104467,95533
5:4:5,0,-1,104468,95532
3:2:2,2,2,104466,95534
5:5:4,0,-1,104467,95533
4:6:6,0,-1,104468,95532
2:4:2,2,2,104466,95534
4:3:5,0,-1,104467,95533
3:6:1,0,-1,104468,95532
2:4:6,1,1,104467,95533
4:5:6,0,-1,104468,95532
6:6:5,0,-1,104469,95531
2:3:2,2,2,104467,95533
4:1:5,0,-1,104468,95532
1:4:5,0,-1,104469,95531
2:3:6,1,1,104468,95532
5:6:5,0,-1,104469,95531
4:3:5,0,-1,104470,95530
1:1:1,0,-1,104471,95529
3:2:5,1,1,104470,95530
4:5:1,0,-1,104471,95529
1:4:4,0,-1,104472,95528
5:5:6,0,-1,104473,95527
5:1:2,1,1,104472,95528
5:6:5,0,-1,104473,95527
3:3:3,0,-1,104474,95526
2:6:5,1,1,104473,95527
1:2:6,1,1,104472,95528
2:1:1,1,1,104471,95529
4:6:3,0,-1,104472,95528
5:2:1,1,1,104471,95529
6:6:3,0,-1,104472,95528
1:3:3,0,-1,104473,95527
6:2:5,1,1,104472,95528
5:3:3,0,-1,104473,95527
2:2:5,2,2,104471,95529
5:2:6,1,1,104470,95530
2:6:3,1,1,104469,95531
1:1:3,0,-1,104470,95530
6:4:3,0,-1,104471,95529
3:1:1,0,-1,104472,95528
1:2:6,1,1,104471,95529
4:2:6,1,1,104470,95530
1:5:5,0,-1,104471,95529
5:6:3,0,-1,104472,95528
6:5:4,0,-1,104473,95527
3:1:2,1,1,104472,95528
4:5:4,0,-1,104473,95527
4:5:4,0,-1,104474,95526
2:6:3,1,1,104473,95527
5:4:5,0,-1,104474,95526
4:4:2,1,1,104473,95527
3:6:2,1,1,104472,95528
4:3:1,0,-1,104473,95527
1:6:6,0,-1,104474,95526
2:4:2,2,2,104472,95528
2:2:4,2,2,104470,95530
2:1:5,1,1,104469,95531
5:4:2,1,1,104468,95532
2:1:5,1,1,104467,95533
4:4:6,0,-1,104468,95532
1:6:2,1,1,104467,95533
6:2:4,1,1,104466,95534
1:5:5,0,-1,104467,95533
4:4:1,0,-1,104468,95532
4:2:3,1,1,104467,95533
4:6:1,0,-1,104468,95532
4:1:2,1,1,104467,95533
4:4:6,0,-1,104468,95532
6:1:6,0,-1,104469,95531
1:6:3,0,-1,104470,95530
2:6:2,2,2,104468,95532
6:6:3,0,-1,104469,95531
4:3:2,1,1,104468,95532
2:5:6,1,1,104467,95533
2:1:2,2,2,104465,95535
2:5:5,1,1,104464,95536
5:2:1,1,1,104463,95537
3:4:5,0,-1,104464,95536
6:4:3,0,-1,104465,95535
4:4:6,0,-1,104466,95534
2:2:2,3,3,104463,95537
4:6:4,0,-1,104464,95536
5:4:5,0,-1,104465,95535
4:5:1,0,-1,104466,95534
5:6:5,0,-1,104467,95533
1:4:1,0,-1,104468,95532
1:6:3,0,-1,104469,95531
6:2:3,1,1,104468,95532
2:1:2,2,2,104466,95534
4:3:1,0,-1,104467,95533
6:6:2,1,1,104466,95534
4:3:1,0,-1,104467,95533
2:5:3,1,1,104466,95534
4:6:3,0,-1,104467,95533
3:3:4,0,-1,104468,95532
1:3:1,0,-1,104469,95531
4:6:5,0,-1,104470,95530
6:6:6,0,-1,104471,95529
5:2:5,1,1,104470,95530
1:1:2,1,1,104469,95531
5:5:1,0,-1,104470,95530
5:6:6,0,-1,104471,95529
4:1:3,0,-1,104472,95528
1:1:6,0,-1,104473,95527
2:5:1,1,1,104472,95528
3:3:1,0,-1,104473,95527
6:2:4,1,1,104472,95528
1:2:4,1,1,104471,95529
1:4:1,0,-1,104472,95528
2:5:1,1,1,104471,95529
6:6:4,0,-1,104472,95528
4:2:4,1,1,104471,95529
5:3:1,0,-1,104472,95528
4:2:5,1,1,104471,95529
2:4:2,2,2,104469,95531
3:5:5,0,-1,104470,95530
6:3:2,1,1,104469,95531
3:4:3,0,-1,104470,95530
4:2:6,1,1,104469,95531
6:1:3,0,-1,104470,95530
3:5:4,0,-1,104471,95529
2:1:1,1,1,104470,95530
1:4:4,0,-1,104471,95529
5:3:3,0,-1,104472,95528
1:5:1,0,-1,104473,95527
2:3:4,1,1,104472,95528
6:5:4,0,-1,104473,95527
6:4:6,0,-1,104474,95526
4:5:1,0,-1,104475,95525
3:6:2,1,1,104474,95526
5:1:6,0,-1,104475,95525
1:6:5,0,-1,104476,95524
4:3:2,1,1,104475,95525
4:4:4,0,-1,104476,95524
3:6:3,0,-1,104477,95523
5:5:1,0,-1,104478,95522
4:2:1,1,1,104477,95523
3:1:1,0,-1,104478,95522
5:6:1,0,-1,104479,95521
3:1:2,1,1,104478,95522
4:2:4,1,1,104477,95523
5:4:4,0,-1,104478,95522
2:6:6,1,1,104477,95523
5:6:3,0,-1,104478,95522
3:1:6,0,-1,104479,95521
2:6:5,1,1,104478,95522
5:2:4,1,1,104477,95523
2:3:4,1,1,104476,95524
3:1:3,0,-1,104477,95523
5:6:1,0,-1,104478,95522
4:6:3,0,-1,104479,95521
2:2:6,2,2,104477,95523
1:3:1,0,-1,104478,95522
4:3:2,1,1,104477,95523
3:3:4,0,-1,104478,95522
4:5:5,0,-1,104479,95521
2:2:3,2,2,104477,95523
5:6:1,0,-1,104478,95522
4:2:1,1,1,104477,95523
6:5:5,0,-1,104478,95522
6:3:2,1,1,104477,95523
5:3:4,0,-1,104478,95522
1:3:5,0,-1,104479,95521
5:1:4,0,-1,104480,95520
1:6:3,0,-1,104481,95519
2:3:3,1,1,104480,95520
1:4:6,0,-1,104481,95519
6:5:6,0,-1,104482,95518
5:1:5,0,-1,104483,95517
1:6:4,0,-1,104484,95516
6:4:3,0,-1,104485,95515
2:1:5,1,1,104484,95516
4:1:4,0,-1,104485,95515
3:3:5,0,-1,104486,95514
2:5:3,1,1,104485,95515
1:3:3,0,-1,104486,95514
4:6:3,0,-1,104487,95513
5:4:5,0,-1,104488,95512
1:3:4,0,-1,104489,95511
5:5:2,1,1,104488,95512
1:3:6,0,-1,104489,95511
2:6:3,1,1,104488,95512
3:1:3,0,-1,104489,95511
1:1:1,0,-1,104490,95510
5:1:2,1,1,104489,95511
6:6:2,1,1,104488,95512
5:1:2,1,1,104487,95513
4:5:1,0,-1,104488,95512
5:6:1,0,-1,104489,95511
3:4:6,0,-1,104490,95510
2:3:4,1,1,104489,95511
6:5:1,0,-1,104490,95510
6:2:5,1,1,104489,95511
3:4:6,0,-1,104490,95510
6:2:1,1,1,104489,95511
3:4:5,0,-1,104490,95510
4:5:1,0,-1,104491,95509
2:4:3,1,1,104490,95510
2:1:5,1,1,104489,95511
4:6:1,0,-1,104490,95510
1:4:2,1,1,104489,95511
4:6:4,0,-1,104490,95510
4:1:6,0,-1,104491,95509
3:5:2,1,1,104490,95510
6:6:2,1,1,104489,95511
3:3:6,0,-1,104490,95510
6:5:6,0,-1,104491,95509
1:6:3,0,-1,104492,95508
1:5:1,0,-1,104493,95507
5:5:6,0,-1,104494,95506
1:6:5,0,-1,104495,95505
2:4:4,1,1,104494,95506
5:3:6,0,-1,104495,95505
5:2:3,1,1,104494,95506
2:5:4,1,1,104493,95507
5:6:4,0,-1,104494,95506
1:3:6,0,-1,104495,95505
5:2:4,1,1,104494,95506
1:1:3,0,-1,104495,95505
6:4:1,0,-1,104496,95504
4:4:1,0,-1,104497,95503
4:3:4,0,-1,104498,95502
3:4:3,0,-1,104499,95501
3:4:1,0,-1,104500,95500
6:2:5,1,1,104499,95501
1:5:5,0,-1,104500,95500
5:6:3,0,-1,104501,95499
1:6:5,0,-1,104502,95498
1:2:3,1,1,104501,95499
2:1:4,1,1,104500,95500
6:5:5,0,-1,104501,95499
4:3:1,0,-1,104502,95498
3:6:3,0,-1,104503,95497
4:1:6,0,-1,104504,95496
5:3:3,0,-1,104505,95495
2:2:2,3,3,104502,95498
5:6:4,0,-1,104503,95497
2:5:5,1,1,104502,95498
6:2:3,1,1,104501,95499
4:5:5,0,-1,104502,95498
3:3:6,0,-1,104503,95497
1:2:6,1,1,104502,95498
3:4:6,0,-1,104503,95497
4:4:2,1,1,104502,95498
4:1:1,0,-1,104503,95497
3:1:1,0,-1,104504,95496
1:4:4,0,-1,104505,95495
6:4:5,0,-1,104506,95494
4:5:1,0,-1,104507,95493
6:5:6,0,-1,104508,95492
4:3:1,0,-1,104509,95491
5:4:3,0,-1,104510,95490
3:1:2,1,1,104509,95491
2:4:1,1,1,104508,95492
1:2:3,1,1,104507,95493
4:3:4,0,-1,104508,95492
5:1:4,0,-1,104509,95491
4:1:2,1,1,104508,95492
4:5:6,0,-1,104509,95491
6:3:2,1,1,104508,95492
6:6:6,0,-1,104509,95491
6:1:4,0,-1,104510,95490
4:2:5,1,1,104509,95491
4:6:5,0,-1,104510,95490
5:4:1,0,-1,104511,95489
6:1:3,0,-1,104512,95488
1:5:6,0,-1,104513,95487
3:1:4,0,-1,104514,95486
5:6:2,1,1,104513,95487
1:2:1,1,1,104512,95488
1:4:4,0,-1,104513,95487
4:4:3,0,-1,104514,95486
6:6:6,0,-1,104515,95485
5:2:1,1,1,104514,95486
1:5:4,0,-1,104515,95485
4:6:3,0,-1,104516,95484
2:6:4,1,1,104515,95485
3:2:6,1,1,104514,95486
4:3:3,0,-1,104515,95485
1:4:4,0,-1,104516,95484
6:2:2,2,2,104514,95486
1:3:4,0,-1,104515,95485
5:6:6,0,-1,104516,95484
4:6:4,0,-1,104517,95483
6:1:3,0,-1,104518,95482
6:1:2,1,1,104517,95483
5:1:4,0,-1,104518,95482
1:2:1,1,1,104517,95483
6:2:5,1,1,104516,95484
2:4:5,1,1,104515,95485
4:3:5,0,-1,104516,95484
2:4:5,1,1,104515,95485
5:5:6,0,-1,104516,95484
1:5:2,1,1,104515,95485
3:4:3,0,-1,104516,95484
5:1:2,1,1,104515,95485
6:6:4,0,-1,104516,95484
2:2:4,2,2,104514,95486
2:6:6,1,1,104513,95487
2:1:2,2,2,104511,95489
5:1:4,0,-1,104512,95488
4:2:3,1,1,104511,95489
5:1:3,0,-1,104512,95488
3:3:4,0,-1,104513,95487
1:2:4,1,1,104512,95488
2:1:5,1,1,104511,95489
5:4:6,0,-1,104512,95488
2:5:6,1,1,104511,95489
1:3:6,0,-1,104512,95488
4:6:5,0,-1,104513,95487
6:3:4,0,-1,104514,95486
6:5:5,0,-1,104515,95485
5:1:2,1,1,104514,95486
4:6:1,0,-1,104515,95485
6:4:2,1,1,104514,95486
4:3:2,1,1,104513,95487
6:1:6,0,-1,104514,95486
1:5:4,0,-1,104515,95485
6:2:6,1,1,104514,95486
5:4:3,0,-1,104515,95485
1:2:2,2,2,104513,95487
6:3:6,0,-1,104514,95486
5:4:3,0,-1,104515,95485
5:3:2,1,1,104514,95486
4:4:6,0,-1,104515,95485
4:6:4,0,-1,104516,95484
4:2:6,1,1,104515,95485
4:4:4,0,-1,104516,95484
6:4:6,0,-1,104517,95483
5:1:4,0,-1,104518,95482
6:4:2,1,1,104517,95483
3:5:4,0,-1,104518,95482
1:6:5,0,-1,104519,95481
1:3:3,0,-1,104520,95480
6:5:1,0,-1,104521,95479
1:6:1,0,-1,104522,95478
6:5:1,0,-1,104523,95477
3:3:4,0,-1,104524,95476
1:1:5,0,-1,104525,95475
3:5:5,0,-1,104526,95474
4:5:5,0,-1,104527,95473
2:6:1,1,1,104526,95474
4:4:3,0,-1,104527,95473
1:3:5,0,-1,104528,95472
2:5:2,2,2,104526,95474
4:4:6,0,-1,104527,95473
5:4:4,0,-1,104528,95472
6:1:6,0,-1,104529,95471
6:5:6,0,-1,104530,95470
4:5:6,0,-1,104531,95469
2:5:4,1,1,104530,95470
6:4:3,0,-1,104531,95469
1:3:4,0,-1,104532,95468
2:1:1,1,1,104531,95469
5:4:3,0,-1,104532,95468
1:5:4,0,-1,104533,95467
3:4:5,0,-1,104534,95466
4:2:3,1,1,104533,95467
1:1:4,0,-1,104534,95466
5:2:1,1,1,104533,95467
6:6:6,0,-1,104534,95466
1:5:2,1,1,104533,95467
2:6:6,1,1,104532,95468
6:6:5,0,-1,104533,95467
3:5:5,0,-1,104534,95466
2:2:4,2,2,104532,95468
3:4:5,0,-1,104533,95467
2:4:2,2,2,104531,95469
4:2:1,1,1,104530,95470
5:2:2,2,2,104528,95472
4:1:5,0,-1,104529,95471
3:2:2,2,2,104527,95473
3:6:1,0,-1,104528,95472
4:5:6,0,-1,104529,95471
2:4:2,2,2,104527,95473
3:6:3,0,-1,104528,95472
3:1:6,0,-1,104529,95471
5:1:4,0,-1,104530,95470
3:2:5,1,1,104529,95471
5:2:3,1,1,104528,95472
4:5:3,0,-1,104529,95471
2:1:3,1,1,104528,95472
6:2:1,1,1,104527,95473
5:2:5,1,1,104526,95474
1:6:6,0,-1,104527,95473
2:2:1,2,2,104525,95475
1:6:1,0,-1,104526,95474
4:4:2,1,1,104525,95475
6:1:3,0,-1,104526,95474
3:3:4,0,-1,104527,95473
2:1:5,1,1,104526,95474
5:5:3,0,-1,104527,95473
2:6:1,1,1,104526,95474
2:2:5,2,2,104524,95476
6:2:1,1,1,104523,95477
2:3:3,1,1,104522,95478
4:4:1,0,-1,104523,95477
2:6:1,1,1,104522,95478
2:3:3,1,1,104521,95479
5:2:4,1,1,104520,95480
5:3:4,0,-1,104521,95479
1:3:4,0,-1,104522,95478
2:4:3,1,1,104521,95479
5:5:6,0,-1,104522,95478
4:1:4,0,-1,104523,95477
2:5:6,1,1,104522,95478
4:4:1,0,-1,104523,95477
2:5:2,2,2,104521,95479
3:6:2,1,1,104520,95480
4:1:5,0,-1,104521,95479
5:1:2,1,1,104520,95480
3:1:1,0,-1,104521,95479
1:2:6,1,1,104520,95480
1:3:5,0,-1,104521,95479
5:1:2,1,1,104520,95480
4:5:6,0,-1,104521,95479
2:1:4,1,1,104520,95480
3:1:3,0,-1,104521,95479
1:3:4,0,-1,104522,95478
6:4:3,0,-1,104523,95477
3:5:4,0,-1,104524,95476
5:1:1,0,-1,104525,95475
4:3:6,0,-1,104526,95474
1:3:1,0,-1,104527,95473
5:1:1,0,-1,104528,95472
5:6:6,0,-1,104529,95471
1:6:1,0,-1,104530,95470
4:2:2,2,2,104528,95472
3:3:3,0,-1,104529,95471
4:3:3,0,-1,104530,95470
4:5:3,0,-1,104531,95469
2:5:1,1,1,104530,95470
6:3:3,0,-1,104531,95469
1:4:4,0,-1,104532,95468
4:6:3,0,-1,104533,95467
3:6:4,0,-1,104534,95466
2:2:4,2,2,104532,95468
3:5:1,0,-1,104533,95467
2:4:1,1,1,104532,95468
4:3:3,0,-1,104533,95467
6:1:3,0,-1,104534,95466
1:6:6,0,-1,104535,95465
2:2:6,2,2,104533,95467
4:2:4,1,1,104532,95468
6:3:3,0,-1,104533,95467
4:5:5,0,-1,104534,95466
6:2:1,1,1,104533,95467
4:5:4,0,-1,104534,95466
1:6:6,0,-1,104535,95465
4:2:4,1,1,104534,95466
3:1:1,0,-1,104535,95465
5:1:4,0,-1,104536,95464
6:3:4,0,-1,104537,95463
5:1:5,0,-1,104538,95462
6:4:2,1,1,104537,95463
5:1:6,0,-1,104538,95462
6:6:2,1,1,104537,95463
3:2:4,1,1,104536,95464
5:5:2,1,1,104535,95465
4:2:1,1,1,104534,95466
1:1:5,0,-1,104535,95465
2:6:5,1,1,104534,95466
6:2:2,2,2,104532,95468
1:6:1,0,-1,104533,95467
2:2:5,2,2,104531,95469
4:2:1,1,1,104530,95470
5:3:3,0,-1,104531,95469
6:2:2,2,2,104529,95471
6:5:4,0,-1,104530,95470
3:3:2,1,1,104529,95471
6:4:6,0,-1,104530,95470
3:4:2,1,1,104529,95471
1:4:6,0,-1,104530,95470
2:2:6,2,2,104528,95472
1:4:5,0,-1,104529,95471
4:4:2,1,1,104528,95472
4:2:3,1,1,104527,95473
1:4:3,0,-1,104528,95472
2:2:4,2,2,104526,95474
6:6:3,0,-1,104527,95473
3:3:2,1,1,104526,95474
3:2:2,2,2,104524,95476
2:1:5,1,1,104523,95477
5:6:1,0,-1,104524,95476
1:1:1,0,-1,104525,95475
3:2:2,2,2,104523,95477
6:6:3,0,-1,104524,95476
6:5:1,0,-1,104525,95475
1:2:3,1,1,104524,95476
5:5:5,0,-1,104525,95475
4:5:1,0,-1,104526,95474
1:4:4,0,-1,104527,95473
2:6:5,1,1,104526,95474
5:5:4,0,-1,104527,95473
2:3:1,1,1,104526,95474
2:5:4,1,1,104525,95475
3:5:5,0,-1,104526,95474
1:2:4,1,1,104525,95475
5:3:3,0,-1,104526,95474
5:1:5,0,-1,104527,95473
2:2:1,2,2,104525,95475
6:2:3,1,1,104524,95476
4:6:4,0,-1,104525,95475
1:1:3,0,-1,104526,95474
3:6:4,0,-1,104527,95473
5:1:3,0,-1,104528,95472
5:5:3,0,-1,104529,95471
3:1:4,0,-1,104530,95470
2:3:1,1,1,104529,95471
3:5:1,0,-1,104530,95470
2:6:6,1,1,104529,95471
5:6:5,0,-1,104530,95470
1:4:5,0,-1,104531,95469
6:5:1,0,-1,104532,95468
5:2:3,1,1,104531,95469
5:5:5,0,-1,104532,95468
1:3:6,0,-1,104533,95467
4:3:2,1,1,104532,95468
6:2:1,1,1,104531,95469
3:4:6,0,-1,104532,95468
4:3:3,0,-1,104533,95467
6:4:6,0,-1,104534,95466
2:2:5,2,2,104532,95468
2:2:5,2,2,104530,95470
4:5:3,0,-1,104531,95469
2:3:6,1,1,104530,95470
4:2:6,1,1,104529,95471
4:5:3,0,-1,104530,95470
6:4:5,0,-1,104531,95469
1:6:5,0,-1,104532,95468
2:6:2,2,2,104530,95470
3:5:3,0,-1,104531,95469
5:3:4,0,-1,104532,95468
1:2:2,2,2,104530,95470
6:2:4,1,1,104529,95471
5:4:1,0,-1,104530,95470
2:1:1,1,1,104529,95471
5:1:1,0,-1,104530,95470
3:2:3,1,1,104529,95471
1:2:1,1,1,104528,95472
4:6:6,0,-1,104529,95471
1:6:6,0,-1,104530,95470
2:2:6,2,2,104528,95472
3:6:5,0,-1,104529,95471
6:5:5,0,-1,104530,95470
2:3:1,1,1,104529,95471
6:4:3,0,-1,104530,95470
3:3:2,1,1,104529,95471
1:6:3,0,-1,104530,95470
5:1:1,0,-1,104531,95469
4:4:1,0,-1,104532,95468
5:3:4,0,-1,104533,95467
4:4:5,0,-1,104534,95466
6:2:5,1,1,104533,95467
2:2:6,2,2,104531,95469
4:2:6,1,1,104530,95470
3:4:4,0,-1,104531,95469
6:4:5,0,-1,104532,95468
4:1:4,0,-1,104533,95467
4:6:3,0,-1,104534,95466
2:4:1,1,1,104533,95467
5:1:4,0,-1,104534,95466
4:2:1,1,1,104533,95467
2:3:4,1,1,104532,95468
2:2:5,2,2,104530,95470
6:5:5,0,-1,104531,95469
3:3:2,1,1,104530,95470
2:3:5,1,1,104529,95471
6:6:2,1,1,104528,95472
6:1:2,1,1,104527,95473
6:2:6,1,1,104526,95474
1:4:5,0,-1,104527,95473
3:1:3,0,-1,104528,95472
3:5:6,0,-1,104529,95471
5:1:4,0,-1,104530,95470
3:5:4,0,-1,104531,95469
4:3:2,1,1,104530,95470
5:6:6,0,-1,104531,95469
6:1:3,0,-1,104532,95468
4:2:1,1,1,104531,95469
2:4:6,1,1,104530,95470
3:3:3,0,-1,104531,95469
2:3:6,1,1,104530,95470
5:3:5,0,-1,104531,95469
4:4:2,1,1,104530,95470
2:3:5,1,1,104529,95471
5:1:6,0,-1,104530,95470
3:3:3,0,-1,104531,95469
4:3:3,0,-1,104532,95468
2:3:3,1,1,104531,95469
5:2:3,1,1,104530,95470
5:3:3,0,-1,104531,95469
6:5:6,0,-1,104532,95468
1:2:4,1,1,104531,95469
3:5:5,0,-1,104532,95468
6:3:3,0,-1,104533,95467
4:5:3,0,-1,104534,95466
4:3:1,0,-1,104535,95465
1:1:5,0,-1,104536,95464
3:5:1,0,-1,104537,95463
2:4:6,1,1,104536,95464
2:5:1,1,1,104535,95465
2:5:6,1,1,104534,95466
4:3:1,0,-1,104535,95465
2:3:1,1,1,104534,95466
3:5:4,0,-1,104535,95465
3:2:6,1,1,104534,95466
1:2:3,1,1,104533,95467
3:6:6,0,-1,104534,95466
1:6:3,0,-1,104535,95465
1:4:6,0,-1,104536,95464
4:6:6,0,-1,104537,95463
2:4:2,2,2,104535,95465
2:1:4,1,1,104534,95466
1:5:4,0,-1,104535,95465
5:2:1,1,1,104534,95466
3:6:5,0,-1,104535,95465
4:5:4,0,-1,104536,95464
4:1:3,0,-1,104537,95463
2:1:5,1,1,104536,95464
5:4:6,0,-1,104537,95463
4:3:1,0,-1,104538,95462
6:5:5,0,-1,104539,95461
4:2:2,2,2,104537,95463
2:4:5,1,1,104536,95464
2:1:5,1,1,104535,95465
4:1:6,0,-1,104536,95464
2:3:4,1,1,104535,95465
6:2:2,2,2,104533,95467
2:6:5,1,1,104532,95468
4:5:5,0,-1,104533,95467
3:4:2,1,1,104532,95468
1:6:2,1,1,104531,95469
6:5:2,1,1,104530,95470
6:4:2,1,1,104529,95471
5:3:6,0,-1,104530,95470
3:2:2,2,2,104528,95472
5:1:3,0,-1,104529,95471
1:2:2,2,2,104527,95473
4:6:5,0,-1,104528,95472
6:2:5,1,1,104527,95473
2:6:6,1,1,104526,95474
1:6:2,1,1,104525,95475
5:6:3,0,-1,104526,95474
3:2:1,1,1,104525,95475
4:3:6,0,-1,104526,95474
1:2:3,1,1,104525,95475
5:2:6,1,1,104524,95476
3:4:4,0,-1,104525,95475
1:1:5,0,-1,104526,95474
3:6:5,0,-1,104527,95473
1:1:1,0,-1,104528,95472
2:1:2,2,2,104526,95474
6:3:2,1,1,104525,95475
2:5:4,1,1,104524,95476
5:4:3,0,-1,104525,95475
5:1:1,0,-1,104526,95474
5:4:4,0,-1,104527,95473
1:6:4,0,-1,104528,95472
4:6:6,0,-1,104529,95471
5:5:5,0,-1,104530,95470
4:4:4,0,-1,104531,95469
5:4:4,0,-1,104532,95468
5:3:1,0,-1,104533,95467
2:4:5,1,1,104532,95468
2:6:4,1,1,104531,95469
1:3:1,0,-1,104532,95468
3:1:2,1,1,104531,95469
4:5:1,0,-1,104532,95468
6:1:3,0,-1,104533,95467
6:3:4,0,-1,104534,95466
3:6:5,0,-1,104535,95465
5:6:5,0,-1,104536,95464
6:4:2,1,1,104535,95465
6:3:2,1,1,104534,95466
2:5:6,1,1,104533,95467
2:2:6,2,2,104531,95469
3:3:4,0,-1,104532,95468
6:5:1,0,-1,104533,95467
5:2:6,1,1,104532,95468
1:4:5,0,-1,104533,95467
6:4:5,0,-1,104534,95466
1:4:6,0,-1,104535,95465
4:1:2,1,1,104534,95466
6:2:1,1,1,104533,95467
2:3:1,1,1,104532,95468
1:4:1,0,-1,104533,95467
1:3:1,0,-1,104534,95466
5:5:6,0,-1,104535,95465
3:6:5,0,-1,104536,95464
2:6:3,1,1,104535,95465
4:1:3,0,-1,104536,95464
4:5:5,0,-1,104537,95463
6:4:3,0,-1,104538,95462
4:3:4,0,-1,104539,95461
4:6:3,0,-1,104540,95460
2:4:4,1,1,104539,95461
5:1:6,0,-1,104540,95460
5:1:3,0,-1,104541,95459
4:1:2,1,1,104540,95460
3:6:4,0,-1,104541,95459
5:5:2,1,1,104540,95460
2:6:3,1,1,104539,95461
3:4:2,1,1,104538,95462
3:3:5,0,-1,104539,95461
4:3:3,0,-1,104540,95460
4:5:3,0,-1,104541,95459
6:2:1,1,1,104540,95460
4:3:4,0,-1,104541,95459
6:5:1,0,-1,104542,95458
1:5:1,0,-1,104543,95457
4:6:5,0,-1,104544,95456
1:6:1,0,-1,104545,95455
1:1:3,0,-1,104546,95454
1:5:2,1,1,104545,95455
2:5:3,1,1,104544,95456
5:3:4,0,-1,104545,95455
1:4:6,0,-1,104546,95454
3:6:4,0,-1,104547,95453
1:2:5,1,1,104546,95454
3:5:3,0,-1,104547,95453
2:3:5,1,1,104546,95454
6:5:6,0,-1,104547,95453
1:5:6,0,-1,104548,95452
6:3:4,0,-1,104549,95451
2:1:1,1,1,104548,95452
5:2:1,1,1,104547,95453
3:4:3,0,-1,104548,95452
1:6:1,0,-1,104549,95451
5:6:1,0,-1,104550,95450
5:6:3,0,-1,104551,95449
5:1:6,0,-1,104552,95448
5:2:5,1,1,104551,95449
3:1:3,0,-1,104552,95448
1:2:3,1,1,104551,95449
6:2:2,2,2,104549,95451
4:3:2,1,1,104548,95452
1:2:3,1,1,104547,95453
5:5:6,0,-1,104548,95452
1:5:1,0,-1,104549,95451
1:6:1,0,-1,104550,95450
4:6:5,0,-1,104551,95449
2:1:6,1,1,104550,95450
3:5:3,0,-1,104551,95449
2:6:3,1,1,104550,95450
6:3:5,0,-1,104551,95449
4:1:4,0,-1,104552,95448
3:5:4,0,-1,104553,95447
3:6:4,0,-1,104554,95446
4:1:6,0,-1,104555,95445
4:1:1,0,-1,104556,95444
2:5:5,1,1,104555,95445
4:2:1,1,1,104554,95446
3:6:2,1,1,104553,95447
4:1:6,0,-1,104554,95446
6:5:2,1,1,104553,95447
6:6:2,1,1,104552,95448
3:4:5,0,-1,104553,95447
6:4:1,0,-1,104554,95446
3:5:6,0,-1,104555,95445
4:6:5,0,-1,104556,95444
3:6:4,0,-1,104557,95443
3:3:5,0,-1,104558,95442
4:2:5,1,1,104557,95443
6:6:6,0,-1,104558,95442
2:4:3,1,1,104557,95443
1:5:1,0,-1,104558,95442
4:6:5,0,-1,104559,95441
5:6:2,1,1,104558,95442
2:2:5,2,2,104556,95444
1:5:3,0,-1,104557,95443
5:6:2,1,1,104556,95444
3:3:5,0,-1,104557,95443
1:5:5,0,-1,104558,95442
6:1:3,0,-1,104559,95441
5:5:3,0,-1,104560,95440
6:5:4,0,-1,104561,95439
5:1:2,1,1,104560,95440
5:5:5,0,-1,104561,95439
2:4:2,2,2,104559,95441
4:5:5,0,-1,104560,95440
6:1:5,0,-1,104561,95439
6:6:5,0,-1,104562,95438
4:3:6,0,-1,104563,95437
1:3:1,0,-1,104564,95436
4:2:1,1,1,104563,95437
1:4:5,0,-1,104564,95436
5:5:1,0,-1,104565,95435
3:6:2,1,1,104564,95436
5:6:4,0,-1,104565,95435
1:2:3,1,1,104564,95436
3:4:2,1,1,104563,95437
2:4:6,1,1,104562,95438
2:3:5,1,1,104561,95439
6:5:6,0,-1,104562,95438
5:2:2,2,2,104560,95440
2:2:5,2,2,104558,95442
2:1:5,1,1,104557,95443
1:1:3,0,-1,104558,95442
4:5:5,0,-1,104559,95441
3:2:1,1,1,104558,95442
1:6:3,0,-1,104559,95441
6:6:3,0,-1,104560,95440
2:4:2,2,2,104558,95442
5:3:3,0,-1,104559,95441
5:1:4,0,-1,104560,95440
1:6:3,0,-1,104561,95439
6:2:1,1,1,104560,95440
2:5:6,1,1,104559,95441
2:6:6,1,1,104558,95442
2:5:6,1,1,104557,95443
5:5:5,0,-1,104558,95442
2:3:3,1,1,104557,95443
1:1:2,1,1,104556,95444
2:1:2,2,2,104554,95446
2:1:6,1,1,104553,95447
5:2:4,1,1,104552,95448
1:4:3,0,-1,104553,95447
4:3:1,0,-1,104554,95446
5:2:4,1,1,104553,95447
3:6:1,0,-1,104554,95446
2:5:6,1,1,104553,95447
2:1:1,1,1,104552,95448
2:5:2,2,2,104550,95450
3:2:5,1,1,104549,95451
6:5:6,0,-1,104550,95450
6:6:5,0,-1,104551,95449
1:1:3,0,-1,104552,95448
5:6:3,0,-1,104553,95447
3:5:6,0,-1,104554,95446
1:6:5,0,-1,104555,95445
6:6:5,0,-1,104556,95444
3:3:4,0,-1,104557,95443
2:4:2,2,2,104555,95445
6:5:3,0,-1,104556,95444
1:5:5,0,-1,104557,95443
2:6:3,1,1,104556,95444
5:4:5,0,-1,104557,95443
4:6:2,1,1,104556,95444
2:6:2,2,2,104554,95446
4:5:6,0,-1,104555,95445
2:5:3,1,1,104554,95446
6:5:5,0,-1,104555,95445
5:6:6,0,-1,104556,95444
1:5:4,0,-1,104557,95443
5:4:3,0,-1,104558,95442
4:4:5,0,-1,104559,95441
5:6:1,0,-1,104560,95440
4:5:5,0,-1,104561,95439
4:2:5,1,1,104560,95440
4:5:3,0,-1,104561,95439
5:4:3,0,-1,104562,95438
2:1:1,1,1,104561,95439
1:6:2,1,1,104560,95440
4:5:1,0,-1,104561,95439
3:5:3,0,-1,104562,95438
6:6:6,0,-1,104563,95437
2:3:3,1,1,104562,95438
4:5:6,0,-1,104563,95437
5:6:6,0,-1,104564,95436
5:4:3,0,-1,104565,95435
2:5:4,1,1,104564,95436
5:4:6,0,-1,104565,95435
2:4:2,2,2,104563,95437
1:6:2,1,1,104562,95438
3:2:3,1,1,104561,95439
5:5:4,0,-1,104562,95438
5:3:4,0,-1,104563,95437
6:2:5,1,1,104562,95438
3:3:6,0,-1,104563,95437
5:6:6,0,-1,104564,95436
2:1:4,1,1,104563,95437
2:1:3,1,1,104562,95438
2:5:5,1,1,104561,95439
2:5:1,1,1,104560,95440
3:3:3,0,-1,104561,95439
3:5:1,0,-1,104562,95438
6:3:1,0,-1,104563,95437
3:1:6,0,-1,104564,95436
2:4:5,1,1,104563,95437
1:3:6,0,-1,104564,95436
3:6:6,0,-1,104565,95435
1:4:1,0,-1,104566,95434
1:6:6,0,-1,104567,95433
6:6:3,0,-1,104568,95432
4:6:2,1,1,104567,95433
5:1:6,0,-1,104568,95432
3:3:5,0,-1,104569,95431
4:6:3,0,-1,104570,95430
5:3:2,1,1,104569,95431
2:5:4,1,1,104568,95432
3:4:5,0,-1,104569,95431
1:6:6,0,-1,104570,95430
1:3:5,0,-1,104571,95429
3:4:3,0,-1,104572,95428
4:6:2,1,1,104571,95429
4:4:4,0,-1,104572,95428
5:6:6,0,-1,104573,95427
4:5:3,0,-1,104574,95426
2:6:5,1,1,104573,95427
3:5:2,1,1,104572,95428
1:1:4,0,-1,104573,95427
1:4:3,0,-1,104574,95426
1:2:6,1,1,104573,95427
6:2:1,1,1,104572,95428
2:2:5,2,2,104570,95430
4:2:2,2,2,104568,95432
3:6:3,0,-1,104569,95431
6:5:3,0,-1,104570,95430
1:6:1,0,-1,104571,95429
3:2:4,1,1,104570,95430
5:5:3,0,-1,104571,95429
3:4:4,0,-1,104572,95428
3:6:1,0,-1,104573,95427
1:5:2,1,1,104572,95428
4:1:3,0,-1,104573,95427
6:6:2,1,1,104572,95428
5:6:6,0,-1,104573,95427
1:1:3,0,-1,104574,95426
5:2:2,2,2,104572,95428
1:6:5,0,-1,104573,95427
1:2:1,1,1,104572,95428
6:1:5,0,-1,104573,95427
4:5:2,1,1,104572,95428
2:6:4,1,1,104571,95429
5:4:1,0,-1,104572,95428
1:3:2,1,1,104571,95429
3:3:2,1,1,104570,95430
2:5:2,2,2,104568,95432
1:1:4,0,-1,104569,95431
2:1:4,1,1,104568,95432
3:4:1,0,-1,104569,95431
2:6:4,1,1,104568,95432
6:5:2,1,1,104567,95433
5:1:5,0,-1,104568,95432
4:2:5,1,1,104567,95433
4:1:2,1,1,104566,95434
4:1:1,0,-1,104567,95433
6:1:2,1,1,104566,95434
1:3:4,0,-1,104567,95433
2:3:2,2,2,104565,95435
3:4:1,0,-1,104566,95434
3:3:5,0,-1,104567,95433
1:1:3,0,-1,104568,95432
3:2:3,1,1,104567,95433
4:1:4,0,-1,104568,95432
5:4:5,0,-1,104569,95431
3:6:1,0,-1,104570,95430
5:5:1,0,-1,104571,95429
4:4:4,0,-1,104572,95428
4:3:4,0,-1,104573,95427
3:3:3,0,-1,104574,95426
1:1:1,0,-1,104575,95425
4:3:4,0,-1,104576,95424
6:1:4,0,-1,104577,95423
3:4:4,0,-1,104578,95422
2:1:4,1,1,104577,95423
6:2:1,1,1,104576,95424
5:5:4,0,-1,104577,95423
1:5:6,0,-1,104578,95422
4:6:4,0,-1,104579,95421
5:4:5,0,-1,104580,95420
5:1:3,0,-1,104581,95419
2:2:4,2,2,104579,95421
1:4:6,0,-1,104580,95420
6:4:3,0,-1,104581,95419
4:5:6,0,-1,104582,95418
4:2:6,1,1,104581,95419
5:1:4,0,-1,104582,95418
2:4:1,1,1,104581,95419
1:6:6,0,-1,104582,95418
2:3:1,1,1,104581,95419
2:2:4,2,2,104579,95421
1:3:4,0,-1,104580,95420
4:5:4,0,-1,104581,95419
6:6:5,0,-1,104582,95418
3:6:1,0,-1,104583,95417
6:6:3,0,-1,104584,95416
4:1:3,0,-1,104585,95415
5:5:2,1,1,104584,95416
6:3:3,0,-1,104585,95415
5:5:2,1,1,104584,95416
3:6:3,0,-1,104585,95415
5:5:1,0,-1,104586,95414
6:6:4,0,-1,104587,95413
3:4:6,0,-1,104588,95412
5:1:3,0,-1,104589,95411
1:5:6,0,-1,104590,95410
5:4:3,0,-1,104591,95409
1:4:6,0,-1,104592,95408
5:5:6,0,-1,104593,95407
1:3:5,0,-1,104594,95406
5:1:1,0,-1,104595,95405
4:3:2,1,1,104594,95406
2:4:5,1,1,104593,95407
2:5:6,1,1,104592,95408
3:3:3,0,-1,104593,95407
5:2:3,1,1,104592,95408
1:3:4,0,-1,104593,95407
2:6:1,1,1,104592,95408
2:1:6,1,1,104591,95409
1:4:4,0,-1,104592,95408
5:2:6,1,1,104591,95409
3:4:5,0,-1,104592,95408
4:2:3,1,1,104591,95409
1:4:5,0,-1,104592,95408
6:6:4,0,-1,104593,95407
2:6:1,1,1,104592,95408
3:4:2,1,1,104591,95409
5:6:2,1,1,104590,95410
2:1:6,1,1,104589,95411
3:4:1,0,-1,104590,95410
5:6:1,0,-1,104591,95409
5:6:1,0,-1,104592,95408
6:2:3,1,1,104591,95409
4:5:6,0,-1,104592,95408
2:6:2,2,2,104590,95410
5:6:2,1,1,104589,95411
1:1:3,0,-1,104590,95410
2:6:3,1,1,104589,95411
2:6:4,1,1,104588,95412
4:4:1,0,-1,104589,95411
1:6:4,0,-1,104590,95410
6:6:5,0,-1,104591,95409
5:6:3,0,-1,104592,95408
1:2:4,1,1,104591,95409
1:1:3,0,-1,104592,95408
1:4:3,0,-1,104593,95407
2:1:1,1,1,104592,95408
3:1:1,0,-1,104593,95407
5:1:4,0,-1,104594,95406
6:2:3,1,1,104593,95407
2:4:1,1,1,104592,95408
6:2:5,1,1,104591,95409
4:4:5,0,-1,104592,95408
1:4:3,0,-1,104593,95407
3:2:1,1,1,104592,95408
1:6:5,0,-1,104593,95407
6:4:4,0,-1,104594,95406
3:6:3,0,-1,104595,95405
2:2:2,3,3,104592,95408
4:2:2,2,2,104590,95410
4:6:3,0,-1,104591,95409
2:3:4,1,1,104590,95410
6:5:4,0,-1,104591,95409
6:1:1,0,-1,104592,95408
3:5:2,1,1,104591,95409
6:3:5,0,-1,104592,95408
3:2:6,1,1,104591,95409
2:1:3,1,1,104590,95410
6:1:3,0,-1,104591,95409
3:6:6,0,-1,104592,95408
4:3:5,0,-1,104593,95407
5:4:3,0,-1,104594,95406
5:2:1,1,1,104593,95407
1:4:5,0,-1,104594,95406
4:4:4,0,-1,104595,95405
1:6:5,0,-1,104596,95404
1:6:3,0,-1,104597,95403
1:5:5,0,-1,104598,95402
1:5:5,0,-1,104599,95401
5:5:3,0,-1,104600,95400
4:3:6,0,-1,104601,95399
5:2:2,2,2,104599,95401
5:4:5,0,-1,104600,95400
1:4:2,1,1,104599,95401
1:5:3,0,-1,104600,95400
4:1:3,0,-1,104601,95399
3:5:2,1,1,104600,95400
5:6:6,0,-1,104601,95399
3:2:2,2,2,104599,95401
6:1:4,0,-1,104600,95400
2:4:4,1,1,104599,95401
2:1:2,2,2,104597,95403
5:6:3,0,-1,104598,95402
2:3:4,1,1,104597,95403
3:3:2,1,1,104596,95404
5:1:5,0,-1,104597,95403
3:2:3,1,1,104596,95404
2:1:6,1,1,104595,95405
5:4:1,0,-1,104596,95404
1:1:1,0,-1,104597,95403
3:2:3,1,1,104596,95404
1:5:4,0,-1,104597,95403
2:1:6,1,1,104596,95404
1:6:1,0,-1,104597,95403
2:3:5,1,1,104596,95404
5:1:3,0,-1,104597,95403
6:4:1,0,-1,104598,95402
5:6:1,0,-1,104599,95401
4:1:1,0,-1,104600,95400
6:2:2,2,2,104598,95402
6:5:4,0,-1,104599,95401
1:2:3,1,1,104598,95402
4:1:1,0,-1,104599,95401
3:2:1,1,1,104598,95402
4:3:1,0,-1,104599,95401
3:2:5,1,1,104598,95402
3:2:6,1,1,104597,95403
5:4:2,1,1,104596,95404
2:2:6,2,2,104594,95406
6:1:6,0,-1,104595,95405
6:4:4,0,-1,104596,95404
3:5:6,0,-1,104597,95403
4:2:5,1,1,104596,95404
2:5:6,1,1,104595,95405
5:1:5,0,-1,104596,95404
6:3:4,0,-1,104597,95403
5:5:3,0,-1,104598,95402
4:3:2,1,1,104597,95403
4:6:4,0,-1,104598,95402
3:4:4,0,-1,104599,95401
5:2:5,1,1,104598,95402
4:3:1,0,-1,104599,95401
4:6:2,1,1,104598,95402
1:1:2,1,1,104597,95403
3:6:4,0,-1,104598,95402
1:2:6,1,1,104597,95403
2:6:4,1,1,104596,95404
2:4:2,2,2,104594,95406
2:4:1,1,1,104593,95407
2:6:1,1,1,104592,95408
2:5:2,2,2,104590,95410
1:1:6,0,-1,104591,95409
5:3:6,0,-1,104592,95408
6:5:6,0,-1,104593,95407
3:2:2,2,2,104591,95409
6:6:1,0,-1,104592,95408
5:3:4,0,-1,104593,95407
3:4:1,0,-1,104594,95406
4:1:4,0,-1,104595,95405
2:3:3,1,1,104594,95406
2:4:2,2,2,104592,95408
1:4:4,0,-1,104593,95407
5:2:1,1,1,104592,95408
2:5:5,1,1,104591,95409
3:4:5,0,-1,104592,95408
4:5:6,0,-1,104593,95407
2:2:1,2,2,104591,95409
5:1:3,0,-1,104592,95408
3:2:1,1,1,104591,95409
2:2:5,2,2,104589,95411
2:4:3,1,1,104588,95412
6:5:2,1,1,104587,95413
5:1:1,0,-1,104588,95412
2:3:4,1,1,104587,95413
5:5:1,0,-1,104588,95412
6:6:2,1,1,104587,95413
5:2:2,2,2,104585,95415
6:2:5,1,1,104584,95416
3:5:5,0,-1,104585,95415
5:6:5,0,-1,104586,95414
6:6:5,0,-1,104587,95413
5:5:1,0,-1,104588,95412
1:1:3,0,-1,104589,95411
3:2:1,1,1,104588,95412
5:5:5,0,-1,104589,95411
1:3:1,0,-1,104590,95410
3:4:6,0,-1,104591,95409
4:4:3,0,-1,104592,95408
5:2:3,1,1,104591,95409
5:1:6,0,-1,104592,95408
4:6:2,1,1,104591,95409
4:2:2,2,2,104589,95411
3:1:3,0,-1,104590,95410
6:5:1,0,-1,104591,95409
6:1:1,0,-1,104592,95408
2:4:3,1,1,104591,95409
5:4:6,0,-1,104592,95408
2:2:1,2,2,104590,95410
1:1:4,0,-1,104591,95409
2:3:3,1,1,104590,95410
1:1:1,0,-1,104591,95409
6:5:4,0,-1,104592,95408
2:5:1,1,1,104591,95409
4:3:4,0,-1,104592,95408
1:6:1,0,-1,104593,95407
1:1:3,0,-1,104594,95406
3:1:6,0,-1,104595,95405
3:4:6,0,-1,104596,95404
6:5:2,1,1,104595,95405
5:6:5,0,-1,104596,95404
2:2:3,2,2,104594,95406
3:4:4,0,-1,104595,95405
1:1:4,0,-1,104596,95404
3:5:2,1,1,104595,95405
5:1:3,0,-1,104596,95404
2:6:6,1,1,104595,95405
1:5:2,1,1,104594,95406
4:1:5,0,-1,104595,95405
1:4:6,0,-1,104596,95404
1:4:5,0,-1,104597,95403
1:2:1,1,1,104596,95404
5:1:1,0,-1,104597,95403
5:4:5,0,-1,104598,95402
5:2:3,1,1,104597,95403
4:6:4,0,-1,104598,95402
2:2:6,2,2,104596,95404
4:6:2,1,1,104595,95405
6:5:1,0,-1,104596,95404
6:2:5,1,1,104595,95405
2:3:6,1,1,104594,95406
2:4:3,1,1,104593,95407
4:4:4,0,-1,104594,95406
4:2:1,1,1,104593,95407
4:2:3,1,1,104592,95408
2:5:1,1,1,104591,95409
5:5:2,1,1,104590,95410
3:5:5,0,-1,104591,95409
3:5:2,1,1,104590,95410
1:3:6,0,-1,104591,95409
6:3:6,0,-1,104592,95408
5:1:5,0,-1,104593,95407
3:5:3,0,-1,104594,95406
1:6:6,0,-1,104595,95405
1:3:5,0,-1,104596,95404
4:1:2,1,1,104595,95405
2:5:5,1,1,104594,95406
2:1:3,1,1,104593,95407
5:4:6,0,-1,104594,95406
2:2:2,3,3,104591,95409
6:4:5,0,-1,104592,95408
5:4:3,0,-1,104593,95407
6:4:2,1,1,104592,95408
2:6:5,1,1,104591,95409
5:2:5,1,1,104590,95410
5:4:6,0,-1,104591,95409
3:4:4,0,-1,104592,95408
6:5:2,1,1,104591,95409
4:5:1,0,-1,104592,95408
2:2:4,2,2,104590,95410
2:3:1,1,1,104589,95411
6:5:5,0,-1,104590,95410
4:6:1,0,-1,104591,95409
6:2:1,1,1,104590,95410
6:4:6,0,-1,104591,95409
5:2:6,1,1,104590,95410
6:4:5,0,-1,104591,95409
2:5:2,2,2,104589,95411
5:6:1,0,-1,104590,95410
5:4:3,0,-1,104591,95409
5:1:6,0,-1,104592,95408
5:2:3,1,1,104591,95409
3:1:3,0,-1,104592,95408
2:1:6,1,1,104591,95409
5:2:3,1,1,104590,95410
5:2:3,1,1,104589,95411
1:1:1,0,-1,104590,95410
5:3:3,0,-1,104591,95409
3:6:2,1,1,104590,95410
3:3:2,1,1,104589,95411
5:3:2,1,1,104588,95412
3:3:1,0,-1,104589,95411
5:6:5,0,-1,104590,95410
2:5:2,2,2,104588,95412
1:4:5,0,-1,104589,95411
1:2:5,1,1,104588,95412
4:1:3,0,-1,104589,95411
1:1:6,0,-1,104590,95410
1:1:1,0,-1,104591,95409
1:6:4,0,-1,104592,95408
4:4:2,1,1,104591,95409
6:4:5,0,-1,104592,95408
3:5:4,0,-1,104593,95407
6:2:2,2,2,104591,95409
5:2:6,1,1,104590,95410
4:2:5,1,1,104589,95411
2:4:1,1,1,104588,95412
3:6:6,0,-1,104589,95411
3:2:3,1,1,104588,95412
1:3:1,0,-1,104589,95411
4:1:6,0,-1,104590,95410
4:6:4,0,-1,104591,95409
5:4:1,0,-1,104592,95408
4:4:6,0,-1,104593,95407
6:5:1,0,-1,104594,95406
3:4:4,0,-1,104595,95405
1:4:3,0,-1,104596,95404
2:2:1,2,2,104594,95406
2:6:4,1,1,104593,95407
2:5:6,1,1,104592,95408
2:1:3,1,1,104591,95409
3:4:5,0,-1,104592,95408
1:1:1,0,-1,104593,95407
4:2:2,2,2,104591,95409
3:5:5,0,-1,104592,95408
2:6:4,1,1,104591,95409
2:4:3,1,1,104590,95410
2:1:4,1,1,104589,95411
2:5:6,1,1,104588,95412
6:2:5,1,1,104587,95413
4:3:6,0,-1,104588,95412
5:2:4,1,1,104587,95413
4:6:3,0,-1,104588,95412
2:6:3,1,1,104587,95413
4:3:6,0,-1,104588,95412
2:4:4,1,1,104587,95413
1:2:1,1,1,104586,95414
6:5:4,0,-1,104587,95413
6:2:1,1,1,104586,95414
2:5:5,1,1,104585,95415
1:2:6,1,1,104584,95416
2:5:3,1,1,104583,95417
5:2:1,1,1,104582,95418
5:6:5,0,-1,104583,95417
1:5:2,1,1,104582,95418
6:6:5,0,-1,104583,95417
2:6:4,1,1,104582,95418
4:6:3,0,-1,104583,95417
2:2:6,2,2,104581,95419
4:1:4,0,-1,104582,95418
3:2:1,1,1,104581,95419
5:3:5,0,-1,104582,95418
3:6:6,0,-1,104583,95417
5:2:2,2,2,104581,95419
2:4:5,1,1,104580,95420
6:5:4,0,-1,104581,95419
4:4:2,1,1,104580,95420
6:3:2,1,1,104579,95421
1:6:2,1,1,104578,95422
3:2:5,1,1,104577,95423
3:5:2,1,1,104576,95424
3:6:6,0,-1,104577,95423
1:2:4,1,1,104576,95424
2:2:5,2,2,104574,95426
1:3:2,1,1,104573,95427
6:6:3,0,-1,104574,95426
3:2:2,2,2,104572,95428
6:6:2,1,1,104571,95429
3:1:1,0,-1,104572,95428
5:6:5,0,-1,104573,95427
2:6:6,1,1,104572,95428
5:2:6,1,1,104571,95429
4:3:2,1,1,104570,95430
6:1:6,0,-1,104571,95429
6:3:6,0,-1,104572,95428
1:2:6,1,1,104571,95429
3:3:4,0,-1,104572,95428
2:4:3,1,1,104571,95429
5:6:6,0,-1,104572,95428
6:6:2,1,1,104571,95429
2:1:4,1,1,104570,95430
3:4:5,0,-1,104571,95429
5:4:2,1,1,104570,95430
2:4:4,1,1,104569,95431
6:4:5,0,-1,104570,95430
2:1:5,1,1,104569,95431
1:2:4,1,1,104568,95432
2:5:2,2,2,104566,95434
5:5:2,1,1,104565,95435
4:6:4,0,-1,104566,95434
5:1:5,0,-1,104567,95433
5:4:4,0,-1,104568,95432
5:5:3,0,-1,104569,95431
5:1:1,0,-1,104570,95430
5:3:4,0,-1,104571,95429
6:3:4,0,-1,104572,95428
3:1:4,0,-1,104573,95427
6:4:5,0,-1,104574,95426
2:1:3,1,1,104573,95427
4:6:3,0,-1,104574,95426
5:1:3,0,-1,104575,95425
5:1:4,0,-1,104576,95424
5:5:4,0,-1,104577,95423
5:3:6,0,-1,104578,95422
5:5:3,0,-1,104579,95421
6:6:4,0,-1,104580,95420
5:5:3,0,-1,104581,95419
3:2:6,1,1,104580,95420
2:5:1,1,1,104579,95421
3:3:4,0,-1,104580,95420
6:2:2,2,2,104578,95422
1:6:4,0,-1,104579,95421
1:5:5,0,-1,104580,95420
6:6:6,0,-1,104581,95419
6:4:5,0,-1,104582,95418
5:2:2,2,2,104580,95420
5:1:2,1,1,104579,95421
2:3:1,1,1,104578,95422
5:1:3,0,-1,104579,95421
2:6:2,2,2,104577,95423
3:5:4,0,-1,104578,95422
6:6:1,0,-1,104579,95421
1:4:2,1,1,104578,95422
6:2:3,1,1,104577,95423
5:5:3,0,-1,104578,95422
1:5:3,0,-1,104579,95421
4:4:5,0,-1,104580,95420
6:2:2,2,2,104578,95422
5:2:5,1,1,104577,95423
5:2:2,2,2,104575,95425
6:5:2,1,1,104574,95426
1:1:5,0,-1,104575,95425
1:2:3,1,1,104574,95426
2:5:6,1,1,104573,95427
1:5:5,0,-1,104574,95426
3:3:1,0,-1,104575,95425
1:2:6,1,1,104574,95426
3:4:3,0,-1,104575,95425
4:1:4,0,-1,104576,95424
6:6:5,0,-1,104577,95423
4:2:6,1,1,104576,95424
3:5:6,0,-1,104577,95423
2:5:4,1,1,104576,95424
5:3:2,1,1,104575,95425
3:6:4,0,-1,104576,95424
2:4:3,1,1,104575,95425
5:1:2,1,1,104574,95426
6:6:3,0,-1,104575,95425
3:6:4,0,-1,104576,95424
2:4:6,1,1,104575,95425
3:1:6,0,-1,104576,95424
1:1:5,0,-1,104577,95423
5:5:2,1,1,104576,95424
3:4:6,0,-1,104577,95423
6:2:3,1,1,104576,95424
4:3:3,0,-1,104577,95423
5:4:3,0,-1,104578,95422
5:4:6,0,-1,104579,95421
1:1:3,0,-1,104580,95420
6:1:1,0,-1,104581,95419
1:5:1,0,-1,104582,95418
4:5:2,1,1,104581,95419
4:1:4,0,-1,104582,95418
6:5:2,1,1,104581,95419
5:1:5,0,-1,104582,95418
4:1:5,0,-1,104583,95417
2:3:2,2,2,104581,95419
5:4:3,0,-1,104582,95418
3:5:3,0,-1,104583,95417
4:1:1,0,-1,104584,95416
2:2:6,2,2,104582,95418
3:5:2,1,1,104581,95419
6:3:2,1,1,104580,95420
6:5:6,0,-1,104581,95419
6:5:3,0,-1,104582,95418
4:3:5,0,-1,104583,95417
1:1:6,0,-1,104584,95416
6:6:3,0,-1,104585,95415
4:1:4,0,-1,104586,95414
5:2:5,1,1,104585,95415
6:3:4,0,-1,104586,95414
2:6:3,1,1,104585,95415
6:6:6,0,-1,104586,95414
2:4:1,1,1,104585,95415
1:6:1,0,-1,104586,95414
3:2:3,1,1,104585,95415
4:2:1,1,1,104584,95416
3:6:2,1,1,104583,95417
1:3:5,0,-1,104584,95416
5:4:2,1,1,104583,95417
6:5:6,0,-1,104584,95416
5:6:2,1,1,104583,95417
1:3:3,0,-1,104584,95416
6:6:2,1,1,104583,95417
4:6:6,0,-1,104584,95416
6:3:1,0,-1,104585,95415
2:5:4,1,1,104584,95416
3:6:3,0,-1,104585,95415
4:1:2,1,1,104584,95416
1:2:1,1,1,104583,95417
5:3:1,0,-1,104584,95416
3:3:4,0,-1,104585,95415
4:6:4,0,-1,104586,95414
2:1:4,1,1,104585,95415
3:2:5,1,1,104584,95416
3:4:1,0,-1,104585,95415
3:1:4,0,-1,104586,95414
3:3:5,0,-1,104587,95413
3:5:5,0,-1,104588,95412
5:4:2,1,1,104587,95413
4:5:2,1,1,104586,95414
2:3:6,1,1,104585,95415
5:1:2,1,1,104584,95416
1:1:2,1,1,104583,95417
5:3:3,0,-1,104584,95416
6:4:4,0,-1,104585,95415
2:4:4,1,1,104584,95416
6:6:2,1,1,104583,95417
2:2:5,2,2,104581,95419
5:6:1,0,-1,104582,95418
4:4:5,0,-1,104583,95417
5:6:1,0,-1,104584,95416
1:3:1,0,-1,104585,95415
4:5:6,0,-1,104586,95414
5:4:4,0,-1,104587,95413
5:3:5,0,-1,104588,95412
2:2:4,2,2,104586,95414
1:4:1,0,-1,104587,95413
3:4:1,0,-1,104588,95412
2:4:2,2,2,104586,95414
4:2:4,1,1,104585,95415
6:2:2,2,2,104583,95417
5:2:4,1,1,104582,95418
4:3:4,0,-1,104583,95417
2:5:4,1,1,104582,95418
2:5:3,1,1,104581,95419
2:6:1,1,1,104580,95420
5:4:6,0,-1,104581,95419
6:2:4,1,1,104580,95420
3:2:3,1,1,104579,95421
2:5:3,1,1,104578,95422
3:1:5,0,-1,104579,95421
5:1:5,0,-1,104580,95420
5:1:1,0,-1,104581,95419
6:1:6,0,-1,104582,95418
2:5:6,1,1,104581,95419
5:3:3,0,-1,104582,95418
6:4:4,0,-1,104583,95417
5:2:2,2,2,104581,95419
4:4:2,1,1,104580,95420
4:5:6,0,-1,104581,95419
1:3:1,0,-1,104582,95418
4:1:6,0,-1,104583,95417
1:1:4,0,-1,104584,95416
2:1:3,1,1,104583,95417
2:4:1,1,1,104582,95418
3:2:1,1,1,104581,95419
4:3:4,0,-1,104582,95418
2:2:5,2,2,104580,95420
4:4:1,0,-1,104581,95419
5:3:2,1,1,104580,95420
5:5:5,0,-1,104581,95419
1:2:2,2,2,104579,95421
6:6:2,1,1,104578,95422
3:6:4,0,-1,104579,95421
6:6:5,0,-1,104580,95420
3:5:2,1,1,104579,95421
1:2:6,1,1,104578,95422
4:3:1,0,-1,104579,95421
3:1:5,0,-1,104580,95420
1:2:5,1,1,104579,95421
1:4:6,0,-1,104580,95420
4:6:1,0,-1,104581,95419
5:4:1,0,-1,104582,95418
5:6:3,0,-1,104583,95417
4:4:3,0,-1,104584,95416
6:2:6,1,1,104583,95417
5:3:6,0,-1,104584,95416
2:4:4,1,1,104583,95417
2:5:2,2,2,104581,95419
5:2:2,2,2,104579,95421
3:5:1,0,-1,104580,95420
1:3:5,0,-1,104581,95419
3:3:3,0,-1,104582,95418
4:3:3,0,-1,104583,95417
4:6:4,0,-1,104584,95416
1:4:6,0,-1,104585,95415
2:4:2,2,2,104583,95417
6:5:1,0,-1,104584,95416
3:5:3,0,-1,104585,95415
2:1:4,1,1,104584,95416
4:5:6,0,-1,104585,95415
2:3:3,1,1,104584,95416
3:5:5,0,-1,104585,95415
3:2:2,2,2,104583,95417
5:3:4,0,-1,104584,95416
6:1:6,0,-1,104585,95415
1:6:5,0,-1,104586,95414
3:4:6,0,-1,104587,95413
1:6:1,0,-1,104588,95412
3:2:3,1,1,104587,95413
1:1:1,0,-1,104588,95412
6:5:1,0,-1,104589,95411
2:2:5,2,2,104587,95413
1:6:2,1,1,104586,95414
2:1:5,1,1,104585,95415
6:6:4,0,-1,104586,95414
6:2:4,1,1,104585,95415
6:6:4,0,-1,104586,95414
1:1:4,0,-1,104587,95413
5:2:6,1,1,104586,95414
3:4:4,0,-1,104587,95413
4:5:3,0,-1,104588,95412
1:5:3,0,-1,104589,95411
6:1:2,1,1,104588,95412
6:3:2,1,1,104587,95413
1:3:2,1,1,104586,95414
3:6:4,0,-1,104587,95413
2:3:4,1,1,104586,95414
5:5:4,0,-1,104587,95413
4:1:4,0,-1,104588,95412
1:5:2,1,1,104587,95413
4:4:2,1,1,104586,95414
5:3:1,0,-1,104587,95413
4:3:5,0,-1,104588,95412
4:1:2,1,1,104587,95413
2:2:4,2,2,104585,95415
2:3:4,1,1,104584,95416
3:2:2,2,2,104582,95418
1:6:2,1,1,104581,95419
6:5:2,1,1,104580,95420
2:4:6,1,1,104579,95421
5:3:3,0,-1,104580,95420
4:5:4,0,-1,104581,95419
1:6:2,1,1,104580,95420
3:2:1,1,1,104579,95421
5:3:5,0,-1,104580,95420
2:1:6,1,1,104579,95421
5:5:3,0,-1,104580,95420
3:1:1,0,-1,104581,95419
6:5:2,1,1,104580,95420
4:2:1,1,1,104579,95421
2:6:5,1,1,104578,95422
6:6:2,1,1,104577,95423
4:1:1,0,-1,104578,95422
5:3:6,0,-1,104579,95421
2:6:2,2,2,104577,95423
3:6:6,0,-1,104578,95422
6:2:5,1,1,104577,95423
5:1:4,0,-1,104578,95422
4:4:5,0,-1,104579,95421
1:4:4,0,-1,104580,95420
6:5:1,0,-1,104581,95419
4:2:6,1,1,104580,95420
2:3:4,1,1,104579,95421
1:1:6,0,-1,104580,95420
1:2:1,1,1,104579,95421
6:2:4,1,1,104578,95422
1:2:4,1,1,104577,95423
5:1:1,0,-1,104578,95422
5:3:1,0,-1,104579,95421
3:6:3,0,-1,104580,95420
2:5:5,1,1,104579,95421
5:2:3,1,1,104578,95422
2:4:3,1,1,104577,95423
2:6:2,2,2,104575,95425
6:1:5,0,-1,104576,95424
1:4:2,1,1,104575,95425
1:3:5,0,-1,104576,95424
4:3:2,1,1,104575,95425
2:6:3,1,1,104574,95426
2:4:1,1,1,104573,95427
3:4:4,0,-1,104574,95426
1:6:4,0,-1,104575,95425
1:1:1,0,-1,104576,95424
4:6:4,0,-1,104577,95423
3:5:6,0,-1,104578,95422
1:3:6,0,-1,104579,95421
3:1:3,0,-1,104580,95420
5:4:6,0,-1,104581,95419
5:4:1,0,-1,104582,95418
6:4:6,0,-1,104583,95417
1:1:4,0,-1,104584,95416
4:5:2,1,1,104583,95417
5:5:4,0,-1,104584,95416
1:1:6,0,-1,104585,95415
3:2:3,1,1,104584,95416
2:1:2,2,2,104582,95418
6:1:2,1,1,104581,95419
3:1:3,0,-1,104582,95418
1:4:3,0,-1,104583,95417
6:3:2,1,1,104582,95418
1:2:5,1,1,104581,95419
5:4:3,0,-1,104582,95418
3:2:3,1,1,104581,95419
3:6:6,0,-1,104582,95418
1:5:4,0,-1,104583,95417
1:5:3,0,-1,104584,95416
3:3:5,0,-1,104585,95415
4:3:5,0,-1,104586,95414
6:5:1,0,-1,104587,95413
4:2:5,1,1,104586,95414
3:5:5,0,-1,104587,95413
2:1:5,1,1,104586,95414
5:4:3,0,-1,104587,95413
1:3:4,0,-1,104588,95412
5:5:3,0,-1,104589,95411
6:3:4,0,-1,104590,95410
2:4:4,1,1,104589,95411
3:5:1,0,-1,104590,95410
4:2:2,2,2,104588,95412
2:2:5,2,2,104586,95414
1:5:2,1,1,104585,95415
5:4:6,0,-1,104586,95414
6:1:5,0,-1,104587,95413
5:3:6,0,-1,104588,95412
3:1:1,0,-1,104589,95411
3:5:3,0,-1,104590,95410
4:3:3,0,-1,104591,95409
3:3:2,1,1,104590,95410
3:4:2,1,1,104589,95411
1:1:5,0,-1,104590,95410
3:3:1,0,-1,104591,95409
3:3:5,0,-1,104592,95408
5:5:1,0,-1,104593,95407
5:3:5,0,-1,104594,95406
2:2:2,3,3,104591,95409
2:5:6,1,1,104590,95410
1:4:5,0,-1,104591,95409
6:3:2,1,1,104590,95410
4:3:3,0,-1,104591,95409
5:6:4,0,-1,104592,95408
1:5:2,1,1,104591,95409
5:4:3,0,-1,104592,95408
3:2:4,1,1,104591,95409
6:5:5,0,-1,104592,95408
6:2:1,1,1,104591,95409
2:3:1,1,1,104590,95410
5:3:6,0,-1,104591,95409
3:5:2,1,1,104590,95410
6:4:6,0,-1,104591,95409
1:2:1,1,1,104590,95410
6:3:6,0,-1,104591,95409
3:5:6,0,-1,104592,95408
4:3:5,0,-1,104593,95407
5:2:3,1,1,104592,95408
1:5:2,1,1,104591,95409
6:3:3,0,-1,104592,95408
5:2:1,1,1,104591,95409
6:3:6,0,-1,104592,95408
6:3:6,0,-1,104593,95407
2:3:2,2,2,104591,95409
3:5:5,0,-1,104592,95408
1:2:3,1,1,104591,95409
6:2:1,1,1,104590,95410
5:3:5,0,-1,104591,95409
5:1:1,0,-1,104592,95408
6:4:2,1,1,104591,95409
2:3:5,1,1,104590,95410
6:4:6,0,-1,104591,95409
4:1:6,0,-1,104592,95408
3:6:6,0,-1,104593,95407
4:3:2,1,1,104592,95408
2:5:3,1,1,104591,95409
1:6:3,0,-1,104592,95408
2:1:6,1,1,104591,95409
3:4:5,0,-1,104592,95408
3:5:6,0,-1,104593,95407
3:3:6,0,-1,104594,95406
1:3:6,0,-1,104595,95405
5:4:3,0,-1,104596,95404
4:4:1,0,-1,104597,95403
6:4:5,0,-1,104598,95402
2:6:3,1,1,104597,95403
2:6:6,1,1,104596,95404
4:6:2,1,1,104595,95405
6:2:4,1,1,104594,95406
6:4:3,0,-1,104595,95405
2:5:2,2,2,104593,95407
4:5:3,0,-1,104594,95406
2:5:4,1,1,104593,95407
5:6:1,0,-1,104594,95406
1:4:4,0,-1,104595,95405
6:2:6,1,1,104594,95406
2:5:5,1,1,104593,95407
1:1:3,0,-1,104594,95406
5:3:6,0,-1,104595,95405
2:4:2,2,2,104593,95407
3:3:5,0,-1,104594,95406
1:2:3,1,1,104593,95407
1:5:6,0,-1,104594,95406
2:6:4,1,1,104593,95407
2:3:3,1,1,104592,95408
3:2:2,2,2,104590,95410
1:4:1,0,-1,104591,95409
4:5:6,0,-1,104592,95408
6:2:2,2,2,104590,95410
6:3:1,0,-1,104591,95409
2:5:1,1,1,104590,95410
2:2:2,3,3,104587,95413
5:1:1,0,-1,104588,95412
2:5:5,1,1,104587,95413
6:3:3,0,-1,104588,95412
3:5:5,0,-1,104589,95411
1:6:1,0,-1,104590,95410
3:5:4,0,-1,104591,95409
2:1:6,1,1,104590,95410
4:3:2,1,1,104589,95411
5:6:4,0,-1,104590,95410
4:2:5,1,1,104589,95411
2:1:1,1,1,104588,95412
2:6:5,1,1,104587,95413
5:5:6,0,-1,104588,95412
3:5:4,0,-1,104589,95411
1:3:5,0,-1,104590,95410
2:1:1,1,1,104589,95411
5:2:6,1,1,104588,95412
6:6:3,0,-1,104589,95411
1:1:3,0,-1,104590,95410
1:1:1,0,-1,104591,95409
2:1:5,1,1,104590,95410
2:6:4,1,1,104589,95411
1:3:1,0,-1,104590,95410
4:1:5,0,-1,104591,95409
1:5:3,0,-1,104592,95408
1:4:1,0,-1,104593,95407
1:6:5,0,-1,104594,95406
3:4:2,1,1,104593,95407
5:4:6,0,-1,104594,95406
3:2:6,1,1,104593,95407
2:3:3,1,1,104592,95408
1:2:6,1,1,104591,95409
3:6:1,0,-1,104592,95408
3:6:4,0,-1,104593,95407
6:6:5,0,-1,104594,95406
5:3:6,0,-1,104595,95405
2:1:3,1,1,104594,95406
5:4:3,0,-1,104595,95405
5:4:1,0,-1,104596,95404
6:1:2,1,1,104595,95405
3:2:3,1,1,104594,95406
4:4:2,1,1,104593,95407
4:6:6,0,-1,104594,95406
6:4:3,0,-1,104595,95405
6:2:5,1,1,104594,95406
2:6:6,1,1,104593,95407
3:5:3,0,-1,104594,95406
2:6:4,1,1,104593,95407
6:6:5,0,-1,104594,95406
6:3:5,0,-1,104595,95405
2:2:1,2,2,104593,95407
3:3:6,0,-1,104594,95406
4:6:3,0,-1,104595,95405
6:1:6,0,-1,104596,95404
5:3:5,0,-1,104597,95403
4:2:1,1,1,104596,95404
1:1:1,0,-1,104597,95403
1:1:4,0,-1,104598,95402
5:2:1,1,1,104597,95403
6:5:4,0,-1,104598,95402
4:1:6,0,-1,104599,95401
4:2:5,1,1,104598,95402
3:3:4,0,-1,104599,95401
5:4:3,0,-1,104600,95400
6:3:2,1,1,104599,95401
2:1:3,1,1,104598,95402
2:1:6,1,1,104597,95403
3:1:4,0,-1,104598,95402
6:1:5,0,-1,104599,95401
6:5:6,0,-1,104600,95400
5:2:3,1,1,104599,95401
5:6:4,0,-1,104600,95400
4:2:3,1,1,104599,95401
6:3:1,0,-1,104600,95400
6:2:5,1,1,104599,95401
5:1:5,0,-1,104600,95400
3:1:3,0,-1,104601,95399
1:3:6,0,-1,104602,95398
3:5:4,0,-1,104603,95397
1:6:6,0,-1,104604,95396
6:6:4,0,-1,104605,95395
4:4:5,0,-1,104606,95394
2:4:6,1,1,104605,95395
2:1:1,1,1,104604,95396
4:3:1,0,-1,104605,95395
1:1:4,0,-1,104606,95394
5:1:3,0,-1,104607,95393
3:1:3,0,-1,104608,95392
3:1:6,0,-1,104609,95391
1:1:1,0,-1,104610,95390
2:4:1,1,1,104609,95391
1:1:1,0,-1,104610,95390
3:6:2,1,1,104609,95391
3:3:3,0,-1,104610,95390
2:2:1,2,2,104608,95392
4:2:5,1,1,104607,95393
5:4:4,0,-1,104608,95392
4:5:4,0,-1,104609,95391
3:5:4,0,-1,104610,95390
6:2:2,2,2,104608,95392
5:6:5,0,-1,104609,95391
6:5:1,0,-1,104610,95390
4:2:1,1,1,104609,95391
4:2:5,1,1,104608,95392
6:3:6,0,-1,104609,95391
2:5:2,2,2,104607,95393
2:1:2,2,2,104605,95395
4:1:4,0,-1,104606,95394
2:6:1,1,1,104605,95395
2:1:5,1,1,104604,95396
3:3:1,0,-1,104605,95395
1:1:4,0,-1,104606,95394
2:6:3,1,1,104605,95395
1:1:5,0,-1,104606,95394
5:6:6,0,-1,104607,95393
6:5:6,0,-1,104608,95392
1:1:2,1,1,104607,95393
1:2:4,1,1,104606,95394
3:3:3,0,-1,104607,95393
4:1:1,0,-1,104608,95392
1:4:3,0,-1,104609,95391
3:1:5,0,-1,104610,95390
1:4:6,0,-1,104611,95389
4:3:3,0,-1,104612,95388
2:5:1,1,1,104611,95389
4:3:4,0,-1,104612,95388
1:1:6,0,-1,104613,95387
6:2:6,1,1,104612,95388
5:6:5,0,-1,104613,95387
4:4:2,1,1,104612,95388
6:1:3,0,-1,104613,95387
3:2:3,1,1,104612,95388
6:4:3,0,-1,104613,95387
3:5:5,0,-1,104614,95386
4:2:1,1,1,104613,95387
5:6:2,1,1,104612,95388
1:6:2,1,1,104611,95389
2:4:4,1,1,104610,95390
2:2:6,2,2,104608,95392
2:4:5,1,1,104607,95393
4:1:2,1,1,104606,95394
5:5:2,1,1,104605,95395
2:2:5,2,2,104603,95397
4:5:5,0,-1,104604,95396
4:4:3,0,-1,104605,95395
4:6:6,0,-1,104606,95394
2:3:3,1,1,104605,95395
5:4:4,0,-1,104606,95394
3:4:6,0,-1,104607,95393
4:6:2,1,1,104606,95394
1:4:6,0,-1,104607,95393
4:2:5,1,1,104606,95394
2:2:1,2,2,104604,95396
3:5:5,0,-1,104605,95395
1:5:4,0,-1,104606,95394
6:5:3,0,-1,104607,95393
3:2:3,1,1,104606,95394
6:4:1,0,-1,104607,95393
1:2:3,1,1,104606,95394
6:5:2,1,1,104605,95395
4:5:1,0,-1,104606,95394
6:1:2,1,1,104605,95395
2:4:5,1,1,104604,95396
1:6:5,0,-1,104605,95395
1:6:5,0,-1,104606,95394
5:6:3,0,-1,104607,95393
2:2:3,2,2,104605,95395
3:2:6,1,1,104604,95396
5:2:3,1,1,104603,95397
2:5:2,2,2,104601,95399
2:4:5,1,1,104600,95400
1:3:4,0,-1,104601,95399
1:5:5,0,-1,104602,95398
5:3:4,0,-1,104603,95397
5:1:5,0,-1,104604,95396
3:3:4,0,-1,104605,95395
6:6:6,0,-1,104606,95394
3:1:5,0,-1,104607,95393
6:5:2,1,1,104606,95394
2:5:3,1,1,104605,95395
6:3:5,0,-1,104606,95394
2:3:2,2,2,104604,95396
3:1:1,0,-1,104605,95395
4:3:6,0,-1,104606,95394
5:3:2,1,1,104605,95395
1:3:1,0,-1,104606,95394
3:4:4,0,-1,104607,95393
4:4:6,0,-1,104608,95392
1:5:2,1,1,104607,95393
4:2:3,1,1,104606,95394
5:1:1,0,-1,104607,95393
1:6:5,0,-1,104608,95392
5:6:6,0,-1,104609,95391
1:1:3,0,-1,104610,95390
2:5:3,1,1,104609,95391
6:4:4,0,-1,104610,95390
1:3:1,0,-1,104611,95389
4:1:6,0,-1,104612,95388
1:3:4,0,-1,104613,95387
1:2:5,1,1,104612,95388
6:4:4,0,-1,104613,95387
6:1:4,0,-1,104614,95386
2:3:3,1,1,104613,95387
2:3:1,1,1,104612,95388
2:4:3,1,1,104611,95389
4:5:6,0,-1,104612,95388
2:3:6,1,1,104611,95389
5:2:5,1,1,104610,95390
3:1:5,0,-1,104611,95389
6:3:5,0,-1,104612,95388
4:4:4,0,-1,104613,95387
4:6:1,0,-1,104614,95386
2:3:4,1,1,104613,95387
4:3:2,1,1,104612,95388
6:5:5,0,-1,104613,95387
5:4:6,0,-1,104614,95386
5:2:5,1,1,104613,95387
2:6:5,1,1,104612,95388
2:4:5,1,1,104611,95389
6:4:2,1,1,104610,95390
2:4:4,1,1,104609,95391
2:5:6,1,1,104608,95392
2:1:3,1,1,104607,95393
4:2:4,1,1,104606,95394
2:3:2,2,2,104604,95396
3:6:2,1,1,104603,95397
6:4:2,1,1,104602,95398
2:2:4,2,2,104600,95400
1:1:6,0,-1,104601,95399
2:6:6,1,1,104600,95400
3:3:3,0,-1,104601,95399
2:4:1,1,1,104600,95400
2:3:2,2,2,104598,95402
5:5:2,1,1,104597,95403
3:6:1,0,-1,104598,95402
4:1:1,0,-1,104599,95401
1:3:3,0,-1,104600,95400
1:4:1,0,-1,104601,95399
6:3:1,0,-1,104602,95398
1:4:2,1,1,104601,95399
5:4:4,0,-1,104602,95398
5:2:4,1,1,104601,95399
5:1:6,0,-1,104602,95398
5:5:1,0,-1,104603,95397
2:5:2,2,2,104601,95399
4:1:4,0,-1,104602,95398
5:2:3,1,1,104601,95399
4:3:5,0,-1,104602,95398
6:4:4,0,-1,104603,95397
1:5:4,0,-1,104604,95396
5:6:3,0,-1,104605,95395
3:2:5,1,1,104604,95396
3:5:5,0,-1,104605,95395
3:3:6,0,-1,104606,95394
2:6:4,1,1,104605,95395
5:1:6,0,-1,104606,95394
3:2:5,1,1,104605,95395
6:1:4,0,-1,104606,95394
2:1:1,1,1,104605,95395
2:5:5,1,1,104604,95396
2:1:4,1,1,104603,95397
1:2:4,1,1,104602,95398
6:1:4,0,-1,104603,95397
1:3:3,0,-1,104604,95396
4:3:4,0,-1,104605,95395
1:4:3,0,-1,104606,95394
5:2:5,1,1,104605,95395
2:3:6,1,1,104604,95396
2:3:6,1,1,104603,95397
1:1:4,0,-1,104604,95396
6:1:1,0,-1,104605,95395
4:4:4,0,-1,104606,95394
4:5:1,0,-1,104607,95393
5:4:1,0,-1,104608,95392
6:4:2,1,1,104607,95393
2:6:5,1,1,104606,95394
4:1:5,0,-1,104607,95393
3:2:2,2,2,104605,95395
3:1:2,1,1,104604,95396
6:3:5,0,-1,104605,95395
6:2:1,1,1,104604,95396
1:1:1,0,-1,104605,95395
1:1:2,1,1,104604,95396
5:2:2,2,2,104602,95398
1:2:6,1,1,104601,95399
6:6:3,0,-1,104602,95398
5:2:5,1,1,104601,95399
3:4:4,0,-1,104602,95398
1:5:1,0,-1,104603,95397
3:4:2,1,1,104602,95398
6:2:3,1,1,104601,95399
1:3:2,1,1,104600,95400
6:1:6,0,-1,104601,95399
1:4:5,0,-1,104602,95398
4:6:3,0,-1,104603,95397
2:3:4,1,1,104602,95398
5:3:1,0,-1,104603,95397
4:5:3,0,-1,104604,95396
5:4:5,0,-1,104605,95395
6:5:2,1,1,104604,95396
5:3:6,0,-1,104605,95395
4:3:1,0,-1,104606,95394
1:5:5,0,-1,104607,95393
5:2:4,1,1,104606,95394
3:3:1,0,-1,104607,95393
6:4:3,0,-1,104608,95392
2:6:1,1,1,104607,95393
2:4:5,1,1,104606,95394
4:5:2,1,1,104605,95395
1:5:2,1,1,104604,95396
4:4:4,0,-1,104605,95395
6:3:5,0,-1,104606,95394
6:4:3,0,-1,104607,95393
5:5:6,0,-1,104608,95392
1:6:5,0,-1,104609,95391
3:3:2,1,1,104608,95392
4:5:6,0,-1,104609,95391
6:4:6,0,-1,104610,95390
2:1:4,1,1,104609,95391
1:1:4,0,-1,104610,95390
5:4:3,0,-1,104611,95389
3:4:6,0,-1,104612,95388
1:1:1,0,-1,104613,95387
5:4:3,0,-1,104614,95386
3:5:6,0,-1,104615,95385
4:4:1,0,-1,104616,95384
5:4:2,1,1,104615,95385
5:6:3,0,-1,104616,95384
4:5:4,0,-1,104617,95383
6:6:6,0,-1,104618,95382
3:1:3,0,-1,104619,95381
5:4:5,0,-1,104620,95380
6:2:3,1,1,104619,95381
1:4:5,0,-1,104620,95380
4:4:3,0,-1,104621,95379
1:2:1,1,1,104620,95380
4:3:1,0,-1,104621,95379
2:4:4,1,1,104620,95380
1:2:4,1,1,104619,95381
5:5:3,0,-1,104620,95380
5:1:2,1,1,104619,95381
4:3:6,0,-1,104620,95380
6:2:1,1,1,104619,95381
3:6:4,0,-1,104620,95380
5:5:1,0,-1,104621,95379
4:5:2,1,1,104620,95380
2:1:3,1,1,104619,95381
3:3:3,0,-1,104620,95380
6:6:6,0,-1,104621,95379
2:5:6,1,1,104620,95380
1:2:5,1,1,104619,95381
2:6:6,1,1,104618,95382
2:3:4,1,1,104617,95383
5:3:2,1,1,104616,95384
3:4:5,0,-1,104617,95383
3:3:4,0,-1,104618,95382
2:1:4,1,1,104617,95383
4:5:2,1,1,104616,95384
5:6:6,0,-1,104617,95383
2:2:2,3,3,104614,95386
2:4:5,1,1,104613,95387
1:5:6,0,-1,104614,95386
6:1:1,0,-1,104615,95385
2:3:5,1,1,104614,95386
2:4:6,1,1,104613,95387
6:1:4,0,-1,104614,95386
1:1:2,1,1,104613,95387
1:3:4,0,-1,104614,95386
6:6:1,0,-1,104615,95385
1:5:2,1,1,104614,95386
5:5:4,0,-1,104615,95385
6:3:5,0,-1,104616,95384
2:6:1,1,1,104615,95385
3:3:1,0,-1,104616,95384
5:4:1,0,-1,104617,95383
2:5:5,1,1,104616,95384
4:3:3,0,-1,104617,95383
6:4:2,1,1,104616,95384
5:3:1,0,-1,104617,95383
6:2:4,1,1,104616,95384
1:4:6,0,-1,104617,95383
5:2:5,1,1,104616,95384
6:2:3,1,1,104615,95385
6:1:4,0,-1,104616,95384
4:1:1,0,-1,104617,95383
1:6:5,0,-1,104618,95382
5:6:5,0,-1,104619,95381
2:4:3,1,1,104618,95382
3:3:1,0,-1,104619,95381
2:3:1,1,1,104618,95382
1:5:6,0,-1,104619,95381
3:6:5,0,-1,104620,95380
2:5:2,2,2,104618,95382
6:3:2,1,1,104617,95383
3:5:5,0,-1,104618,95382
5:5:6,0,-1,104619,95381
3:6:5,0,-1,104620,95380
6:3:6,0,-1,104621,95379
4:2:4,1,1,104620,95380
2:5:5,1,1,104619,95381
1:1:5,0,-1,104620,95380
3:5:6,0,-1,104621,95379
3:5:3,0,-1,104622,95378
1:6:2,1,1,104621,95379
2:2:6,2,2,104619,95381
1:6:1,0,-1,104620,95380
3:6:4,0,-1,104621,95379
1:4:5,0,-1,104622,95378
6:5:3,0,-1,104623,95377
1:1:3,0,-1,104624,95376
6:2:6,1,1,104623,95377
2:6:5,1,1,104622,95378
4:6:4,0,-1,104623,95377
3:3:5,0,-1,104624,95376
6:4:6,0,-1,104625,95375
6:4:2,1,1,104624,95376
4:3:5,0,-1,104625,95375
3:2:6,1,1,104624,95376
4:2:5,1,1,104623,95377
3:5:6,0,-1,104624,95376
2:4:5,1,1,104623,95377
1:5:6,0,-1,104624,95376
4:3:4,0,-1,104625,95375
4:2:6,1,1,104624,95376
3:3:5,0,-1,104625,95375
3:2:1,1,1,104624,95376
6:6:1,0,-1,104625,95375
4:1:2,1,1,104624,95376
5:5:2,1,1,104623,95377
3:5:2,1,1,104622,95378
6:2:4,1,1,104621,95379
6:4:4,0,-1,104622,95378
2:2:6,2,2,104620,95380
2:4:3,1,1,104619,95381
4:5:4,0,-1,104620,95380
1:4:5,0,-1,104621,95379
5:5:4,0,-1,104622,95378
5:3:1,0,-1,104623,95377
5:1:2,1,1,104622,95378
3:5:3,0,-1,104623,95377
6:3:2,1,1,104622,95378
2:6:4,1,1,104621,95379
2:6:3,1,1,104620,95380
3:3:3,0,-1,104621,95379
4:3:4,0,-1,104622,95378
6:6:3,0,-1,104623,95377
1:6:6,0,-1,104624,95376
2:6:1,1,1,104623,95377
1:3:5,0,-1,104624,95376
4:4:2,1,1,104623,95377
1:3:2,1,1,104622,95378
4:2:2,2,2,104620,95380
1:4:4,0,-1,104621,95379
2:3:5,1,1,104620,95380
2:2:2,3,3,104617,95383
6:2:2,2,2,104615,95385
2:4:2,2,2,104613,95387
2:6:2,2,2,104611,95389
3:5:6,0,-1,104612,95388
4:1:1,0,-1,104613,95387
4:3:1,0,-1,104614,95386
1:5:3,0,-1,104615,95385
5:3:1,0,-1,104616,95384
5:2:1,1,1,104615,95385
6:5:6,0,-1,104616,95384
1:4:3,0,-1,104617,95383
4:5:6,0,-1,104618,95382
1:2:2,2,2,104616,95384
1:3:5,0,-1,104617,95383
4:2:6,1,1,104616,95384
2:3:1,1,1,104615,95385
1:6:6,0,-1,104616,95384
5:6:2,1,1,104615,95385
1:3:1,0,-1,104616,95384
5:4:1,0,-1,104617,95383
5:3:6,0,-1,104618,95382
3:5:1,0,-1,104619,95381
5:1:5,0,-1,104620,95380
2:2:5,2,2,104618,95382
2:1:6,1,1,104617,95383
6:6:4,0,-1,104618,95382
3:5:6,0,-1,104619,95381
3:6:6,0,-1,104620,95380
2:2:1,2,2,104618,95382
5:5:3,0,-1,104619,95381
3:6:6,0,-1,104620,95380
4:4:5,0,-1,104621,95379
5:6:5,0,-1,104622,95378
3:6:6,0,-1,104623,95377
1:6:6,0,-1,104624,95376
6:3:2,1,1,104623,95377
1:5:1,0,-1,104624,95376
1:6:1,0,-1,104625,95375
3:6:3,0,-1,104626,95374
3:4:2,1,1,104625,95375
1:3:5,0,-1,104626,95374
1:5:2,1,1,104625,95375
2:6:2,2,2,104623,95377
2:3:1,1,1,104622,95378
3:6:2,1,1,104621,95379
3:6:3,0,-1,104622,95378
5:2:3,1,1,104621,95379
4:5:5,0,-1,104622,95378
3:6:4,0,-1,104623,95377
6:5:2,1,1,104622,95378
6:1:4,0,-1,104623,95377
4:4:4,0,-1,104624,95376
4:4:2,1,1,104623,95377
2:4:1,1,1,104622,95378
6:5:6,0,-1,104623,95377
2:1:5,1,1,104622,95378
2:2:2,3,3,104619,95381
5:5:6,0,-1,104620,95380
4:1:1,0,-1,104621,95379
3:6:6,0,-1,104622,95378
5:6:2,1,1,104621,95379
3:6:1,0,-1,104622,95378
2:2:1,2,2,104620,95380
3:2:2,2,2,104618,95382
4:1:6,0,-1,104619,95381
6:6:6,0,-1,104620,95380
6:3:5,0,-1,104621,95379
2:4:3,1,1,104620,95380
2:5:1,1,1,104619,95381
3:6:1,0,-1,104620,95380
1:3:3,0,-1,104621,95379
6:5:2,1,1,104620,95380
1:6:6,0,-1,104621,95379
6:3:3,0,-1,104622,95378
2:2:5,2,2,104620,95380
5:4:1,0,-1,104621,95379
1:6:3,0,-1,104622,95378
5:3:2,1,1,104621,95379
3:1:3,0,-1,104622,95378
5:5:4,0,-1,104623,95377
2:3:1,1,1,104622,95378
3:6:3,0,-1,104623,95377
1:6:6,0,-1,104624,95376
6:3:3,0,-1,104625,95375
4:3:1,0,-1,104626,95374
4:4:4,0,-1,104627,95373
3:1:1,0,-1,104628,95372
3:1:2,1,1,104627,95373
5:5:2,1,1,104626,95374
4:2:2,2,2,104624,95376
1:4:5,0,-1,104625,95375
1:2:4,1,1,104624,95376
3:2:2,2,2,104622,95378
3:1:1,0,-1,104623,95377
3:2:1,1,1,104622,95378
3:5:1,0,-1,104623,95377
6:5:2,1,1,104622,95378
3:4:3,0,-1,104623,95377
4:5:3,0,-1,104624,95376
5:3:2,1,1,104623,95377
2:1:1,1,1,104622,95378
2:3:6,1,1,104621,95379
5:4:1,0,-1,104622,95378
4:2:1,1,1,104621,95379
1:2:6,1,1,104620,95380
3:3:2,1,1,104619,95381
6:2:2,2,2,104617,95383
5:6:3,0,-1,104618,95382
5:2:3,1,1,104617,95383
5:6:4,0,-1,104618,95382
3:5:3,0,-1,104619,95381
5:4:4,0,-1,104620,95380
1:4:1,0,-1,104621,95379
3:2:3,1,1,104620,95380
3:6:1,0,-1,104621,95379
2:4:4,1,1,104620,95380
3:1:2,1,1,104619,95381
4:6:2,1,1,104618,95382
3:3:1,0,-1,104619,95381
5:2:3,1,1,104618,95382
5:6:4,0,-1,104619,95381
2:1:1,1,1,104618,95382
3:2:1,1,1,104617,95383
6:5:6,0,-1,104618,95382
4:2:5,1,1,104617,95383
3:1:1,0,-1,104618,95382
1:1:5,0,-1,104619,95381
2:4:1,1,1,104618,95382
4:5:3,0,-1,104619,95381
2:1:1,1,1,104618,95382
6:3:4,0,-1,104619,95381
4:6:4,0,-1,104620,95380
5:2:5,1,1,104619,95381
2:3:2,2,2,104617,95383
1:1:4,0,-1,104618,95382
2:5:3,1,1,104617,95383
4:5:1,0,-1,104618,95382
4:2:2,2,2,104616,95384
2:3:3,1,1,104615,95385
5:3:5,0,-1,104616,95384
1:2:5,1,1,104615,95385
6:6:3,0,-1,104616,95384
5:1:3,0,-1,104617,95383
1:2:2,2,2,104615,95385
2:5:4,1,1,104614,95386
5:5:1,0,-1,104615,95385
4:1:2,1,1,104614,95386
6:1:4,0,-1,104615,95385
6:5:4,0,-1,104616,95384
1:6:1,0,-1,104617,95383
6:2:3,1,1,104616,95384
3:1:5,0,-1,104617,95383
1:2:1,1,1,104616,95384
2:5:4,1,1,104615,95385
1:2:6,1,1,104614,95386
3:4:2,1,1,104613,95387
2:5:1,1,1,104612,95388
2:4:5,1,1,104611,95389
2:4:1,1,1,104610,95390
1:6:5,0,-1,104611,95389
1:3:2,1,1,104610,95390
3:4:4,0,-1,104611,95389
3:5:5,0,-1,104612,95388
3:3:1,0,-1,104613,95387
3:1:5,0,-1,104614,95386
6:5:5,0,-1,104615,95385
5:4:2,1,1,104614,95386
4:2:2,2,2,104612,95388
6:1:6,0,-1,104613,95387
6:2:4,1,1,104612,95388
6:5:2,1,1,104611,95389
6:5:5,0,-1,104612,95388
2:3:2,2,2,104610,95390
1:2:2,2,2,104608,95392
2:4:5,1,1,104607,95393
3:2:6,1,1,104606,95394
6:1:6,0,-1,104607,95393
6:5:4,0,-1,104608,95392
4:3:4,0,-1,104609,95391
3:4:6,0,-1,104610,95390
4:6:2,1,1,104609,95391
2:2:1,2,2,104607,95393
1:1:4,0,-1,104608,95392
5:4:4,0,-1,104609,95391
6:4:4,0,-1,104610,95390
6:6:5,0,-1,104611,95389
3:1:3,0,-1,104612,95388
4:2:6,1,1,104611,95389
1:4:4,0,-1,104612,95388
2:4:4,1,1,104611,95389
2:2:6,2,2,104609,95391
5:1:1,0,-1,104610,95390
4:4:1,0,-1,104611,95389
1:4:1,0,-1,104612,95388
1:5:6,0,-1,104613,95387
2:3:6,1,1,104612,95388
5:1:3,0,-1,104613,95387
5:6:4,0,-1,104614,95386
6:2:2,2,2,104612,95388
6:2:5,1,1,104611,95389
5:6:2,1,1,104610,95390
6:6:2,1,1,104609,95391
5:1:5,0,-1,104610,95390
2:2:3,2,2,104608,95392
4:3:1,0,-1,104609,95391
4:4:4,0,-1,104610,95390
6:1:3,0,-1,104611,95389
5:4:2,1,1,104610,95390
6:1:3,0,-1,104611,95389
5:1:4,0,-1,104612,95388
4:4:4,0,-1,104613,95387
1:2:4,1,1,104612,95388
3:2:1,1,1,104611,95389
2:4:2,2,2,104609,95391
5:4:6,0,-1,104610,95390
4:6:6,0,-1,104611,95389
1:4:6,0,-1,104612,95388
6:5:5,0,-1,104613,95387
2:4:3,1,1,104612,95388
4:5:4,0,-1,104613,95387
5:6:1,0,-1,104614,95386
5:4:3,0,-1,104615,95385
6:1:1,0,-1,104616,95384
6:5:3,0,-1,104617,95383
4:4:3,0,-1,104618,95382
5:3:3,0,-1,104619,95381
5:6:5,0,-1,104620,95380
4:4:3,0,-1,104621,95379
3:4:3,0,-1,104622,95378
6:3:1,0,-1,104623,95377
2:3:6,1,1,104622,95378
2:5:3,1,1,104621,95379
6:1:2,1,1,104620,95380
1:5:5,0,-1,104621,95379
2:5:6,1,1,104620,95380
4:1:2,1,1,104619,95381
5:6:5,0,-1,104620,95380
4:4:4,0,-1,104621,95379
6:6:1,0,-1,104622,95378
4:5:5,0,-1,104623,95377
4:1:3,0,-1,104624,95376
1:5:6,0,-1,104625,95375
3:1:1,0,-1,104626,95374
4:4:5,0,-1,104627,95373
6:5:1,0,-1,104628,95372
4:2:1,1,1,104627,95373
3:2:5,1,1,104626,95374
6:4:4,0,-1,104627,95373
4:3:1,0,-1,104628,95372
5:1:3,0,-1,104629,95371
6:5:1,0,-1,104630,95370
4:3:5,0,-1,104631,95369
2:2:6,2,2,104629,95371
3:2:2,2,2,104627,95373
3:2:2,2,2,104625,95375
3:1:6,0,-1,104626,95374
1:5:6,0,-1,104627,95373
1:2:2,2,2,104625,95375
4:1:5,0,-1,104626,95374
4:5:4,0,-1,104627,95373
2:1:1,1,1,104626,95374
5:5:2,1,1,104625,95375
2:5:6,1,1,104624,95376
4:1:5,0,-1,104625,95375
6:2:5,1,1,104624,95376
5:1:6,0,-1,104625,95375
6:1:1,0,-1,104626,95374
5:4:4,0,-1,104627,95373
2:4:2,2,2,104625,95375
6:3:6,0,-1,104626,95374
2:1:5,1,1,104625,95375
3:1:1,0,-1,104626,95374
6:6:1,0,-1,104627,95373
6:4:5,0,-1,104628,95372
2:5:4,1,1,104627,95373
1:2:2,2,2,104625,95375
1:1:6,0,-1,104626,95374
1:2:1,1,1,104625,95375
2:6:5,1,1,104624,95376
5:4:3,0,-1,104625,95375
2:2:5,2,2,104623,95377
4:2:4,1,1,104622,95378
6:4:6,0,-1,104623,95377
3:3:2,1,1,104622,95378
1:4:1,0,-1,104623,95377
3:3:4,0,-1,104624,95376
2:2:2,3,3,104621,95379
1:2:6,1,1,104620,95380
5:1:5,0,-1,104621,95379
3:1:1,0,-1,104622,95378
3:2:6,1,1,104621,95379
4:3:4,0,-1,104622,95378
2:4:4,1,1,104621,95379
5:6:1,0,-1,104622,95378
2:3:6,1,1,104621,95379
5:3:1,0,-1,104622,95378
1:5:2,1,1,104621,95379
3:4:2,1,1,104620,95380
3:5:4,0,-1,104621,95379
5:6:6,0,-1,104622,95378
4:5:6,0,-1,104623,95377
6:1:6,0,-1,104624,95376
5:1:4,0,-1,104625,95375
3:5:6,0,-1,104626,95374
1:1:2,1,1,104625,95375
4:4:2,1,1,104624,95376
3:2:4,1,1,104623,95377
1:4:2,1,1,104622,95378
6:2:2,2,2,104620,95380
3:6:5,0,-1,104621,95379
2:3:3,1,1,104620,95380
6:2:1,1,1,104619,95381
2:5:3,1,1,104618,95382
4:6:5,0,-1,104619,95381
1:1:5,0,-1,104620,95380
4:4:6,0,-1,104621,95379
3:5:1,0,-1,104622,95378
6:3:1,0,-1,104623,95377
2:5:3,1,1,104622,95378
6:3:6,0,-1,104623,95377
1:5:3,0,-1,104624,95376
4:5:2,1,1,104623,95377
1:4:2,1,1,104622,95378
1:6:5,0,-1,104623,95377
4:3:6,0,-1,104624,95376
5:2:2,2,2,104622,95378
3:6:1,0,-1,104623,95377
5:6:3,0,-1,104624,95376
4:3:1,0,-1,104625,95375
3:5:3,0,-1,104626,95374
1:4:1,0,-1,104627,95373
1:1:6,0,-1,104628,95372
5:4:3,0,-1,104629,95371
6:5:5,0,-1,104630,95370
6:5:3,0,-1,104631,95369
6:2:1,1,1,104630,95370
6:4:6,0,-1,104631,95369
3:4:4,0,-1,104632,95368
3:4:6,0,-1,104633,95367
1:4:2,1,1,104632,95368
2:2:5,2,2,104630,95370
1:4:2,1,1,104629,95371
4:3:3,0,-1,104630,95370
3:5:5,0,-1,104631,95369
5:5:3,0,-1,104632,95368
2:6:3,1,1,104631,95369
1:6:5,0,-1,104632,95368
6:2:3,1,1,104631,95369
2:1:5,1,1,104630,95370
2:2:6,2,2,104628,95372
1:2:5,1,1,104627,95373
5:5:6,0,-1,104628,95372
2:5:6,1,1,104627,95373
1:1:4,0,-1,104628,95372
5:2:6,1,1,104627,95373
6:4:2,1,1,104626,95374
2:3:3,1,1,104625,95375
1:4:5,0,-1,104626,95374
1:3:3,0,-1,104627,95373
6:3:3,0,-1,104628,95372
5:6:3,0,-1,104629,95371
1:6:2,1,1,104628,95372
3:6:4,0,-1,104629,95371
1:2:5,1,1,104628,95372
3:4:2,1,1,104627,95373
4:1:3,0,-1,104628,95372
5:2:1,1,1,104627,95373
6:3:1,0,-1,104628,95372
5:1:4,0,-1,104629,95371
2:4:3,1,1,104628,95372
2:6:4,1,1,104627,95373
5:6:6,0,-1,104628,95372
2:5:1,1,1,104627,95373
3:2:3,1,1,104626,95374
6:3:4,0,-1,104627,95373
3:5:2,1,1,104626,95374
6:3:6,0,-1,104627,95373
4:5:2,1,1,104626,95374
1:4:3,0,-1,104627,95373
2:4:5,1,1,104626,95374
5:4:6,0,-1,104627,95373
6:2:1,1,1,104626,95374
4:5:3,0,-1,104627,95373
6:1:3,0,-1,104628,95372
1:4:2,1,1,104627,95373
1:3:3,0,-1,104628,95372
6:5:3,0,-1,104629,95371
4:3:1,0,-1,104630,95370
2:3:5,1,1,104629,95371
3:4:4,0,-1,104630,95370
6:5:2,1,1,104629,95371
6:2:6,1,1,104628,95372
2:4:6,1,1,104627,95373
4:4:3,0,-1,104628,95372
1:6:1,0,-1,104629,95371
1:6:4,0,-1,104630,95370
5:4:3,0,-1,104631,95369
3:3:4,0,-1,104632,95368
3:5:5,0,-1,104633,95367
4:3:4,0,-1,104634,95366
1:3:5,0,-1,104635,95365
2:3:3,1,1,104634,95366
4:4:2,1,1,104633,95367
3:4:3,0,-1,104634,95366
4:6:1,0,-1,104635,95365
5:1:1,0,-1,104636,95364
1:3:4,0,-1,104637,95363
6:6:4,0,-1,104638,95362
2:3:4,1,1,104637,95363
6:5:2,1,1,104636,95364
5:2:2,2,2,104634,95366
2:1:3,1,1,104633,95367
6:6:1,0,-1,104634,95366
5:2:3,1,1,104633,95367
6:3:5,0,-1,104634,95366
4:3:2,1,1,104633,95367
6:1:6,0,-1,104634,95366
1:4:1,0,-1,104635,95365
6:6:2,1,1,104634,95366
3:5:1,0,-1,104635,95365
6:1:1,0,-1,104636,95364
6:6:1,0,-1,104637,95363
4:3:4,0,-1,104638,95362
2:3:3,1,1,104637,95363
2:5:6,1,1,104636,95364
4:4:1,0,-1,104637,95363
3:3:6,0,-1,104638,95362
4:6:1,0,-1,104639,95361
1:1:5,0,-1,104640,95360
1:6:6,0,-1,104641,95359
6:6:4,0,-1,104642,95358
6:5:1,0,-1,104643,95357
4:5:5,0,-1,104644,95356
6:2:6,1,1,104643,95357
2:3:2,2,2,104641,95359
4:6:3,0,-1,104642,95358
6:3:5,0,-1,104643,95357
3:1:6,0,-1,104644,95356
3:2:1,1,1,104643,95357
2:3:3,1,1,104642,95358
3:4:3,0,-1,104643,95357
5:5:1,0,-1,104644,95356
2:4:6,1,1,104643,95357
1:3:5,0,-1,104644,95356
6:2:2,2,2,104642,95358
5:5:6,0,-1,104643,95357
2:3:2,2,2,104641,95359
1:5:2,1,1,104640,95360
5:6:5,0,-1,104641,95359
4:3:6,0,-1,104642,95358
6:6:1,0,-1,104643,95357
6:6:3,0,-1,104644,95356
6:3:4,0,-1,104645,95355
2:4:3,1,1,104644,95356
5:1:5,0,-1,104645,95355
3:1:1,0,-1,104646,95354
3:3:1,0,-1,104647,95353
6:6:1,0,-1,104648,95352
1:4:4,0,-1,104649,95351
1:4:4,0,-1,104650,95350
5:6:3,0,-1,104651,95349
3:1:3,0,-1,104652,95348
4:4:4,0,-1,104653,95347
3:3:5,0,-1,104654,95346
6:1:5,0,-1,104655,95345
3:5:4,0,-1,104656,95344
5:4:2,1,1,104655,95345
4:1:6,0,-1,104656,95344
5:1:1,0,-1,104657,95343
5:4:5,0,-1,104658,95342
6:6:2,1,1,104657,95343
3:2:2,2,2,104655,95345
6:4:2,1,1,104654,95346
4:4:5,0,-1,104655,95345
6:4:1,0,-1,104656,95344
3:3:3,0,-1,104657,95343
6:6:3,0,-1,104658,95342
4:4:3,0,-1,104659,95341
3:1:4,0,-1,104660,95340
2:3:3,1,1,104659,95341
4:5:5,0,-1,104660,95340
2:3:3,1,1,104659,95341
3:4:3,0,-1,104660,95340
6:5:1,0,-1,104661,95339
5:2:1,1,1,104660,95340
6:2:3,1,1,104659,95341
6:1:4,0,-1,104660,95340
3:4:2,1,1,104659,95341
6:2:3,1,1,104658,95342
3:1:2,1,1,104657,95343
6:6:4,0,-1,104658,95342
3:2:4,1,1,104657,95343
6:5:3,0,-1,104658,95342
1:5:1,0,-1,104659,95341
3:2:3,1,1,104658,95342
6:6:3,0,-1,104659,95341
5:1:4,0,-1,104660,95340
2:4:1,1,1,104659,95341
2:6:2,2,2,104657,95343
1:2:1,1,1,104656,95344
6:3:4,0,-1,104657,95343
6:3:6,0,-1,104658,95342
5:6:3,0,-1,104659,95341
6:2:1,1,1,104658,95342
6:5:4,0,-1,104659,95341
2:6:3,1,1,104658,95342
2:4:4,1,1,104657,95343
1:3:2,1,1,104656,95344
5:2:5,1,1,104655,95345
5:3:5,0,-1,104656,95344
5:2:1,1,1,104655,95345
2:2:3,2,2,104653,95347
3:6:5,0,-1,104654,95346
6:6:3,0,-1,104655,95345
1:6:2,1,1,104654,95346
4:6:6,0,-1,104655,95345
3:4:5,0,-1,104656,95344
1:4:2,1,1,104655,95345
3:2:4,1,1,104654,95346
6:4:2,1,1,104653,95347
3:3:1,0,-1,104654,95346
1:1:3,0,-1,104655,95345
1:3:2,1,1,104654,95346
1:6:4,0,-1,104655,95345
4:4:4,0,-1,104656,95344
6:2:1,1,1,104655,95345
1:2:6,1,1,104654,95346
1:5:3,0,-1,104655,95345
6:6:2,1,1,104654,95346
2:4:4,1,1,104653,95347
6:2:5,1,1,104652,95348
6:5:1,0,-1,104653,95347
2:3:1,1,1,104652,95348
5:4:5,0,-1,104653,95347
5:6:1,0,-1,104654,95346
2:3:6,1,1,104653,95347
2:4:5,1,1,104652,95348
2:6:1,1,1,104651,95349
3:3:3,0,-1,104652,95348
4:4:6,0,-1,104653,95347
5:5:1,0,-1,104654,95346
6:2:1,1,1,104653,95347
1:4:6,0,-1,104654,95346
1:3:6,0,-1,104655,95345
1:2:2,2,2,104653,95347
4:6:2,1,1,104652,95348
4:5:2,1,1,104651,95349
2:6:4,1,1,104650,95350
1:3:4,0,-1,104651,95349
4:6:3,0,-1,104652,95348
6:5:6,0,-1,104653,95347
2:6:5,1,1,104652,95348
6:2:5,1,1,104651,95349
3:2:5,1,1,104650,95350
3:1:5,0,-1,104651,95349
3:2:1,1,1,104650,95350
4:2:6,1,1,104649,95351
3:4:5,0,-1,104650,95350
4:6:3,0,-1,104651,95349
1:4:2,1,1,104650,95350
2:3:3,1,1,104649,95351
4:1:2,1,1,104648,95352
6:3:5,0,-1,104649,95351
5:6:4,0,-1,104650,95350
6:6:2,1,1,104649,95351
2:4:6,1,1,104648,95352
4:4:1,0,-1,104649,95351
3:4:3,0,-1,104650,95350
4:2:1,1,1,104649,95351
4:1:1,0,-1,104650,95350
4:1:1,0,-1,104651,95349
2:2:2,3,3,104648,95352
4:3:5,0,-1,104649,95351
5:6:4,0,-1,104650,95350
4:6:4,0,-1,104651,95349
6:3:4,0,-1,104652,95348
2:4:2,2,2,104650,95350
6:2:2,2,2,104648,95352
1:1:5,0,-1,104649,95351
1:6:4,0,-1,104650,95350
2:5:4,1,1,104649,95351
3:3:1,0,-1,104650,95350
6:4:4,0,-1,104651,95349
3:5:6,0,-1,104652,95348
1:6:6,0,-1,104653,95347
5:5:4,0,-1,104654,95346
6:4:3,0,-1,104655,95345
5:3:2,1,1,104654,95346
4:5:1,0,-1,104655,95345
2:2:6,2,2,104653,95347
2:1:5,1,1,104652,95348
6:6:2,1,1,104651,95349
3:2:4,1,1,104650,95350
3:3:2,1,1,104649,95351
3:6:6,0,-1,104650,95350
3:2:5,1,1,104649,95351
1:3:1,0,-1,104650,95350
1:5:3,0,-1,104651,95349
4:4:4,0,-1,104652,95348
6:5:2,1,1,104651,95349
2:6:2,2,2,104649,95351
2:2:3,2,2,104647,95353
3:1:5,0,-1,104648,95352
1:1:5,0,-1,104649,95351
2:1:3,1,1,104648,95352
3:3:1,0,-1,104649,95351
6:6:3,0,-1,104650,95350
5:6:3,0,-1,104651,95349
6:4:3,0,-1,104652,95348
6:3:3,0,-1,104653,95347
3:1:2,1,1,104652,95348
5:3:5,0,-1,104653,95347
1:1:5,0,-1,104654,95346
1:1:3,0,-1,104655,95345
2:3:5,1,1,104654,95346
3:5:5,0,-1,104655,95345
5:4:3,0,-1,104656,95344
6:4:5,0,-1,104657,95343
3:5:3,0,-1,104658,95342
4:2:1,1,1,104657,95343
4:3:1,0,-1,104658,95342
5:3:5,0,-1,104659,95341
1:3:3,0,-1,104660,95340
3:4:2,1,1,104659,95341
1:5:1,0,-1,104660,95340
1:3:2,1,1,104659,95341
4:3:2,1,1,104658,95342
1:5:1,0,-1,104659,95341
2:5:3,1,1,104658,95342
4:1:1,0,-1,104659,95341
6:5:6,0,-1,104660,95340
5:5:5,0,-1,104661,95339
2:2:6,2,2,104659,95341
4:3:5,0,-1,104660,95340
2:5:5,1,1,104659,95341
5:2:4,1,1,104658,95342
4:6:5,0,-1,104659,95341
5:6:2,1,1,104658,95342
6:4:6,0,-1,104659,95341
4:1:6,0,-1,104660,95340
1:4:3,0,-1,104661,95339
3:6:5,0,-1,104662,95338
3:3:5,0,-1,104663,95337
4:6:6,0,-1,104664,95336
4:4:6,0,-1,104665,95335
5:4:5,0,-1,104666,95334
4:3:3,0,-1,104667,95333
2:5:6,1,1,104666,95334
2:1:1,1,1,104665,95335
5:3:3,0,-1,104666,95334
1:1:5,0,-1,104667,95333
5:2:2,2,2,104665,95335
1:2:3,1,1,104664,95336
4:5:5,0,-1,104665,95335
3:4:4,0,-1,104666,95334
2:5:6,1,1,104665,95335
5:5:4,0,-1,104666,95334
2:4:3,1,1,104665,95335
3:2:2,2,2,104663,95337
6:3:3,0,-1,104664,95336
2:4:3,1,1,104663,95337
3:5:5,0,-1,104664,95336
5:2:3,1,1,104663,95337
5:1:2,1,1,104662,95338
2:6:4,1,1,104661,95339
5:3:3,0,-1,104662,95338
1:1:1,0,-1,104663,95337
1:4:4,0,-1,104664,95336
4:1:5,0,-1,104665,95335
6:5:6,0,-1,104666,95334
5:6:1,0,-1,104667,95333
6:6:3,0,-1,104668,95332
3:5:2,1,1,104667,95333
1:5:4,0,-1,104668,95332
5:3:5,0,-1,104669,95331
2:1:5,1,1,104668,95332
2:6:1,1,1,104667,95333
2:5:2,2,2,104665,95335
4:1:3,0,-1,104666,95334
2:1:5,1,1,104665,95335
4:6:2,1,1,104664,95336
4:2:1,1,1,104663,95337
2:3:4,1,1,104662,95338
2:1:3,1,1,104661,95339
6:6:2,1,1,104660,95340
2:1:3,1,1,104659,95341
5:3:6,0,-1,104660,95340
5:5:2,1,1,104659,95341
1:1:4,0,-1,104660,95340
2:6:2,2,2,104658,95342
6:4:4,0,-1,104659,95341
3:5:3,0,-1,104660,95340
4:3:5,0,-1,104661,95339
1:1:3,0,-1,104662,95338
3:6:6,0,-1,104663,95337
4:1:6,0,-1,104664,95336
1:1:5,0,-1,104665,95335
2:6:5,1,1,104664,95336
3:6:1,0,-1,104665,95335
4:1:2,1,1,104664,95336
5:1:4,0,-1,104665,95335
2:2:4,2,2,104663,95337
1:3:2,1,1,104662,95338
4:3:2,1,1,104661,95339
3:3:1,0,-1,104662,95338
5:3:4,0,-1,104663,95337
3:3:4,0,-1,104664,95336
6:6:6,0,-1,104665,95335
1:5:4,0,-1,104666,95334
2:2:6,2,2,104664,95336
6:5:4,0,-1,104665,95335
4:6:4,0,-1,104666,95334
5:2:2,2,2,104664,95336
1:6:3,0,-1,104665,95335
1:2:4,1,1,104664,95336
2:3:5,1,1,104663,95337
6:5:3,0,-1,104664,95336
1:5:6,0,-1,104665,95335
6:5:4,0,-1,104666,95334
5:4:3,0,-1,104667,95333
4:5:6,0,-1,104668,95332
5:1:4,0,-1,104669,95331
2:3:4,1,1,104668,95332
5:3:6,0,-1,104669,95331
5:6:6,0,-1,104670,95330
1:2:4,1,1,104669,95331
6:4:2,1,1,104668,95332
6:6:6,0,-1,104669,95331
3:1:6,0,-1,104670,95330
3:6:3,0,-1,104671,95329
5:5:6,0,-1,104672,95328
5:3:6,0,-1,104673,95327
4:4:1,0,-1,104674,95326
6:3:1,0,-1,104675,95325
5:3:6,0,-1,104676,95324
6:1:3,0,-1,104677,95323
5:3:3,0,-1,104678,95322
3:1:5,0,-1,104679,95321
4:2:4,1,1,104678,95322
5:2:1,1,1,104677,95323
2:1:2,2,2,104675,95325
3:6:2,1,1,104674,95326
6:4:6,0,-1,104675,95325
5:6:3,0,-1,104676,95324
6:6:1,0,-1,104677,95323
2:1:1,1,1,104676,95324
5:6:5,0,-1,104677,95323
5:6:2,1,1,104676,95324
2:4:5,1,1,104675,95325
6:2:4,1,1,104674,95326
4:4:3,0,-1,104675,95325
5:2:4,1,1,104674,95326
6:3:2,1,1,104673,95327
2:1:2,2,2,104671,95329
1:4:3,0,-1,104672,95328
4:2:5,1,1,104671,95329
4:1:3,0,-1,104672,95328
2:3:2,2,2,104670,95330
2:2:3,2,2,104668,95332
5:4:5,0,-1,104669,95331
3:5:3,0,-1,104670,95330
1:2:6,1,1,104669,95331
6:6:5,0,-1,104670,95330
3:5:6,0,-1,104671,95329
4:5:6,0,-1,104672,95328
3:2:2,2,2,104670,95330
3:3:2,1,1,104669,95331
1:3:1,0,-1,104670,95330
6:4:2,1,1,104669,95331
3:3:1,0,-1,104670,95330
2:1:5,1,1,104669,95331
1:2:5,1,1,104668,95332
6:1:6,0,-1,104669,95331
5:4:6,0,-1,104670,95330
6:3:2,1,1,104669,95331
3:2:1,1,1,104668,95332
5:4:1,0,-1,104669,95331
3:2:4,1,1,104668,95332
6:4:2,1,1,104667,95333
4:2:1,1,1,104666,95334
1:6:3,0,-1,104667,95333
6:5:3,0,-1,104668,95332
5:2:6,1,1,104667,95333
1:1:3,0,-1,104668,95332
4:3:5,0,-1,104669,95331
3:5:3,0,-1,104670,95330
2:1:2,2,2,104668,95332
1:6:5,0,-1,104669,95331
2:4:1,1,1,104668,95332
3:2:2,2,2,104666,95334
6:4:2,1,1,104665,95335
2:3:5,1,1,104664,95336
6:1:6,0,-1,104665,95335
5:2:3,1,1,104664,95336
4:6:5,0,-1,104665,95335
3:1:3,0,-1,104666,95334
3:6:5,0,-1,104667,95333
4:3:4,0,-1,104668,95332
3:5:6,0,-1,104669,95331
5:1:3,0,-1,104670,95330
6:5:2,1,1,104669,95331
4:6:2,1,1,104668,95332
6:6:3,0,-1,104669,95331
3:1:6,0,-1,104670,95330
3:3:5,0,-1,104671,95329
6:5:4,0,-1,104672,95328
2:4:6,1,1,104671,95329
6:6:1,0,-1,104672,95328
3:5:1,0,-1,104673,95327
6:3:5,0,-1,104674,95326
6:5:3,0,-1,104675,95325
3:6:2,1,1,104674,95326
6:1:6,0,-1,104675,95325
6:4:1,0,-1,104676,95324
3:3:6,0,-1,104677,95323
5:3:5,0,-1,104678,95322
6:1:5,0,-1,104679,95321
6:1:6,0,-1,104680,95320
3:6:5,0,-1,104681,95319
5:1:4,0,-1,104682,95318
3:4:5,0,-1,104683,95317
5:4:5,0,-1,104684,95316
4:3:5,0,-1,104685,95315
6:6:1,0,-1,104686,95314
5:2:2,2,2,104684,95316
2:5:5,1,1,104683,95317
6:1:6,0,-1,104684,95316
5:6:6,0,-1,104685,95315
6:6:5,0,-1,104686,95314
3:3:4,0,-1,104687,95313
4:5:4,0,-1,104688,95312
5:5:5,0,-1,104689,95311
1:3:5,0,-1,104690,95310
6:4:4,0,-1,104691,95309
6:3:2,1,1,104690,95310
6:6:5,0,-1,104691,95309
4:4:2,1,1,104690,95310
5:1:2,1,1,104689,95311
4:4:5,0,-1,104690,95310
3:1:6,0,-1,104691,95309
6:4:1,0,-1,104692,95308
1:5:3,0,-1,104693,95307
5:4:6,0,-1,104694,95306
5:3:2,1,1,104693,95307
6:4:1,0,-1,104694,95306
1:5:4,0,-1,104695,95305
2:6:6,1,1,104694,95306
5:6:3,0,-1,104695,95305
5:4:5,0,-1,104696,95304
3:4:6,0,-1,104697,95303
2:1:5,1,1,104696,95304
6:6:3,0,-1,104697,95303
5:3:6,0,-1,104698,95302
3:4:3,0,-1,104699,95301
1:1:2,1,1,104698,95302
1:1:2,1,1,104697,95303
1:5:5,0,-1,104698,95302
3:5:2,1,1,104697,95303
4:1:2,1,1,104696,95304
2:4:4,1,1,104695,95305
3:2:2,2,2,104693,95307
3:1:5,0,-1,104694,95306
3:1:4,0,-1,104695,95305
1:2:3,1,1,104694,95306
4:4:3,0,-1,104695,95305
5:3:3,0,-1,104696,95304
6:1:6,0,-1,104697,95303
6:4:4,0,-1,104698,95302
3:6:4,0,-1,104699,95301
2:1:1,1,1,104698,95302
5:5:5,0,-1,104699,95301
2:3:2,2,2,104697,95303
1:6:3,0,-1,104698,95302
3:5:1,0,-1,104699,95301
6:1:5,0,-1,104700,95300
1:2:1,1,1,104699,95301
6:3:3,0,-1,104700,95300
4:1:2,1,1,104699,95301
2:2:5,2,2,104697,95303
6:6:4,0,-1,104698,95302
4:6:3,0,-1,104699,95301
1:1:3,0,-1,104700,95300
5:4:2,1,1,104699,95301
6:6:5,0,-1,104700,95300
3:2:3,1,1,104699,95301
6:6:3,0,-1,104700,95300
5:2:5,1,1,104699,95301
5:2:4,1,1,104698,95302
2:3:1,1,1,104697,95303
5:1:3,0,-1,104698,95302
4:1:6,0,-1,104699,95301
3:6:4,0,-1,104700,95300
6:5:2,1,1,104699,95301
4:3:6,0,-1,104700,95300
1:2:5,1,1,104699,95301
5:3:5,0,-1,104700,95300
4:6:4,0,-1,104701,95299
5:3:5,0,-1,104702,95298
1:1:4,0,-1,104703,95297
6:5:5,0,-1,104704,95296
6:4:2,1,1,104703,95297
2:4:6,1,1,104702,95298
1:2:6,1,1,104701,95299
6:2:3,1,1,104700,95300
6:4:2,1,1,104699,95301
5:1:2,1,1,104698,95302
6:3:1,0,-1,104699,95301
3:3:3,0,-1,104700,95300
4:1:3,0,-1,104701,95299
5:3:3,0,-1,104702,95298
5:5:2,1,1,104701,95299
1:3:2,1,1,104700,95300
1:6:6,0,-1,104701,95299
2:6:3,1,1,104700,95300
1:1:6,0,-1,104701,95299
1:1:1,0,-1,104702,95298
4:6:5,0,-1,104703,95297
2:5:5,1,1,104702,95298
3:3:3,0,-1,104703,95297
5:1:6,0,-1,104704,95296
5:3:4,0,-1,104705,95295
5:6:5,0,-1,104706,95294
4:2:6,1,1,104705,95295
1:4:2,1,1,104704,95296
1:1:6,0,-1,104705,95295
5:2:2,2,2,104703,95297
5:5:1,0,-1,104704,95296
5:2:5,1,1,104703,95297
4:2:3,1,1,104702,95298
2:2:1,2,2,104700,95300
1:3:3,0,-1,104701,95299
3:1:3,0,-1,104702,95298
2:1:4,1,1,104701,95299
6:5:5,0,-1,104702,95298
4:4:2,1,1,104701,95299
5:1:5,0,-1,104702,95298
5:3:5,0,-1,104703,95297
6:2:3,1,1,104702,95298
1:6:4,0,-1,104703,95297
6:4:6,0,-1,104704,95296
5:6:2,1,1,104703,95297
1:5:1,0,-1,104704,95296
3:6:5,0,-1,104705,95295
1:4:1,0,-1,104706,95294
1:2:4,1,1,104705,95295
3:3:6,0,-1,104706,95294
5:5:4,0,-1,104707,95293
2:6:4,1,1,104706,95294
1:2:5,1,1,104705,95295
2:1:5,1,1,104704,95296
4:2:5,1,1,104703,95297
4:1:5,0,-1,104704,95296
2:5:2,2,2,104702,95298
3:4:4,0,-1,104703,95297
6:1:6,0,-1,104704,95296
3:1:1,0,-1,104705,95295
5:5:3,0,-1,104706,95294
3:5:4,0,-1,104707,95293
6:5:6,0,-1,104708,95292
3:1:6,0,-1,104709,95291
4:1:6,0,-1,104710,95290
2:4:6,1,1,104709,95291
3:4:2,1,1,104708,95292
6:4:1,0,-1,104709,95291
5:5:5,0,-1,104710,95290
6:5:1,0,-1,104711,95289
5:2:2,2,2,104709,95291
6:1:3,0,-1,104710,95290
5:5:4,0,-1,104711,95289
5:6:5,0,-1,104712,95288
1:4:2,1,1,104711,95289
6:1:1,0,-1,104712,95288
1:2:5,1,1,104711,95289
4:5:3,0,-1,104712,95288
3:4:6,0,-1,104713,95287
2:6:5,1,1,104712,95288
4:2:2,2,2,104710,95290
4:1:2,1,1,104709,95291
3:6:5,0,-1,104710,95290
4:2:4,1,1,104709,95291
4:1:5,0,-1,104710,95290
6:1:1,0,-1,104711,95289
1:5:5,0,-1,104712,95288
4:2:2,2,2,104710,95290
3:6:4,0,-1,104711,95289
4:2:1,1,1,104710,95290
3:6:1,0,-1,104711,95289
1:3:6,0,-1,104712,95288
6:3:6,0,-1,104713,95287
4:4:6,0,-1,104714,95286
5:5:1,0,-1,104715,95285
5:2:5,1,1,104714,95286
5:3:2,1,1,104713,95287
4:6:2,1,1,104712,95288
3:2:5,1,1,104711,95289
1:1:6,0,-1,104712,95288
3:3:4,0,-1,104713,95287
5:2:5,1,1,104712,95288
5:2:1,1,1,104711,95289
2:5:4,1,1,104710,95290
5:4:1,0,-1,104711,95289
1:3:4,0,-1,104712,95288
5:1:4,0,-1,104713,95287
6:3:3,0,-1,104714,95286
4:4:6,0,-1,104715,95285
2:2:3,2,2,104713,95287
1:5:5,0,-1,104714,95286
1:3:5,0,-1,104715,95285
6:1:5,0,-1,104716,95284
6:4:6,0,-1,104717,95283
2:4:1,1,1,104716,95284
3:6:1,0,-1,104717,95283
5:4:3,0,-1,104718,95282
5:1:6,0,-1,104719,95281
3:5:6,0,-1,104720,95280
3:1:3,0,-1,104721,95279
5:3:2,1,1,104720,95280
6:2:6,1,1,104719,95281
6:3:1,0,-1,104720,95280
6:3:1,0,-1,104721,95279
1:1:1,0,-1,104722,95278
5:2:4,1,1,104721,95279
4:5:6,0,-1,104722,95278
2:6:3,1,1,104721,95279
1:1:3,0,-1,104722,95278
2:1:3,1,1,104721,95279
5:2:2,2,2,104719,95281
6:3:1,0,-1,104720,95280
2:1:4,1,1,104719,95281
5:3:1,0,-1,104720,95280
5:4:1,0,-1,104721,95279
3:1:1,0,-1,104722,95278
3:6:1,0,-1,104723,95277
4:2:3,1,1,104722,95278
3:3:1,0,-1,104723,95277
4:1:4,0,-1,104724,95276
6:4:6,0,-1,104725,95275
6:6:6,0,-1,104726,95274
6:2:1,1,1,104725,95275
1:4:4,0,-1,104726,95274
1:6:5,0,-1,104727,95273
5:5:6,0,-1,104728,95272
2:4:5,1,1,104727,95273
4:2:5,1,1,104726,95274
5:3:6,0,-1,104727,95273
1:4:2,1,1,104726,95274
1:6:5,0,-1,104727,95273
4:5:2,1,1,104726,95274
5:3:6,0,-1,104727,95273
6:6:3,0,-1,104728,95272
5:2:4,1,1,104727,95273
6:1:1,0,-1,104728,95272
1:4:2,1,1,104727,95273
1:3:3,0,-1,104728,95272
6:2:5,1,1,104727,95273
2:4:3,1,1,104726,95274
5:2:3,1,1,104725,95275
5:2:5,1,1,104724,95276
6:6:4,0,-1,104725,95275
6:5:5,0,-1,104726,95274
1:3:6,0,-1,104727,95273
4:6:2,1,1,104726,95274
4:6:5,0,-1,104727,95273
2:5:4,1,1,104726,95274
3:6:1,0,-1,104727,95273
5:3:2,1,1,104726,95274
4:5:2,1,1,104725,95275
3:5:1,0,-1,104726,95274
5:6:5,0,-1,104727,95273
2:6:1,1,1,104726,95274
5:6:4,0,-1,104727,95273
6:6:5,0,-1,104728,95272
3:4:4,0,-1,104729,95271
3:5:1,0,-1,104730,95270
6:6:6,0,-1,104731,95269
1:3:5,0,-1,104732,95268
4:2:4,1,1,104731,95269
5:1:4,0,-1,104732,95268
5:6:4,0,-1,104733,95267
2:3:5,1,1,104732,95268
2:3:4,1,1,104731,95269
3:1:4,0,-1,104732,95268
3:5:2,1,1,104731,95269
4:6:5,0,-1,104732,95268
2:2:1,2,2,104730,95270
1:5:4,0,-1,104731,95269
3:5:1,0,-1,104732,95268
1:1:3,0,-1,104733,95267
2:2:4,2,2,104731,95269
4:3:6,0,-1,104732,95268
6:2:4,1,1,104731,95269
4:2:6,1,1,104730,95270
2:3:3,1,1,104729,95271
3:6:1,0,-1,104730,95270
2:5:4,1,1,104729,95271
5:5:4,0,-1,104730,95270
1:3:3,0,-1,104731,95269
3:1:6,0,-1,104732,95268
6:5:6,0,-1,104733,95267
2:6:1,1,1,104732,95268
4:5:6,0,-1,104733,95267
4:2:2,2,2,104731,95269
1:4:2,1,1,104730,95270
2:3:5,1,1,104729,95271
4:3:1,0,-1,104730,95270
6:3:5,0,-1,104731,95269
5:1:5,0,-1,104732,95268
2:6:3,1,1,104731,95269
3:4:2,1,1,104730,95270
5:1:4,0,-1,104731,95269
2:5:5,1,1,104730,95270
4:6:4,0,-1,104731,95269
2:2:1,2,2,104729,95271
5:2:4,1,1,104728,95272
2:4:6,1,1,104727,95273
4:6:3,0,-1,104728,95272
1:4:5,0,-1,104729,95271
6:5:2,1,1,104728,95272
5:6:6,0,-1,104729,95271
1:3:5,0,-1,104730,95270
6:4:6,0,-1,104731,95269
6:3:2,1,1,104730,95270
4:2:1,1,1,104729,95271
1:1:4,0,-1,104730,95270
1:4:2,1,1,104729,95271
6:2:4,1,1,104728,95272
2:5:1,1,1,104727,95273
3:4:4,0,-1,104728,95272
6:6:6,0,-1,104729,95271
6:6:2,1,1,104728,95272
3:6:3,0,-1,104729,95271
2:2:4,2,2,104727,95273
2:5:6,1,1,104726,95274
5:3:5,0,-1,104727,95273
4:6:3,0,-1,104728,95272
1:2:6,1,1,104727,95273
5:1:6,0,-1,104728,95272
3:6:1,0,-1,104729,95271
1:5:3,0,-1,104730,95270
4:1:5,0,-1,104731,95269
4:3:4,0,-1,104732,95268
5:1:6,0,-1,104733,95267
4:1:2,1,1,104732,95268
2:1:4,1,1,104731,95269
3:3:3,0,-1,104732,95268
4:1:4,0,-1,104733,95267
1:1:4,0,-1,104734,95266
4:4:4,0,-1,104735,95265
3:5:2,1,1,104734,95266
4:6:6,0,-1,104735,95265
1:1:6,0,-1,104736,95264
3:5:5,0,-1,104737,95263
6:3:4,0,-1,104738,95262
2:4:5,1,1,104737,95263
1:1:3,0,-1,104738,95262
2:3:1,1,1,104737,95263
5:5:4,0,-1,104738,95262
4:2:4,1,1,104737,95263
5:3:2,1,1,104736,95264
3:2:6,1,1,104735,95265
5:3:2,1,1,104734,95266
5:5:2,1,1,104733,95267
1:6:1,0,-1,104734,95266
4:4:2,1,1,104733,95267
3:1:1,0,-1,104734,95266
4:5:6,0,-1,104735,95265
4:6:2,1,1,104734,95266
3:5:1,0,-1,104735,95265
4:2:5,1,1,104734,95266
4:5:3,0,-1,104735,95265
5:2:5,1,1,104734,95266
5:4:4,0,-1,104735,95265
1:2:4,1,1,104734,95266
3:4:6,0,-1,104735,95265
2:2:1,2,2,104733,95267
1:3:5,0,-1,104734,95266
5:2:2,2,2,104732,95268
5:6:6,0,-1,104733,95267
5:5:1,0,-1,104734,95266
2:1:4,1,1,104733,95267
5:1:3,0,-1,104734,95266
6:5:2,1,1,104733,95267
4:2:2,2,2,104731,95269
2:5:4,1,1,104730,95270
1:6:6,0,-1,104731,95269
1:6:2,1,1,104730,95270
4:6:5,0,-1,104731,95269
4:2:4,1,1,104730,95270
4:4:6,0,-1,104731,95269
5:4:5,0,-1,104732,95268
5:1:6,0,-1,104733,95267
6:1:6,0,-1,104734,95266
5:3:6,0,-1,104735,95265
2:1:5,1,1,104734,95266
3:5:4,0,-1,104735,95265
5:5:5,0,-1,104736,95264
2:4:3,1,1,104735,95265
4:4:5,0,-1,104736,95264
2:4:5,1,1,104735,95265
2:4:4,1,1,104734,95266
2:5:3,1,1,104733,95267
1:3:3,0,-1,104734,95266
3:6:5,0,-1,104735,95265
1:3:4,0,-1,104736,95264
1:5:6,0,-1,104737,95263
5:4:5,0,-1,104738,95262
6:2:2,2,2,104736,95264
4:1:1,0,-1,104737,95263
3:6:5,0,-1,104738,95262
5:4:5,0,-1,104739,95261
5:4:6,0,-1,104740,95260
6:2:2,2,2,104738,95262
5:3:3,0,-1,104739,95261
6:2:3,1,1,104738,95262
6:2:1,1,1,104737,95263
1:5:1,0,-1,104738,95262
6:6:1,0,-1,104739,95261
2:1:1,1,1,104738,95262
1:5:6,0,-1,104739,95261
1:4:6,0,-1,104740,95260
2:1:1,1,1,104739,95261
2:1:3,1,1,104738,95262
6:2:4,1,1,104737,95263
1:3:6,0,-1,104738,95262
5:6:2,1,1,104737,95263
2:2:2,3,3,104734,95266
5:3:5,0,-1,104735,95265
6:5:6,0,-1,104736,95264
5:2:2,2,2,104734,95266
1:5:4,0,-1,104735,95265
6:2:5,1,1,104734,95266
1:4:3,0,-1,104735,95265
3:2:2,2,2,104733,95267
4:6:3,0,-1,104734,95266
6:6:2,1,1,104733,95267
2:2:3,2,2,104731,95269
2:1:1,1,1,104730,95270
6:1:2,1,1,104729,95271
4:5:1,0,-1,104730,95270
6:1:6,0,-1,104731,95269
3:3:1,0,-1,104732,95268
6:5:1,0,-1,104733,95267
6:3:6,0,-1,104734,95266
6:4:5,0,-1,104735,95265
6:3:5,0,-1,104736,95264
2:1:5,1,1,104735,95265
1:3:6,0,-1,104736,95264
1:5:4,0,-1,104737,95263
4:1:4,0,-1,104738,95262
1:4:4,0,-1,104739,95261
4:1:2,1,1,104738,95262
6:3:4,0,-1,104739,95261
4:3:3,0,-1,104740,95260
6:5:2,1,1,104739,95261
1:5:1,0,-1,104740,95260
2:4:6,1,1,104739,95261
2:4:6,1,1,104738,95262
3:4:4,0,-1,104739,95261
2:3:2,2,2,104737,95263
6:4:3,0,-1,104738,95262
5:4:6,0,-1,104739,95261
1:5:6,0,-1,104740,95260
1:1:1,0,-1,104741,95259
2:3:6,1,1,104740,95260
5:2:3,1,1,104739,95261
3:6:2,1,1,104738,95262
2:5:3,1,1,104737,95263
5:5:1,0,-1,104738,95262
2:6:5,1,1,104737,95263
1:2:3,1,1,104736,95264
3:6:5,0,-1,104737,95263
3:2:3,1,1,104736,95264
6:1:1,0,-1,104737,95263
3:5:4,0,-1,104738,95262
6:6:3,0,-1,104739,95261
1:4:5,0,-1,104740,95260
5:2:6,1,1,104739,95261
5:2:2,2,2,104737,95263
4:1:2,1,1,104736,95264
1:3:4,0,-1,104737,95263
3:6:1,0,-1,104738,95262
5:5:5,0,-1,104739,95261
5:5:2,1,1,104738,95262
1:5:4,0,-1,104739,95261
1:5:4,0,-1,104740,95260
5:6:5,0,-1,104741,95259
3:3:5,0,-1,104742,95258
6:3:4,0,-1,104743,95257
2:4:5,1,1,104742,95258
6:5:4,0,-1,104743,95257
2:5:6,1,1,104742,95258
5:2:3,1,1,104741,95259
5:2:2,2,2,104739,95261
5:4:2,1,1,104738,95262
3:2:4,1,1,104737,95263
4:1:6,0,-1,104738,95262
4:2:4,1,1,104737,95263
4:6:4,0,-1,104738,95262
3:4:1,0,-1,104739,95261
1:1:3,0,-1,104740,95260
3:3:2,1,1,104739,95261
2:1:3,1,1,104738,95262
6:4:6,0,-1,104739,95261
4:5:2,1,1,104738,95262
1:1:4,0,-1,104739,95261
4:4:6,0,-1,104740,95260
5:4:4,0,-1,104741,95259
2:3:3,1,1,104740,95260
5:6:1,0,-1,104741,95259
5:3:6,0,-1,104742,95258
3:2:2,2,2,104740,95260
6:4:3,0,-1,104741,95259
1:4:3,0,-1,104742,95258
3:5:6,0,-1,104743,95257
6:4:6,0,-1,104744,95256
2:2:6,2,2,104742,95258
4:6:1,0,-1,104743,95257
2:6:5,1,1,104742,95258
3:4:6,0,-1,104743,95257
2:2:4,2,2,104741,95259
2:5:5,1,1,104740,95260
3:6:4,0,-1,104741,95259
3:4:1,0,-1,104742,95258
5:5:6,0,-1,104743,95257
4:3:3,0,-1,104744,95256
1:4:5,0,-1,104745,95255
4:3:1,0,-1,104746,95254
6:5:3,0,-1,104747,95253
4:2:4,1,1,104746,95254
5:2:6,1,1,104745,95255
3:1:1,0,-1,104746,95254
3:2:5,1,1,104745,95255
6:1:6,0,-1,104746,95254
6:6:6,0,-1,104747,95253
1:2:6,1,1,104746,95254
1:4:1,0,-1,104747,95253
2:3:5,1,1,104746,95254
1:6:2,1,1,104745,95255
4:3:4,0,-1,104746,95254
5:1:2,1,1,104745,95255
1:6:1,0,-1,104746,95254
3:1:5,0,-1,104747,95253
2:2:5,2,2,104745,95255
2:4:6,1,1,104744,95256
1:2:4,1,1,104743,95257
4:4:1,0,-1,104744,95256
2:2:5,2,2,104742,95258
4:4:6,0,-1,104743,95257
3:1:5,0,-1,104744,95256
1:3:2,1,1,104743,95257
1:2:5,1,1,104742,95258
4:5:3,0,-1,104743,95257
4:5:5,0,-1,104744,95256
5:3:3,0,-1,104745,95255
6:4:3,0,-1,104746,95254
6:6:3,0,-1,104747,95253
6:4:4,0,-1,104748,95252
1:5:5,0,-1,104749,95251
6:1:3,0,-1,104750,95250
1:5:2,1,1,104749,95251
5:1:5,0,-1,104750,95250
3:6:2,1,1,104749,95251
5:4:4,0,-1,104750,95250
6:2:5,1,1,104749,95251
4:3:4,0,-1,104750,95250
1:2:6,1,1,104749,95251
2:5:1,1,1,104748,95252
5:5:6,0,-1,104749,95251
5:1:4,0,-1,104750,95250
6:3:2,1,1,104749,95251
1:6:1,0,-1,104750,95250
6:1:5,0,-1,104751,95249
4:4:5,0,-1,104752,95248
6:3:6,0,-1,104753,95247
6:6:4,0,-1,104754,95246
3:2:5,1,1,104753,95247
1:4:6,0,-1,104754,95246
4:4:3,0,-1,104755,95245
6:3:3,0,-1,104756,95244
1:6:3,0,-1,104757,95243
4:6:4,0,-1,104758,95242
5:2:1,1,1,104757,95243
1:6:4,0,-1,104758,95242
6:6:5,0,-1,104759,95241
5:3:3,0,-1,104760,95240
4:1:1,0,-1,104761,95239
1:5:5,0,-1,104762,95238
1:5:3,0,-1,104763,95237
2:6:3,1,1,104762,95238
6:2:2,2,2,104760,95240
1:4:1,0,-1,104761,95239
6:1:4,0,-1,104762,95238
4:6:4,0,-1,104763,95237
1:4:1,0,-1,104764,95236
4:3:3,0,-1,104765,95235
5:3:2,1,1,104764,95236
4:2:5,1,1,104763,95237
3:1:1,0,-1,104764,95236
1:5:5,0,-1,104765,95235
3:3:1,0,-1,104766,95234
2:1:3,1,1,104765,95235
1:2:2,2,2,104763,95237
2:5:2,2,2,104761,95239
3:4:2,1,1,104760,95240
3:3:6,0,-1,104761,95239
5:1:4,0,-1,104762,95238
4:2:4,1,1,104761,95239
5:2:6,1,1,104760,95240
1:5:6,0,-1,104761,95239
3:3:2,1,1,104760,95240
4:6:3,0,-1,104761,95239
2:5:1,1,1,104760,95240
6:2:3,1,1,104759,95241
4:6:5,0,-1,104760,95240
4:3:3,0,-1,104761,95239
1:3:2,1,1,104760,95240
5:6:6,0,-1,104761,95239
2:4:6,1,1,104760,95240
3:1:4,0,-1,104761,95239
3:6:5,0,-1,104762,95238
6:4:1,0,-1,104763,95237
5:4:2,1,1,104762,95238
6:6:5,0,-1,104763,95237
1:6:4,0,-1,104764,95236
3:6:1,0,-1,104765,95235
3:6:1,0,-1,104766,95234
6:4:1,0,-1,104767,95233
5:4:3,0,-1,104768,95232
3:1:2,1,1,104767,95233
4:3:6,0,-1,104768,95232
4:2:4,1,1,104767,95233
6:5:6,0,-1,104768,95232
4:3:4,0,-1,104769,95231
1:6:5,0,-1,104770,95230
2:5:4,1,1,104769,95231
2:3:5,1,1,104768,95232
4:3:1,0,-1,104769,95231
6:3:1,0,-1,104770,95230
3:2:4,1,1,104769,95231
2:5:5,1,1,104768,95232
3:6:2,1,1,104767,95233
2:2:1,2,2,104765,95235
3:3:1,0,-1,104766,95234
2:1:3,1,1,104765,95235
3:2:1,1,1,104764,95236
2:3:4,1,1,104763,95237
2:2:3,2,2,104761,95239
3:1:6,0,-1,104762,95238
4:1:2,1,1,104761,95239
1:4:1,0,-1,104762,95238
2:6:2,2,2,104760,95240
4:2:3,1,1,104759,95241
5:2:3,1,1,104758,95242
1:2:5,1,1,104757,95243
3:4:3,0,-1,104758,95242
3:6:3,0,-1,104759,95241
6:5:1,0,-1,104760,95240
5:1:2,1,1,104759,95241
1:2:2,2,2,104757,95243
6:6:1,0,-1,104758,95242
3:5:6,0,-1,104759,95241
2:1:2,2,2,104757,95243
5:6:4,0,-1,104758,95242
1:6:1,0,-1,104759,95241
3:1:3,0,-1,104760,95240
4:3:5,0,-1,104761,95239
2:1:5,1,1,104760,95240
4:1:3,0,-1,104761,95239
2:4:5,1,1,104760,95240
6:4:2,1,1,104759,95241
4:6:2,1,1,104758,95242
4:4:2,1,1,104757,95243
3:3:4,0,-1,104758,95242
5:6:2,1,1,104757,95243
4:4:1,0,-1,104758,95242
2:4:4,1,1,104757,95243
5:4:5,0,-1,104758,95242
2:2:2,3,3,104755,95245
1:5:4,0,-1,104756,95244
4:4:6,0,-1,104757,95243
5:1:3,0,-1,104758,95242
1:1:5,0,-1,104759,95241
6:1:1,0,-1,104760,95240
4:5:6,0,-1,104761,95239
3:2:3,1,1,104760,95240
5:3:1,0,-1,104761,95239
5:4:4,0,-1,104762,95238
6:3:4,0,-1,104763,95237
5:1:3,0,-1,104764,95236
3:5:6,0,-1,104765,95235
2:4:5,1,1,104764,95236
6:5:1,0,-1,104765,95235
6:5:3,0,-1,104766,95234
6:3:6,0,-1,104767,95233
3:2:1,1,1,104766,95234
1:2:5,1,1,104765,95235
6:4:1,0,-1,104766,95234
3:4:1,0,-1,104767,95233
3:1:2,1,1,104766,95234
2:3:4,1,1,104765,95235
6:6:5,0,-1,104766,95234
5:2:4,1,1,104765,95235
1:3:4,0,-1,104766,95234
4:4:3,0,-1,104767,95233
4:6:1,0,-1,104768,95232
1:4:1,0,-1,104769,95231
3:3:1,0,-1,104770,95230
6:3:1,0,-1,104771,95229
2:3:6,1,1,104770,95230
3:4:4,0,-1,104771,95229
2:1:5,1,1,104770,95230
5:5:4,0,-1,104771,95229
4:6:5,0,-1,104772,95228
6:3:5,0,-1,104773,95227
3:3:4,0,-1,104774,95226
3:2:1,1,1,104773,95227
4:2:6,1,1,104772,95228
2:5:3,1,1,104771,95229
4:1:6,0,-1,104772,95228
4:4:1,0,-1,104773,95227
5:5:6,0,-1,104774,95226
5:4:3,0,-1,104775,95225
3:5:4,0,-1,104776,95224
1:5:3,0,-1,104777,95223
3:5:4,0,-1,104778,95222
1:2:5,1,1,104777,95223
1:1:1,0,-1,104778,95222
3:5:1,0,-1,104779,95221
2:3:4,1,1,104778,95222
3:2:2,2,2,104776,95224
6:2:2,2,2,104774,95226
4:2:1,1,1,104773,95227
5:3:4,0,-1,104774,95226
3:1:5,0,-1,104775,95225
3:3:6,0,-1,104776,95224
5:5:2,1,1,104775,95225
5:1:5,0,-1,104776,95224
1:1:3,0,-1,104777,95223
1:5:5,0,-1,104778,95222
5:3:4,0,-1,104779,95221
4:5:4,0,-1,104780,95220
6:5:2,1,1,104779,95221
1:2:3,1,1,104778,95222
3:2:4,1,1,104777,95223
4:3:1,0,-1,104778,95222
2:4:4,1,1,104777,95223
5:2:5,1,1,104776,95224
5:4:6,0,-1,104777,95223
3:1:2,1,1,104776,95224
3:2:5,1,1,104775,95225
5:2:3,1,1,104774,95226
6:1:2,1,1,104773,95227
1:4:3,0,-1,104774,95226
4:4:6,0,-1,104775,95225
6:2:4,1,1,104774,95226
5:3:2,1,1,104773,95227
3:2:3,1,1,104772,95228
3:1:3,0,-1,104773,95227
6:3:3,0,-1,104774,95226
6:5:2,1,1,104773,95227
5:3:6,0,-1,104774,95226
6:2:2,2,2,104772,95228
5:2:3,1,1,104771,95229
1:1:4,0,-1,104772,95228
4:1:5,0,-1,104773,95227
3:2:3,1,1,104772,95228
5:5:3,0,-1,104773,95227
5:2:5,1,1,104772,95228
6:2:3,1,1,104771,95229
2:1:5,1,1,104770,95230
6:2:2,2,2,104768,95232
2:5:3,1,1,104767,95233
1:5:3,0,-1,104768,95232
2:3:2,2,2,104766,95234
6:3:1,0,-1,104767,95233
2:3:3,1,1,104766,95234
5:6:6,0,-1,104767,95233
6:4:6,0,-1,104768,95232
6:6:3,0,-1,104769,95231
3:5:5,0,-1,104770,95230
4:4:2,1,1,104769,95231
2:1:6,1,1,104768,95232
6:6:1,0,-1,104769,95231
4:2:2,2,2,104767,95233
5:1:5,0,-1,104768,95232
6:4:5,0,-1,104769,95231
4:5:1,0,-1,104770,95230
6:2:3,1,1,104769,95231
6:3:1,0,-1,104770,95230
3:5:6,0,-1,104771,95229
1:3:3,0,-1,104772,95228
6:4:6,0,-1,104773,95227
4:3:2,1,1,104772,95228
4:2:3,1,1,104771,95229
4:4:2,1,1,104770,95230
4:1:5,0,-1,104771,95229
4:2:5,1,1,104770,95230
1:1:2,1,1,104769,95231
1:3:3,0,-1,104770,95230
1:6:4,0,-1,104771,95229
1:5:4,0,-1,104772,95228
1:5:3,0,-1,104773,95227
1:4:5,0,-1,104774,95226
6:5:2,1,1,104773,95227
2:6:2,2,2,104771,95229
6:5:5,0,-1,104772,95228
5:4:2,1,1,104771,95229
3:5:2,1,1,104770,95230
6:5:3,0,-1,104771,95229
6:5:2,1,1,104770,95230
4:3:1,0,-1,104771,95229
3:1:4,0,-1,104772,95228
3:3:4,0,-1,104773,95227
5:3:3,0,-1,104774,95226
1:4:4,0,-1,104775,95225
2:4:3,1,1,104774,95226
3:6:2,1,1,104773,95227
6:1:2,1,1,104772,95228
3:1:5,0,-1,104773,95227
3:1:3,0,-1,104774,95226
2:5:3,1,1,104773,95227
5:5:6,0,-1,104774,95226
6:6:3,0,-1,104775,95225
2:1:4,1,1,104774,95226
4:2:6,1,1,104773,95227
4:4:2,1,1,104772,95228
5:5:6,0,-1,104773,95227
6:2:3,1,1,104772,95228
3:3:5,0,-1,104773,95227
3:1:3,0,-1,104774,95226
5:4:1,0,-1,104775,95225
3:1:6,0,-1,104776,95224
4:2:3,1,1,104775,95225
4:5:6,0,-1,104776,95224
4:4:1,0,-1,104777,95223
2:1:2,2,2,104775,95225
6:3:1,0,-1,104776,95224
1:3:3,0,-1,104777,95223
4:5:6,0,-1,104778,95222
2:2:2,3,3,104775,95225
5:3:1,0,-1,104776,95224
2:4:3,1,1,104775,95225
5:5:3,0,-1,104776,95224
2:6:4,1,1,104775,95225
5:1:2,1,1,104774,95226
6:1:3,0,-1,104775,95225
5:6:5,0,-1,104776,95224
5:5:4,0,-1,104777,95223
3:6:6,0,-1,104778,95222
2:4:4,1,1,104777,95223
5:6:3,0,-1,104778,95222
3:4:6,0,-1,104779,95221
5:1:3,0,-1,104780,95220
4:4:5,0,-1,104781,95219
3:6:4,0,-1,104782,95218
5:6:6,0,-1,104783,95217
4:1:2,1,1,104782,95218
5:2:5,1,1,104781,95219
2:6:6,1,1,104780,95220
2:1:3,1,1,104779,95221
6:1:4,0,-1,104780,95220
6:2:3,1,1,104779,95221
1:2:2,2,2,104777,95223
6:6:4,0,-1,104778,95222
3:2:5,1,1,104777,95223
5:6:1,0,-1,104778,95222
6:5:4,0,-1,104779,95221
4:1:1,0,-1,104780,95220
4:6:6,0,-1,104781,95219
1:4:4,0,-1,104782,95218
3:2:1,1,1,104781,95219
6:4:6,0,-1,104782,95218
4:1:1,0,-1,104783,95217
2:3:4,1,1,104782,95218
4:6:2,1,1,104781,95219
2:3:6,1,1,104780,95220
5:5:1,0,-1,104781,95219
4:5:2,1,1,104780,95220
5:5:1,0,-1,104781,95219
4:3:5,0,-1,104782,95218
6:3:1,0,-1,104783,95217
3:3:5,0,-1,104784,95216
5:4:3,0,-1,104785,95215
4:4:5,0,-1,104786,95214
2:1:1,1,1,104785,95215
6:4:6,0,-1,104786,95214
1:1:4,0,-1,104787,95213
1:5:1,0,-1,104788,95212
1:1:6,0,-1,104789,95211
6:5:2,1,1,104788,95212
2:3:2,2,2,104786,95214
3:1:3,0,-1,104787,95213
5:1:1,0,-1,104788,95212
5:4:2,1,1,104787,95213
5:5:1,0,-1,104788,95212
6:3:5,0,-1,104789,95211
2:4:1,1,1,104788,95212
5:3:6,0,-1,104789,95211
1:3:1,0,-1,104790,95210
1:5:2,1,1,104789,95211
6:6:4,0,-1,104790,95210
4:2:3,1,1,104789,95211
6:1:4,0,-1,104790,95210
2:5:4,1,1,104789,95211
4:4:3,0,-1,104790,95210
4:5:5,0,-1,104791,95209
6:4:1,0,-1,104792,95208
3:3:2,1,1,104791,95209
4:6:2,1,1,104790,95210
6:6:3,0,-1,104791,95209
3:5:1,0,-1,104792,95208
1:4:4,0,-1,104793,95207
2:6:1,1,1,104792,95208
4:5:5,0,-1,104793,95207
3:4:3,0,-1,104794,95206
4:4:6,0,-1,104795,95205
1:1:3,0,-1,104796,95204
3:5:5,0,-1,104797,95203
4:1:5,0,-1,104798,95202
5:2:1,1,1,104797,95203
6:1:3,0,-1,104798,95202
4:4:1,0,-1,104799,95201
3:6:3,0,-1,104800,95200
4:2:4,1,1,104799,95201
4:1:2,1,1,104798,95202
6:1:4,0,-1,104799,95201
3:4:3,0,-1,104800,95200
6:4:6,0,-1,104801,95199
2:2:5,2,2,104799,95201
4:6:2,1,1,104798,95202
4:4:2,1,1,104797,95203
1:1:1,0,-1,104798,95202
3:3:3,0,-1,104799,95201
4:3:6,0,-1,104800,95200
2:4:1,1,1,104799,95201
5:4:6,0,-1,104800,95200
2:1:5,1,1,104799,95201
5:2:2,2,2,104797,95203
2:1:3,1,1,104796,95204
2:1:6,1,1,104795,95205
5:6:3,0,-1,104796,95204
5:3:5,0,-1,104797,95203
3:4:5,0,-1,104798,95202
6:1:6,0,-1,104799,95201
4:1:5,0,-1,104800,95200
6:3:4,0,-1,104801,95199
5:5:3,0,-1,104802,95198
5:5:6,0,-1,104803,95197
2:4:4,1,1,104802,95198
4:2:1,1,1,104801,95199
2:4:5,1,1,104800,95200
2:4:6,1,1,104799,95201
3:2:6,1,1,104798,95202
3:5:5,0,-1,104799,95201
5:5:3,0,-1,104800,95200
1:2:6,1,1,104799,95201
6:6:3,0,-1,104800,95200
4:2:1,1,1,104799,95201
1:6:3,0,-1,104800,95200
2:1:5,1,1,104799,95201
6:6:3,0,-1,104800,95200
6:6:2,1,1,104799,95201
1:6:3,0,-1,104800,95200
5:6:2,1,1,104799,95201
6:6:2,1,1,104798,95202
4:4:1,0,-1,104799,95201
3:1:4,0,-1,104800,95200
1:6:5,0,-1,104801,95199
1:1:1,0,-1,104802,95198
5:2:4,1,1,104801,95199
1:3:6,0,-1,104802,95198
6:1:1,0,-1,104803,95197
4:4:6,0,-1,104804,95196
2:6:6,1,1,104803,95197
2:1:2,2,2,104801,95199
3:4:1,0,-1,104802,95198
2:3:3,1,1,104801,95199
1:4:1,0,-1,104802,95198
5:6:3,0,-1,104803,95197
6:6:5,0,-1,104804,95196
3:6:2,1,1,104803,95197
3:4:2,1,1,104802,95198
3:5:6,0,-1,104803,95197
6:2:3,1,1,104802,95198
5:2:2,2,2,104800,95200
5:4:2,1,1,104799,95201
1:4:2,1,1,104798,95202
2:2:2,3,3,104795,95205
6:4:2,1,1,104794,95206
2:5:4,1,1,104793,95207
3:5:5,0,-1,104794,95206
2:6:4,1,1,104793,95207
4:5:2,1,1,104792,95208
5:1:5,0,-1,104793,95207
4:3:6,0,-1,104794,95206
2:4:2,2,2,104792,95208
4:2:3,1,1,104791,95209
3:3:2,1,1,104790,95210
2:4:2,2,2,104788,95212
4:6:5,0,-1,104789,95211
4:2:1,1,1,104788,95212
2:4:4,1,1,104787,95213
4:3:1,0,-1,104788,95212
3:6:3,0,-1,104789,95211
2:5:4,1,1,104788,95212
1:3:5,0,-1,104789,95211
1:2:5,1,1,104788,95212
3:4:4,0,-1,104789,95211
2:6:3,1,1,104788,95212
1:3:4,0,-1,104789,95211
3:4:3,0,-1,104790,95210
5:1:6,0,-1,104791,95209
6:6:4,0,-1,104792,95208
1:1:6,0,-1,104793,95207
3:2:3,1,1,104792,95208
2:4:3,1,1,104791,95209
6:4:5,0,-1,104792,95208
2:6:6,1,1,104791,95209
5:4:1,0,-1,104792,95208
5:1:5,0,-1,104793,95207
5:6:5,0,-1,104794,95206
4:4:5,0,-1,104795,95205
6:5:6,0,-1,104796,95204
3:4:6,0,-1,104797,95203
6:3:5,0,-1,104798,95202
1:6:5,0,-1,104799,95201
2:3:2,2,2,104797,95203
3:3:5,0,-1,104798,95202
1:1:5,0,-1,104799,95201
1:4:4,0,-1,104800,95200
6:3:6,0,-1,104801,95199
2:6:1,1,1,104800,95200
1:1:5,0,-1,104801,95199
6:5:3,0,-1,104802,95198
3:4:2,1,1,104801,95199
4:5:5,0,-1,104802,95198
2:5:6,1,1,104801,95199
1:1:4,0,-1,104802,95198
5:1:2,1,1,104801,95199
3:1:3,0,-1,104802,95198
6:5:5,0,-1,104803,95197
4:4:2,1,1,104802,95198
1:2:5,1,1,104801,95199
6:2:4,1,1,104800,95200
5:5:4,0,-1,104801,95199
5:2:3,1,1,104800,95200
6:2:4,1,1,104799,95201
3:2:6,1,1,104798,95202
6:1:1,0,-1,104799,95201
4:5:5,0,-1,104800,95200
2:6:2,2,2,104798,95202
5:4:6,0,-1,104799,95201
4:6:5,0,-1,104800,95200
4:5:4,0,-1,104801,95199
5:5:3,0,-1,104802,95198
1:6:5,0,-1,104803,95197
1:4:3,0,-1,104804,95196
4:2:4,1,1,104803,95197
5:3:5,0,-1,104804,95196
5:5:3,0,-1,104805,95195
3:3:3,0,-1,104806,95194
1:4:1,0,-1,104807,95193
6:4:4,0,-1,104808,95192
2:5:3,1,1,104807,95193
6:2:4,1,1,104806,95194
3:3:1,0,-1,104807,95193
4:2:6,1,1,104806,95194
6:4:4,0,-1,104807,95193
3:5:4,0,-1,104808,95192
3:6:1,0,-1,104809,95191
3:4:3,0,-1,104810,95190
1:3:1,0,-1,104811,95189
2:2:2,3,3,104808,95192
6:3:5,0,-1,104809,95191
6:1:5,0,-1,104810,95190
3:1:1,0,-1,104811,95189
5:4:2,1,1,104810,95190
2:1:6,1,1,104809,95191
5:1:5,0,-1,104810,95190
2:2:3,2,2,104808,95192
3:4:2,1,1,104807,95193
1:1:6,0,-1,104808,95192
5:6:6,0,-1,104809,95191
5:1:5,0,-1,104810,95190
6:3:1,0,-1,104811,95189
6:3:5,0,-1,104812,95188
3:5:5,0,-1,104813,95187
2:6:6,1,1,104812,95188
6:6:4,0,-1,104813,95187
4:4:3,0,-1,104814,95186
5:2:3,1,1,104813,95187
2:1:2,2,2,104811,95189
6:3:4,0,-1,104812,95188
4:1:4,0,-1,104813,95187
5:5:4,0,-1,104814,95186
1:6:5,0,-1,104815,95185
5:3:2,1,1,104814,95186
4:3:1,0,-1,104815,95185
1:1:2,1,1,104814,95186
4:3:5,0,-1,104815,95185
6:1:5,0,-1,104816,95184
3:2:3,1,1,104815,95185
4:4:5,0,-1,104816,95184
1:1:6,0,-1,104817,95183
1:3:5,0,-1,104818,95182
1:5:4,0,-1,104819,95181
6:1:6,0,-1,104820,95180
3:6:1,0,-1,104821,95179
3:6:1,0,-1,104822,95178
2:6:6,1,1,104821,95179
2:6:3,1,1,104820,95180
3:6:4,0,-1,104821,95179
4:5:3,0,-1,104822,95178
3:4:4,0,-1,104823,95177
4:1:1,0,-1,104824,95176
2:3:5,1,1,104823,95177
2:1:1,1,1,104822,95178
1:1:3,0,-1,104823,95177
2:3:4,1,1,104822,95178
5:1:4,0,-1,104823,95177
2:2:5,2,2,104821,95179
4:3:2,1,1,104820,95180
5:3:5,0,-1,104821,95179
4:3:1,0,-1,104822,95178
1:2:5,1,1,104821,95179
1:6:2,1,1,104820,95180
5:1:2,1,1,104819,95181
5:1:1,0,-1,104820,95180
4:1:5,0,-1,104821,95179
1:4:1,0,-1,104822,95178
4:6:6,0,-1,104823,95177
1:4:3,0,-1,104824,95176
4:3:5,0,-1,104825,95175
3:6:3,0,-1,104826,95174
6:3:5,0,-1,104827,95173
1:4:1,0,-1,104828,95172
5:6:2,1,1,104827,95173
3:5:1,0,-1,104828,95172
3:6:5,0,-1,104829,95171
6:6:2,1,1,104828,95172
5:6:1,0,-1,104829,95171
1:2:2,2,2,104827,95173
1:3:2,1,1,104826,95174
6:6:5,0,-1,104827,95173
1:6:5,0,-1,104828,95172
2:6:5,1,1,104827,95173
4:2:2,2,2,104825,95175
4:6:5,0,-1,104826,95174
6:3:1,0,-1,104827,95173
6:2:5,1,1,104826,95174
6:2:2,2,2,104824,95176
2:1:1,1,1,104823,95177
4:4:3,0,-1,104824,95176
3:6:5,0,-1,104825,95175
1:1:4,0,-1,104826,95174
2:3:3,1,1,104825,95175
6:5:3,0,-1,104826,95174
2:2:3,2,2,104824,95176
3:1:2,1,1,104823,95177
6:4:3,0,-1,104824,95176
5:1:2,1,1,104823,95177
4:6:6,0,-1,104824,95176
6:1:4,0,-1,104825,95175
2:5:2,2,2,104823,95177
5:4:6,0,-1,104824,95176
5:1:3,0,-1,104825,95175
1:5:1,0,-1,104826,95174
1:3:3,0,-1,104827,95173
6:4:3,0,-1,104828,95172
4:1:2,1,1,104827,95173
5:3:4,0,-1,104828,95172
4:5:3,0,-1,104829,95171
1:2:4,1,1,104828,95172
1:1:3,0,-1,104829,95171
4:4:4,0,-1,104830,95170
6:5:4,0,-1,104831,95169
4:4:1,0,-1,104832,95168
5:2:2,2,2,104830,95170
3:5:3,0,-1,104831,95169
2:4:6,1,1,104830,95170
4:5:2,1,1,104829,95171
3:4:4,0,-1,104830,95170
6:6:2,1,1,104829,95171
6:3:2,1,1,104828,95172
3:3:3,0,-1,104829,95171
3:4:1,0,-1,104830,95170
5:3:2,1,1,104829,95171
1:1:1,0,-1,104830,95170
6:4:4,0,-1,104831,95169
2:1:3,1,1,104830,95170
1:5:5,0,-1,104831,95169
1:6:3,0,-1,104832,95168
6:6:4,0,-1,104833,95167
5:4:3,0,-1,104834,95166
4:6:1,0,-1,104835,95165
4:4:6,0,-1,104836,95164
5:4:5,0,-1,104837,95163
6:6:6,0,-1,104838,95162
3:6:3,0,-1,104839,95161
4:1:6,0,-1,104840,95160
6:2:4,1,1,104839,95161
6:1:4,0,-1,104840,95160
3:3:3,0,-1,104841,95159
5:6:5,0,-1,104842,95158
4:4:2,1,1,104841,95159
3:2:2,2,2,104839,95161
4:1:6,0,-1,104840,95160
2:6:2,2,2,104838,95162
2:4:3,1,1,104837,95163
5:6:5,0,-1,104838,95162
5:3:3,0,-1,104839,95161
1:5:2,1,1,104838,95162
2:2:3,2,2,104836,95164
1:2:6,1,1,104835,95165
4:2:4,1,1,104834,95166
6:6:3,0,-1,104835,95165
6:2:3,1,1,104834,95166
1:5:6,0,-1,104835,95165
2:4:5,1,1,104834,95166
6:5:3,0,-1,104835,95165
5:4:2,1,1,104834,95166
6:4:6,0,-1,104835,95165
2:6:5,1,1,104834,95166
2:2:1,2,2,104832,95168
2:6:2,2,2,104830,95170
2:3:3,1,1,104829,95171
4:6:2,1,1,104828,95172
3:5:5,0,-1,104829,95171
5:3:2,1,1,104828,95172
2:4:6,1,1,104827,95173
3:4:3,0,-1,104828,95172
1:3:2,1,1,104827,95173
6:4:3,0,-1,104828,95172
2:3:3,1,1,104827,95173
3:3:6,0,-1,104828,95172
4:2:2,2,2,104826,95174
1:4:6,0,-1,104827,95173
3:1:2,1,1,104826,95174
2:2:4,2,2,104824,95176
1:4:3,0,-1,104825,95175
2:4:6,1,1,104824,95176
4:3:5,0,-1,104825,95175
2:1:1,1,1,104824,95176
4:4:2,1,1,104823,95177
2:2:4,2,2,104821,95179
1:5:4,0,-1,104822,95178
2:5:5,1,1,104821,95179
6:6:5,0,-1,104822,95178
6:4:4,0,-1,104823,95177
6:2:5,1,1,104822,95178
5:6:2,1,1,104821,95179
1:5:2,1,1,104820,95180
1:6:3,0,-1,104821,95179
6:3:2,1,1,104820,95180
5:6:5,0,-1,104821,95179
6:2:6,1,1,104820,95180
4:1:5,0,-1,104821,95179
3:4:6,0,-1,104822,95178
5:6:5,0,-1,104823,95177
3:5:4,0,-1,104824,95176
2:1:5,1,1,104823,95177
2:6:6,1,1,104822,95178
5:4:1,0,-1,104823,95177
1:6:2,1,1,104822,95178
1:5:2,1,1,104821,95179
3:5:4,0,-1,104822,95178
4:5:6,0,-1,104823,95177
4:2:6,1,1,104822,95178
2:5:1,1,1,104821,95179
4:1:2,1,1,104820,95180
2:5:2,2,2,104818,95182
6:2:1,1,1,104817,95183
3:1:1,0,-1,104818,95182
6:4:2,1,1,104817,95183
1:5:4,0,-1,104818,95182
2:5:4,1,1,104817,95183
3:1:2,1,1,104816,95184
1:3:1,0,-1,104817,95183
6:3:1,0,-1,104818,95182
1:6:2,1,1,104817,95183
2:1:6,1,1,104816,95184
4:5:1,0,-1,104817,95183
5:1:2,1,1,104816,95184
5:3:1,0,-1,104817,95183
1:1:3,0,-1,104818,95182
3:5:1,0,-1,104819,95181
2:6:5,1,1,104818,95182
2:6:4,1,1,104817,95183
5:4:1,0,-1,104818,95182
3:2:2,2,2,104816,95184
1:6:6,0,-1,104817,95183
2:4:4,1,1,104816,95184
1:4:3,0,-1,104817,95183
4:1:3,0,-1,104818,95182
4:2:2,2,2,104816,95184
5:6:3,0,-1,104817,95183
2:6:6,1,1,104816,95184
4:3:4,0,-1,104817,95183
5:3:4,0,-1,104818,95182
1:4:1,0,-1,104819,95181
4:5:5,0,-1,104820,95180
1:4:5,0,-1,104821,95179
1:2:4,1,1,104820,95180
3:1:1,0,-1,104821,95179
2:6:3,1,1,104820,95180
5:3:6,0,-1,104821,95179
5:6:3,0,-1,104822,95178
1:4:2,1,1,104821,95179
6:4:6,0,-1,104822,95178
2:5:3,1,1,104821,95179
5:4:5,0,-1,104822,95178
6:5:5,0,-1,104823,95177
6:2:3,1,1,104822,95178
6:1:3,0,-1,104823,95177
6:4:6,0,-1,104824,95176
1:3:6,0,-1,104825,95175
5:6:1,0,-1,104826,95174
4:1:2,1,1,104825,95175
3:6:5,0,-1,104826,95174
6:5:1,0,-1,104827,95173
1:1:2,1,1,104826,95174
3:1:5,0,-1,104827,95173
4:6:2,1,1,104826,95174
1:1:6,0,-1,104827,95173
5:6:2,1,1,104826,95174
3:1:2,1,1,104825,95175
6:6:1,0,-1,104826,95174
1:1:3,0,-1,104827,95173
6:6:3,0,-1,104828,95172
6:3:3,0,-1,104829,95171
6:2:5,1,1,104828,95172
6:3:3,0,-1,104829,95171
4:4:5,0,-1,104830,95170
6:2:2,2,2,104828,95172
6:4:3,0,-1,104829,95171
3:5:4,0,-1,104830,95170
4:2:5,1,1,104829,95171
5:1:1,0,-1,104830,95170
6:4:1,0,-1,104831,95169
4:5:2,1,1,104830,95170
4:6:2,1,1,104829,95171
1:2:1,1,1,104828,95172
4:2:4,1,1,104827,95173
4:4:5,0,-1,104828,95172
2:2:6,2,2,104826,95174
6:3:4,0,-1,104827,95173
5:6:5,0,-1,104828,95172
3:3:5,0,-1,104829,95171
1:4:3,0,-1,104830,95170
1:5:5,0,-1,104831,95169
6:1:5,0,-1,104832,95168
2:4:2,2,2,104830,95170
1:6:6,0,-1,104831,95169
2:6:1,1,1,104830,95170
2:1:5,1,1,104829,95171
4:1:5,0,-1,104830,95170
5:4:4,0,-1,104831,95169
1:3:2,1,1,104830,95170
2:2:1,2,2,104828,95172
2:3:5,1,1,104827,95173
1:5:5,0,-1,104828,95172
3:4:4,0,-1,104829,95171
6:1:1,0,-1,104830,95170
6:1:6,0,-1,104831,95169
6:3:6,0,-1,104832,95168
5:4:5,0,-1,104833,95167
3:5:1,0,-1,104834,95166
3:3:6,0,-1,104835,95165
3:6:3,0,-1,104836,95164
3:6:6,0,-1,104837,95163
5:4:3,0,-1,104838,95162
3:3:1,0,-1,104839,95161
4:4:3,0,-1,104840,95160
5:1:3,0,-1,104841,95159
2:2:6,2,2,104839,95161
3:6:5,0,-1,104840,95160
1:5:4,0,-1,104841,95159
2:5:5,1,1,104840,95160
4:6:5,0,-1,104841,95159
6:1:3,0,-1,104842,95158
6:3:6,0,-1,104843,95157
3:6:5,0,-1,104844,95156
2:5:4,1,1,104843,95157
5:3:6,0,-1,104844,95156
5:5:3,0,-1,104845,95155
3:6:2,1,1,104844,95156
4:5:5,0,-1,104845,95155
4:6:1,0,-1,104846,95154
4:5:1,0,-1,104847,95153
2:2:3,2,2,104845,95155
4:2:2,2,2,104843,95157
2:3:3,1,1,104842,95158
3:5:6,0,-1,104843,95157
5:5:1,0,-1,104844,95156
1:5:5,0,-1,104845,95155
3:5:3,0,-1,104846,95154
4:2:3,1,1,104845,95155
4:4:2,1,1,104844,95156
4:4:4,0,-1,104845,95155
6:3:2,1,1,104844,95156
6:3:5,0,-1,104845,95155
6:3:5,0,-1,104846,95154
2:1:5,1,1,104845,95155
2:6:1,1,1,104844,95156
1:1:2,1,1,104843,95157
1:6:3,0,-1,104844,95156
4:3:6,0,-1,104845,95155
5:2:1,1,1,104844,95156
5:5:1,0,-1,104845,95155
1:4:4,0,-1,104846,95154
3:3:6,0,-1,104847,95153
4:4:6,0,-1,104848,95152
5:6:3,0,-1,104849,95151
5:5:2,1,1,104848,95152
1:4:3,0,-1,104849,95151
6:5:2,1,1,104848,95152
5:1:3,0,-1,104849,95151
3:6:6,0,-1,104850,95150
6:1:2,1,1,104849,95151
3:6:2,1,1,104848,95152
6:4:5,0,-1,104849,95151
2:5:5,1,1,104848,95152
4:1:5,0,-1,104849,95151
3:5:6,0,-1,104850,95150
4:3:5,0,-1,104851,95149
4:6:4,0,-1,104852,95148
3:6:4,0,-1,104853,95147
6:3:2,1,1,104852,95148
6:6:4,0,-1,104853,95147
4:2:6,1,1,104852,95148
5:6:2,1,1,104851,95149
4:4:4,0,-1,104852,95148
2:5:1,1,1,104851,95149
4:6:3,0,-1,104852,95148
6:2:3,1,1,104851,95149
4:2:6,1,1,104850,95150
5:3:2,1,1,104849,95151
1:5:1,0,-1,104850,95150
1:5:3,0,-1,104851,95149
5:1:5,0,-1,104852,95148
2:5:4,1,1,104851,95149
1:5:4,0,-1,104852,95148
6:6:3,0,-1,104853,95147
4:4:6,0,-1,104854,95146
1:6:5,0,-1,104855,95145
5:3:4,0,-1,104856,95144
3:3:2,1,1,104855,95145
4:2:2,2,2,104853,95147
1:4:1,0,-1,104854,95146
4:1:3,0,-1,104855,95145
6:4:1,0,-1,104856,95144
2:4:6,1,1,104855,95145
6:2:3,1,1,104854,95146
1:1:1,0,-1,104855,95145
2:3:3,1,1,104854,95146
4:5:2,1,1,104853,95147
1:5:5,0,-1,104854,95146
3:2:5,1,1,104853,95147
2:2:4,2,2,104851,95149
4:1:1,0,-1,104852,95148
2:2:3,2,2,104850,95150
4:1:3,0,-1,104851,95149
1:3:3,0,-1,104852,95148
4:3:3,0,-1,104853,95147
5:3:3,0,-1,104854,95146
5:6:3,0,-1,104855,95145
6:6:3,0,-1,104856,95144
6:5:4,0,-1,104857,95143
2:4:5,1,1,104856,95144
5:6:5,0,-1,104857,95143
1:5:4,0,-1,104858,95142
5:5:4,0,-1,104859,95141
2:5:4,1,1,104858,95142
3:3:6,0,-1,104859,95141
5:5:4,0,-1,104860,95140
2:4:5,1,1,104859,95141
3:1:1,0,-1,104860,95140
6:4:4,0,-1,104861,95139
2:1:3,1,1,104860,95140
6:6:1,0,-1,104861,95139
6:4:4,0,-1,104862,95138
1:1:5,0,-1,104863,95137
5:6:6,0,-1,104864,95136
4:2:4,1,1,104863,95137
1:4:6,0,-1,104864,95136
2:5:4,1,1,104863,95137
1:3:1,0,-1,104864,95136
1:6:2,1,1,104863,95137
6:6:5,0,-1,104864,95136
3:3:5,0,-1,104865,95135
2:2:4,2,2,104863,95137
3:5:3,0,-1,104864,95136
1:1:2,1,1,104863,95137
1:3:1,0,-1,104864,95136
6:4:3,0,-1,104865,95135
5:3:3,0,-1,104866,95134
4:1:2,1,1,104865,95135
4:6:1,0,-1,104866,95134
2:1:1,1,1,104865,95135
5:1:6,0,-1,104866,95134
3:5:3,0,-1,104867,95133
4:5:5,0,-1,104868,95132
6:6:3,0,-1,104869,95131
6:1:4,0,-1,104870,95130
6:3:3,0,-1,104871,95129
5:1:1,0,-1,104872,95128
6:3:6,0,-1,104873,95127
3:5:5,0,-1,104874,95126
1:4:4,0,-1,104875,95125
6:2:3,1,1,104874,95126
2:6:2,2,2,104872,95128
6:4:5,0,-1,104873,95127
1:1:5,0,-1,104874,95126
3:2:4,1,1,104873,95127
6:6:3,0,-1,104874,95126
4:2:2,2,2,104872,95128
3:5:3,0,-1,104873,95127
3:2:4,1,1,104872,95128
6:4:2,1,1,104871,95129
5:4:2,1,1,104870,95130
2:6:4,1,1,104869,95131
5:3:3,0,-1,104870,95130
5:4:3,0,-1,104871,95129
4:4:6,0,-1,104872,95128
4:4:6,0,-1,104873,95127
4:6:4,0,-1,104874,95126
3:3:5,0,-1,104875,95125
1:3:3,0,-1,104876,95124
2:6:2,2,2,104874,95126
6:6:1,0,-1,104875,95125
2:6:6,1,1,104874,95126
4:5:1,0,-1,104875,95125
1:4:5,0,-1,104876,95124
4:2:6,1,1,104875,95125
1:4:3,0,-1,104876,95124
5:2:4,1,1,104875,95125
5:2:3,1,1,104874,95126
4:6:6,0,-1,104875,95125
6:2:5,1,1,104874,95126
6:4:1,0,-1,104875,95125
3:6:4,0,-1,104876,95124
1:5:6,0,-1,104877,95123
6:4:3,0,-1,104878,95122
4:4:3,0,-1,104879,95121
5:4:6,0,-1,104880,95120
6:1:1,0,-1,104881,95119
4:3:6,0,-1,104882,95118
2:1:5,1,1,104881,95119
5:2:3,1,1,104880,95120
5:4:1,0,-1,104881,95119
4:6:4,0,-1,104882,95118
3:6:3,0,-1,104883,95117
1:4:2,1,1,104882,95118
3:5:5,0,-1,104883,95117
6:6:5,0,-1,104884,95116
2:3:6,1,1,104883,95117
5:1:2,1,1,104882,95118
3:5:4,0,-1,104883,95117
4:2:6,1,1,104882,95118
2:2:2,3,3,104879,95121
4:5:4,0,-1,104880,95120
1:2:1,1,1,104879,95121
3:5:4,0,-1,104880,95120
1:6:2,1,1,104879,95121
2:1:2,2,2,104877,95123
4:5:1,0,-1,104878,95122
6:4:2,1,1,104877,95123
5:4:3,0,-1,104878,95122
5:2:2,2,2,104876,95124
2:5:3,1,1,104875,95125
5:2:5,1,1,104874,95126
4:3:1,0,-1,104875,95125
3:5:3,0,-1,104876,95124
6:3:6,0,-1,104877,95123
1:3:5,0,-1,104878,95122
4:3:4,0,-1,104879,95121
3:6:5,0,-1,104880,95120
4:2:6,1,1,104879,95121
4:5:5,0,-1,104880,95120
5:4:5,0,-1,104881,95119
1:1:1,0,-1,104882,95118
3:6:6,0,-1,104883,95117
6:3:1,0,-1,104884,95116
2:6:3,1,1,104883,95117
2:4:1,1,1,104882,95118
2:2:2,3,3,104879,95121
5:5:2,1,1,104878,95122
1:3:5,0,-1,104879,95121
3:6:4,0,-1,104880,95120
2:4:1,1,1,104879,95121
4:5:1,0,-1,104880,95120
5:3:2,1,1,104879,95121
2:6:1,1,1,104878,95122
4:2:1,1,1,104877,95123
5:4:2,1,1,104876,95124
1:1:3,0,-1,104877,95123
1:3:4,0,-1,104878,95122
4:3:2,1,1,104877,95123
5:4:2,1,1,104876,95124
3:1:4,0,-1,104877,95123
5:2:6,1,1,104876,95124
5:4:2,1,1,104875,95125
5:2:2,2,2,104873,95127
3:5:1,0,-1,104874,95126
5:2:6,1,1,104873,95127
4:5:6,0,-1,104874,95126
6:3:1,0,-1,104875,95125
1:2:3,1,1,104874,95126
5:4:6,0,-1,104875,95125
4:2:4,1,1,104874,95126
2:3:1,1,1,104873,95127
2:6:1,1,1,104872,95128
6:4:5,0,-1,104873,95127
4:2:6,1,1,104872,95128
5:5:4,0,-1,104873,95127
6:2:2,2,2,104871,95129
1:4:6,0,-1,104872,95128
2:3:3,1,1,104871,95129
3:4:3,0,-1,104872,95128
5:4:2,1,1,104871,95129
1:3:6,0,-1,104872,95128
5:1:5,0,-1,104873,95127
3:2:3,1,1,104872,95128
5:5:2,1,1,104871,95129
5:4:2,1,1,104870,95130
6:4:2,1,1,104869,95131
3:6:1,0,-1,104870,95130
5:3:4,0,-1,104871,95129
2:6:3,1,1,104870,95130
2:3:1,1,1,104869,95131
3:2:6,1,1,104868,95132
2:5:6,1,1,104867,95133
4:6:1,0,-1,104868,95132
1:3:2,1,1,104867,95133
5:3:5,0,-1,104868,95132
3:2:5,1,1,104867,95133
1:3:2,1,1,104866,95134
1:1:1,0,-1,104867,95133
1:2:4,1,1,104866,95134
5:4:2,1,1,104865,95135
3:3:2,1,1,104864,95136
2:4:1,1,1,104863,95137
6:1:1,0,-1,104864,95136
3:4:3,0,-1,104865,95135
6:5:5,0,-1,104866,95134
2:3:5,1,1,104865,95135
2:2:2,3,3,104862,95138
6:5:6,0,-1,104863,95137
1:5:6,0,-1,104864,95136
1:3:1,0,-1,104865,95135
3:5:3,0,-1,104866,95134
6:3:2,1,1,104865,95135
1:1:2,1,1,104864,95136
1:4:3,0,-1,104865,95135
5:2:2,2,2,104863,95137
2:5:2,2,2,104861,95139
2:3:2,2,2,104859,95141
3:2:3,1,1,104858,95142
4:2:5,1,1,104857,95143
4:6:5,0,-1,104858,95142
5:6:4,0,-1,104859,95141
3:2:4,1,1,104858,95142
5:2:1,1,1,104857,95143
6:5:4,0,-1,104858,95142
6:1:6,0,-1,104859,95141
6:2:6,1,1,104858,95142
6:4:1,0,-1,104859,95141
4:5:5,0,-1,104860,95140
5:2:1,1,1,104859,95141
2:5:6,1,1,104858,95142
1:3:6,0,-1,104859,95141
6:2:4,1,1,104858,95142
5:1:4,0,-1,104859,95141
3:6:6,0,-1,104860,95140
6:5:2,1,1,104859,95141
1:4:4,0,-1,104860,95140
6:6:1,0,-1,104861,95139
3:1:3,0,-1,104862,95138
6:4:2,1,1,104861,95139
5:2:6,1,1,104860,95140
3:2:1,1,1,104859,95141
2:6:4,1,1,104858,95142
1:4:3,0,-1,104859,95141
6:1:5,0,-1,104860,95140
3:1:4,0,-1,104861,95139
1:4:6,0,-1,104862,95138
6:2:6,1,1,104861,95139
5:4:2,1,1,104860,95140
6:5:5,0,-1,104861,95139
3:6:2,1,1,104860,95140
3:2:6,1,1,104859,95141
4:3:4,0,-1,104860,95140
3:1:5,0,-1,104861,95139
3:3:2,1,1,104860,95140
6:5:6,0,-1,104861,95139
5:5:4,0,-1,104862,95138
5:2:6,1,1,104861,95139
3:5:6,0,-1,104862,95138
5:4:4,0,-1,104863,95137
2:4:5,1,1,104862,95138
3:1:6,0,-1,104863,95137
6:1:5,0,-1,104864,95136
3:3:1,0,-1,104865,95135
3:3:3,0,-1,104866,95134
2:4:6,1,1,104865,95135
1:3:1,0,-1,104866,95134
6:6:5,0,-1,104867,95133
2:5:3,1,1,104866,95134
5:5:3,0,-1,104867,95133
4:6:1,0,-1,104868,95132
4:6:5,0,-1,104869,95131
6:2:6,1,1,104868,95132
5:3:1,0,-1,104869,95131
2:6:5,1,1,104868,95132
2:6:5,1,1,104867,95133
4:3:1,0,-1,104868,95132
1:3:4,0,-1,104869,95131
2:4:1,1,1,104868,95132
5:6:5,0,-1,104869,95131
6:3:1,0,-1,104870,95130
5:1:3,0,-1,104871,95129
4:2:1,1,1,104870,95130
4:4:5,0,-1,104871,95129
5:3:2,1,1,104870,95130
6:1:3,0,-1,104871,95129
5:3:1,0,-1,104872,95128
1:1:2,1,1,104871,95129
3:5:3,0,-1,104872,95128
1:3:2,1,1,104871,95129
5:5:6,0,-1,104872,95128
3:1:4,0,-1,104873,95127
5:2:4,1,1,104872,95128
4:3:1,0,-1,104873,95127
6:4:2,1,1,104872,95128
4:2:5,1,1,104871,95129
3:5:5,0,-1,104872,95128
1:2:1,1,1,104871,95129
3:1:4,0,-1,104872,95128
3:2:5,1,1,104871,95129
6:4:4,0,-1,104872,95128
6:4:4,0,-1,104873,95127
1:1:5,0,-1,104874,95126
6:4:2,1,1,104873,95127
3:4:4,0,-1,104874,95126
5:2:6,1,1,104873,95127
6:1:2,1,1,104872,95128
1:5:1,0,-1,104873,95127
2:2:5,2,2,104871,95129
1:3:2,1,1,104870,95130
2:2:1,2,2,104868,95132
4:4:4,0,-1,104869,95131
2:1:4,1,1,104868,95132
3:1:4,0,-1,104869,95131
3:2:6,1,1,104868,95132
3:1:5,0,-1,104869,95131
5:3:4,0,-1,104870,95130
5:1:2,1,1,104869,95131
3:5:5,0,-1,104870,95130
1:6:5,0,-1,104871,95129
5:6:3,0,-1,104872,95128
5:1:3,0,-1,104873,95127
1:6:3,0,-1,104874,95126
4:2:3,1,1,104873,95127
5:4:1,0,-1,104874,95126
2:4:6,1,1,104873,95127
6:3:6,0,-1,104874,95126
1:6:5,0,-1,104875,95125
6:3:4,0,-1,104876,95124
4:6:3,0,-1,104877,95123
6:6:2,1,1,104876,95124
2:3:3,1,1,104875,95125
3:1:6,0,-1,104876,95124
5:4:4,0,-1,104877,95123
3:5:3,0,-1,104878,95122
5:1:3,0,-1,104879,95121
4:4:4,0,-1,104880,95120
4:4:2,1,1,104879,95121
2:2:1,2,2,104877,95123
3:1:6,0,-1,104878,95122
3:5:5,0,-1,104879,95121
2:4:5,1,1,104878,95122
2:6:6,1,1,104877,95123
5:3:1,0,-1,104878,95122
5:4:2,1,1,104877,95123
3:1:5,0,-1,104878,95122
2:2:3,2,2,104876,95124
3:2:1,1,1,104875,95125
6:5:3,0,-1,104876,95124
3:1:1,0,-1,104877,95123
4:6:3,0,-1,104878,95122
1:1:2,1,1,104877,95123
4:3:2,1,1,104876,95124
6:5:4,0,-1,104877,95123
6:3:2,1,1,104876,95124
3:1:6,0,-1,104877,95123
1:1:5,0,-1,104878,95122
2:4:1,1,1,104877,95123
6:1:6,0,-1,104878,95122
6:2:1,1,1,104877,95123
3:5:3,0,-1,104878,95122
3:3:3,0,-1,104879,95121
3:3:2,1,1,104878,95122
1:4:5,0,-1,104879,95121
1:1:5,0,-1,104880,95120
5:6:6,0,-1,104881,95119
5:3:2,1,1,104880,95120
4:5:3,0,-1,104881,95119
1:5:3,0,-1,104882,95118
5:6:6,0,-1,104883,95117
5:6:1,0,-1,104884,95116
2:6:5,1,1,104883,95117
4:3:3,0,-1,104884,95116
1:2:2,2,2,104882,95118
1:2:1,1,1,104881,95119
6:5:5,0,-1,104882,95118
5:2:2,2,2,104880,95120
1:1:1,0,-1,104881,95119
6:3:6,0,-1,104882,95118
4:4:1,0,-1,104883,95117
2:3:1,1,1,104882,95118
2:6:2,2,2,104880,95120
5:3:4,0,-1,104881,95119
5:6:4,0,-1,104882,95118
5:1:5,0,-1,104883,95117
5:5:5,0,-1,104884,95116
1:3:5,0,-1,104885,95115
4:6:5,0,-1,104886,95114
2:4:2,2,2,104884,95116
1:4:5,0,-1,104885,95115
5:5:3,0,-1,104886,95114
3:3:6,0,-1,104887,95113
1:1:4,0,-1,104888,95112
1:6:5,0,-1,104889,95111
4:5:4,0,-1,104890,95110
2:2:4,2,2,104888,95112
2:4:3,1,1,104887,95113
6:2:6,1,1,104886,95114
4:5:3,0,-1,104887,95113
5:3:2,1,1,104886,95114
4:6:5,0,-1,104887,95113
6:6:4,0,-1,104888,95112
3:1:1,0,-1,104889,95111
3:1:1,0,-1,104890,95110
4:3:2,1,1,104889,95111
5:2:4,1,1,104888,95112
2:5:6,1,1,104887,95113
4:2:6,1,1,104886,95114
3:1:2,1,1,104885,95115
4:3:2,1,1,104884,95116
3:3:5,0,-1,104885,95115
6:6:6,0,-1,104886,95114
3:6:3,0,-1,104887,95113
1:2:1,1,1,104886,95114
6:3:2,1,1,104885,95115
2:2:6,2,2,104883,95117
6:4:2,1,1,104882,95118
4:5:2,1,1,104881,95119
5:4:5,0,-1,104882,95118
5:1:6,0,-1,104883,95117
3:5:3,0,-1,104884,95116
1:6:3,0,-1,104885,95115
3:5:6,0,-1,104886,95114
1:4:2,1,1,104885,95115
3:1:1,0,-1,104886,95114
6:1:5,0,-1,104887,95113
3:5:6,0,-1,104888,95112
6:4:6,0,-1,104889,95111
6:5:1,0,-1,104890,95110
2:4:1,1,1,104889,95111
6:2:1,1,1,104888,95112
1:2:5,1,1,104887,95113
4:3:5,0,-1,104888,95112
4:5:1,0,-1,104889,95111
2:6:2,2,2,104887,95113
2:3:6,1,1,104886,95114
4:2:6,1,1,104885,95115
2:5:3,1,1,104884,95116
6:3:1,0,-1,104885,95115
6:2:6,1,1,104884,95116
6:5:4,0,-1,104885,95115
3:1:5,0,-1,104886,95114
5:1:5,0,-1,104887,95113
5:1:3,0,-1,104888,95112
6:2:3,1,1,104887,95113
5:1:1,0,-1,104888,95112
1:1:5,0,-1,104889,95111
5:5:1,0,-1,104890,95110
4:3:6,0,-1,104891,95109
6:1:3,0,-1,104892,95108
1:5:2,1,1,104891,95109
5:5:5,0,-1,104892,95108
5:1:5,0,-1,104893,95107
1:5:5,0,-1,104894,95106
2:4:1,1,1,104893,95107
2:4:1,1,1,104892,95108
1:3:4,0,-1,104893,95107
1:4:5,0,-1,104894,95106
1:2:2,2,2,104892,95108
5:2:3,1,1,104891,95109
2:5:4,1,1,104890,95110
6:2:4,1,1,104889,95111
1:3:2,1,1,104888,95112
3:4:2,1,1,104887,95113
5:5:4,0,-1,104888,95112
2:6:2,2,2,104886,95114
1:5:5,0,-1,104887,95113
2:6:4,1,1,104886,95114
6:2:4,1,1,104885,95115
3:5:3,0,-1,104886,95114
5:3:5,0,-1,104887,95113
1:4:2,1,1,104886,95114
3:4:2,1,1,104885,95115
6:3:1,0,-1,104886,95114
5:1:5,0,-1,104887,95113
3:1:6,0,-1,104888,95112
3:5:1,0,-1,104889,95111
2:4:6,1,1,104888,95112
1:2:6,1,1,104887,95113
3:2:4,1,1,104886,95114
3:4:2,1,1,104885,95115
1:4:6,0,-1,104886,95114
4:4:5,0,-1,104887,95113
6:2:5,1,1,104886,95114
5:3:6,0,-1,104887,95113
2:3:1,1,1,104886,95114
6:3:3,0,-1,104887,95113
6:6:6,0,-1,104888,95112
2:1:1,1,1,104887,95113
1:3:2,1,1,104886,95114
3:3:1,0,-1,104887,95113
5:4:4,0,-1,104888,95112
2:2:5,2,2,104886,95114
2:4:4,1,1,104885,95115
1:5:5,0,-1,104886,95114
4:1:5,0,-1,104887,95113
4:6:3,0,-1,104888,95112
1:2:6,1,1,104887,95113
4:6:2,1,1,104886,95114
1:4:5,0,-1,104887,95113
4:1:2,1,1,104886,95114
5:2:2,2,2,104884,95116
5:2:2,2,2,104882,95118
4:1:1,0,-1,104883,95117
6:5:3,0,-1,104884,95116
2:4:2,2,2,104882,95118
6:2:1,1,1,104881,95119
3:1:5,0,-1,104882,95118
2:5:6,1,1,104881,95119
1:4:5,0,-1,104882,95118
2:5:6,1,1,104881,95119
1:2:6,1,1,104880,95120
5:6:4,0,-1,104881,95119
1:1:6,0,-1,104882,95118
5:6:6,0,-1,104883,95117
1:1:3,0,-1,104884,95116
5:6:6,0,-1,104885,95115
1:4:3,0,-1,104886,95114
4:3:4,0,-1,104887,95113
1:1:3,0,-1,104888,95112
2:2:2,3,3,104885,95115
4:4:1,0,-1,104886,95114
2:1:6,1,1,104885,95115
2:1:1,1,1,104884,95116
5:5:3,0,-1,104885,95115
2:3:1,1,1,104884,95116
4:5:1,0,-1,104885,95115
6:5:1,0,-1,104886,95114
4:2:3,1,1,104885,95115
1:1:4,0,-1,104886,95114
4:5:6,0,-1,104887,95113
2:2:3,2,2,104885,95115
5:1:2,1,1,104884,95116
2:2:1,2,2,104882,95118
4:3:4,0,-1,104883,95117
3:5:2,1,1,104882,95118
5:1:4,0,-1,104883,95117
6:2:1,1,1,104882,95118
6:5:3,0,-1,104883,95117
5:2:5,1,1,104882,95118
1:3:5,0,-1,104883,95117
6:1:1,0,-1,104884,95116
3:5:1,0,-1,104885,95115
2:4:3,1,1,104884,95116
3:5:6,0,-1,104885,95115
4:3:1,0,-1,104886,95114
2:2:4,2,2,104884,95116
1:1:2,1,1,104883,95117
6:5:3,0,-1,104884,95116
6:3:3,0,-1,104885,95115
5:2:3,1,1,104884,95116
5:4:6,0,-1,104885,95115
2:3:2,2,2,104883,95117
5:6:3,0,-1,104884,95116
5:3:2,1,1,104883,95117
2:3:2,2,2,104881,95119
2:2:4,2,2,104879,95121
2:4:5,1,1,104878,95122
6:2:3,1,1,104877,95123
3:1:2,1,1,104876,95124
3:4:1,0,-1,104877,95123
3:3:6,0,-1,104878,95122
1:6:1,0,-1,104879,95121
6:4:2,1,1,104878,95122
3:5:2,1,1,104877,95123
5:5:2,1,1,104876,95124
2:3:6,1,1,104875,95125
5:3:2,1,1,104874,95126
3:1:5,0,-1,104875,95125
3:3:1,0,-1,104876,95124
6:5:5,0,-1,104877,95123
6:5:4,0,-1,104878,95122
1:5:5,0,-1,104879,95121
5:4:4,0,-1,104880,95120
1:5:6,0,-1,104881,95119
3:2:4,1,1,104880,95120
5:6:4,0,-1,104881,95119
5:6:2,1,1,104880,95120
3:6:6,0,-1,104881,95119
1:3:3,0,-1,104882,95118
5:3:6,0,-1,104883,95117
6:1:4,0,-1,104884,95116
2:3:6,1,1,104883,95117
1:6:5,0,-1,104884,95116
6:5:2,1,1,104883,95117
4:6:3,0,-1,104884,95116
4:5:4,0,-1,104885,95115
6:3:1,0,-1,104886,95114
3:2:4,1,1,104885,95115
3:3:1,0,-1,104886,95114
3:1:2,1,1,104885,95115
4:1:4,0,-1,104886,95114
1:4:4,0,-1,104887,95113
5:6:3,0,-1,104888,95112
3:4:4,0,-1,104889,95111
6:4:6,0,-1,104890,95110
6:2:5,1,1,104889,95111
1:5:5,0,-1,104890,95110
3:6:1,0,-1,104891,95109
4:6:4,0,-1,104892,95108
5:6:6,0,-1,104893,95107
6:3:4,0,-1,104894,95106
6:6:6,0,-1,104895,95105
2:1:1,1,1,104894,95106
5:5:1,0,-1,104895,95105
4:6:4,0,-1,104896,95104
4:3:5,0,-1,104897,95103
3:3:6,0,-1,104898,95102
3:2:1,1,1,104897,95103
2:3:4,1,1,104896,95104
5:3:5,0,-1,104897,95103
1:4:4,0,-1,104898,95102
4:5:6,0,-1,104899,95101
6:3:2,1,1,104898,95102
3:4:1,0,-1,104899,95101
6:5:1,0,-1,104900,95100
6:4:2,1,1,104899,95101
2:2:3,2,2,104897,95103
6:5:5,0,-1,104898,95102
6:4:4,0,-1,104899,95101
1:6:1,0,-1,104900,95100
1:6:6,0,-1,104901,95099
1:3:4,0,-1,104902,95098
1:4:3,0,-1,104903,95097
5:4:1,0,-1,104904,95096
1:2:2,2,2,104902,95098
3:6:3,0,-1,104903,95097
3:3:3,0,-1,104904,95096
5:5:4,0,-1,104905,95095
3:5:2,1,1,104904,95096
4:3:2,1,1,104903,95097
6:3:4,0,-1,104904,95096
2:6:1,1,1,104903,95097
5:4:4,0,-1,104904,95096
1:1:6,0,-1,104905,95095
2:6:4,1,1,104904,95096
1:4:3,0,-1,104905,95095
1:1:1,0,-1,104906,95094
4:2:3,1,1,104905,95095
6:4:6,0,-1,104906,95094
4:5:3,0,-1,104907,95093
5:2:6,1,1,104906,95094
3:4:3,0,-1,104907,95093
4:1:5,0,-1,104908,95092
5:6:1,0,-1,104909,95091
6:3:6,0,-1,104910,95090
3:4:1,0,-1,104911,95089
5:6:3,0,-1,104912,95088
2:2:1,2,2,104910,95090
5:3:4,0,-1,104911,95089
3:4:5,0,-1,104912,95088
1:4:2,1,1,104911,95089
4:1:3,0,-1,104912,95088
1:6:1,0,-1,104913,95087
2:2:6,2,2,104911,95089
5:6:6,0,-1,104912,95088
2:4:4,1,1,104911,95089
6:3:4,0,-1,104912,95088
2:5:6,1,1,104911,95089
3:5:1,0,-1,104912,95088
1:2:4,1,1,104911,95089
6:5:1,0,-1,104912,95088
5:1:4,0,-1,104913,95087
3:6:3,0,-1,104914,95086
4:3:6,0,-1,104915,95085
4:4:4,0,-1,104916,95084
4:4:1,0,-1,104917,95083
5:4:5,0,-1,104918,95082
2:2:6,2,2,104916,95084
6:4:2,1,1,104915,95085
5:6:2,1,1,104914,95086
6:4:2,1,1,104913,95087
3:5:3,0,-1,104914,95086
6:1:2,1,1,104913,95087
6:1:6,0,-1,104914,95086
4:5:2,1,1,104913,95087
4:2:4,1,1,104912,95088
1:5:3,0,-1,104913,95087
4:5:2,1,1,104912,95088
5:1:4,0,-1,104913,95087
3:6:1,0,-1,104914,95086
1:2:2,2,2,104912,95088
2:2:4,2,2,104910,95090
1:5:5,0,-1,104911,95089
1:4:4,0,-1,104912,95088
6:2:3,1,1,104911,95089
6:6:5,0,-1,104912,95088
1:1:3,0,-1,104913,95087
5:2:3,1,1,104912,95088
4:3:1,0,-1,104913,95087
6:3:3,0,-1,104914,95086
6:1:6,0,-1,104915,95085
6:2:2,2,2,104913,95087
1:4:2,1,1,104912,95088
1:2:1,1,1,104911,95089
2:6:3,1,1,104910,95090
3:5:5,0,-1,104911,95089
6:1:1,0,-1,104912,95088
2:6:2,2,2,104910,95090
4:4:4,0,-1,104911,95089
4:1:4,0,-1,104912,95088
5:2:3,1,1,104911,95089
5:1:1,0,-1,104912,95088
3:6:5,0,-1,104913,95087
6:5:2,1,1,104912,95088
3:5:6,0,-1,104913,95087
3:1:2,1,1,104912,95088
4:4:2,1,1,104911,95089
1:5:4,0,-1,104912,95088
2:2:3,2,2,104910,95090
2:3:1,1,1,104909,95091
2:1:3,1,1,104908,95092
6:1:1,0,-1,104909,95091
5:3:4,0,-1,104910,95090
2:2:2,3,3,104907,95093
3:4:4,0,-1,104908,95092
1:2:5,1,1,104907,95093
3:4:1,0,-1,104908,95092
2:2:4,2,2,104906,95094
6:3:5,0,-1,104907,95093
4:6:1,0,-1,104908,95092
5:4:3,0,-1,104909,95091
2:2:4,2,2,104907,95093
1:1:3,0,-1,104908,95092
5:3:6,0,-1,104909,95091
4:2:2,2,2,104907,95093
6:6:2,1,1,104906,95094
1:2:2,2,2,104904,95096
5:5:3,0,-1,104905,95095
4:5:5,0,-1,104906,95094
1:1:4,0,-1,104907,95093
2:2:6,2,2,104905,95095
1:2:6,1,1,104904,95096
1:4:6,0,-1,104905,95095
2:3:4,1,1,104904,95096
1:3:4,0,-1,104905,95095
3:1:6,0,-1,104906,95094
2:3:1,1,1,104905,95095
1:5:3,0,-1,104906,95094
6:1:1,0,-1,104907,95093
1:6:3,0,-1,104908,95092
4:4:6,0,-1,104909,95091
3:4:3,0,-1,104910,95090
6:1:4,0,-1,104911,95089
3:6:5,0,-1,104912,95088
5:6:3,0,-1,104913,95087
6:3:5,0,-1,104914,95086
5:6:4,0,-1,104915,95085
3:2:2,2,2,104913,95087
3:5:5,0,-1,104914,95086
2:4:3,1,1,104913,95087
1:4:5,0,-1,104914,95086
6:2:4,1,1,104913,95087
1:1:5,0,-1,104914,95086
1:4:2,1,1,104913,95087
2:2:5,2,2,104911,95089
4:3:4,0,-1,104912,95088
5:1:3,0,-1,104913,95087
1:5:5,0,-1,104914,95086
1:4:4,0,-1,104915,95085
1:5:1,0,-1,104916,95084
5:5:4,0,-1,104917,95083
3:6:4,0,-1,104918,95082
5:5:1,0,-1,104919,95081
3:6:5,0,-1,104920,95080
4:6:1,0,-1,104921,95079
1:1:6,0,-1,104922,95078
2:1:5,1,1,104921,95079
1:2:1,1,1,104920,95080
6:2:1,1,1,104919,95081
2:5:4,1,1,104918,95082
1:3:3,0,-1,104919,95081
2:3:2,2,2,104917,95083
5:2:6,1,1,104916,95084
2:5:4,1,1,104915,95085
3:2:2,2,2,104913,95087
2:5:4,1,1,104912,95088
5:3:3,0,-1,104913,95087
1:6:6,0,-1,104914,95086
6:6:6,0,-1,104915,95085
1:3:2,1,1,104914,95086
6:2:1,1,1,104913,95087
5:3:4,0,-1,104914,95086
1:5:4,0,-1,104915,95085
3:5:6,0,-1,104916,95084
3:4:6,0,-1,104917,95083
3:2:4,1,1,104916,95084
4:6:1,0,-1,104917,95083
5:3:4,0,-1,104918,95082
3:1:6,0,-1,104919,95081
6:6:1,0,-1,104920,95080
4:1:5,0,-1,104921,95079
5:2:1,1,1,104920,95080
2:6:2,2,2,104918,95082
3:4:1,0,-1,104919,95081
2:2:6,2,2,104917,95083
2:2:5,2,2,104915,95085
3:6:6,0,-1,104916,95084
6:1:1,0,-1,104917,95083
5:2:1,1,1,104916,95084
3:2:3,1,1,104915,95085
2:6:4,1,1,104914,95086
4:2:6,1,1,104913,95087
6:4:5,0,-1,104914,95086
2:2:5,2,2,104912,95088
6:5:4,0,-1,104913,95087
5:4:4,0,-1,104914,95086
6:5:3,0,-1,104915,95085
5:4:1,0,-1,104916,95084
1:1:3,0,-1,104917,95083
2:1:5,1,1,104916,95084
5:6:4,0,-1,104917,95083
5:3:3,0,-1,104918,95082
6:1:2,1,1,104917,95083
1:1:2,1,1,104916,95084
5:4:1,0,-1,104917,95083
4:5:5,0,-1,104918,95082
4:6:4,0,-1,104919,95081
2:5:5,1,1,104918,95082
4:4:2,1,1,104917,95083
5:1:4,0,-1,104918,95082
2:6:1,1,1,104917,95083
5:5:4,0,-1,104918,95082
2:6:1,1,1,104917,95083
4:4:2,1,1,104916,95084
1:2:6,1,1,104915,95085
3:2:4,1,1,104914,95086
3:5:1,0,-1,104915,95085
1:2:3,1,1,104914,95086
2:1:6,1,1,104913,95087
5:6:4,0,-1,104914,95086
3:6:6,0,-1,104915,95085
5:6:1,0,-1,104916,95084
3:4:6,0,-1,104917,95083
1:1:2,1,1,104916,95084
5:4:2,1,1,104915,95085
1:3:1,0,-1,104916,95084
4:1:1,0,-1,104917,95083
6:4:2,1,1,104916,95084
6:6:5,0,-1,104917,95083
4:3:4,0,-1,104918,95082
6:5:4,0,-1,104919,95081
2:1:4,1,1,104918,95082
5:2:3,1,1,104917,95083
3:4:1,0,-1,104918,95082
2:5:3,1,1,104917,95083
3:6:6,0,-1,104918,95082
3:3:6,0,-1,104919,95081
6:2:2,2,2,104917,95083
4:5:4,0,-1,104918,95082
5:1:1,0,-1,104919,95081
3:3:3,0,-1,104920,95080
3:2:4,1,1,104919,95081
6:3:4,0,-1,104920,95080
5:5:3,0,-1,104921,95079
2:4:5,1,1,104920,95080
6:3:1,0,-1,104921,95079
5:4:4,0,-1,104922,95078
4:2:5,1,1,104921,95079
6:2:5,1,1,104920,95080
2:6:1,1,1,104919,95081
6:4:1,0,-1,104920,95080
2:6:3,1,1,104919,95081
1:1:3,0,-1,104920,95080
6:2:3,1,1,104919,95081
2:6:1,1,1,104918,95082
3:3:5,0,-1,104919,95081
4:2:5,1,1,104918,95082
3:5:5,0,-1,104919,95081
5:4:6,0,-1,104920,95080
2:2:6,2,2,104918,95082
6:5:5,0,-1,104919,95081
2:5:5,1,1,104918,95082
2:5:2,2,2,104916,95084
4:5:1,0,-1,104917,95083
2:5:2,2,2,104915,95085
1:6:2,1,1,104914,95086
2:4:5,1,1,104913,95087
5:4:2,1,1,104912,95088
5:2:3,1,1,104911,95089
4:1:6,0,-1,104912,95088
1:6:2,1,1,104911,95089
5:1:5,0,-1,104912,95088
1:4:4,0,-1,104913,95087
6:3:1,0,-1,104914,95086
4:2:4,1,1,104913,95087
4:2:2,2,2,104911,95089
1:2:5,1,1,104910,95090
2:5:4,1,1,104909,95091
4:4:1,0,-1,104910,95090
4:2:3,1,1,104909,95091
2:3:2,2,2,104907,95093
3:4:5,0,-1,104908,95092
1:6:2,1,1,104907,95093
4:4:4,0,-1,104908,95092
4:5:6,0,-1,104909,95091
3:4:5,0,-1,104910,95090
2:1:1,1,1,104909,95091
2:2:6,2,2,104907,95093
4:5:5,0,-1,104908,95092
4:2:4,1,1,104907,95093
1:6:4,0,-1,104908,95092
5:1:2,1,1,104907,95093
4:6:6,0,-1,104908,95092
6:5:4,0,-1,104909,95091
6:2:6,1,1,104908,95092
4:1:2,1,1,104907,95093
1:3:5,0,-1,104908,95092
4:3:3,0,-1,104909,95091
6:6:1,0,-1,104910,95090
1:6:6,0,-1,104911,95089
4:5:3,0,-1,104912,95088
2:1:1,1,1,104911,95089
6:6:1,0,-1,104912,95088
2:6:2,2,2,104910,95090
1:4:1,0,-1,104911,95089
1:4:2,1,1,104910,95090
4:5:4,0,-1,104911,95089
2:5:1,1,1,104910,95090
2:1:1,1,1,104909,95091
4:3:2,1,1,104908,95092
5:5:5,0,-1,104909,95091
6:5:6,0,-1,104910,95090
2:5:5,1,1,104909,95091
4:3:4,0,-1,104910,95090
3:5:6,0,-1,104911,95089
4:5:4,0,-1,104912,95088
3:3:3,0,-1,104913,95087
1:1:2,1,1,104912,95088
2:2:1,2,2,104910,95090
2:4:5,1,1,104909,95091
2:4:2,2,2,104907,95093
6:3:2,1,1,104906,95094
2:5:2,2,2,104904,95096
3:2:2,2,2,104902,95098
1:4:1,0,-1,104903,95097
1:2:3,1,1,104902,95098
5:4:4,0,-1,104903,95097
1:1:3,0,-1,104904,95096
2:5:2,2,2,104902,95098
3:5:2,1,1,104901,95099
5:3:3,0,-1,104902,95098
5:1:2,1,1,104901,95099
1:3:4,0,-1,104902,95098
2:4:6,1,1,104901,95099
1:1:4,0,-1,104902,95098
1:6:3,0,-1,104903,95097
4:1:6,0,-1,104904,95096
6:3:1,0,-1,104905,95095
3:3:6,0,-1,104906,95094
3:1:3,0,-1,104907,95093
5:6:2,1,1,104906,95094
3:3:1,0,-1,104907,95093
5:3:1,0,-1,104908,95092
6:4:6,0,-1,104909,95091
4:2:2,2,2,104907,95093
4:6:3,0,-1,104908,95092
4:1:2,1,1,104907,95093
4:2:1,1,1,104906,95094
1:3:2,1,1,104905,95095
5:4:3,0,-1,104906,95094
1:2:3,1,1,104905,95095
4:5:3,0,-1,104906,95094
3:5:6,0,-1,104907,95093
4:3:1,0,-1,104908,95092
4:3:1,0,-1,104909,95091
5:5:6,0,-1,104910,95090
3:6:4,0,-1,104911,95089
1:4:4,0,-1,104912,95088
4:6:6,0,-1,104913,95087
3:6:5,0,-1,104914,95086
1:1:6,0,-1,104915,95085
1:4:1,0,-1,104916,95084
4:1:2,1,1,104915,95085
3:1:1,0,-1,104916,95084
4:5:4,0,-1,104917,95083
1:5:6,0,-1,104918,95082
2:6:1,1,1,104917,95083
4:4:6,0,-1,104918,95082
1:2:4,1,1,104917,95083
1:3:6,0,-1,104918,95082
3:3:4,0,-1,104919,95081
6:5:5,0,-1,104920,95080
1:5:2,1,1,104919,95081
4:6:4,0,-1,104920,95080
6:4:1,0,-1,104921,95079
1:4:2,1,1,104920,95080
2:2:2,3,3,104917,95083
5:6:3,0,-1,104918,95082
4:3:6,0,-1,104919,95081
6:1:1,0,-1,104920,95080
5:3:2,1,1,104919,95081
4:4:6,0,-1,104920,95080
2:1:2,2,2,104918,95082
6:6:5,0,-1,104919,95081
6:5:1,0,-1,104920,95080
6:3:5,0,-1,104921,95079
6:4:3,0,-1,104922,95078
6:6:3,0,-1,104923,95077
6:4:4,0,-1,104924,95076
3:4:1,0,-1,104925,95075
3:3:6,0,-1,104926,95074
5:6:6,0,-1,104927,95073
1:5:2,1,1,104926,95074
6:5:4,0,-1,104927,95073
5:4:4,0,-1,104928,95072
4:1:1,0,-1,104929,95071
3:5:5,0,-1,104930,95070
6:5:5,0,-1,104931,95069
2:4:1,1,1,104930,95070
6:3:1,0,-1,104931,95069
4:1:1,0,-1,104932,95068
6:6:1,0,-1,104933,95067
3:6:6,0,-1,104934,95066
2:3:3,1,1,104933,95067
5:3:6,0,-1,104934,95066
1:6:1,0,-1,104935,95065
6:2:6,1,1,104934,95066
2:1:1,1,1,104933,95067
6:1:2,1,1,104932,95068
5:6:6,0,-1,104933,95067
4:5:3,0,-1,104934,95066
6:5:2,1,1,104933,95067
6:2:1,1,1,104932,95068
6:5:4,0,-1,104933,95067
4:4:1,0,-1,104934,95066
1:4:5,0,-1,104935,95065
1:5:4,0,-1,104936,95064
1:1:2,1,1,104935,95065
1:6:4,0,-1,104936,95064
1:2:5,1,1,104935,95065
6:3:5,0,-1,104936,95064
2:3:1,1,1,104935,95065
1:4:5,0,-1,104936,95064
5:2:1,1,1,104935,95065
5:4:5,0,-1,104936,95064
3:1:1,0,-1,104937,95063
5:6:2,1,1,104936,95064
4:4:6,0,-1,104937,95063
1:5:5,0,-1,104938,95062
4:4:3,0,-1,104939,95061
3:1:4,0,-1,104940,95060
4:1:4,0,-1,104941,95059
6:3:4,0,-1,104942,95058
4:5:1,0,-1,104943,95057
1:2:2,2,2,104941,95059
5:6:3,0,-1,104942,95058
3:4:5,0,-1,104943,95057
2:2:6,2,2,104941,95059
5:2:5,1,1,104940,95060
2:1:6,1,1,104939,95061
3:3:3,0,-1,104940,95060
3:6:5,0,-1,104941,95059
5:4:2,1,1,104940,95060
1:5:1,0,-1,104941,95059
2:4:3,1,1,104940,95060
2:5:5,1,1,104939,95061
2:1:4,1,1,104938,95062
4:4:6,0,-1,104939,95061
1:3:2,1,1,104938,95062
3:2:6,1,1,104937,95063
3:4:6,0,-1,104938,95062
2:5:1,1,1,104937,95063
5:6:4,0,-1,104938,95062
1:1:5,0,-1,104939,95061
6:1:4,0,-1,104940,95060
2:5:5,1,1,104939,95061
2:5:1,1,1,104938,95062
4:1:5,0,-1,104939,95061
2:3:3,1,1,104938,95062
2:6:1,1,1,104937,95063
2:2:1,2,2,104935,95065
1:1:3,0,-1,104936,95064
5:2:5,1,1,104935,95065
1:1:4,0,-1,104936,95064
5:5:5,0,-1,104937,95063
5:5:1,0,-1,104938,95062
6:6:4,0,-1,104939,95061
6:2:4,1,1,104938,95062
6:3:3,0,-1,104939,95061
2:4:5,1,1,104938,95062
2:2:5,2,2,104936,95064
3:5:3,0,-1,104937,95063
5:5:2,1,1,104936,95064
2:3:5,1,1,104935,95065
2:6:6,1,1,104934,95066
3:3:4,0,-1,104935,95065
3:1:1,0,-1,104936,95064
1:6:2,1,1,104935,95065
5:2:3,1,1,104934,95066
5:2:1,1,1,104933,95067
1:6:5,0,-1,104934,95066
5:2:5,1,1,104933,95067
4:6:6,0,-1,104934,95066
1:5:4,0,-1,104935,95065
4:2:4,1,1,104934,95066
3:3:4,0,-1,104935,95065
2:5:5,1,1,104934,95066
5:4:5,0,-1,104935,95065
1:3:4,0,-1,104936,95064
1:5:6,0,-1,104937,95063
2:5:3,1,1,104936,95064
2:1:6,1,1,104935,95065
5:3:2,1,1,104934,95066
3:6:6,0,-1,104935,95065
6:1:6,0,-1,104936,95064
2:2:6,2,2,104934,95066
4:3:1,0,-1,104935,95065
6:6:2,1,1,104934,95066
3:1:2,1,1,104933,95067
2:3:3,1,1,104932,95068
2:1:3,1,1,104931,95069
2:4:5,1,1,104930,95070
4:3:2,1,1,104929,95071
5:3:2,1,1,104928,95072
4:1:3,0,-1,104929,95071
3:6:5,0,-1,104930,95070
4:2:3,1,1,104929,95071
4:6:1,0,-1,104930,95070
5:6:3,0,-1,104931,95069
6:4:3,0,-1,104932,95068
3:2:6,1,1,104931,95069
5:6:1,0,-1,104932,95068
5:1:5,0,-1,104933,95067
6:1:3,0,-1,104934,95066
4:4:1,0,-1,104935,95065
4:6:5,0,-1,104936,95064
1:2:1,1,1,104935,95065
6:1:3,0,-1,104936,95064
6:6:6,0,-1,104937,95063
6:4:3,0,-1,104938,95062
4:3:4,0,-1,104939,95061
2:1:4,1,1,104938,95062
2:6:3,1,1,104937,95063
4:6:4,0,-1,104938,95062
5:3:5,0,-1,104939,95061
4:1:6,0,-1,104940,95060
4:6:4,0,-1,104941,95059
3:5:6,0,-1,104942,95058
4:2:6,1,1,104941,95059
3:5:6,0,-1,104942,95058
6:3:3,0,-1,104943,95057
2:6:5,1,1,104942,95058
3:4:3,0,-1,104943,95057
4:4:6,0,-1,104944,95056
1:6:4,0,-1,104945,95055
5:4:4,0,-1,104946,95054
3:2:5,1,1,104945,95055
5:5:1,0,-1,104946,95054
5:4:2,1,1,104945,95055
1:1:1,0,-1,104946,95054
2:3:6,1,1,104945,95055
6:4:5,0,-1,104946,95054
1:3:6,0,-1,104947,95053
5:6:1,0,-1,104948,95052
3:5:6,0,-1,104949,95051
1:2:2,2,2,104947,95053
5:2:2,2,2,104945,95055
6:2:6,1,1,104944,95056
1:2:6,1,1,104943,95057
1:6:2,1,1,104942,95058
5:4:2,1,1,104941,95059
5:1:6,0,-1,104942,95058
5:5:4,0,-1,104943,95057
1:4:2,1,1,104942,95058
4:4:2,1,1,104941,95059
2:3:3,1,1,104940,95060
4:5:3,0,-1,104941,95059
5:4:1,0,-1,104942,95058
3:2:3,1,1,104941,95059
3:5:5,0,-1,104942,95058
3:3:3,0,-1,104943,95057
3:4:3,0,-1,104944,95056
6:2:6,1,1,104943,95057
1:4:4,0,-1,104944,95056
4:3:3,0,-1,104945,95055
5:4:5,0,-1,104946,95054
1:5:5,0,-1,104947,95053
3:3:4,0,-1,104948,95052
1:5:1,0,-1,104949,95051
2:3:6,1,1,104948,95052
5:1:1,0,-1,104949,95051
1:6:4,0,-1,104950,95050
3:3:3,0,-1,104951,95049
2:2:4,2,2,104949,95051
4:4:5,0,-1,104950,95050
1:6:4,0,-1,104951,95049
5:6:4,0,-1,104952,95048
3:2:6,1,1,104951,95049
2:6:6,1,1,104950,95050
6:3:3,0,-1,104951,95049
5:2:1,1,1,104950,95050
5:5:5,0,-1,104951,95049
4:6:2,1,1,104950,95050
5:5:5,0,-1,104951,95049
3:1:5,0,-1,104952,95048
5:1:2,1,1,104951,95049
5:4:2,1,1,104950,95050
6:6:1,0,-1,104951,95049
3:3:5,0,-1,104952,95048
4:6:6,0,-1,104953,95047
1:3:5,0,-1,104954,95046
1:3:5,0,-1,104955,95045
3:4:2,1,1,104954,95046
6:2:1,1,1,104953,95047
2:2:1,2,2,104951,95049
2:3:1,1,1,104950,95050
3:3:5,0,-1,104951,95049
4:5:5,0,-1,104952,95048
1:1:3,0,-1,104953,95047
2:1:1,1,1,104952,95048
3:2:3,1,1,104951,95049
2:6:5,1,1,104950,95050
5:3:3,0,-1,104951,95049
5:4:4,0,-1,104952,95048
3:6:6,0,-1,104953,95047
1:6:5,0,-1,104954,95046
5:1:3,0,-1,104955,95045
6:1:6,0,-1,104956,95044
4:6:4,0,-1,104957,95043
6:3:6,0,-1,104958,95042
5:4:3,0,-1,104959,95041
1:1:2,1,1,104958,95042
3:3:3,0,-1,104959,95041
3:5:3,0,-1,104960,95040
3:1:4,0,-1,104961,95039
5:1:6,0,-1,104962,95038
2:4:5,1,1,104961,95039
5:2:3,1,1,104960,95040
6:1:2,1,1,104959,95041
5:1:6,0,-1,104960,95040
4:6:1,0,-1,104961,95039
1:2:6,1,1,104960,95040
6:1:6,0,-1,104961,95039
1:4:2,1,1,104960,95040
3:3:6,0,-1,104961,95039
5:2:3,1,1,104960,95040
5:4:2,1,1,104959,95041
5:2:1,1,1,104958,95042
1:1:1,0,-1,104959,95041
3:4:6,0,-1,104960,95040
5:1:3,0,-1,104961,95039
4:2:1,1,1,104960,95040
2:5:5,1,1,104959,95041
2:6:3,1,1,104958,95042
4:6:4,0,-1,104959,95041
3:6:1,0,-1,104960,95040
1:5:3,0,-1,104961,95039
5:5:1,0,-1,104962,95038
5:5:2,1,1,104961,95039
4:4:3,0,-1,104962,95038
4:4:1,0,-1,104963,95037
3:3:3,0,-1,104964,95036
6:3:6,0,-1,104965,95035
1:3:6,0,-1,104966,95034
2:6:4,1,1,104965,95035
1:4:2,1,1,104964,95036
5:5:3,0,-1,104965,95035
1:2:2,2,2,104963,95037
5:4:4,0,-1,104964,95036
1:3:6,0,-1,104965,95035
2:4:1,1,1,104964,95036
5:5:4,0,-1,104965,95035
3:4:3,0,-1,104966,95034
6:1:6,0,-1,104967,95033
2:2:3,2,2,104965,95035
5:1:5,0,-1,104966,95034
6:1:5,0,-1,104967,95033
4:1:2,1,1,104966,95034
1:2:2,2,2,104964,95036
4:1:2,1,1,104963,95037
4:5:4,0,-1,104964,95036
3:4:1,0,-1,104965,95035
5:2:1,1,1,104964,95036
5:1:5,0,-1,104965,95035
2:6:6,1,1,104964,95036
6:2:1,1,1,104963,95037
3:6:6,0,-1,104964,95036
6:4:5,0,-1,104965,95035
6:6:4,0,-1,104966,95034
6:4:5,0,-1,104967,95033
1:3:5,0,-1,104968,95032
6:4:4,0,-1,104969,95031
6:6:6,0,-1,104970,95030
2:6:3,1,1,104969,95031
5:4:1,0,-1,104970,95030
1:1:2,1,1,104969,95031
1:1:4,0,-1,104970,95030
5:4:5,0,-1,104971,95029
6:2:6,1,1,104970,95030
4:6:1,0,-1,104971,95029
1:1:5,0,-1,104972,95028
1:6:6,0,-1,104973,95027
2:1:3,1,1,104972,95028
6:2:1,1,1,104971,95029
4:3:3,0,-1,104972,95028
6:1:5,0,-1,104973,95027
4:4:1,0,-1,104974,95026
1:1:6,0,-1,104975,95025
2:2:5,2,2,104973,95027
1:3:2,1,1,104972,95028
6:6:2,1,1,104971,95029
4:1:4,0,-1,104972,95028
5:2:2,2,2,104970,95030
3:3:1,0,-1,104971,95029
1:5:2,1,1,104970,95030
3:2:6,1,1,104969,95031
2:6:3,1,1,104968,95032
3:3:2,1,1,104967,95033
5:6:2,1,1,104966,95034
5:2:1,1,1,104965,95035
3:2:5,1,1,104964,95036
6:2:3,1,1,104963,95037
1:4:3,0,-1,104964,95036
1:6:4,0,-1,104965,95035
6:4:6,0,-1,104966,95034
2:4:1,1,1,104965,95035
2:5:2,2,2,104963,95037
4:1:2,1,1,104962,95038
4:1:6,0,-1,104963,95037
3:6:1,0,-1,104964,95036
5:4:6,0,-1,104965,95035
4:4:2,1,1,104964,95036
5:5:5,0,-1,104965,95035
4:5:5,0,-1,104966,95034
3:5:1,0,-1,104967,95033
1:1:6,0,-1,104968,95032
1:3:3,0,-1,104969,95031
2:2:4,2,2,104967,95033
4:2:5,1,1,104966,95034
4:4:6,0,-1,104967,95033
3:6:3,0,-1,104968,95032
1:3:6,0,-1,104969,95031
3:4:2,1,1,104968,95032
4:1:4,0,-1,104969,95031
5:1:2,1,1,104968,95032
2:3:5,1,1,104967,95033
6:3:2,1,1,104966,95034
1:1:4,0,-1,104967,95033
4:5:2,1,1,104966,95034
6:1:2,1,1,104965,95035
6:1:5,0,-1,104966,95034
4:4:4,0,-1,104967,95033
6:3:6,0,-1,104968,95032
3:4:4,0,-1,104969,95031
5:2:1,1,1,104968,95032
5:1:3,0,-1,104969,95031
4:1:6,0,-1,104970,95030
3:1:3,0,-1,104971,95029
4:1:4,0,-1,104972,95028
5:2:4,1,1,104971,95029
2:2:6,2,2,104969,95031
2:5:4,1,1,104968,95032
6:6:4,0,-1,104969,95031
2:6:2,2,2,104967,95033
6:1:2,1,1,104966,95034
2:3:2,2,2,104964,95036
4:2:5,1,1,104963,95037
4:1:5,0,-1,104964,95036
2:2:1,2,2,104962,95038
1:1:1,0,-1,104963,95037
6:5:1,0,-1,104964,95036
4:5:6,0,-1,104965,95035
2:4:4,1,1,104964,95036
1:4:4,0,-1,104965,95035
5:1:4,0,-1,104966,95034
6:3:1,0,-1,104967,95033
1:5:5,0,-1,104968,95032
3:5:6,0,-1,104969,95031
3:4:4,0,-1,104970,95030
6:6:4,0,-1,104971,95029
2:1:1,1,1,104970,95030
3:3:3,0,-1,104971,95029
1:1:1,0,-1,104972,95028
3:6:6,0,-1,104973,95027
1:4:6,0,-1,104974,95026
6:2:3,1,1,104973,95027
2:6:4,1,1,104972,95028
2:5:4,1,1,104971,95029
1:1:1,0,-1,104972,95028
4:6:2,1,1,104971,95029
2:4:2,2,2,104969,95031
4:6:6,0,-1,104970,95030
6:6:3,0,-1,104971,95029
2:3:2,2,2,104969,95031
1:4:1,0,-1,104970,95030
6:4:2,1,1,104969,95031
5:4:4,0,-1,104970,95030
3:6:4,0,-1,104971,95029
4:4:4,0,-1,104972,95028
5:2:4,1,1,104971,95029
2:6:2,2,2,104969,95031
2:1:2,2,2,104967,95033
1:1:1,0,-1,104968,95032
1:1:4,0,-1,104969,95031
3:5:3,0,-1,104970,95030
4:2:4,1,1,104969,95031
4:1:4,0,-1,104970,95030
1:5:1,0,-1,104971,95029
2:4:2,2,2,104969,95031
1:2:3,1,1,104968,95032
2:3:6,1,1,104967,95033
3:5:6,0,-1,104968,95032
4:3:6,0,-1,104969,95031
6:2:3,1,1,104968,95032
2:1:3,1,1,104967,95033
1:3:3,0,-1,104968,95032
5:4:2,1,1,104967,95033
6:5:2,1,1,104966,95034
3:4:1,0,-1,104967,95033
5:4:1,0,-1,104968,95032
6:6:1,0,-1,104969,95031
1:2:3,1,1,104968,95032
4:6:5,0,-1,104969,95031
1:6:6,0,-1,104970,95030
4:5:6,0,-1,104971,95029
6:4:3,0,-1,104972,95028
5:2:5,1,1,104971,95029
6:3:2,1,1,104970,95030
3:1:6,0,-1,104971,95029
5:3:3,0,-1,104972,95028
5:5:5,0,-1,104973,95027
3:1:3,0,-1,104974,95026
6:5:1,0,-1,104975,95025
3:5:5,0,-1,104976,95024
5:2:1,1,1,104975,95025
3:2:6,1,1,104974,95026
6:6:4,0,-1,104975,95025
1:1:6,0,-1,104976,95024
1:2:1,1,1,104975,95025
1:3:2,1,1,104974,95026
6:2:3,1,1,104973,95027
3:4:2,1,1,104972,95028
4:3:4,0,-1,104973,95027
3:3:1,0,-1,104974,95026
5:1:3,0,-1,104975,95025
3:5:3,0,-1,104976,95024
2:6:2,2,2,104974,95026
5:3:5,0,-1,104975,95025
3:1:6,0,-1,104976,95024
1:1:4,0,-1,104977,95023
1:3:1,0,-1,104978,95022
2:4:2,2,2,104976,95024
5:6:2,1,1,104975,95025
1:2:1,1,1,104974,95026
1:3:2,1,1,104973,95027
1:4:1,0,-1,104974,95026
4:6:2,1,1,104973,95027
6:5:2,1,1,104972,95028
2:2:6,2,2,104970,95030
5:5:4,0,-1,104971,95029
6:6:2,1,1,104970,95030
5:6:2,1,1,104969,95031
1:1:2,1,1,104968,95032
5:1:3,0,-1,104969,95031
5:3:6,0,-1,104970,95030
5:5:6,0,-1,104971,95029
2:1:5,1,1,104970,95030
2:5:5,1,1,104969,95031
5:1:3,0,-1,104970,95030
3:2:1,1,1,104969,95031
5:1:3,0,-1,104970,95030
1:3:5,0,-1,104971,95029
5:1:1,0,-1,104972,95028
1:6:3,0,-1,104973,95027
6:3:5,0,-1,104974,95026
3:1:3,0,-1,104975,95025
2:3:2,2,2,104973,95027
1:2:3,1,1,104972,95028
6:2:4,1,1,104971,95029
1:1:1,0,-1,104972,95028
6:5:4,0,-1,104973,95027
4:6:2,1,1,104972,95028
6:1:6,0,-1,104973,95027
4:6:1,0,-1,104974,95026
6:1:4,0,-1,104975,95025
5:5:6,0,-1,104976,95024
4:5:5,0,-1,104977,95023
6:3:2,1,1,104976,95024
4:4:4,0,-1,104977,95023
4:1:5,0,-1,104978,95022
3:1:4,0,-1,104979,95021
6:6:5,0,-1,104980,95020
1:2:1,1,1,104979,95021
3:2:2,2,2,104977,95023
1:2:6,1,1,104976,95024
6:2:2,2,2,104974,95026
5:2:6,1,1,104973,95027
2:6:5,1,1,104972,95028
5:4:5,0,-1,104973,95027
6:4:5,0,-1,104974,95026
1:6:4,0,-1,104975,95025
4:5:6,0,-1,104976,95024
1:5:4,0,-1,104977,95023
3:1:2,1,1,104976,95024
3:5:5,0,-1,104977,95023
4:1:2,1,1,104976,95024
5:6:4,0,-1,104977,95023
6:1:6,0,-1,104978,95022
3:4:2,1,1,104977,95023
3:4:3,0,-1,104978,95022
4:4:3,0,-1,104979,95021
4:1:3,0,-1,104980,95020
4:6:1,0,-1,104981,95019
6:4:2,1,1,104980,95020
2:1:4,1,1,104979,95021
6:3:2,1,1,104978,95022
1:4:5,0,-1,104979,95021
4:4:1,0,-1,104980,95020
2:2:1,2,2,104978,95022
1:6:2,1,1,104977,95023
5:1:3,0,-1,104978,95022
4:3:4,0,-1,104979,95021
3:1:2,1,1,104978,95022
5:4:4,0,-1,104979,95021
6:5:1,0,-1,104980,95020
2:1:5,1,1,104979,95021
5:4:5,0,-1,104980,95020
6:2:1,1,1,104979,95021
4:5:3,0,-1,104980,95020
6:2:1,1,1,104979,95021
5:2:6,1,1,104978,95022
6:3:3,0,-1,104979,95021
3:5:1,0,-1,104980,95020
1:6:4,0,-1,104981,95019
1:1:3,0,-1,104982,95018
2:2:4,2,2,104980,95020
2:6:1,1,1,104979,95021
5:5:6,0,-1,104980,95020
2:2:4,2,2,104978,95022
2:6:4,1,1,104977,95023
2:2:6,2,2,104975,95025
2:1:3,1,1,104974,95026
6:2:4,1,1,104973,95027
5:6:4,0,-1,104974,95026
2:1:2,2,2,104972,95028
3:5:4,0,-1,104973,95027
3:4:1,0,-1,104974,95026
1:2:5,1,1,104973,95027
6:5:5,0,-1,104974,95026
3:4:2,1,1,104973,95027
3:1:1,0,-1,104974,95026
3:1:6,0,-1,104975,95025
4:2:4,1,1,104974,95026
4:5:4,0,-1,104975,95025
5:4:3,0,-1,104976,95024
2:5:6,1,1,104975,95025
5:1:3,0,-1,104976,95024
3:6:1,0,-1,104977,95023
3:4:3,0,-1,104978,95022
3:6:3,0,-1,104979,95021
2:1:4,1,1,104978,95022
5:4:1,0,-1,104979,95021
2:1:6,1,1,104978,95022
2:5:4,1,1,104977,95023
2:6:2,2,2,104975,95025
5:5:1,0,-1,104976,95024
6:4:3,0,-1,104977,95023
4:3:5,0,-1,104978,95022
6:6:4,0,-1,104979,95021
3:4:1,0,-1,104980,95020
5:3:6,0,-1,104981,95019
1:2:5,1,1,104980,95020
3:3:2,1,1,104979,95021
3:2:2,2,2,104977,95023
3:3:6,0,-1,104978,95022
2:5:2,2,2,104976,95024
3:4:2,1,1,104975,95025
6:4:2,1,1,104974,95026
5:4:6,0,-1,104975,95025
3:5:5,0,-1,104976,95024
6:5:3,0,-1,104977,95023
4:3:3,0,-1,104978,95022
3:5:2,1,1,104977,95023
2:3:6,1,1,104976,95024
1:2:2,2,2,104974,95026
5:2:6,1,1,104973,95027
5:3:5,0,-1,104974,95026
3:4:3,0,-1,104975,95025
2:4:6,1,1,104974,95026
6:3:4,0,-1,104975,95025
6:2:3,1,1,104974,95026
4:4:1,0,-1,104975,95025
2:4:5,1,1,104974,95026
5:4:2,1,1,104973,95027
3:2:6,1,1,104972,95028
6:6:6,0,-1,104973,95027
5:6:3,0,-1,104974,95026
4:6:5,0,-1,104975,95025
6:1:1,0,-1,104976,95024
3:1:4,0,-1,104977,95023
1:3:5,0,-1,104978,95022
3:3:1,0,-1,104979,95021
2:6:2,2,2,104977,95023
2:6:1,1,1,104976,95024
3:3:4,0,-1,104977,95023
6:1:1,0,-1,104978,95022
6:1:4,0,-1,104979,95021
4:4:3,0,-1,104980,95020
4:6:4,0,-1,104981,95019
1:3:4,0,-1,104982,95018
4:3:1,0,-1,104983,95017
6:5:3,0,-1,104984,95016
5:2:4,1,1,104983,95017
4:6:6,0,-1,104984,95016
5:2:4,1,1,104983,95017
4:2:6,1,1,104982,95018
3:3:2,1,1,104981,95019
5:2:2,2,2,104979,95021
5:1:4,0,-1,104980,95020
1:6:1,0,-1,104981,95019
5:4:6,0,-1,104982,95018
6:2:5,1,1,104981,95019
2:5:2,2,2,104979,95021
5:2:1,1,1,104978,95022
2:2:5,2,2,104976,95024
2:6:2,2,2,104974,95026
1:3:1,0,-1,104975,95025
6:3:4,0,-1,104976,95024
6:3:6,0,-1,104977,95023
1:1:1,0,-1,104978,95022
1:5:5,0,-1,104979,95021
4:4:6,0,-1,104980,95020
2:1:3,1,1,104979,95021
5:2:6,1,1,104978,95022
6:1:5,0,-1,104979,95021
4:4:6,0,-1,104980,95020
3:2:5,1,1,104979,95021
1:1:6,0,-1,104980,95020
1:3:4,0,-1,104981,95019
2:1:5,1,1,104980,95020
4:4:2,1,1,104979,95021
4:4:4,0,-1,104980,95020
6:2:1,1,1,104979,95021
1:3:1,0,-1,104980,95020
3:4:3,0,-1,104981,95019
2:6:1,1,1,104980,95020
6:4:3,0,-1,104981,95019
1:2:1,1,1,104980,95020
3:6:6,0,-1,104981,95019
4:5:2,1,1,104980,95020
4:1:1,0,-1,104981,95019
4:2:6,1,1,104980,95020
2:1:3,1,1,104979,95021
1:4:2,1,1,104978,95022
2:4:5,1,1,104977,95023
3:2:6,1,1,104976,95024
2:1:6,1,1,104975,95025
4:3:1,0,-1,104976,95024
4:2:5,1,1,104975,95025
4:6:4,0,-1,104976,95024
6:6:6,0,-1,104977,95023
6:5:6,0,-1,104978,95022
2:4:2,2,2,104976,95024
1:1:3,0,-1,104977,95023
2:4:2,2,2,104975,95025
1:4:6,0,-1,104976,95024
5:6:6,0,-1,104977,95023
6:1:2,1,1,104976,95024
1:4:1,0,-1,104977,95023
5:6:3,0,-1,104978,95022
2:6:3,1,1,104977,95023
2:4:2,2,2,104975,95025
5:6:2,1,1,104974,95026
5:4:6,0,-1,104975,95025
6:6:3,0,-1,104976,95024
1:5:2,1,1,104975,95025
1:1:6,0,-1,104976,95024
5:2:2,2,2,104974,95026
1:5:6,0,-1,104975,95025
1:2:4,1,1,104974,95026
5:3:3,0,-1,104975,95025
5:1:2,1,1,104974,95026
5:2:6,1,1,104973,95027
4:6:3,0,-1,104974,95026
2:4:4,1,1,104973,95027
6:4:4,0,-1,104974,95026
2:3:4,1,1,104973,95027
6:1:1,0,-1,104974,95026
6:5:3,0,-1,104975,95025
4:2:1,1,1,104974,95026
2:4:4,1,1,104973,95027
5:2:4,1,1,104972,95028
6:3:5,0,-1,104973,95027
3:1:3,0,-1,104974,95026
6:1:3,0,-1,104975,95025
1:4:3,0,-1,104976,95024
5:2:2,2,2,104974,95026
6:5:6,0,-1,104975,95025
2:4:6,1,1,104974,95026
2:3:4,1,1,104973,95027
6:4:2,1,1,104972,95028
2:5:6,1,1,104971,95029
6:1:1,0,-1,104972,95028
4:5:3,0,-1,104973,95027
5:2:4,1,1,104972,95028
4:1:3,0,-1,104973,95027
1:1:4,0,-1,104974,95026
1:4:1,0,-1,104975,95025
1:5:3,0,-1,104976,95024
5:6:3,0,-1,104977,95023
1:4:5,0,-1,104978,95022
6:6:4,0,-1,104979,95021
4:6:2,1,1,104978,95022
6:5:6,0,-1,104979,95021
4:6:2,1,1,104978,95022
1:2:5,1,1,104977,95023
5:2:5,1,1,104976,95024
5:2:5,1,1,104975,95025
1:3:6,0,-1,104976,95024
2:3:5,1,1,104975,95025
3:3:4,0,-1,104976,95024
3:3:2,1,1,104975,95025
5:6:4,0,-1,104976,95024
3:4:1,0,-1,104977,95023
6:1:4,0,-1,104978,95022
2:5:2,2,2,104976,95024
4:4:4,0,-1,104977,95023
5:5:3,0,-1,104978,95022
3:6:6,0,-1,104979,95021
4:2:4,1,1,104978,95022
6:5:6,0,-1,104979,95021
4:2:6,1,1,104978,95022
5:4:2,1,1,104977,95023
6:4:5,0,-1,104978,95022
6:5:4,0,-1,104979,95021
3:1:3,0,-1,104980,95020
4:5:1,0,-1,104981,95019
2:6:2,2,2,104979,95021
4:5:4,0,-1,104980,95020
3:1:6,0,-1,104981,95019
2:6:4,1,1,104980,95020
3:1:5,0,-1,104981,95019
6:2:4,1,1,104980,95020
1:4:6,0,-1,104981,95019
1:3:6,0,-1,104982,95018
4:2:3,1,1,104981,95019
3:4:5,0,-1,104982,95018
2:1:2,2,2,104980,95020
2:1:4,1,1,104979,95021
3:4:5,0,-1,104980,95020
3:4:3,0,-1,104981,95019
1:6:2,1,1,104980,95020
3:6:6,0,-1,104981,95019
1:6:5,0,-1,104982,95018
1:3:1,0,-1,104983,95017
2:1:1,1,1,104982,95018
2:1:1,1,1,104981,95019
3:5:6,0,-1,104982,95018
3:4:1,0,-1,104983,95017
5:4:5,0,-1,104984,95016
5:1:1,0,-1,104985,95015
6:1:6,0,-1,104986,95014
1:4:5,0,-1,104987,95013
3:1:2,1,1,104986,95014
6:2:5,1,1,104985,95015
1:5:4,0,-1,104986,95014
6:6:1,0,-1,104987,95013
2:1:5,1,1,104986,95014
2:6:1,1,1,104985,95015
6:5:4,0,-1,104986,95014
6:3:6,0,-1,104987,95013
3:4:1,0,-1,104988,95012
5:2:4,1,1,104987,95013
6:2:3,1,1,104986,95014
3:5:2,1,1,104985,95015
4:3:4,0,-1,104986,95014
2:3:2,2,2,104984,95016
3:5:2,1,1,104983,95017
4:2:1,1,1,104982,95018
1:4:5,0,-1,104983,95017
2:2:5,2,2,104981,95019
2:3:5,1,1,104980,95020
2:3:2,2,2,104978,95022
5:5:3,0,-1,104979,95021
3:4:2,1,1,104978,95022
5:4:5,0,-1,104979,95021
3:1:2,1,1,104978,95022
6:4:6,0,-1,104979,95021
2:1:5,1,1,104978,95022
5:5:6,0,-1,104979,95021
6:1:3,0,-1,104980,95020
2:2:2,3,3,104977,95023
3:1:2,1,1,104976,95024
3:5:1,0,-1,104977,95023
6:5:5,0,-1,104978,95022
4:3:2,1,1,104977,95023
1:2:4,1,1,104976,95024
3:5:5,0,-1,104977,95023
1:2:3,1,1,104976,95024
4:2:2,2,2,104974,95026
2:3:6,1,1,104973,95027
4:4:5,0,-1,104974,95026
3:2:3,1,1,104973,95027
4:5:1,0,-1,104974,95026
3:4:3,0,-1,104975,95025
1:4:1,0,-1,104976,95024
2:5:2,2,2,104974,95026
4:5:2,1,1,104973,95027
3:4:5,0,-1,104974,95026
1:4:3,0,-1,104975,95025
1:2:5,1,1,104974,95026
6:3:1,0,-1,104975,95025
2:6:6,1,1,104974,95026
6:1:1,0,-1,104975,95025
5:5:1,0,-1,104976,95024
2:2:2,3,3,104973,95027
4:2:2,2,2,104971,95029
2:6:5,1,1,104970,95030
5:1:3,0,-1,104971,95029
5:5:4,0,-1,104972,95028
1:5:4,0,-1,104973,95027
3:1:6,0,-1,104974,95026
3:2:4,1,1,104973,95027
6:6:4,0,-1,104974,95026
2:2:2,3,3,104971,95029
6:1:5,0,-1,104972,95028
4:1:2,1,1,104971,95029
2:6:1,1,1,104970,95030
4:1:4,0,-1,104971,95029
1:6:3,0,-1,104972,95028
4:1:6,0,-1,104973,95027
4:2:6,1,1,104972,95028
4:1:6,0,-1,104973,95027
5:6:3,0,-1,104974,95026
1:2:3,1,1,104973,95027
2:6:1,1,1,104972,95028
6:4:5,0,-1,104973,95027
2:2:2,3,3,104970,95030
3:4:1,0,-1,104971,95029
6:6:5,0,-1,104972,95028
5:1:6,0,-1,104973,95027
3:4:6,0,-1,104974,95026
1:6:3,0,-1,104975,95025
6:6:3,0,-1,104976,95024
3:6:5,0,-1,104977,95023
4:2:1,1,1,104976,95024
5:2:6,1,1,104975,95025
3:5:1,0,-1,104976,95024
2:2:6,2,2,104974,95026
1:3:1,0,-1,104975,95025
4:4:3,0,-1,104976,95024
5:5:4,0,-1,104977,95023
2:5:2,2,2,104975,95025
2:4:6,1,1,104974,95026
6:6:4,0,-1,104975,95025
5:2:5,1,1,104974,95026
1:6:2,1,1,104973,95027
1:5:4,0,-1,104974,95026
6:3:1,0,-1,104975,95025
3:6:2,1,1,104974,95026
6:5:3,0,-1,104975,95025
4:4:2,1,1,104974,95026
6:4:5,0,-1,104975,95025
2:5:3,1,1,104974,95026
6:1:6,0,-1,104975,95025
2:6:6,1,1,104974,95026
3:5:4,0,-1,104975,95025
6:6:1,0,-1,104976,95024
6:6:5,0,-1,104977,95023
4:6:2,1,1,104976,95024
3:1:2,1,1,104975,95025
1:2:3,1,1,104974,95026
1:2:6,1,1,104973,95027
6:1:6,0,-1,104974,95026
3:4:3,0,-1,104975,95025
4:4:3,0,-1,104976,95024
6:3:6,0,-1,104977,95023
3:4:3,0,-1,104978,95022
5:4:1,0,-1,104979,95021
1:5:2,1,1,104978,95022
2:4:3,1,1,104977,95023
6:6:5,0,-1,104978,95022
3:3:4,0,-1,104979,95021
2:4:2,2,2,104977,95023
2:6:5,1,1,104976,95024
4:4:4,0,-1,104977,95023
3:3:2,1,1,104976,95024
4:3:1,0,-1,104977,95023
2:2:3,2,2,104975,95025
5:1:1,0,-1,104976,95024
6:4:6,0,-1,104977,95023
1:2:4,1,1,104976,95024
2:5:2,2,2,104974,95026
1:6:5,0,-1,104975,95025
3:1:5,0,-1,104976,95024
1:1:4,0,-1,104977,95023
4:2:1,1,1,104976,95024
2:3:1,1,1,104975,95025
5:4:3,0,-1,104976,95024
1:1:4,0,-1,104977,95023
2:4:5,1,1,104976,95024
6:2:4,1,1,104975,95025
6:6:3,0,-1,104976,95024
6:6:2,1,1,104975,95025
1:2:5,1,1,104974,95026
3:1:6,0,-1,104975,95025
5:1:5,0,-1,104976,95024
1:2:5,1,1,104975,95025
5:5:3,0,-1,104976,95024
6:6:5,0,-1,104977,95023
5:5:5,0,-1,104978,95022
6:5:1,0,-1,104979,95021
2:1:4,1,1,104978,95022
2:3:1,1,1,104977,95023
1:5:4,0,-1,104978,95022
1:1:4,0,-1,104979,95021
5:5:4,0,-1,104980,95020
5:2:2,2,2,104978,95022
5:2:2,2,2,104976,95024
1:6:4,0,-1,104977,95023
5:2:2,2,2,104975,95025
6:5:4,0,-1,104976,95024
6:3:3,0,-1,104977,95023
6:3:2,1,1,104976,95024
1:1:5,0,-1,104977,95023
3:5:4,0,-1,104978,95022
3:3:3,0,-1,104979,95021
6:1:1,0,-1,104980,95020
6:2:4,1,1,104979,95021
3:1:1,0,-1,104980,95020
2:4:3,1,1,104979,95021
1:1:6,0,-1,104980,95020
2:5:4,1,1,104979,95021
1:1:4,0,-1,104980,95020
1:3:2,1,1,104979,95021
2:6:3,1,1,104978,95022
2:3:6,1,1,104977,95023
4:5:6,0,-1,104978,95022
6:1:2,1,1,104977,95023
6:4:6,0,-1,104978,95022
6:1:4,0,-1,104979,95021
5:6:6,0,-1,104980,95020
3:4:1,0,-1,104981,95019
3:4:3,0,-1,104982,95018
2:6:1,1,1,104981,95019
5:3:1,0,-1,104982,95018
4:5:2,1,1,104981,95019
4:5:5,0,-1,104982,95018
6:1:2,1,1,104981,95019
4:1:2,1,1,104980,95020
5:1:2,1,1,104979,95021
4:2:6,1,1,104978,95022
6:2:1,1,1,104977,95023
6:2:3,1,1,104976,95024
4:1:3,0,-1,104977,95023
6:5:4,0,-1,104978,95022
3:4:6,0,-1,104979,95021
2:2:6,2,2,104977,95023
2:5:4,1,1,104976,95024
4:5:5,0,-1,104977,95023
1:5:5,0,-1,104978,95022
6:1:4,0,-1,104979,95021
2:2:5,2,2,104977,95023
4:3:3,0,-1,104978,95022
3:2:2,2,2,104976,95024
2:1:6,1,1,104975,95025
2:4:2,2,2,104973,95027
6:5:3,0,-1,104974,95026
5:4:6,0,-1,104975,95025
2:3:3,1,1,104974,95026
1:1:2,1,1,104973,95027
6:4:4,0,-1,104974,95026
3:6:3,0,-1,104975,95025
2:6:5,1,1,104974,95026
2:1:4,1,1,104973,95027
1:4:2,1,1,104972,95028
2:6:5,1,1,104971,95029
6:2:2,2,2,104969,95031
6:6:1,0,-1,104970,95030
6:6:6,0,-1,104971,95029
1:2:4,1,1,104970,95030
4:6:4,0,-1,104971,95029
4:4:5,0,-1,104972,95028
2:6:6,1,1,104971,95029
3:5:5,0,-1,104972,95028
5:5:6,0,-1,104973,95027
6:2:4,1,1,104972,95028
2:2:5,2,2,104970,95030
6:2:5,1,1,104969,95031
5:6:5,0,-1,104970,95030
2:6:5,1,1,104969,95031
3:1:1,0,-1,104970,95030
5:5:5,0,-1,104971,95029
2:2:1,2,2,104969,95031
2:2:5,2,2,104967,95033
1:6:4,0,-1,104968,95032
1:4:1,0,-1,104969,95031
4:4:6,0,-1,104970,95030
6:6:3,0,-1,104971,95029
6:4:3,0,-1,104972,95028
3:5:1,0,-1,104973,95027
5:4:1,0,-1,104974,95026
6:6:4,0,-1,104975,95025
6:5:2,1,1,104974,95026
6:1:2,1,1,104973,95027
2:3:1,1,1,104972,95028
4:2:5,1,1,104971,95029
6:2:5,1,1,104970,95030
6:2:3,1,1,104969,95031
4:1:4,0,-1,104970,95030
6:5:1,0,-1,104971,95029
2:1:3,1,1,104970,95030
5:4:5,0,-1,104971,95029
4:1:5,0,-1,104972,95028
6:1:5,0,-1,104973,95027
5:2:4,1,1,104972,95028
5:1:3,0,-1,104973,95027
3:3:1,0,-1,104974,95026
3:3:6,0,-1,104975,95025
6:3:1,0,-1,104976,95024
4:3:2,1,1,104975,95025
4:6:6,0,-1,104976,95024
6:1:2,1,1,104975,95025
5:3:1,0,-1,104976,95024
6:2:6,1,1,104975,95025
1:5:5,0,-1,104976,95024
4:4:5,0,-1,104977,95023
5:4:6,0,-1,104978,95022
2:1:3,1,1,104977,95023
1:6:5,0,-1,104978,95022
1:2:4,1,1,104977,95023
6:1:6,0,-1,104978,95022
1:5:6,0,-1,104979,95021
6:3:6,0,-1,104980,95020
2:5:6,1,1,104979,95021
4:1:2,1,1,104978,95022
4:4:2,1,1,104977,95023
1:3:5,0,-1,104978,95022
1:5:3,0,-1,104979,95021
5:1:3,0,-1,104980,95020
5:1:4,0,-1,104981,95019
2:3:4,1,1,104980,95020
6:3:1,0,-1,104981,95019
3:1:4,0,-1,104982,95018
6:2:5,1,1,104981,95019
1:2:2,2,2,104979,95021
4:1:6,0,-1,104980,95020
5:3:4,0,-1,104981,95019
2:6:2,2,2,104979,95021
1:6:1,0,-1,104980,95020
1:1:6,0,-1,104981,95019
3:6:5,0,-1,104982,95018
2:3:2,2,2,104980,95020
6:5:4,0,-1,104981,95019
6:6:3,0,-1,104982,95018
3:6:2,1,1,104981,95019
4:6:2,1,1,104980,95020
1:6:5,0,-1,104981,95019
3:2:5,1,1,104980,95020
5:3:3,0,-1,104981,95019
3:1:1,0,-1,104982,95018
2:1:6,1,1,104981,95019
2:4:5,1,1,104980,95020
3:2:5,1,1,104979,95021
2:1:6,1,1,104978,95022
3:4:4,0,-1,104979,95021
6:3:5,0,-1,104980,95020
4:3:3,0,-1,104981,95019
3:5:4,0,-1,104982,95018
2:1:3,1,1,104981,95019
1:6:4,0,-1,104982,95018
4:1:3,0,-1,104983,95017
3:6:4,0,-1,104984,95016
5:3:6,0,-1,104985,95015
6:4:6,0,-1,104986,95014
3:6:4,0,-1,104987,95013
2:6:4,1,1,104986,95014
1:5:1,0,-1,104987,95013
6:4:4,0,-1,104988,95012
5:2:5,1,1,104987,95013
1:4:6,0,-1,104988,95012
4:4:2,1,1,104987,95013
6:6:6,0,-1,104988,95012
4:5:6,0,-1,104989,95011
6:1:3,0,-1,104990,95010
1:1:2,1,1,104989,95011
3:3:4,0,-1,104990,95010
5:2:3,1,1,104989,95011
4:1:4,0,-1,104990,95010
4:2:4,1,1,104989,95011
2:2:4,2,2,104987,95013
5:6:2,1,1,104986,95014
4:3:4,0,-1,104987,95013
2:4:2,2,2,104985,95015
4:4:5,0,-1,104986,95014
1:3:5,0,-1,104987,95013
3:4:2,1,1,104986,95014
3:2:2,2,2,104984,95016
1:1:1,0,-1,104985,95015
1:6:3,0,-1,104986,95014
2:3:1,1,1,104985,95015
4:2:5,1,1,104984,95016
5:6:6,0,-1,104985,95015
5:4:5,0,-1,104986,95014
6:6:4,0,-1,104987,95013
5:3:3,0,-1,104988,95012
1:2:4,1,1,104987,95013
2:5:4,1,1,104986,95014
4:1:3,0,-1,104987,95013
6:2:4,1,1,104986,95014
2:6:3,1,1,104985,95015
6:5:2,1,1,104984,95016
4:5:3,0,-1,104985,95015
5:4:5,0,-1,104986,95014
2:1:1,1,1,104985,95015
1:6:6,0,-1,104986,95014
6:2:2,2,2,104984,95016
2:3:2,2,2,104982,95018
5:3:3,0,-1,104983,95017
3:1:5,0,-1,104984,95016
2:2:4,2,2,104982,95018
5:5:6,0,-1,104983,95017
5:4:2,1,1,104982,95018
2:3:5,1,1,104981,95019
1:5:6,0,-1,104982,95018
2:2:2,3,3,104979,95021
1:4:5,0,-1,104980,95020
4:5:5,0,-1,104981,95019
1:2:5,1,1,104980,95020
1:4:6,0,-1,104981,95019
3:6:6,0,-1,104982,95018
6:6:6,0,-1,104983,95017
6:4:2,1,1,104982,95018
6:6:6,0,-1,104983,95017
5:1:6,0,-1,104984,95016
6:4:5,0,-1,104985,95015
1:2:6,1,1,104984,95016
1:3:5,0,-1,104985,95015
5:4:5,0,-1,104986,95014
6:3:4,0,-1,104987,95013
5:2:5,1,1,104986,95014
5:6:4,0,-1,104987,95013
6:3:2,1,1,104986,95014
1:3:1,0,-1,104987,95013
1:5:3,0,-1,104988,95012
3:3:1,0,-1,104989,95011
5:6:3,0,-1,104990,95010
5:2:4,1,1,104989,95011
4:6:3,0,-1,104990,95010
4:1:5,0,-1,104991,95009
3:4:5,0,-1,104992,95008
5:1:3,0,-1,104993,95007
6:2:5,1,1,104992,95008
1:2:5,1,1,104991,95009
6:6:5,0,-1,104992,95008
3:2:1,1,1,104991,95009
3:5:4,0,-1,104992,95008
1:6:3,0,-1,104993,95007
3:3:2,1,1,104992,95008
3:1:6,0,-1,104993,95007
4:6:5,0,-1,104994,95006
3:3:2,1,1,104993,95007
3:4:1,0,-1,104994,95006
3:3:4,0,-1,104995,95005
5:5:6,0,-1,104996,95004
1:1:4,0,-1,104997,95003
6:2:6,1,1,104996,95004
1:2:4,1,1,104995,95005
1:2:4,1,1,104994,95006
6:5:5,0,-1,104995,95005
6:5:3,0,-1,104996,95004
5:6:4,0,-1,104997,95003
3:4:1,0,-1,104998,95002
6:1:1,0,-1,104999,95001
5:4:6,0,-1,105000,95000
2:5:1,1,1,104999,95001
1:2:5,1,1,104998,95002
3:2:3,1,1,104997,95003
5:4:6,0,-1,104998,95002
3:2:5,1,1,104997,95003
4:2:1,1,1,104996,95004
5:5:4,0,-1,104997,95003
6:4:4,0,-1,104998,95002
1:1:2,1,1,104997,95003
1:1:5,0,-1,104998,95002
6:4:6,0,-1,104999,95001
3:6:5,0,-1,105000,95000
3:1:6,0,-1,105001,94999
6:1:3,0,-1,105002,94998
3:1:1,0,-1,105003,94997
1:4:5,0,-1,105004,94996
2:3:4,1,1,105003,94997
4:6:2,1,1,105002,94998
2:3:4,1,1,105001,94999
3:4:3,0,-1,105002,94998
5:1:1,0,-1,105003,94997
1:6:2,1,1,105002,94998
3:1:1,0,-1,105003,94997
3:6:3,0,-1,105004,94996
3:5:2,1,1,105003,94997
6:6:6,0,-1,105004,94996
4:3:5,0,-1,105005,94995
1:3:6,0,-1,105006,94994
4:3:5,0,-1,105007,94993
1:1:4,0,-1,105008,94992
2:2:5,2,2,105006,94994
5:5:3,0,-1,105007,94993
2:3:5,1,1,105006,94994
6:2:3,1,1,105005,94995
6:5:5,0,-1,105006,94994
3:6:6,0,-1,105007,94993
3:5:1,0,-1,105008,94992
4:4:5,0,-1,105009,94991
2:2:2,3,3,105006,94994
4:2:1,1,1,105005,94995
1:6:2,1,1,105004,94996
4:5:3,0,-1,105005,94995
6:1:6,0,-1,105006,94994
5:6:6,0,-1,105007,94993
2:1:1,1,1,105006,94994
3:6:3,0,-1,105007,94993
6:6:2,1,1,105006,94994
5:1:1,0,-1,105007,94993
2:2:4,2,2,105005,94995
4:2:2,2,2,105003,94997
4:4:5,0,-1,105004,94996
3:6:2,1,1,105003,94997
2:6:2,2,2,105001,94999
5:1:3,0,-1,105002,94998
4:6:1,0,-1,105003,94997
2:5:3,1,1,105002,94998
1:3:1,0,-1,105003,94997
5:2:3,1,1,105002,94998
3:4:6,0,-1,105003,94997
2:5:2,2,2,105001,94999
1:2:5,1,1,105000,95000
6:2:1,1,1,104999,95001
2:5:3,1,1,104998,95002
4:4:2,1,1,104997,95003
5:3:3,0,-1,104998,95002
5:2:5,1,1,104997,95003
1:4:3,0,-1,104998,95002
2:1:1,1,1,104997,95003
2:6:5,1,1,104996,95004
5:6:5,0,-1,104997,95003
6:1:5,0,-1,104998,95002
4:3:5,0,-1,104999,95001
4:4:2,1,1,104998,95002
4:6:5,0,-1,104999,95001
4:5:1,0,-1,105000,95000
1:4:1,0,-1,105001,94999
2:1:4,1,1,105000,95000
2:4:6,1,1,104999,95001
1:6:3,0,-1,105000,95000
3:3:3,0,-1,105001,94999
1:1:4,0,-1,105002,94998
6:6:6,0,-1,105003,94997
1:6:6,0,-1,105004,94996
2:1:1,1,1,105003,94997
1:2:1,1,1,105002,94998
5:3:6,0,-1,105003,94997
6:6:1,0,-1,105004,94996
4:4:6,0,-1,105005,94995
2:5:5,1,1,105004,94996
5:5:2,1,1,105003,94997
3:5:3,0,-1,105004,94996
5:5:2,1,1,105003,94997
2:1:2,2,2,105001,94999
6:3:5,0,-1,105002,94998
2:1:5,1,1,105001,94999
1:2:1,1,1,105000,95000
6:1:2,1,1,104999,95001
1:2:4,1,1,104998,95002
5:1:4,0,-1,104999,95001
2:6:1,1,1,104998,95002
2:5:6,1,1,104997,95003
6:6:6,0,-1,104998,95002
3:6:2,1,1,104997,95003
3:2:1,1,1,104996,95004
6:3:3,0,-1,104997,95003
4:1:2,1,1,104996,95004
6:2:4,1,1,104995,95005
6:3:6,0,-1,104996,95004
3:6:5,0,-1,104997,95003
4:5:5,0,-1,104998,95002
5:3:5,0,-1,104999,95001
2:2:5,2,2,104997,95003
4:5:5,0,-1,104998,95002
6:3:2,1,1,104997,95003
5:4:6,0,-1,104998,95002
6:2:1,1,1,104997,95003
4:2:2,2,2,104995,95005
4:1:5,0,-1,104996,95004
3:5:5,0,-1,104997,95003
5:2:6,1,1,104996,95004
2:4:4,1,1,104995,95005
1:5:6,0,-1,104996,95004
1:1:3,0,-1,104997,95003
5:6:1,0,-1,104998,95002
3:2:4,1,1,104997,95003
5:5:3,0,-1,104998,95002
4:3:4,0,-1,104999,95001
5:5:1,0,-1,105000,95000
6:3:3,0,-1,105001,94999
1:4:5,0,-1,105002,94998
5:5:2,1,1,105001,94999
3:5:1,0,-1,105002,94998
5:5:6,0,-1,105003,94997
2:5:5,1,1,105002,94998
5:3:2,1,1,105001,94999
3:2:6,1,1,105000,95000
3:3:1,0,-1,105001,94999
2:1:6,1,1,105000,95000
2:2:5,2,2,104998,95002
6:3:1,0,-1,104999,95001
3:2:6,1,1,104998,95002
2:6:2,2,2,104996,95004
3:4:5,0,-1,104997,95003
6:2:3,1,1,104996,95004
1:3:6,0,-1,104997,95003
4:5:5,0,-1,104998,95002
5:4:3,0,-1,104999,95001
5:6:2,1,1,104998,95002
6:1:2,1,1,104997,95003
4:1:5,0,-1,104998,95002
2:1:6,1,1,104997,95003
3:2:5,1,1,104996,95004
5:4:3,0,-1,104997,95003
5:2:4,1,1,104996,95004
3:5:1,0,-1,104997,95003
1:2:3,1,1,104996,95004
2:3:6,1,1,104995,95005
4:5:5,0,-1,104996,95004
1:3:3,0,-1,104997,95003
5:1:2,1,1,104996,95004
6:5:4,0,-1,104997,95003
5:2:3,1,1,104996,95004
6:1:5,0,-1,104997,95003
1:2:5,1,1,104996,95004
3:2:1,1,1,104995,95005
4:1:6,0,-1,104996,95004
1:3:2,1,1,104995,95005
2:4:4,1,1,104994,95006
4:3:2,1,1,104993,95007
2:5:6,1,1,104992,95008
5:5:3,0,-1,104993,95007
4:3:5,0,-1,104994,95006
1:4:2,1,1,104993,95007
5:1:4,0,-1,104994,95006
1:2:1,1,1,104993,95007
1:5:1,0,-1,104994,95006
5:1:1,0,-1,104995,95005
4:6:4,0,-1,104996,95004
1:2:1,1,1,104995,95005
5:2:3,1,1,104994,95006
4:6:2,1,1,104993,95007
6:4:1,0,-1,104994,95006
1:4:6,0,-1,104995,95005
3:1:4,0,-1,104996,95004
2:1:2,2,2,104994,95006
5:2:2,2,2,104992,95008
4:3:6,0,-1,104993,95007
5:1:1,0,-1,104994,95006
3:3:2,1,1,104993,95007
3:5:4,0,-1,104994,95006
4:3:2,1,1,104993,95007
3:5:2,1,1,104992,95008
4:1:5,0,-1,104993,95007
1:5:2,1,1,104992,95008
4:2:1,1,1,104991,95009
4:1:4,0,-1,104992,95008
6:5:2,1,1,104991,95009
3:4:6,0,-1,104992,95008
5:1:5,0,-1,104993,95007
4:3:5,0,-1,104994,95006
4:6:6,0,-1,104995,95005
1:3:2,1,1,104994,95006
2:2:4,2,2,104992,95008
3:1:2,1,1,104991,95009
4:4:3,0,-1,104992,95008
3:3:4,0,-1,104993,95007
4:3:5,0,-1,104994,95006
6:2:2,2,2,104992,95008
5:2:6,1,1,104991,95009
1:4:2,1,1,104990,95010
4:4:3,0,-1,104991,95009
5:4:2,1,1,104990,95010
1:1:1,0,-1,104991,95009
3:4:5,0,-1,104992,95008
4:4:1,0,-1,104993,95007
3:3:3,0,-1,104994,95006
4:6:4,0,-1,104995,95005
1:1:6,0,-1,104996,95004
1:3:1,0,-1,104997,95003
1:5:2,1,1,104996,95004
6:6:1,0,-1,104997,95003
6:6:2,1,1,104996,95004
2:5:1,1,1,104995,95005
6:1:6,0,-1,104996,95004
3:6:4,0,-1,104997,95003
3:3:4,0,-1,104998,95002
6:1:4,0,-1,104999,95001
4:4:4,0,-1,105000,95000
3:4:5,0,-1,105001,94999
2:2:4,2,2,104999,95001
5:6:1,0,-1,105000,95000
5:5:2,1,1,104999,95001
3:4:5,0,-1,105000,95000
3:1:4,0,-1,105001,94999
6:4:1,0,-1,105002,94998
6:4:3,0,-1,105003,94997
6:5:2,1,1,105002,94998
4:2:2,2,2,105000,95000
4:6:5,0,-1,105001,94999
2:2:2,3,3,104998,95002
4:5:5,0,-1,104999,95001
5:3:2,1,1,104998,95002
4:6:6,0,-1,104999,95001
1:5:3,0,-1,105000,95000
4:5:3,0,-1,105001,94999
2:3:4,1,1,105000,95000
1:4:2,1,1,104999,95001
1:2:2,2,2,104997,95003
5:5:6,0,-1,104998,95002
3:2:6,1,1,104997,95003
1:4:4,0,-1,104998,95002
3:2:2,2,2,104996,95004
1:2:4,1,1,104995,95005
6:3:3,0,-1,104996,95004
2:3:2,2,2,104994,95006
4:4:5,0,-1,104995,95005
2:1:4,1,1,104994,95006
1:5:6,0,-1,104995,95005
6:2:1,1,1,104994,95006
6:5:6,0,-1,104995,95005
4:6:2,1,1,104994,95006
4:6:3,0,-1,104995,95005
1:6:4,0,-1,104996,95004
6:4:6,0,-1,104997,95003
3:4:3,0,-1,104998,95002
5:3:6,0,-1,104999,95001
5:2:5,1,1,104998,95002
6:6:3,0,-1,104999,95001
3:4:3,0,-1,105000,95000
5:2:2,2,2,104998,95002
6:5:6,0,-1,104999,95001
1:2:3,1,1,104998,95002
3:2:6,1,1,104997,95003
4:5:1,0,-1,104998,95002
4:2:5,1,1,104997,95003
1:6:2,1,1,104996,95004
3:3:3,0,-1,104997,95003
2:5:3,1,1,104996,95004
2:5:1,1,1,104995,95005
6:4:2,1,1,104994,95006
6:6:2,1,1,104993,95007
5:3:1,0,-1,104994,95006
3:4:1,0,-1,104995,95005
1:4:6,0,-1,104996,95004
6:5:2,1,1,104995,95005
2:1:3,1,1,104994,95006
5:5:5,0,-1,104995,95005
1:6:3,0,-1,104996,95004
5:2:4,1,1,104995,95005
1:4:2,1,1,104994,95006
5:6:1,0,-1,104995,95005
1:4:5,0,-1,104996,95004
4:5:3,0,-1,104997,95003
2:3:1,1,1,104996,95004
3:1:2,1,1,104995,95005
1:4:5,0,-1,104996,95004
4:2:4,1,1,104995,95005
3:2:3,1,1,104994,95006
6:4:6,0,-1,104995,95005
2:3:6,1,1,104994,95006
2:3:6,1,1,104993,95007
1:3:2,1,1,104992,95008
4:3:6,0,-1,104993,95007
5:6:5,0,-1,104994,95006
1:4:5,0,-1,104995,95005
5:4:1,0,-1,104996,95004
2:4:2,2,2,104994,95006
4:5:3,0,-1,104995,95005
5:4:6,0,-1,104996,95004
4:6:3,0,-1,104997,95003
1:5:5,0,-1,104998,95002
3:4:6,0,-1,104999,95001
5:3:3,0,-1,105000,95000
2:5:1,1,1,104999,95001
6:4:4,0,-1,105000,95000
5:6:1,0,-1,105001,94999
4:2:4,1,1,105000,95000
2:6:1,1,1,104999,95001
3:1:2,1,1,104998,95002
1:1:6,0,-1,104999,95001
2:1:2,2,2,104997,95003
4:3:4,0,-1,104998,95002
1:3:4,0,-1,104999,95001
5:3:4,0,-1,105000,95000
5:1:4,0,-1,105001,94999
3:6:6,0,-1,105002,94998
3:4:1,0,-1,105003,94997
6:1:5,0,-1,105004,94996
5:2:6,1,1,105003,94997
5:4:1,0,-1,105004,94996
6:2:6,1,1,105003,94997
5:4:5,0,-1,105004,94996
4:1:3,0,-1,105005,94995
5:6:4,0,-1,105006,94994
2:6:6,1,1,105005,94995
1:4:5,0,-1,105006,94994
4:4:5,0,-1,105007,94993
3:4:3,0,-1,105008,94992
6:6:6,0,-1,105009,94991
3:4:1,0,-1,105010,94990
5:5:2,1,1,105009,94991
1:3:5,0,-1,105010,94990
4:5:1,0,-1,105011,94989
5:5:3,0,-1,105012,94988
1:4:2,1,1,105011,94989
2:5:1,1,1,105010,94990
6:6:2,1,1,105009,94991
6:1:5,0,-1,105010,94990
5:5:3,0,-1,105011,94989
4:4:4,0,-1,105012,94988
6:5:2,1,1,105011,94989
1:1:2,1,1,105010,94990
3:3:2,1,1,105009,94991
2:2:6,2,2,105007,94993
1:6:2,1,1,105006,94994
4:4:4,0,-1,105007,94993
4:6:2,1,1,105006,94994
5:2:6,1,1,105005,94995
2:5:4,1,1,105004,94996
3:1:1,0,-1,105005,94995
1:1:2,1,1,105004,94996
6:1:5,0,-1,105005,94995
4:5:2,1,1,105004,94996
5:2:4,1,1,105003,94997
3:5:3,0,-1,105004,94996
1:5:1,0,-1,105005,94995
1:2:5,1,1,105004,94996
4:5:3,0,-1,105005,94995
4:5:1,0,-1,105006,94994
3:5:1,0,-1,105007,94993
5:6:3,0,-1,105008,94992
4:2:3,1,1,105007,94993
4:1:2,1,1,105006,94994
6:1:3,0,-1,105007,94993
6:2:4,1,1,105006,94994
1:5:3,0,-1,105007,94993
6:1:2,1,1,105006,94994
4:3:3,0,-1,105007,94993
3:1:1,0,-1,105008,94992
2:4:4,1,1,105007,94993
5:4:6,0,-1,105008,94992
4:1:4,0,-1,105009,94991
3:2:4,1,1,105008,94992
6:3:5,0,-1,105009,94991
1:6:5,0,-1,105010,94990
4:1:3,0,-1,105011,94989
2:1:5,1,1,105010,94990
6:6:4,0,-1,105011,94989
4:4:6,0,-1,105012,94988
6:3:3,0,-1,105013,94987
2:1:1,1,1,105012,94988
3:4:5,0,-1,105013,94987
2:5:5,1,1,105012,94988
5:1:4,0,-1,105013,94987
5:5:4,0,-1,105014,94986
4:6:3,0,-1,105015,94985
3:1:2,1,1,105014,94986
6:2:3,1,1,105013,94987
2:3:6,1,1,105012,94988
1:3:4,0,-1,105013,94987
5:1:6,0,-1,105014,94986
4:4:6,0,-1,105015,94985
3:6:3,0,-1,105016,94984
2:5:2,2,2,105014,94986
5:5:3,0,-1,105015,94985
6:2:6,1,1,105014,94986
4:1:1,0,-1,105015,94985
6:2:4,1,1,105014,94986
1:3:4,0,-1,105015,94985
5:6:5,0,-1,105016,94984
5:6:4,0,-1,105017,94983
2:3:4,1,1,105016,94984
4:2:3,1,1,105015,94985
6:5:2,1,1,105014,94986
3:2:4,1,1,105013,94987
4:1:3,0,-1,105014,94986
6:1:2,1,1,105013,94987
1:5:1,0,-1,105014,94986
6:1:1,0,-1,105015,94985
1:2:5,1,1,105014,94986
1:4:1,0,-1,105015,94985
2:2:5,2,2,105013,94987
6:1:4,0,-1,105014,94986
2:1:1,1,1,105013,94987
1:2:3,1,1,105012,94988
3:5:2,1,1,105011,94989
5:2:3,1,1,105010,94990
6:1:2,1,1,105009,94991
2:6:2,2,2,105007,94993
4:4:5,0,-1,105008,94992
1:5:4,0,-1,105009,94991
6:5:6,0,-1,105010,94990
4:2:1,1,1,105009,94991
5:6:2,1,1,105008,94992
6:5:6,0,-1,105009,94991
2:1:3,1,1,105008,94992
4:6:5,0,-1,105009,94991
4:1:2,1,1,105008,94992
1:1:4,0,-1,105009,94991
5:3:3,0,-1,105010,94990
1:3:4,0,-1,105011,94989
6:1:5,0,-1,105012,94988
1:5:6,0,-1,105013,94987
2:5:1,1,1,105012,94988
1:4:4,0,-1,105013,94987
2:1:1,1,1,105012,94988
2:4:4,1,1,105011,94989
4:6:5,0,-1,105012,94988
1:3:2,1,1,105011,94989
6:4:3,0,-1,105012,94988
5:3:3,0,-1,105013,94987
1:5:6,0,-1,105014,94986
5:5:3,0,-1,105015,94985
2:2:5,2,2,105013,94987
2:2:6,2,2,105011,94989
1:6:2,1,1,105010,94990
6:6:5,0,-1,105011,94989
4:4:5,0,-1,105012,94988
4:6:6,0,-1,105013,94987
5:5:4,0,-1,105014,94986
4:3:3,0,-1,105015,94985
2:5:5,1,1,105014,94986
6:5:6,0,-1,105015,94985
2:4:2,2,2,105013,94987
6:1:3,0,-1,105014,94986
1:3:1,0,-1,105015,94985
4:6:6,0,-1,105016,94984
5:2:1,1,1,105015,94985
4:6:3,0,-1,105016,94984
5:5:5,0,-1,105017,94983
3:3:3,0,-1,105018,94982
5:1:3,0,-1,105019,94981
5:6:3,0,-1,105020,94980
5:4:4,0,-1,105021,94979
3:3:4,0,-1,105022,94978
3:5:2,1,1,105021,94979
3:1:1,0,-1,105022,94978
1:3:3,0,-1,105023,94977
2:1:1,1,1,105022,94978
1:2:1,1,1,105021,94979
6:1:2,1,1,105020,94980
6:2:2,2,2,105018,94982
6:1:3,0,-1,105019,94981
5:1:6,0,-1,105020,94980
1:3:2,1,1,105019,94981
5:4:2,1,1,105018,94982
2:1:5,1,1,105017,94983
1:6:3,0,-1,105018,94982
4:1:4,0,-1,105019,94981
2:5:1,1,1,105018,94982
3:3:2,1,1,105017,94983
3:5:6,0,-1,105018,94982
4:4:2,1,1,105017,94983
5:2:3,1,1,105016,94984
3:5:5,0,-1,105017,94983
4:1:5,0,-1,105018,94982
1:2:3,1,1,105017,94983
5:5:3,0,-1,105018,94982
1:3:3,0,-1,105019,94981
4:5:1,0,-1,105020,94980
4:5:5,0,-1,105021,94979
1:6:2,1,1,105020,94980
2:5:6,1,1,105019,94981
3:2:1,1,1,105018,94982
4:4:4,0,-1,105019,94981
6:3:2,1,1,105018,94982
3:5:5,0,-1,105019,94981
6:6:1,0,-1,105020,94980
5:4:6,0,-1,105021,94979
2:3:3,1,1,105020,94980
6:3:4,0,-1,105021,94979
2:5:5,1,1,105020,94980
4:5:1,0,-1,105021,94979
3:2:2,2,2,105019,94981
5:1:1,0,-1,105020,94980
5:6:5,0,-1,105021,94979
5:2:1,1,1,105020,94980
4:4:5,0,-1,105021,94979
6:3:4,0,-1,105022,94978
6:3:6,0,-1,105023,94977
5:1:6,0,-1,105024,94976
1:4:3,0,-1,105025,94975
5:2:6,1,1,105024,94976
2:3:5,1,1,105023,94977
1:3:4,0,-1,105024,94976
1:4:2,1,1,105023,94977
5:4:3,0,-1,105024,94976
1:1:3,0,-1,105025,94975
6:5:1,0,-1,105026,94974
2:5:1,1,1,105025,94975
6:2:1,1,1,105024,94976
4:2:1,1,1,105023,94977
5:3:6,0,-1,105024,94976
1:1:6,0,-1,105025,94975
4:6:1,0,-1,105026,94974
3:2:5,1,1,105025,94975
5:6:4,0,-1,105026,94974
2:6:3,1,1,105025,94975
1:5:6,0,-1,105026,94974
4:2:3,1,1,105025,94975
1:2:6,1,1,105024,94976
3:1:1,0,-1,105025,94975
1:5:5,0,-1,105026,94974
6:5:6,0,-1,105027,94973
1:3:1,0,-1,105028,94972
1:3:2,1,1,105027,94973
6:1:2,1,1,105026,94974
1:2:1,1,1,105025,94975
3:2:6,1,1,105024,94976
6:3:3,0,-1,105025,94975
1:4:6,0,-1,105026,94974
1:1:2,1,1,105025,94975
5:6:6,0,-1,105026,94974
3:3:4,0,-1,105027,94973
6:5:6,0,-1,105028,94972
6:4:3,0,-1,105029,94971
1:3:4,0,-1,105030,94970
4:6:1,0,-1,105031,94969
4:4:5,0,-1,105032,94968
4:4:1,0,-1,105033,94967
3:3:1,0,-1,105034,94966
2:5:1,1,1,105033,94967
3:2:2,2,2,105031,94969
5:5:1,0,-1,105032,94968
3:1:5,0,-1,105033,94967
6:1:1,0,-1,105034,94966
5:4:6,0,-1,105035,94965
6:2:1,1,1,105034,94966
5:6:3,0,-1,105035,94965
2:6:6,1,1,105034,94966
3:6:1,0,-1,105035,94965
3:1:1,0,-1,105036,94964
3:2:3,1,1,105035,94965
4:3:6,0,-1,105036,94964
2:6:1,1,1,105035,94965
3:4:1,0,-1,105036,94964
5:4:6,0,-1,105037,94963
4:1:5,0,-1,105038,94962
4:3:4,0,-1,105039,94961
3:4:3,0,-1,105040,94960
1:6:3,0,-1,105041,94959
5:4:6,0,-1,105042,94958
3:4:4,0,-1,105043,94957
4:3:6,0,-1,105044,94956
4:3:5,0,-1,105045,94955
5:1:3,0,-1,105046,94954
5:1:3,0,-1,105047,94953
6:6:6,0,-1,105048,94952
2:3:6,1,1,105047,94953
5:1:2,1,1,105046,94954
4:1:6,0,-1,105047,94953
4:5:6,0,-1,105048,94952
4:1:3,0,-1,105049,94951
1:6:6,0,-1,105050,94950
6:6:3,0,-1,105051,94949
1:5:3,0,-1,105052,94948
4:6:6,0,-1,105053,94947
2:5:4,1,1,105052,94948
2:2:3,2,2,105050,94950
5:5:5,0,-1,105051,94949
6:2:6,1,1,105050,94950
3:2:6,1,1,105049,94951
1:4:5,0,-1,105050,94950
5:4:2,1,1,105049,94951
3:4:2,1,1,105048,94952
2:4:5,1,1,105047,94953
2:3:4,1,1,105046,94954
6:3:3,0,-1,105047,94953
4:5:2,1,1,105046,94954
3:2:2,2,2,105044,94956
2:6:1,1,1,105043,94957
6:5:4,0,-1,105044,94956
4:5:5,0,-1,105045,94955
2:2:5,2,2,105043,94957
4:2:5,1,1,105042,94958
4:4:3,0,-1,105043,94957
4:3:6,0,-1,105044,94956
1:6:5,0,-1,105045,94955
4:2:2,2,2,105043,94957
5:1:2,1,1,105042,94958
1:5:5,0,-1,105043,94957
3:3:6,0,-1,105044,94956
1:6:2,1,1,105043,94957
6:3:4,0,-1,105044,94956
4:5:1,0,-1,105045,94955
6:5:2,1,1,105044,94956
6:6:4,0,-1,105045,94955
5:3:6,0,-1,105046,94954
2:6:5,1,1,105045,94955
4:3:3,0,-1,105046,94954
6:3:4,0,-1,105047,94953
5:4:5,0,-1,105048,94952
1:2:6,1,1,105047,94953
3:1:2,1,1,105046,94954
4:3:1,0,-1,105047,94953
1:1:3,0,-1,105048,94952
6:6:2,1,1,105047,94953
3:5:5,0,-1,105048,94952
3:3:1,0,-1,105049,94951
4:6:2,1,1,105048,94952
4:4:6,0,-1,105049,94951
1:2:2,2,2,105047,94953
4:1:6,0,-1,105048,94952
6:6:2,1,1,105047,94953
5:1:6,0,-1,105048,94952
3:3:4,0,-1,105049,94951
5:3:4,0,-1,105050,94950
1:4:5,0,-1,105051,94949
5:2:2,2,2,105049,94951
2:5:2,2,2,105047,94953
6:2:1,1,1,105046,94954
4:1:4,0,-1,105047,94953
2:6:3,1,1,105046,94954
6:6:3,0,-1,105047,94953
4:3:2,1,1,105046,94954
6:2:1,1,1,105045,94955
2:2:2,3,3,105042,94958
5:4:4,0,-1,105043,94957
6:4:3,0,-1,105044,94956
5:2:2,2,2,105042,94958
3:2:5,1,1,105041,94959
6:2:2,2,2,105039,94961
3:3:3,0,-1,105040,94960
5:4:5,0,-1,105041,94959
3:2:5,1,1,105040,94960
3:1:2,1,1,105039,94961
2:1:3,1,1,105038,94962
3:1:6,0,-1,105039,94961
1:6:4,0,-1,105040,94960
2:2:1,2,2,105038,94962
3:1:3,0,-1,105039,94961
4:3:3,0,-1,105040,94960
6:3:2,1,1,105039,94961
1:1:6,0,-1,105040,94960
1:4:5,0,-1,105041,94959
1:5:2,1,1,105040,94960
6:2:4,1,1,105039,94961
5:4:4,0,-1,105040,94960
5:3:1,0,-1,105041,94959
2:4:2,2,2,105039,94961
2:6:3,1,1,105038,94962
3:1:4,0,-1,105039,94961
1:3:5,0,-1,105040,94960
2:1:1,1,1,105039,94961
1:1:1,0,-1,105040,94960
6:3:3,0,-1,105041,94959
1:3:5,0,-1,105042,94958
6:5:6,0,-1,105043,94957
5:1:6,0,-1,105044,94956
5:3:4,0,-1,105045,94955
1:3:3,0,-1,105046,94954
6:5:3,0,-1,105047,94953
5:2:2,2,2,105045,94955
6:3:5,0,-1,105046,94954
1:6:2,1,1,105045,94955
1:2:6,1,1,105044,94956
4:3:1,0,-1,105045,94955
5:1:2,1,1,105044,94956
2:3:1,1,1,105043,94957
6:2:2,2,2,105041,94959
6:1:4,0,-1,105042,94958
2:4:6,1,1,105041,94959
3:5:6,0,-1,105042,94958
1:4:3,0,-1,105043,94957
5:2:5,1,1,105042,94958
3:5:2,1,1,105041,94959
4:2:3,1,1,105040,94960
3:1:4,0,-1,105041,94959
6:4:6,0,-1,105042,94958
3:3:3,0,-1,105043,94957
5:4:3,0,-1,105044,94956
2:1:6,1,1,105043,94957
3:3:2,1,1,105042,94958
3:5:5,0,-1,105043,94957
4:3:5,0,-1,105044,94956
5:4:6,0,-1,105045,94955
6:2:3,1,1,105044,94956
4:1:5,0,-1,105045,94955
1:5:1,0,-1,105046,94954
1:1:1,0,-1,105047,94953
3:5:3,0,-1,105048,94952
3:4:1,0,-1,105049,94951
5:1:3,0,-1,105050,94950
6:1:2,1,1,105049,94951
3:3:6,0,-1,105050,94950
3:1:2,1,1,105049,94951
3:1:2,1,1,105048,94952
6:3:4,0,-1,105049,94951
4:6:6,0,-1,105050,94950
5:4:1,0,-1,105051,94949
6:2:1,1,1,105050,94950
3:2:3,1,1,105049,94951
4:6:1,0,-1,105050,94950
2:2:3,2,2,105048,94952
2:4:3,1,1,105047,94953
6:5:4,0,-1,105048,94952
3:1:4,0,-1,105049,94951
3:2:2,2,2,105047,94953
4:1:6,0,-1,105048,94952
5:6:3,0,-1,105049,94951
1:6:5,0,-1,105050,94950
5:3:1,0,-1,105051,94949
2:5:3,1,1,105050,94950
2:4:1,1,1,105049,94951
6:1:1,0,-1,105050,94950
5:4:3,0,-1,105051,94949
4:4:5,0,-1,105052,94948
6:6:6,0,-1,105053,94947
1:2:1,1,1,105052,94948
5:1:4,0,-1,105053,94947
2:1:2,2,2,105051,94949
5:6:3,0,-1,105052,94948
1:5:3,0,-1,105053,94947
6:3:3,0,-1,105054,94946
3:5:5,0,-1,105055,94945
2:3:3,1,1,105054,94946
5:6:6,0,-1,105055,94945
6:1:2,1,1,105054,94946
6:2:3,1,1,105053,94947
2:5:4,1,1,105052,94948
5:6:2,1,1,105051,94949
5:3:5,0,-1,105052,94948
6:5:4,0,-1,105053,94947
1:4:3,0,-1,105054,94946
3:2:6,1,1,105053,94947
2:4:6,1,1,105052,94948
5:1:2,1,1,105051,94949
3:5:6,0,-1,105052,94948
2:5:6,1,1,105051,94949
1:1:6,0,-1,105052,94948
4:2:3,1,1,105051,94949
3:1:6,0,-1,105052,94948
6:1:6,0,-1,105053,94947
2:1:1,1,1,105052,94948
5:5:6,0,-1,105053,94947
5:3:2,1,1,105052,94948
4:2:5,1,1,105051,94949
5:6:6,0,-1,105052,94948
6:6:6,0,-1,105053,94947
6:3:2,1,1,105052,94948
4:2:2,2,2,105050,94950
3:6:5,0,-1,105051,94949
5:3:3,0,-1,105052,94948
4:3:3,0,-1,105053,94947
1:4:4,0,-1,105054,94946
4:5:3,0,-1,105055,94945
4:6:5,0,-1,105056,94944
4:3:6,0,-1,105057,94943
3:5:5,0,-1,105058,94942
3:4:3,0,-1,105059,94941
2:4:1,1,1,105058,94942
6:1:4,0,-1,105059,94941
4:1:3,0,-1,105060,94940
6:1:4,0,-1,105061,94939
3:4:5,0,-1,105062,94938
4:2:4,1,1,105061,94939
4:2:5,1,1,105060,94940
2:6:3,1,1,105059,94941
2:1:2,2,2,105057,94943
2:6:5,1,1,105056,94944
3:4:2,1,1,105055,94945
4:5:3,0,-1,105056,94944
1:2:3,1,1,105055,94945
2:6:4,1,1,105054,94946
6:5:6,0,-1,105055,94945
5:1:5,0,-1,105056,94944
3:5:2,1,1,105055,94945
5:4:4,0,-1,105056,94944
1:4:1,0,-1,105057,94943
4:3:2,1,1,105056,94944
3:3:2,1,1,105055,94945
1:3:4,0,-1,105056,94944
4:5:5,0,-1,105057,94943
2:3:2,2,2,105055,94945
6:6:4,0,-1,105056,94944
5:5:6,0,-1,105057,94943
1:3:4,0,-1,105058,94942
1:5:5,0,-1,105059,94941
6:1:3,0,-1,105060,94940
2:5:5,1,1,105059,94941
6:5:5,0,-1,105060,94940
2:2:6,2,2,105058,94942
6:6:5,0,-1,105059,94941
1:1:1,0,-1,105060,94940
6:1:2,1,1,105059,94941
6:6:1,0,-1,105060,94940
4:4:1,0,-1,105061,94939
4:1:5,0,-1,105062,94938
1:4:6,0,-1,105063,94937
1:5:3,0,-1,105064,94936
2:6:2,2,2,105062,94938
4:5:5,0,-1,105063,94937
6:1:2,1,1,105062,94938
3:3:4,0,-1,105063,94937
2:2:1,2,2,105061,94939
6:6:1,0,-1,105062,94938
4:4:5,0,-1,105063,94937
5:2:5,1,1,105062,94938
6:5:1,0,-1,105063,94937
6:5:2,1,1,105062,94938
2:1:4,1,1,105061,94939
5:1:6,0,-1,105062,94938
2:1:6,1,1,105061,94939
5:5:6,0,-1,105062,94938
5:1:4,0,-1,105063,94937
3:3:1,0,-1,105064,94936
2:4:2,2,2,105062,94938
1:5:6,0,-1,105063,94937
5:5:6,0,-1,105064,94936
1:3:6,0,-1,105065,94935
3:3:2,1,1,105064,94936
5:2:3,1,1,105063,94937
4:2:5,1,1,105062,94938
3:6:6,0,-1,105063,94937
3:3:3,0,-1,105064,94936
2:6:6,1,1,105063,94937
4:6:3,0,-1,105064,94936
1:1:1,0,-1,105065,94935
4:4:1,0,-1,105066,94934
4:5:4,0,-1,105067,94933
2:5:5,1,1,105066,94934
4:6:6,0,-1,105067,94933
3:2:4,1,1,105066,94934
1:1:3,0,-1,105067,94933
3:1:6,0,-1,105068,94932
2:6:5,1,1,105067,94933
3:1:3,0,-1,105068,94932
1:3:6,0,-1,105069,94931
5:6:2,1,1,105068,94932
4:2:3,1,1,105067,94933
5:2:5,1,1,105066,94934
5:4:2,1,1,105065,94935
6:4:5,0,-1,105066,94934
4:5:3,0,-1,105067,94933
1:6:3,0,-1,105068,94932
4:5:5,0,-1,105069,94931
6:3:3,0,-1,105070,94930
4:3:5,0,-1,105071,94929
1:1:1,0,-1,105072,94928
2:6:2,2,2,105070,94930
6:5:3,0,-1,105071,94929
3:6:3,0,-1,105072,94928
6:1:6,0,-1,105073,94927
4:3:5,0,-1,105074,94926
5:3:3,0,-1,105075,94925
5:6:3,0,-1,105076,94924
2:1:6,1,1,105075,94925
2:3:5,1,1,105074,94926
5:6:6,0,-1,105075,94925
2:2:3,2,2,105073,94927
5:4:4,0,-1,105074,94926
6:2:4,1,1,105073,94927
2:3:4,1,1,105072,94928
5:6:5,0,-1,105073,94927
1:6:2,1,1,105072,94928
5:4:3,0,-1,105073,94927
2:5:5,1,1,105072,94928
5:2:3,1,1,105071,94929
5:4:4,0,-1,105072,94928
1:5:3,0,-1,105073,94927
1:6:6,0,-1,105074,94926
6:2:6,1,1,105073,94927
6:5:3,0,-1,105074,94926
6:6:6,0,-1,105075,94925
5:6:1,0,-1,105076,94924
6:6:2,1,1,105075,94925
2:1:4,1,1,105074,94926
2:2:3,2,2,105072,94928
4:6:5,0,-1,105073,94927
5:3:5,0,-1,105074,94926
5:2:4,1,1,105073,94927
4:1:2,1,1,105072,94928
5:6:4,0,-1,105073,94927
3:1:4,0,-1,105074,94926
3:1:6,0,-1,105075,94925
3:5:3,0,-1,105076,94924
6:5:2,1,1,105075,94925
1:5:3,0,-1,105076,94924
1:6:2,1,1,105075,94925
1:3:6,0,-1,105076,94924
2:1:2,2,2,105074,94926
5:5:4,0,-1,105075,94925
2:3:6,1,1,105074,94926
3:6:2,1,1,105073,94927
3:3:2,1,1,105072,94928
1:1:5,0,-1,105073,94927
2:2:1,2,2,105071,94929
3:1:2,1,1,105070,94930
4:5:1,0,-1,105071,94929
1:6:5,0,-1,105072,94928
1:2:1,1,1,105071,94929
3:2:6,1,1,105070,94930
5:4:4,0,-1,105071,94929
4:6:2,1,1,105070,94930
3:6:1,0,-1,105071,94929
4:2:5,1,1,105070,94930
6:5:2,1,1,105069,94931
2:5:6,1,1,105068,94932
3:1:3,0,-1,105069,94931
1:4:2,1,1,105068,94932
5:5:4,0,-1,105069,94931
4:3:6,0,-1,105070,94930
2:3:3,1,1,105069,94931
2:2:3,2,2,105067,94933
5:6:3,0,-1,105068,94932
2:2:6,2,2,105066,94934
5:6:4,0,-1,105067,94933
5:2:2,2,2,105065,94935
1:3:3,0,-1,105066,94934
1:1:1,0,-1,105067,94933
1:3:5,0,-1,105068,94932
6:1:5,0,-1,105069,94931
2:5:2,2,2,105067,94933
1:5:2,1,1,105066,94934
3:6:5,0,-1,105067,94933
2:6:2,2,2,105065,94935
4:5:4,0,-1,105066,94934
6:1:3,0,-1,105067,94933
6:4:4,0,-1,105068,94932
6:1:5,0,-1,105069,94931
1:5:1,0,-1,105070,94930
5:3:6,0,-1,105071,94929
2:6:1,1,1,105070,94930
4:5:5,0,-1,105071,94929
1:1:1,0,-1,105072,94928
3:4:4,0,-1,105073,94927
6:3:1,0,-1,105074,94926
6:3:6,0,-1,105075,94925
4:1:4,0,-1,105076,94924
6:6:2,1,1,105075,94925
2:4:3,1,1,105074,94926
2:6:1,1,1,105073,94927
3:1:5,0,-1,105074,94926
5:4:1,0,-1,105075,94925
2:4:6,1,1,105074,94926
2:3:6,1,1,105073,94927
4:4:4,0,-1,105074,94926
2:2:3,2,2,105072,94928
4:3:2,1,1,105071,94929
5:4:3,0,-1,105072,94928
6:5:4,0,-1,105073,94927
5:2:6,1,1,105072,94928
6:4:6,0,-1,105073,94927
3:6:5,0,-1,105074,94926
1:6:2,1,1,105073,94927
4:3:1,0,-1,105074,94926
2:4:3,1,1,105073,94927
5:1:4,0,-1,105074,94926
6:1:2,1,1,105073,94927
6:2:3,1,1,105072,94928
2:4:4,1,1,105071,94929
6:5:1,0,-1,105072,94928
5:6:2,1,1,105071,94929
5:3:4,0,-1,105072,94928
2:1:4,1,1,105071,94929
6:2:4,1,1,105070,94930
5:4:3,0,-1,105071,94929
1:4:2,1,1,105070,94930
4:4:2,1,1,105069,94931
6:3:6,0,-1,105070,94930
4:5:6,0,-1,105071,94929
1:2:5,1,1,105070,94930
6:3:2,1,1,105069,94931
1:4:4,0,-1,105070,94930
3:2:1,1,1,105069,94931
6:3:3,0,-1,105070,94930
5:3:6,0,-1,105071,94929
4:3:2,1,1,105070,94930
4:2:6,1,1,105069,94931
4:1:3,0,-1,105070,94930
1:5:4,0,-1,105071,94929
5:4:1,0,-1,105072,94928
2:2:2,3,3,105069,94931
5:2:2,2,2,105067,94933
5:3:5,0,-1,105068,94932
3:2:1,1,1,105067,94933
5:5:3,0,-1,105068,94932
1:4:5,0,-1,105069,94931
2:5:2,2,2,105067,94933
5:4:6,0,-1,105068,94932
3:5:3,0,-1,105069,94931
3:3:2,1,1,105068,94932
4:3:5,0,-1,105069,94931
1:1:1,0,-1,105070,94930
2:3:2,2,2,105068,94932
3:5:4,0,-1,105069,94931
2:2:2,3,3,105066,94934
2:1:4,1,1,105065,94935
2:6:1,1,1,105064,94936
2:2:1,2,2,105062,94938
1:1:4,0,-1,105063,94937
6:3:5,0,-1,105064,94936
4:4:2,1,1,105063,94937
6:3:1,0,-1,105064,94936
2:2:5,2,2,105062,94938
6:3:5,0,-1,105063,94937
4:3:6,0,-1,105064,94936
1:3:5,0,-1,105065,94935
1:5:5,0,-1,105066,94934
3:1:1,0,-1,105067,94933
3:6:2,1,1,105066,94934
2:5:2,2,2,105064,94936
1:3:6,0,-1,105065,94935
1:1:4,0,-1,105066,94934
4:3:1,0,-1,105067,94933
6:6:1,0,-1,105068,94932
2:1:1,1,1,105067,94933
6:3:4,0,-1,105068,94932
3:5:4,0,-1,105069,94931
3:1:6,0,-1,105070,94930
4:1:3,0,-1,105071,94929
5:6:6,0,-1,105072,94928
2:3:4,1,1,105071,94929
1:5:5,0,-1,105072,94928
2:5:2,2,2,105070,94930
2:5:5,1,1,105069,94931
3:1:1,0,-1,105070,94930
5:6:4,0,-1,105071,94929
4:6:3,0,-1,105072,94928
3:2:3,1,1,105071,94929
1:1:2,1,1,105070,94930
1:3:6,0,-1,105071,94929
6:4:6,0,-1,105072,94928
5:3:1,0,-1,105073,94927
4:4:4,0,-1,105074,94926
3:6:3,0,-1,105075,94925
6:5:4,0,-1,105076,94924
1:6:4,0,-1,105077,94923
6:4:2,1,1,105076,94924
6:6:2,1,1,105075,94925
6:6:3,0,-1,105076,94924
6:3:2,1,1,105075,94925
5:3:4,0,-1,105076,94924
4:6:2,1,1,105075,94925
3:3:4,0,-1,105076,94924
6:4:1,0,-1,105077,94923
4:1:1,0,-1,105078,94922
6:1:6,0,-1,105079,94921
3:1:3,0,-1,105080,94920
3:2:2,2,2,105078,94922
6:5:1,0,-1,105079,94921
1:6:1,0,-1,105080,94920
2:4:6,1,1,105079,94921
1:4:5,0,-1,105080,94920
1:4:4,0,-1,105081,94919
5:3:1,0,-1,105082,94918
3:2:6,1,1,105081,94919
6:1:3,0,-1,105082,94918
4:3:4,0,-1,105083,94917
4:4:6,0,-1,105084,94916
3:3:5,0,-1,105085,94915
1:2:5,1,1,105084,94916
2:1:1,1,1,105083,94917
1:6:2,1,1,105082,94918
5:2:1,1,1,105081,94919
1:2:3,1,1,105080,94920
2:4:3,1,1,105079,94921
5:1:5,0,-1,105080,94920
3:2:3,1,1,105079,94921
6:4:2,1,1,105078,94922
4:6:1,0,-1,105079,94921
1:2:5,1,1,105078,94922
2:2:2,3,3,105075,94925
1:4:5,0,-1,105076,94924
2:5:4,1,1,105075,94925
5:2:6,1,1,105074,94926
3:5:3,0,-1,105075,94925
6:3:5,0,-1,105076,94924
5:5:1,0,-1,105077,94923
2:5:5,1,1,105076,94924
2:4:2,2,2,105074,94926
4:3:5,0,-1,105075,94925
3:6:6,0,-1,105076,94924
4:2:2,2,2,105074,94926
5:2:6,1,1,105073,94927
1:1:3,0,-1,105074,94926
4:6:2,1,1,105073,94927
1:5:2,1,1,105072,94928
4:1:4,0,-1,105073,94927
2:3:3,1,1,105072,94928
5:4:6,0,-1,105073,94927
3:5:2,1,1,105072,94928
5:6:5,0,-1,105073,94927
4:3:4,0,-1,105074,94926
1:6:4,0,-1,105075,94925
4:2:4,1,1,105074,94926
2:5:1,1,1,105073,94927
3:6:6,0,-1,105074,94926
5:5:3,0,-1,105075,94925
6:3:2,1,1,105074,94926
6:3:6,0,-1,105075,94925
3:2:5,1,1,105074,94926
1:3:5,0,-1,105075,94925
2:1:5,1,1,105074,94926
4:1:3,0,-1,105075,94925
1:3:5,0,-1,105076,94924
3:2:3,1,1,105075,94925
1:5:4,0,-1,105076,94924
5:4:6,0,-1,105077,94923
4:5:6,0,-1,105078,94922
2:1:1,1,1,105077,94923
1:6:6,0,-1,105078,94922
4:3:1,0,-1,105079,94921
2:6:3,1,1,105078,94922
1:3:5,0,-1,105079,94921
6:5:4,0,-1,105080,94920
3:3:5,0,-1,105081,94919
3:5:3,0,-1,105082,94918
5:3:5,0,-1,105083,94917
2:6:3,1,1,105082,94918
4:3:4,0,-1,105083,94917
2:2:5,2,2,105081,94919
4:2:6,1,1,105080,94920
6:5:1,0,-1,105081,94919
2:2:5,2,2,105079,94921
3:2:1,1,1,105078,94922
4:2:6,1,1,105077,94923
1:6:1,0,-1,105078,94922
4:6:4,0,-1,105079,94921
6:4:4,0,-1,105080,94920
2:5:5,1,1,105079,94921
5:5:3,0,-1,105080,94920
2:4:5,1,1,105079,94921
2:2:6,2,2,105077,94923
4:3:6,0,-1,105078,94922
2:4:6,1,1,105077,94923
2:6:2,2,2,105075,94925
1:4:5,0,-1,105076,94924
1:6:4,0,-1,105077,94923
4:6:4,0,-1,105078,94922
5:4:5,0,-1,105079,94921
4:5:6,0,-1,105080,94920
3:3:3,0,-1,105081,94919
3:2:1,1,1,105080,94920
4:6:3,0,-1,105081,94919
5:1:5,0,-1,105082,94918
3:3:3,0,-1,105083,94917
5:3:2,1,1,105082,94918
3:2:6,1,1,105081,94919
4:6:1,0,-1,105082,94918
2:5:6,1,1,105081,94919
4:3:5,0,-1,105082,94918
5:2:6,1,1,105081,94919
6:3:4,0,-1,105082,94918
2:3:1,1,1,105081,94919
6:3:1,0,-1,105082,94918
1:5:6,0,-1,105083,94917
6:4:1,0,-1,105084,94916
1:6:5,0,-1,105085,94915
4:6:1,0,-1,105086,94914
6:3:5,0,-1,105087,94913
1:3:3,0,-1,105088,94912
6:2:4,1,1,105087,94913
2:4:1,1,1,105086,94914
5:2:2,2,2,105084,94916
2:3:4,1,1,105083,94917
4:6:3,0,-1,105084,94916
1:3:5,0,-1,105085,94915
2:4:6,1,1,105084,94916
5:3:6,0,-1,105085,94915
1:4:6,0,-1,105086,94914
1:2:1,1,1,105085,94915
2:6:5,1,1,105084,94916
3:1:6,0,-1,105085,94915
1:1:3,0,-1,105086,94914
4:2:2,2,2,105084,94916
3:5:1,0,-1,105085,94915
2:3:1,1,1,105084,94916
4:5:6,0,-1,105085,94915
1:3:3,0,-1,105086,94914
2:1:5,1,1,105085,94915
4:5:4,0,-1,105086,94914
4:5:3,0,-1,105087,94913
6:3:5,0,-1,105088,94912
1:3:2,1,1,105087,94913
2:5:3,1,1,105086,94914
1:4:1,0,-1,105087,94913
2:3:3,1,1,105086,94914
1:4:6,0,-1,105087,94913
6:6:4,0,-1,105088,94912
5:2:3,1,1,105087,94913
5:5:1,0,-1,105088,94912
1:4:4,0,-1,105089,94911
1:5:4,0,-1,105090,94910
4:5:6,0,-1,105091,94909
1:2:1,1,1,105090,94910
6:1:2,1,1,105089,94911
6:2:1,1,1,105088,94912
5:3:5,0,-1,105089,94911
3:5:6,0,-1,105090,94910
5:5:5,0,-1,105091,94909
1:6:6,0,-1,105092,94908
2:1:5,1,1,105091,94909
4:6:3,0,-1,105092,94908
4:4:2,1,1,105091,94909
6:3:5,0,-1,105092,94908
2:2:4,2,2,105090,94910
3:3:1,0,-1,105091,94909
1:3:5,0,-1,105092,94908
2:5:6,1,1,105091,94909
4:6:3,0,-1,105092,94908
2:2:4,2,2,105090,94910
1:4:3,0,-1,105091,94909
4:6:4,0,-1,105092,94908
4:5:2,1,1,105091,94909
5:5:6,0,-1,105092,94908
4:3:3,0,-1,105093,94907
4:1:5,0,-1,105094,94906
6:3:6,0,-1,105095,94905
5:1:3,0,-1,105096,94904
2:4:2,2,2,105094,94906
3:5:3,0,-1,105095,94905
4:1:4,0,-1,105096,94904
5:6:4,0,-1,105097,94903
3:3:2,1,1,105096,94904
1:2:2,2,2,105094,94906
5:5:5,0,-1,105095,94905
4:3:6,0,-1,105096,94904
6:6:4,0,-1,105097,94903
4:6:3,0,-1,105098,94902
2:5:4,1,1,105097,94903
5:3:2,1,1,105096,94904
2:5:1,1,1,105095,94905
1:5:1,0,-1,105096,94904
3:2:4,1,1,105095,94905
2:1:6,1,1,105094,94906
6:2:1,1,1,105093,94907
2:2:6,2,2,105091,94909
6:3:1,0,-1,105092,94908
3:1:6,0,-1,105093,94907
6:3:3,0,-1,105094,94906
2:6:2,2,2,105092,94908
5:4:4,0,-1,105093,94907
2:3:1,1,1,105092,94908
3:3:2,1,1,105091,94909
4:2:3,1,1,105090,94910
5:6:4,0,-1,105091,94909
5:2:2,2,2,105089,94911
1:1:1,0,-1,105090,94910
5:5:4,0,-1,105091,94909
4:3:3,0,-1,105092,94908
1:2:5,1,1,105091,94909
3:2:5,1,1,105090,94910
2:1:4,1,1,105089,94911
3:4:3,0,-1,105090,94910
4:2:2,2,2,105088,94912
5:1:2,1,1,105087,94913
4:1:2,1,1,105086,94914
6:5:3,0,-1,105087,94913
5:4:6,0,-1,105088,94912
6:5:6,0,-1,105089,94911
6:1:1,0,-1,105090,94910
3:3:5,0,-1,105091,94909
2:4:5,1,1,105090,94910
3:5:5,0,-1,105091,94909
4:1:3,0,-1,105092,94908
4:4:6,0,-1,105093,94907
5:6:5,0,-1,105094,94906
1:4:3,0,-1,105095,94905
1:1:2,1,1,105094,94906
3:1:3,0,-1,105095,94905
1:5:3,0,-1,105096,94904
4:1:1,0,-1,105097,94903
5:4:2,1,1,105096,94904
2:6:6,1,1,105095,94905
5:3:5,0,-1,105096,94904
3:5:4,0,-1,105097,94903
5:3:2,1,1,105096,94904
3:2:2,2,2,105094,94906
5:6:2,1,1,105093,94907
3:1:2,1,1,105092,94908
2:1:3,1,1,105091,94909
3:1:5,0,-1,105092,94908
1:1:4,0,-1,105093,94907
3:3:4,0,-1,105094,94906
4:1:4,0,-1,105095,94905
1:3:4,0,-1,105096,94904
3:4:5,0,-1,105097,94903
3:3:2,1,1,105096,94904
6:6:2,1,1,105095,94905
5:6:2,1,1,105094,94906
3:2:3,1,1,105093,94907
1:1:5,0,-1,105094,94906
1:5:3,0,-1,105095,94905
3:2:6,1,1,105094,94906
2:1:6,1,1,105093,94907
5:3:6,0,-1,105094,94906
3:5:5,0,-1,105095,94905
5:1:1,0,-1,105096,94904
6:4:6,0,-1,105097,94903
2:2:3,2,2,105095,94905
1:3:1,0,-1,105096,94904
1:1:5,0,-1,105097,94903
1:4:6,0,-1,105098,94902
1:6:1,0,-1,105099,94901
6:1:6,0,-1,105100,94900
6:4:4,0,-1,105101,94899
5:4:5,0,-1,105102,94898
1:3:4,0,-1,105103,94897
4:2:2,2,2,105101,94899
6:6:2,1,1,105100,94900
2:1:6,1,1,105099,94901
1:5:1,0,-1,105100,94900
6:3:6,0,-1,105101,94899
4:2:1,1,1,105100,94900
4:4:4,0,-1,105101,94899
6:5:1,0,-1,105102,94898
6:6:5,0,-1,105103,94897
2:1:3,1,1,105102,94898
2:1:6,1,1,105101,94899
6:2:2,2,2,105099,94901
5:2:4,1,1,105098,94902
4:3:2,1,1,105097,94903
3:6:1,0,-1,105098,94902
6:3:2,1,1,105097,94903
4:3:2,1,1,105096,94904
6:1:1,0,-1,105097,94903
2:3:4,1,1,105096,94904
3:1:6,0,-1,105097,94903
1:6:3,0,-1,105098,94902
6:2:1,1,1,105097,94903
6:5:1,0,-1,105098,94902
5:2:2,2,2,105096,94904
2:1:3,1,1,105095,94905
5:2:2,2,2,105093,94907
5:1:1,0,-1,105094,94906
3:1:2,1,1,105093,94907
1:5:2,1,1,105092,94908
1:4:1,0,-1,105093,94907
3:5:1,0,-1,105094,94906
5:2:1,1,1,105093,94907
4:3:2,1,1,105092,94908
6:1:6,0,-1,105093,94907
3:6:5,0,-1,105094,94906
1:4:3,0,-1,105095,94905
6:2:2,2,2,105093,94907
2:4:4,1,1,105092,94908
6:4:4,0,-1,105093,94907
2:1:2,2,2,105091,94909
5:1:6,0,-1,105092,94908
4:2:3,1,1,105091,94909
1:6:6,0,-1,105092,94908
6:6:1,0,-1,105093,94907
4:3:6,0,-1,105094,94906
3:2:5,1,1,105093,94907
2:6:4,1,1,105092,94908
4:4:6,0,-1,105093,94907
6:1:4,0,-1,105094,94906
2:5:4,1,1,105093,94907
5:1:3,0,-1,105094,94906
1:1:4,0,-1,105095,94905
4:4:5,0,-1,105096,94904
3:4:1,0,-1,105097,94903
6:5:5,0,-1,105098,94902
3:2:6,1,1,105097,94903
6:2:3,1,1,105096,94904
5:2:1,1,1,105095,94905
1:1:2,1,1,105094,94906
2:2:4,2,2,105092,94908
1:6:6,0,-1,105093,94907
1:4:5,0,-1,105094,94906
3:4:3,0,-1,105095,94905
6:2:3,1,1,105094,94906
5:4:3,0,-1,105095,94905
6:6:2,1,1,105094,94906
5:3:5,0,-1,105095,94905
3:6:2,1,1,105094,94906
6:4:6,0,-1,105095,94905
3:4:5,0,-1,105096,94904
4:5:5,0,-1,105097,94903
1:4:3,0,-1,105098,94902
1:3:3,0,-1,105099,94901
5:2:2,2,2,105097,94903
2:4:4,1,1,105096,94904
1:6:2,1,1,105095,94905
6:6:3,0,-1,105096,94904
3:1:2,1,1,105095,94905
1:4:4,0,-1,105096,94904
3:3:2,1,1,105095,94905
4:3:4,0,-1,105096,94904
2:3:6,1,1,105095,94905
6:4:1,0,-1,105096,94904
5:4:6,0,-1,105097,94903
4:6:2,1,1,105096,94904
6:1:2,1,1,105095,94905
4:6:6,0,-1,105096,94904
5:6:6,0,-1,105097,94903
6:4:1,0,-1,105098,94902
2:4:4,1,1,105097,94903
4:1:4,0,-1,105098,94902
2:3:1,1,1,105097,94903
1:3:6,0,-1,105098,94902
2:6:1,1,1,105097,94903
5:5:2,1,1,105096,94904
2:3:6,1,1,105095,94905
2:4:1,1,1,105094,94906
4:1:4,0,-1,105095,94905
3:1:6,0,-1,105096,94904
5:1:5,0,-1,105097,94903
2:2:6,2,2,105095,94905
5:2:4,1,1,105094,94906
1:4:2,1,1,105093,94907
4:4:2,1,1,105092,94908
1:4:1,0,-1,105093,94907
5:4:5,0,-1,105094,94906
3:3:1,0,-1,105095,94905
3:4:1,0,-1,105096,94904
3:1:4,0,-1,105097,94903
6:3:6,0,-1,105098,94902
1:4:6,0,-1,105099,94901
2:5:1,1,1,105098,94902
3:6:2,1,1,105097,94903
3:6:3,0,-1,105098,94902
6:2:6,1,1,105097,94903
5:5:4,0,-1,105098,94902
3:3:6,0,-1,105099,94901
1:4:5,0,-1,105100,94900
6:1:6,0,-1,105101,94899
4:6:3,0,-1,105102,94898
6:2:6,1,1,105101,94899
2:6:2,2,2,105099,94901
3:3:5,0,-1,105100,94900
5:1:1,0,-1,105101,94899
4:1:2,1,1,105100,94900
4:1:6,0,-1,105101,94899
2:1:5,1,1,105100,94900
4:1:5,0,-1,105101,94899
3:3:3,0,-1,105102,94898
4:2:4,1,1,105101,94899
4:3:4,0,-1,105102,94898
1:2:5,1,1,105101,94899
4:1:3,0,-1,105102,94898
5:5:2,1,1,105101,94899
6:1:4,0,-1,105102,94898
6:4:2,1,1,105101,94899
6:6:1,0,-1,105102,94898
3:4:3,0,-1,105103,94897
2:2:3,2,2,105101,94899
1:5:3,0,-1,105102,94898
3:4:4,0,-1,105103,94897
5:6:1,0,-1,105104,94896
4:4:6,0,-1,105105,94895
1:6:4,0,-1,105106,94894
6:5:4,0,-1,105107,94893
4:5:2,1,1,105106,94894
4:6:6,0,-1,105107,94893
4:4:5,0,-1,105108,94892
1:5:6,0,-1,105109,94891
5:2:5,1,1,105108,94892
6:6:2,1,1,105107,94893
1:5:6,0,-1,105108,94892
5:6:4,0,-1,105109,94891
6:4:4,0,-1,105110,94890
1:3:1,0,-1,105111,94889
1:5:3,0,-1,105112,94888
2:6:3,1,1,105111,94889
4:5:3,0,-1,105112,94888
5:1:1,0,-1,105113,94887
6:4:4,0,-1,105114,94886
1:6:1,0,-1,105115,94885
1:3:4,0,-1,105116,94884
4:2:2,2,2,105114,94886
6:3:2,1,1,105113,94887
1:4:3,0,-1,105114,94886
5:1:4,0,-1,105115,94885
6:4:4,0,-1,105116,94884
3:5:1,0,-1,105117,94883
1:5:4,0,-1,105118,94882
2:5:4,1,1,105117,94883
1:1:5,0,-1,105118,94882
3:3:3,0,-1,105119,94881
3:2:1,1,1,105118,94882
3:2:2,2,2,105116,94884
6:6:2,1,1,105115,94885
1:5:6,0,-1,105116,94884
1:3:1,0,-1,105117,94883
1:3:1,0,-1,105118,94882
4:6:2,1,1,105117,94883
1:1:6,0,-1,105118,94882
3:6:6,0,-1,105119,94881
2:5:3,1,1,105118,94882
6:6:2,1,1,105117,94883
6:1:5,0,-1,105118,94882
2:4:3,1,1,105117,94883
6:2:6,1,1,105116,94884
2:2:1,2,2,105114,94886
4:3:5,0,-1,105115,94885
4:3:2,1,1,105114,94886
3:3:4,0,-1,105115,94885
3:6:1,0,-1,105116,94884
2:1:2,2,2,105114,94886
1:4:2,1,1,105113,94887
5:4:6,0,-1,105114,94886
4:2:5,1,1,105113,94887
3:1:2,1,1,105112,94888
5:5:2,1,1,105111,94889
4:4:3,0,-1,105112,94888
1:2:2,2,2,105110,94890
5:1:4,0,-1,105111,94889
5:3:2,1,1,105110,94890
5:5:2,1,1,105109,94891
1:1:5,0,-1,105110,94890
1:3:1,0,-1,105111,94889
3:4:2,1,1,105110,94890
3:1:1,0,-1,105111,94889
2:4:1,1,1,105110,94890
2:6:1,1,1,105109,94891
2:3:6,1,1,105108,94892
3:1:2,1,1,105107,94893
2:5:6,1,1,105106,94894
3:4:6,0,-1,105107,94893
4:3:3,0,-1,105108,94892
1:3:3,0,-1,105109,94891
3:4:1,0,-1,105110,94890
3:3:6,0,-1,105111,94889
6:1:1,0,-1,105112,94888
1:4:6,0,-1,105113,94887
3:3:2,1,1,105112,94888
3:4:1,0,-1,105113,94887
2:3:3,1,1,105112,94888
5:1:2,1,1,105111,94889
3:2:4,1,1,105110,94890
2:1:1,1,1,105109,94891
3:2:5,1,1,105108,94892
6:1:3,0,-1,105109,94891
2:5:1,1,1,105108,94892
1:2:1,1,1,105107,94893
4:5:6,0,-1,105108,94892
6:6:1,0,-1,105109,94891
1:5:6,0,-1,105110,94890
6:6:2,1,1,105109,94891
5:2:2,2,2,105107,94893
1:6:4,0,-1,105108,94892
3:5:3,0,-1,105109,94891
5:5:3,0,-1,105110,94890
2:6:6,1,1,105109,94891
2:4:3,1,1,105108,94892
5:2:2,2,2,105106,94894
2:5:4,1,1,105105,94895
5:1:2,1,1,105104,94896
2:2:3,2,2,105102,94898
4:5:2,1,1,105101,94899
1:3:3,0,-1,105102,94898
5:3:5,0,-1,105103,94897
3:1:6,0,-1,105104,94896
1:5:4,0,-1,105105,94895
4:2:5,1,1,105104,94896
1:4:4,0,-1,105105,94895
2:4:1,1,1,105104,94896
1:5:4,0,-1,105105,94895
6:6:4,0,-1,105106,94894
2:2:2,3,3,105103,94897
6:2:6,1,1,105102,94898
3:3:4,0,-1,105103,94897
1:6:6,0,-1,105104,94896
2:6:4,1,1,105103,94897
2:5:1,1,1,105102,94898
5:5:3,0,-1,105103,94897
5:4:3,0,-1,105104,94896
1:2:4,1,1,105103,94897
5:3:2,1,1,105102,94898
6:5:4,0,-1,105103,94897
3:1:3,0,-1,105104,94896
6:5:5,0,-1,105105,94895
2:2:3,2,2,105103,94897
1:5:6,0,-1,105104,94896
6:4:5,0,-1,105105,94895
4:4:3,0,-1,105106,94894
5:6:6,0,-1,105107,94893
4:5:4,0,-1,105108,94892
2:1:1,1,1,105107,94893
2:5:2,2,2,105105,94895
4:1:5,0,-1,105106,94894
4:1:2,1,1,105105,94895
4:6:2,1,1,105104,94896
1:3:5,0,-1,105105,94895
3:6:1,0,-1,105106,94894
4:1:5,0,-1,105107,94893
2:6:6,1,1,105106,94894
3:4:3,0,-1,105107,94893
3:2:6,1,1,105106,94894
6:2:3,1,1,105105,94895
4:6:5,0,-1,105106,94894
5:6:2,1,1,105105,94895
6:6:5,0,-1,105106,94894
2:1:2,2,2,105104,94896
4:3:1,0,-1,105105,94895
6:3:4,0,-1,105106,94894
2:2:1,2,2,105104,94896
5:4:6,0,-1,105105,94895
3:4:3,0,-1,105106,94894
6:6:5,0,-1,105107,94893
1:5:5,0,-1,105108,94892
2:6:1,1,1,105107,94893
3:2:5,1,1,105106,94894
6:3:4,0,-1,105107,94893
6:5:4,0,-1,105108,94892
6:6:2,1,1,105107,94893
4:1:3,0,-1,105108,94892
3:6:4,0,-1,105109,94891
4:1:4,0,-1,105110,94890
5:5:5,0,-1,105111,94889
6:3:1,0,-1,105112,94888
3:6:5,0,-1,105113,94887
1:6:6,0,-1,105114,94886
3:2:1,1,1,105113,94887
4:2:6,1,1,105112,94888
5:4:4,0,-1,105113,94887
5:3:5,0,-1,105114,94886
1:5:5,0,-1,105115,94885
2:6:6,1,1,105114,94886
1:4:2,1,1,105113,94887
4:4:6,0,-1,105114,94886
5:4:5,0,-1,105115,94885
5:4:5,0,-1,105116,94884
4:6:3,0,-1,105117,94883
6:4:4,0,-1,105118,94882
2:4:2,2,2,105116,94884
2:6:5,1,1,105115,94885
4:2:3,1,1,105114,94886
6:5:6,0,-1,105115,94885
3:6:6,0,-1,105116,94884
3:4:6,0,-1,105117,94883
5:2:5,1,1,105116,94884
3:5:4,0,-1,105117,94883
2:5:1,1,1,105116,94884
5:4:4,0,-1,105117,94883
6:3:2,1,1,105116,94884
5:6:1,0,-1,105117,94883
5:5:1,0,-1,105118,94882
4:6:6,0,-1,105119,94881
1:4:2,1,1,105118,94882
5:5:1,0,-1,105119,94881
4:3:6,0,-1,105120,94880
6:2:6,1,1,105119,94881
1:2:6,1,1,105118,94882
2:2:4,2,2,105116,94884
1:1:5,0,-1,105117,94883
3:6:3,0,-1,105118,94882
1:3:1,0,-1,105119,94881
3:4:4,0,-1,105120,94880
5:2:5,1,1,105119,94881
6:4:4,0,-1,105120,94880
4:1:5,0,-1,105121,94879
4:1:3,0,-1,105122,94878
1:6:5,0,-1,105123,94877
4:2:2,2,2,105121,94879
1:3:2,1,1,105120,94880
2:3:2,2,2,105118,94882
6:3:1,0,-1,105119,94881
2:3:4,1,1,105118,94882
5:5:5,0,-1,105119,94881
1:1:5,0,-1,105120,94880
5:1:5,0,-1,105121,94879
1:3:6,0,-1,105122,94878
1:5:4,0,-1,105123,94877
4:5:3,0,-1,105124,94876
1:1:4,0,-1,105125,94875
2:4:1,1,1,105124,94876
5:4:6,0,-1,105125,94875
1:3:5,0,-1,105126,94874
5:2:6,1,1,105125,94875
4:1:1,0,-1,105126,94874
4:6:5,0,-1,105127,94873
3:5:5,0,-1,105128,94872
1:5:2,1,1,105127,94873
5:2:2,2,2,105125,94875
3:5:2,1,1,105124,94876
1:2:3,1,1,105123,94877
6:4:5,0,-1,105124,94876
3:2:3,1,1,105123,94877
2:3:1,1,1,105122,94878
5:2:6,1,1,105121,94879
3:5:5,0,-1,105122,94878
1:1:6,0,-1,105123,94877
5:1:6,0,-1,105124,94876
4:4:6,0,-1,105125,94875
2:5:5,1,1,105124,94876
1:3:1,0,-1,105125,94875
2:3:4,1,1,105124,94876
3:1:3,0,-1,105125,94875
4:1:4,0,-1,105126,94874
5:1:1,0,-1,105127,94873
6:2:3,1,1,105126,94874
4:2:6,1,1,105125,94875
6:5:6,0,-1,105126,94874
6:1:3,0,-1,105127,94873
4:5:1,0,-1,105128,94872
2:6:5,1,1,105127,94873
4:2:2,2,2,105125,94875
5:1:4,0,-1,105126,94874
2:2:2,3,3,105123,94877
1:6:6,0,-1,105124,94876
2:6:1,1,1,105123,94877
1:3:1,0,-1,105124,94876
1:4:3,0,-1,105125,94875
2:6:5,1,1,105124,94876
5:3:4,0,-1,105125,94875
3:2:4,1,1,105124,94876
3:3:4,0,-1,105125,94875
5:2:4,1,1,105124,94876
3:5:3,0,-1,105125,94875
4:6:2,1,1,105124,94876
3:3:3,0,-1,105125,94875
1:2:2,2,2,105123,94877
6:5:6,0,-1,105124,94876
3:1:5,0,-1,105125,94875
4:3:3,0,-1,105126,94874
3:1:6,0,-1,105127,94873
3:5:6,0,-1,105128,94872
4:3:2,1,1,105127,94873
2:4:3,1,1,105126,94874
4:6:1,0,-1,105127,94873
6:2:2,2,2,105125,94875
2:5:6,1,1,105124,94876
2:4:1,1,1,105123,94877
6:1:3,0,-1,105124,94876
5:3:2,1,1,105123,94877
3:6:1,0,-1,105124,94876
5:2:2,2,2,105122,94878
4:4:5,0,-1,105123,94877
6:6:6,0,-1,105124,94876
3:5:1,0,-1,105125,94875
6:5:3,0,-1,105126,94874
3:2:1,1,1,105125,94875
6:3:6,0,-1,105126,94874
5:5:5,0,-1,105127,94873
2:5:1,1,1,105126,94874
5:6:5,0,-1,105127,94873
2:2:3,2,2,105125,94875
1:2:6,1,1,105124,94876
4:1:2,1,1,105123,94877
6:6:3,0,-1,105124,94876
3:1:2,1,1,105123,94877
5:4:5,0,-1,105124,94876
2:1:3,1,1,105123,94877
6:4:2,1,1,105122,94878
2:5:1,1,1,105121,94879
2:4:4,1,1,105120,94880
3:3:6,0,-1,105121,94879
5:6:5,0,-1,105122,94878
6:2:6,1,1,105121,94879
3:3:1,0,-1,105122,94878
6:3:1,0,-1,105123,94877
3:3:2,1,1,105122,94878
6:6:1,0,-1,105123,94877
3:4:2,1,1,105122,94878
1:3:4,0,-1,105123,94877
6:4:5,0,-1,105124,94876
1:2:2,2,2,105122,94878
6:3:4,0,-1,105123,94877
1:1:4,0,-1,105124,94876
1:6:4,0,-1,105125,94875
3:3:4,0,-1,105126,94874
1:4:3,0,-1,105127,94873
6:5:2,1,1,105126,94874
3:1:6,0,-1,105127,94873
2:5:4,1,1,105126,94874
5:3:2,1,1,105125,94875
2:4:5,1,1,105124,94876
5:3:3,0,-1,105125,94875
1:4:5,0,-1,105126,94874
3:3:5,0,-1,105127,94873
2:5:4,1,1,105126,94874
4:4:3,0,-1,105127,94873
5:5:5,0,-1,105128,94872
6:5:3,0,-1,105129,94871
6:6:1,0,-1,105130,94870
4:2:3,1,1,105129,94871
5:3:6,0,-1,105130,94870
4:6:1,0,-1,105131,94869
4:3:6,0,-1,105132,94868
1:5:4,0,-1,105133,94867
1:4:2,1,1,105132,94868
6:4:1,0,-1,105133,94867
5:1:4,0,-1,105134,94866
3:5:3,0,-1,105135,94865
3:6:2,1,1,105134,94866
2:4:1,1,1,105133,94867
2:5:2,2,2,105131,94869
6:3:1,0,-1,105132,94868
4:6:3,0,-1,105133,94867
5:1:3,0,-1,105134,94866
2:2:2,3,3,105131,94869
5:2:3,1,1,105130,94870
4:3:2,1,1,105129,94871
4:6:4,0,-1,105130,94870
2:2:4,2,2,105128,94872
4:1:4,0,-1,105129,94871
4:5:6,0,-1,105130,94870
2:2:2,3,3,105127,94873
4:2:3,1,1,105126,94874
2:4:4,1,1,105125,94875
1:3:5,0,-1,105126,94874
5:4:4,0,-1,105127,94873
1:4:5,0,-1,105128,94872
2:3:4,1,1,105127,94873
2:2:2,3,3,105124,94876
1:4:2,1,1,105123,94877
3:6:6,0,-1,105124,94876
1:3:3,0,-1,105125,94875
6:1:1,0,-1,105126,94874
4:1:2,1,1,105125,94875
6:1:5,0,-1,105126,94874
4:4:3,0,-1,105127,94873
3:5:4,0,-1,105128,94872
4:6:2,1,1,105127,94873
2:3:1,1,1,105126,94874
6:1:6,0,-1,105127,94873
4:1:6,0,-1,105128,94872
6:4:5,0,-1,105129,94871
6:3:5,0,-1,105130,94870
3:4:3,0,-1,105131,94869
6:3:3,0,-1,105132,94868
3:4:4,0,-1,105133,94867
1:5:5,0,-1,105134,94866
2:6:5,1,1,105133,94867
2:3:3,1,1,105132,94868
1:1:6,0,-1,105133,94867
4:2:1,1,1,105132,94868
1:3:5,0,-1,105133,94867
4:2:3,1,1,105132,94868
3:5:6,0,-1,105133,94867
6:2:3,1,1,105132,94868
4:2:3,1,1,105131,94869
6:4:3,0,-1,105132,94868
5:6:5,0,-1,105133,94867
4:6:2,1,1,105132,94868
6:1:2,1,1,105131,94869
5:3:2,1,1,105130,94870
2:2:2,3,3,105127,94873
6:3:4,0,-1,105128,94872
1:4:4,0,-1,105129,94871
4:3:1,0,-1,105130,94870
6:6:4,0,-1,105131,94869
6:6:6,0,-1,105132,94868
6:2:3,1,1,105131,94869
6:4:3,0,-1,105132,94868
6:5:5,0,-1,105133,94867
1:6:1,0,-1,105134,94866
3:1:2,1,1,105133,94867
4:3:4,0,-1,105134,94866
2:1:1,1,1,105133,94867
4:1:2,1,1,105132,94868
4:6:3,0,-1,105133,94867
6:1:4,0,-1,105134,94866
4:1:4,0,-1,105135,94865
3:5:5,0,-1,105136,94864
4:5:5,0,-1,105137,94863
4:5:1,0,-1,105138,94862
1:3:5,0,-1,105139,94861
6:3:3,0,-1,105140,94860
3:2:6,1,1,105139,94861
6:2:6,1,1,105138,94862
6:2:2,2,2,105136,94864
3:1:6,0,-1,105137,94863
3:1:1,0,-1,105138,94862
6:1:6,0,-1,105139,94861
2:3:1,1,1,105138,94862
5:1:6,0,-1,105139,94861
2:2:6,2,2,105137,94863
3:5:1,0,-1,105138,94862
4:4:3,0,-1,105139,94861
4:1:4,0,-1,105140,94860
4:2:1,1,1,105139,94861
2:3:5,1,1,105138,94862
2:3:3,1,1,105137,94863
3:5:2,1,1,105136,94864
4:6:2,1,1,105135,94865
6:3:2,1,1,105134,94866
4:5:5,0,-1,105135,94865
2:1:6,1,1,105134,94866
5:5:5,0,-1,105135,94865
2:4:2,2,2,105133,94867
5:6:4,0,-1,105134,94866
5:1:1,0,-1,105135,94865
1:5:2,1,1,105134,94866
3:1:1,0,-1,105135,94865
6:2:4,1,1,105134,94866
2:1:3,1,1,105133,94867
1:2:5,1,1,105132,94868
3:3:3,0,-1,105133,94867
5:1:4,0,-1,105134,94866
2:4:5,1,1,105133,94867
5:2:5,1,1,105132,94868
1:1:3,0,-1,105133,94867
4:4:3,0,-1,105134,94866
1:6:3,0,-1,105135,94865
1:1:6,0,-1,105136,94864
2:6:3,1,1,105135,94865
3:3:4,0,-1,105136,94864
5:3:4,0,-1,105137,94863
6:2:3,1,1,105136,94864
5:4:3,0,-1,105137,94863
3:3:2,1,1,105136,94864
1:2:2,2,2,105134,94866
5:4:5,0,-1,105135,94865
1:4:4,0,-1,105136,94864
4:2:1,1,1,105135,94865
2:2:5,2,2,105133,94867
4:4:6,0,-1,105134,94866
6:5:6,0,-1,105135,94865
2:5:1,1,1,105134,94866
1:2:6,1,1,105133,94867
4:3:2,1,1,105132,94868
3:5:1,0,-1,105133,94867
6:6:6,0,-1,105134,94866
5:2:2,2,2,105132,94868
5:3:1,0,-1,105133,94867
5:3:5,0,-1,105134,94866
5:3:3,0,-1,105135,94865
6:5:5,0,-1,105136,94864
3:4:1,0,-1,105137,94863
5:6:2,1,1,105136,94864
6:5:2,1,1,105135,94865
5:5:3,0,-1,105136,94864
1:1:5,0,-1,105137,94863
3:1:5,0,-1,105138,94862
3:6:5,0,-1,105139,94861
4:1:6,0,-1,105140,94860
1:3:2,1,1,105139,94861
3:6:6,0,-1,105140,94860
5:3:1,0,-1,105141,94859
6:2:5,1,1,105140,94860
6:3:4,0,-1,105141,94859
6:2:4,1,1,105140,94860
5:1:4,0,-1,105141,94859
1:3:2,1,1,105140,94860
6:5:1,0,-1,105141,94859
1:5:2,1,1,105140,94860
3:5:6,0,-1,105141,94859
2:3:4,1,1,105140,94860
4:2:4,1,1,105139,94861
5:5:2,1,1,105138,94862
3:6:2,1,1,105137,94863
6:1:4,0,-1,105138,94862
2:3:2,2,2,105136,94864
2:6:1,1,1,105135,94865
2:1:1,1,1,105134,94866
5:4:6,0,-1,105135,94865
4:2:1,1,1,105134,94866
1:2:1,1,1,105133,94867
4:1:2,1,1,105132,94868
3:4:3,0,-1,105133,94867
4:4:4,0,-1,105134,94866
5:5:6,0,-1,105135,94865
2:4:4,1,1,105134,94866
1:4:6,0,-1,105135,94865
2:1:6,1,1,105134,94866
2:2:2,3,3,105131,94869
2:4:1,1,1,105130,94870
6:2:2,2,2,105128,94872
2:3:4,1,1,105127,94873
6:1:4,0,-1,105128,94872
2:1:2,2,2,105126,94874
5:2:3,1,1,105125,94875
2:6:6,1,1,105124,94876
2:3:5,1,1,105123,94877
3:1:5,0,-1,105124,94876
3:3:5,0,-1,105125,94875
3:1:2,1,1,105124,94876
6:1:6,0,-1,105125,94875
1:6:3,0,-1,105126,94874
5:4:1,0,-1,105127,94873
4:6:1,0,-1,105128,94872
1:4:2,1,1,105127,94873
6:2:1,1,1,105126,94874
6:1:3,0,-1,105127,94873
3:6:1,0,-1,105128,94872
5:3:4,0,-1,105129,94871
1:3:6,0,-1,105130,94870
3:1:3,0,-1,105131,94869
6:6:1,0,-1,105132,94868
3:6:3,0,-1,105133,94867
5:5:2,1,1,105132,94868
1:4:3,0,-1,105133,94867
2:3:3,1,1,105132,94868
4:6:3,0,-1,105133,94867
1:5:3,0,-1,105134,94866
4:4:6,0,-1,105135,94865
6:4:1,0,-1,105136,94864
3:4:1,0,-1,105137,94863
6:6:1,0,-1,105138,94862
4:4:5,0,-1,105139,94861
1:4:6,0,-1,105140,94860
3:5:4,0,-1,105141,94859
5:3:2,1,1,105140,94860
3:4:2,1,1,105139,94861
6:5:5,0,-1,105140,94860
1:3:3,0,-1,105141,94859
6:3:1,0,-1,105142,94858
3:4:4,0,-1,105143,94857
4:3:4,0,-1,105144,94856
1:2:6,1,1,105143,94857
1:6:1,0,-1,105144,94856
4:6:5,0,-1,105145,94855
2:2:5,2,2,105143,94857
2:2:5,2,2,105141,94859
1:1:1,0,-1,105142,94858
5:6:4,0,-1,105143,94857
6:3:3,0,-1,105144,94856
6:1:6,0,-1,105145,94855
6:2:6,1,1,105144,94856
2:4:6,1,1,105143,94857
1:3:2,1,1,105142,94858
3:5:6,0,-1,105143,94857
6:2:5,1,1,105142,94858
6:5:3,0,-1,105143,94857
4:4:2,1,1,105142,94858
6:4:4,0,-1,105143,94857
5:5:6,0,-1,105144,94856
6:1:2,1,1,105143,94857
6:6:5,0,-1,105144,94856
1:3:3,0,-1,105145,94855
2:5:5,1,1,105144,94856
6:5:2,1,1,105143,94857
4:1:1,0,-1,105144,94856
6:5:2,1,1,105143,94857
6:5:4,0,-1,105144,94856
6:5:6,0,-1,105145,94855
5:3:3,0,-1,105146,94854
6:5:5,0,-1,105147,94853
4:2:1,1,1,105146,94854
1:3:3,0,-1,105147,94853
4:6:4,0,-1,105148,94852
2:5:3,1,1,105147,94853
1:2:6,1,1,105146,94854
4:5:4,0,-1,105147,94853
5:4:3,0,-1,105148,94852
5:3:6,0,-1,105149,94851
1:6:2,1,1,105148,94852
3:4:4,0,-1,105149,94851
1:2:4,1,1,105148,94852
1:5:5,0,-1,105149,94851
2:2:1,2,2,105147,94853
6:3:1,0,-1,105148,94852
1:4:6,0,-1,105149,94851
6:2:2,2,2,105147,94853
2:5:1,1,1,105146,94854
4:4:1,0,-1,105147,94853
3:6:3,0,-1,105148,94852
3:2:4,1,1,105147,94853
4:1:5,0,-1,105148,94852
2:1:2,2,2,105146,94854
3:3:5,0,-1,105147,94853
5:3:3,0,-1,105148,94852
2:6:4,1,1,105147,94853
1:6:3,0,-1,105148,94852
1:6:6,0,-1,105149,94851
2:1:4,1,1,105148,94852
3:6:2,1,1,105147,94853
4:4:1,0,-1,105148,94852
1:4:2,1,1,105147,94853
4:1:5,0,-1,105148,94852
6:1:6,0,-1,105149,94851
6:1:2,1,1,105148,94852
5:4:4,0,-1,105149,94851
6:6:3,0,-1,105150,94850
4:5:4,0,-1,105151,94849
6:6:6,0,-1,105152,94848
6:5:6,0,-1,105153,94847
2:6:1,1,1,105152,94848
5:2:6,1,1,105151,94849
6:2:3,1,1,105150,94850
4:3:4,0,-1,105151,94849
6:4:4,0,-1,105152,94848
4:6:2,1,1,105151,94849
3:1:6,0,-1,105152,94848
3:6:1,0,-1,105153,94847
2:3:6,1,1,105152,94848
3:6:3,0,-1,105153,94847
4:3:1,0,-1,105154,94846
5:4:4,0,-1,105155,94845
5:2:4,1,1,105154,94846
6:4:6,0,-1,105155,94845
5:2:2,2,2,105153,94847
2:1:5,1,1,105152,94848
4:3:6,0,-1,105153,94847
6:2:4,1,1,105152,94848
2:2:1,2,2,105150,94850
4:1:3,0,-1,105151,94849
3:2:5,1,1,105150,94850
4:1:6,0,-1,105151,94849
4:6:2,1,1,105150,94850
2:1:5,1,1,105149,94851
5:3:5,0,-1,105150,94850
6:5:5,0,-1,105151,94849
2:1:4,1,1,105150,94850
5:2:3,1,1,105149,94851
2:3:3,1,1,105148,94852
4:6:6,0,-1,105149,94851
4:3:5,0,-1,105150,94850
1:2:6,1,1,105149,94851
1:5:1,0,-1,105150,94850
5:4:6,0,-1,105151,94849
3:5:3,0,-1,105152,94848
4:2:6,1,1,105151,94849
2:2:4,2,2,105149,94851
1:6:1,0,-1,105150,94850
6:2:3,1,1,105149,94851
1:1:4,0,-1,105150,94850
1:1:5,0,-1,105151,94849
4:1:5,0,-1,105152,94848
4:4:2,1,1,105151,94849
1:2:1,1,1,105150,94850
5:6:6,0,-1,105151,94849
3:4:1,0,-1,105152,94848
2:3:3,1,1,105151,94849
2:3:1,1,1,105150,94850
1:6:1,0,-1,105151,94849
5:2:1,1,1,105150,94850
1:5:3,0,-1,105151,94849
4:6:4,0,-1,105152,94848
1:4:5,0,-1,105153,94847
3:6:1,0,-1,105154,94846
3:1:1,0,-1,105155,94845
1:3:3,0,-1,105156,94844
3:3:6,0,-1,105157,94843
2:4:2,2,2,105155,94845
1:4:2,1,1,105154,94846
5:6:5,0,-1,105155,94845
2:6:5,1,1,105154,94846
4:2:6,1,1,105153,94847
5:5:3,0,-1,105154,94846
6:4:1,0,-1,105155,94845
5:2:5,1,1,105154,94846
1:2:6,1,1,105153,94847
5:6:4,0,-1,105154,94846
2:3:1,1,1,105153,94847
6:5:6,0,-1,105154,94846
2:4:3,1,1,105153,94847
3:1:1,0,-1,105154,94846
6:5:1,0,-1,105155,94845
5:1:5,0,-1,105156,94844
5:6:5,0,-1,105157,94843
2:5:1,1,1,105156,94844
2:1:1,1,1,105155,94845
1:3:5,0,-1,105156,94844
3:4:6,0,-1,105157,94843
4:2:6,1,1,105156,94844
4:6:4,0,-1,105157,94843
6:4:4,0,-1,105158,94842
2:3:3,1,1,105157,94843
5:6:2,1,1,105156,94844
2:5:5,1,1,105155,94845
4:5:1,0,-1,105156,94844
4:3:1,0,-1,105157,94843
1:2:4,1,1,105156,94844
1:3:4,0,-1,105157,94843
6:1:4,0,-1,105158,94842
1:2:2,2,2,105156,94844
3:2:3,1,1,105155,94845
4:1:6,0,-1,105156,94844
6:2:5,1,1,105155,94845
1:6:6,0,-1,105156,94844
6:1:6,0,-1,105157,94843
1:5:5,0,-1,105158,94842
2:3:2,2,2,105156,94844
3:1:3,0,-1,105157,94843
4:1:6,0,-1,105158,94842
2:5:2,2,2,105156,94844
3:2:3,1,1,105155,94845
1:6:1,0,-1,105156,94844
6:4:6,0,-1,105157,94843
6:3:1,0,-1,105158,94842
3:2:6,1,1,105157,94843
5:5:4,0,-1,105158,94842
2:2:2,3,3,105155,94845
2:3:4,1,1,105154,94846
6:1:6,0,-1,105155,94845
6:6:3,0,-1,105156,94844
2:3:3,1,1,105155,94845
3:4:3,0,-1,105156,94844
5:2:4,1,1,105155,94845
5:2:2,2,2,105153,94847
3:2:4,1,1,105152,94848
5:1:5,0,-1,105153,94847
1:6:3,0,-1,105154,94846
4:2:4,1,1,105153,94847
1:4:1,0,-1,105154,94846
5:1:4,0,-1,105155,94845
2:3:2,2,2,105153,94847
2:2:5,2,2,105151,94849
3:1:2,1,1,105150,94850
1:1:4,0,-1,105151,94849
2:2:6,2,2,105149,94851
1:6:2,1,1,105148,94852
4:5:3,0,-1,105149,94851
2:4:4,1,1,105148,94852
2:3:2,2,2,105146,94854
4:1:3,0,-1,105147,94853
3:6:2,1,1,105146,94854
3:4:1,0,-1,105147,94853
5:5:4,0,-1,105148,94852
3:1:3,0,-1,105149,94851
2:1:2,2,2,105147,94853
5:2:1,1,1,105146,94854
4:4:1,0,-1,105147,94853
1:5:6,0,-1,105148,94852
2:5:2,2,2,105146,94854
3:6:2,1,1,105145,94855
6:6:2,1,1,105144,94856
3:4:5,0,-1,105145,94855
3:1:4,0,-1,105146,94854
6:1:6,0,-1,105147,94853
2:1:1,1,1,105146,94854
5:2:4,1,1,105145,94855
3:6:5,0,-1,105146,94854
1:3:2,1,1,105145,94855
4:2:4,1,1,105144,94856
1:4:2,1,1,105143,94857
1:5:5,0,-1,105144,94856
6:1:1,0,-1,105145,94855
5:3:3,0,-1,105146,94854
3:5:1,0,-1,105147,94853
1:4:3,0,-1,105148,94852
4:3:6,0,-1,105149,94851
1:2:2,2,2,105147,94853
4:3:4,0,-1,105148,94852
4:1:3,0,-1,105149,94851
6:4:3,0,-1,105150,94850
3:5:3,0,-1,105151,94849
4:2:5,1,1,105150,94850
6:1:3,0,-1,105151,94849
1:2:4,1,1,105150,94850
5:3:5,0,-1,105151,94849
5:3:1,0,-1,105152,94848
1:1:3,0,-1,105153,94847
6:3:2,1,1,105152,94848
3:6:6,0,-1,105153,94847
1:6:6,0,-1,105154,94846
1:1:4,0,-1,105155,94845
2:4:5,1,1,105154,94846
5:2:5,1,1,105153,94847
3:1:3,0,-1,105154,94846
2:1:4,1,1,105153,94847
4:2:1,1,1,105152,94848
3:6:6,0,-1,105153,94847
2:6:5,1,1,105152,94848
3:6:4,0,-1,105153,94847
1:1:1,0,-1,105154,94846
6:5:6,0,-1,105155,94845
6:6:1,0,-1,105156,94844
4:4:3,0,-1,105157,94843
5:4:2,1,1,105156,94844
6:3:5,0,-1,105157,94843
4:2:1,1,1,105156,94844
6:5:5,0,-1,105157,94843
2:6:5,1,1,105156,94844
1:3:2,1,1,105155,94845
2:5:4,1,1,105154,94846
3:3:1,0,-1,105155,94845
1:4:5,0,-1,105156,94844
1:1:4,0,-1,105157,94843
2:3:2,2,2,105155,94845
3:6:1,0,-1,105156,94844
2:4:4,1,1,105155,94845
5:4:5,0,-1,105156,94844
1:1:3,0,-1,105157,94843
5:1:1,0,-1,105158,94842
4:6:6,0,-1,105159,94841
1:1:6,0,-1,105160,94840
1:2:3,1,1,105159,94841
2:1:1,1,1,105158,94842
5:2:3,1,1,105157,94843
5:3:2,1,1,105156,94844
4:5:3,0,-1,105157,94843
4:1:5,0,-1,105158,94842
5:1:1,0,-1,105159,94841
1:1:5,0,-1,105160,94840
2:1:3,1,1,105159,94841
2:4:3,1,1,105158,94842
4:5:3,0,-1,105159,94841
4:6:3,0,-1,105160,94840
3:5:1,0,-1,105161,94839
1:6:3,0,-1,105162,94838
6:1:5,0,-1,105163,94837
5:1:5,0,-1,105164,94836
5:1:1,0,-1,105165,94835
5:2:4,1,1,105164,94836
5:5:1,0,-1,105165,94835
3:2:4,1,1,105164,94836
1:1:1,0,-1,105165,94835
4:2:4,1,1,105164,94836
5:3:1,0,-1,105165,94835
4:6:6,0,-1,105166,94834
5:1:2,1,1,105165,94835
6:6:2,1,1,105164,94836
4:1:4,0,-1,105165,94835
5:4:5,0,-1,105166,94834
3:2:5,1,1,105165,94835
6:3:5,0,-1,105166,94834
2:1:6,1,1,105165,94835
3:1:1,0,-1,105166,94834
1:3:4,0,-1,105167,94833
1:2:3,1,1,105166,94834
2:6:6,1,1,105165,94835
1:2:4,1,1,105164,94836
4:1:4,0,-1,105165,94835
6:6:2,1,1,105164,94836
6:6:4,0,-1,105165,94835
2:2:4,2,2,105163,94837
4:1:5,0,-1,105164,94836
5:6:4,0,-1,105165,94835
1:5:4,0,-1,105166,94834
4:6:1,0,-1,105167,94833
2:1:5,1,1,105166,94834
6:1:6,0,-1,105167,94833
3:5:2,1,1,105166,94834
6:6:1,0,-1,105167,94833
3:1:1,0,-1,105168,94832
4:6:3,0,-1,105169,94831
5:5:4,0,-1,105170,94830
1:1:4,0,-1,105171,94829
5:1:6,0,-1,105172,94828
3:6:4,0,-1,105173,94827
1:5:1,0,-1,105174,94826
4:6:3,0,-1,105175,94825
4:6:5,0,-1,105176,94824
6:4:1,0,-1,105177,94823
1:6:1,0,-1,105178,94822
3:5:1,0,-1,105179,94821
2:4:2,2,2,105177,94823
4:3:4,0,-1,105178,94822
4:2:2,2,2,105176,94824
6:4:2,1,1,105175,94825
5:3:2,1,1,105174,94826
2:3:4,1,1,105173,94827
4:6:3,0,-1,105174,94826
1:3:2,1,1,105173,94827
6:6:5,0,-1,105174,94826
6:3:5,0,-1,105175,94825
5:5:4,0,-1,105176,94824
6:6:3,0,-1,105177,94823
5:1:4,0,-1,105178,94822
1:6:1,0,-1,105179,94821
5:4:5,0,-1,105180,94820
2:2:1,2,2,105178,94822
5:3:2,1,1,105177,94823
3:5:5,0,-1,105178,94822
5:2:2,2,2,105176,94824
3:4:4,0,-1,105177,94823
3:5:4,0,-1,105178,94822
1:1:3,0,-1,105179,94821
5:1:3,0,-1,105180,94820
4:1:4,0,-1,105181,94819
3:1:3,0,-1,105182,94818
6:1:1,0,-1,105183,94817
1:6:4,0,-1,105184,94816
5:2:1,1,1,105183,94817
3:6:4,0,-1,105184,94816
5:3:5,0,-1,105185,94815
6:5:3,0,-1,105186,94814
4:5:3,0,-1,105187,94813
6:3:4,0,-1,105188,94812
2:4:6,1,1,105187,94813
1:5:3,0,-1,105188,94812
5:3:3,0,-1,105189,94811
4:2:4,1,1,105188,94812
3:2:3,1,1,105187,94813
6:3:2,1,1,105186,94814
6:6:1,0,-1,105187,94813
3:3:5,0,-1,105188,94812
5:1:5,0,-1,105189,94811
2:6:2,2,2,105187,94813
4:1:5,0,-1,105188,94812
2:4:2,2,2,105186,94814
1:2:6,1,1,105185,94815
1:2:6,1,1,105184,94816
6:4:4,0,-1,105185,94815
6:1:6,0,-1,105186,94814
4:4:3,0,-1,105187,94813
4:6:2,1,1,105186,94814
1:3:2,1,1,105185,94815
5:6:3,0,-1,105186,94814
2:5:2,2,2,105184,94816
3:4:5,0,-1,105185,94815
6:1:2,1,1,105184,94816
5:4:2,1,1,105183,94817
6:2:2,2,2,105181,94819
4:2:4,1,1,105180,94820
6:3:1,0,-1,105181,94819
6:2:6,1,1,105180,94820
4:1:1,0,-1,105181,94819
3:3:5,0,-1,105182,94818
4:6:5,0,-1,105183,94817
4:4:1,0,-1,105184,94816
3:5:5,0,-1,105185,94815
6:4:1,0,-1,105186,94814
2:4:6,1,1,105185,94815
5:1:5,0,-1,105186,94814
5:3:2,1,1,105185,94815
2:2:5,2,2,105183,94817
2:3:3,1,1,105182,94818
1:5:3,0,-1,105183,94817
5:2:4,1,1,105182,94818
5:2:2,2,2,105180,94820
4:6:1,0,-1,105181,94819
3:5:2,1,1,105180,94820
5:1:5,0,-1,105181,94819
1:4:6,0,-1,105182,94818
6:3:4,0,-1,105183,94817
1:2:5,1,1,105182,94818
4:5:5,0,-1,105183,94817
6:3:1,0,-1,105184,94816
4:6:3,0,-1,105185,94815
2:1:4,1,1,105184,94816
3:2:4,1,1,105183,94817
3:1:6,0,-1,105184,94816
4:1:4,0,-1,105185,94815
2:6:6,1,1,105184,94816
1:5:3,0,-1,105185,94815
4:1:1,0,-1,105186,94814
2:4:2,2,2,105184,94816
4:1:4,0,-1,105185,94815
5:4:1,0,-1,105186,94814
2:4:2,2,2,105184,94816
5:2:3,1,1,105183,94817
2:6:2,2,2,105181,94819
2:6:3,1,1,105180,94820
4:1:3,0,-1,105181,94819
6:5:6,0,-1,105182,94818
4:6:3,0,-1,105183,94817
2:6:6,1,1,105182,94818
4:5:3,0,-1,105183,94817
1:5:4,0,-1,105184,94816
5:3:2,1,1,105183,94817
5:4:2,1,1,105182,94818
1:3:2,1,1,105181,94819
5:6:4,0,-1,105182,94818
2:6:1,1,1,105181,94819
1:2:5,1,1,105180,94820
6:4:2,1,1,105179,94821
5:4:2,1,1,105178,94822
5:6:5,0,-1,105179,94821
4:6:6,0,-1,105180,94820
6:6:6,0,-1,105181,94819
3:3:5,0,-1,105182,94818
2:2:5,2,2,105180,94820
4:3:2,1,1,105179,94821
6:5:2,1,1,105178,94822
3:2:3,1,1,105177,94823
5:3:4,0,-1,105178,94822
5:1:3,0,-1,105179,94821
4:4:1,0,-1,105180,94820
6:3:6,0,-1,105181,94819
6:4:4,0,-1,105182,94818
6:5:5,0,-1,105183,94817
2:5:2,2,2,105181,94819
2:6:2,2,2,105179,94821
5:6:2,1,1,105178,94822
4:4:2,1,1,105177,94823
1:2:1,1,1,105176,94824
3:4:6,0,-1,105177,94823
2:3:2,2,2,105175,94825
4:6:3,0,-1,105176,94824
5:1:6,0,-1,105177,94823
4:6:6,0,-1,105178,94822
3:6:6,0,-1,105179,94821
2:2:4,2,2,105177,94823
5:6:1,0,-1,105178,94822
2:5:6,1,1,105177,94823
1:1:1,0,-1,105178,94822
1:1:5,0,-1,105179,94821
3:6:3,0,-1,105180,94820
2:3:2,2,2,105178,94822
2:3:3,1,1,105177,94823
3:6:6,0,-1,105178,94822
1:3:4,0,-1,105179,94821
2:5:5,1,1,105178,94822
1:2:5,1,1,105177,94823
4:4:2,1,1,105176,94824
3:3:5,0,-1,105177,94823
3:5:3,0,-1,105178,94822
5:2:4,1,1,105177,94823
1:6:5,0,-1,105178,94822
1:1:1,0,-1,105179,94821
2:6:3,1,1,105178,94822
3:1:4,0,-1,105179,94821
3:4:6,0,-1,105180,94820
2:6:3,1,1,105179,94821
1:4:5,0,-1,105180,94820
3:4:2,1,1,105179,94821
6:5:5,0,-1,105180,94820
4:1:1,0,-1,105181,94819
6:4:4,0,-1,105182,94818
1:5:5,0,-1,105183,94817
5:4:2,1,1,105182,94818
4:1:4,0,-1,105183,94817
1:3:6,0,-1,105184,94816
1:4:5,0,-1,105185,94815
5:2:2,2,2,105183,94817
3:4:5,0,-1,105184,94816
1:4:1,0,-1,105185,94815
4:1:3,0,-1,105186,94814
3:4:3,0,-1,105187,94813
6:3:2,1,1,105186,94814
4:4:6,0,-1,105187,94813
6:6:4,0,-1,105188,94812
3:5:5,0,-1,105189,94811
5:4:6,0,-1,105190,94810
3:4:3,0,-1,105191,94809
4:4:6,0,-1,105192,94808
1:4:4,0,-1,105193,94807
3:3:3,0,-1,105194,94806
2:5:1,1,1,105193,94807
4:5:1,0,-1,105194,94806
3:5:5,0,-1,105195,94805
3:4:6,0,-1,105196,94804
4:4:6,0,-1,105197,94803
1:1:2,1,1,105196,94804
1:2:2,2,2,105194,94806
6:3:5,0,-1,105195,94805
3:6:4,0,-1,105196,94804
1:4:3,0,-1,105197,94803
2:1:3,1,1,105196,94804
5:2:2,2,2,105194,94806
5:4:6,0,-1,105195,94805
1:2:3,1,1,105194,94806
1:6:3,0,-1,105195,94805
4:2:5,1,1,105194,94806
4:6:4,0,-1,105195,94805
1:6:3,0,-1,105196,94804
1:4:5,0,-1,105197,94803
1:6:4,0,-1,105198,94802
4:2:3,1,1,105197,94803
3:5:4,0,-1,105198,94802
2:6:6,1,1,105197,94803
3:5:6,0,-1,105198,94802
6:4:6,0,-1,105199,94801
5:5:2,1,1,105198,94802
5:2:2,2,2,105196,94804
4:4:6,0,-1,105197,94803
3:6:2,1,1,105196,94804
3:2:5,1,1,105195,94805
2:6:3,1,1,105194,94806
2:2:4,2,2,105192,94808
6:6:2,1,1,105191,94809
3:3:1,0,-1,105192,94808
5:3:4,0,-1,105193,94807
3:3:6,0,-1,105194,94806
3:3:2,1,1,105193,94807
6:5:4,0,-1,105194,94806
2:1:1,1,1,105193,94807
3:2:3,1,1,105192,94808
4:4:5,0,-1,105193,94807
2:5:2,2,2,105191,94809
1:2:3,1,1,105190,94810
6:2:3,1,1,105189,94811
4:6:5,0,-1,105190,94810
3:6:2,1,1,105189,94811
1:5:5,0,-1,105190,94810
3:4:3,0,-1,105191,94809
2:1:2,2,2,105189,94811
6:3:6,0,-1,105190,94810
3:2:2,2,2,105188,94812
2:6:6,1,1,105187,94813
6:3:3,0,-1,105188,94812
6:3:1,0,-1,105189,94811
6:2:4,1,1,105188,94812
5:2:4,1,1,105187,94813
1:6:2,1,1,105186,94814
3:2:5,1,1,105185,94815
3:5:1,0,-1,105186,94814
1:3:3,0,-1,105187,94813
2:3:1,1,1,105186,94814
4:3:1,0,-1,105187,94813
5:3:6,0,-1,105188,94812
2:4:1,1,1,105187,94813
3:2:3,1,1,105186,94814
4:5:5,0,-1,105187,94813
4:6:1,0,-1,105188,94812
5:1:2,1,1,105187,94813
5:4:3,0,-1,105188,94812
4:2:4,1,1,105187,94813
2:4:4,1,1,105186,94814
1:3:4,0,-1,105187,94813
6:3:6,0,-1,105188,94812
4:6:1,0,-1,105189,94811
6:5:4,0,-1,105190,94810
4:3:4,0,-1,105191,94809
3:6:4,0,-1,105192,94808
5:3:4,0,-1,105193,94807
5:5:3,0,-1,105194,94806
1:4:3,0,-1,105195,94805
1:3:5,0,-1,105196,94804
1:5:1,0,-1,105197,94803
2:6:5,1,1,105196,94804
1:2:2,2,2,105194,94806
5:6:1,0,-1,105195,94805
5:1:3,0,-1,105196,94804
5:1:4,0,-1,105197,94803
6:3:2,1,1,105196,94804
5:3:5,0,-1,105197,94803
5:5:6,0,-1,105198,94802
1:1:5,0,-1,105199,94801
5:5:4,0,-1,105200,94800
5:1:1,0,-1,105201,94799
6:4:5,0,-1,105202,94798
6:6:2,1,1,105201,94799
4:4:5,0,-1,105202,94798
5:4:1,0,-1,105203,94797
5:1:5,0,-1,105204,94796
2:5:1,1,1,105203,94797
4:6:2,1,1,105202,94798
1:6:6,0,-1,105203,94797
1:1:2,1,1,105202,94798
6:2:2,2,2,105200,94800
1:6:5,0,-1,105201,94799
6:3:6,0,-1,105202,94798
3:2:4,1,1,105201,94799
5:3:5,0,-1,105202,94798
3:4:1,0,-1,105203,94797
4:6:1,0,-1,105204,94796
3:3:6,0,-1,105205,94795
6:2:5,1,1,105204,94796
3:2:5,1,1,105203,94797
3:1:2,1,1,105202,94798
3:3:6,0,-1,105203,94797
2:2:5,2,2,105201,94799
2:5:3,1,1,105200,94800
1:4:6,0,-1,105201,94799
6:5:3,0,-1,105202,94798
6:2:2,2,2,105200,94800
4:6:2,1,1,105199,94801
3:4:3,0,-1,105200,94800
6:4:1,0,-1,105201,94799
3:4:6,0,-1,105202,94798
1:6:3,0,-1,105203,94797
5:6:2,1,1,105202,94798
4:3:4,0,-1,105203,94797
4:2:6,1,1,105202,94798
6:5:5,0,-1,105203,94797
5:5:3,0,-1,105204,94796
5:2:4,1,1,105203,94797
1:3:6,0,-1,105204,94796
1:5:4,0,-1,105205,94795
5:3:2,1,1,105204,94796
1:1:1,0,-1,105205,94795
6:4:1,0,-1,105206,94794
6:4:1,0,-1,105207,94793
2:3:2,2,2,105205,94795
4:5:6,0,-1,105206,94794
4:4:2,1,1,105205,94795
3:3:4,0,-1,105206,94794
4:1:5,0,-1,105207,94793
2:3:6,1,1,105206,94794
2:5:3,1,1,105205,94795
2:1:2,2,2,105203,94797
2:3:5,1,1,105202,94798
1:6:1,0,-1,105203,94797
5:3:5,0,-1,105204,94796
1:1:1,0,-1,105205,94795
4:6:3,0,-1,105206,94794
4:1:4,0,-1,105207,94793
4:4:2,1,1,105206,94794
6:2:5,1,1,105205,94795
5:5:1,0,-1,105206,94794
1:4:2,1,1,105205,94795
1:4:5,0,-1,105206,94794
1:1:3,0,-1,105207,94793
6:2:5,1,1,105206,94794
4:5:6,0,-1,105207,94793
2:3:2,2,2,105205,94795
1:6:3,0,-1,105206,94794
3:1:4,0,-1,105207,94793
1:2:3,1,1,105206,94794
5:5:2,1,1,105205,94795
6:1:3,0,-1,105206,94794
6:3:5,0,-1,105207,94793
2:1:2,2,2,105205,94795
1:1:4,0,-1,105206,94794
5:6:4,0,-1,105207,94793
4:6:5,0,-1,105208,94792
5:2:1,1,1,105207,94793
6:4:2,1,1,105206,94794
4:6:6,0,-1,105207,94793
4:2:1,1,1,105206,94794
6:3:4,0,-1,105207,94793
2:3:1,1,1,105206,94794
2:5:2,2,2,105204,94796
3:6:3,0,-1,105205,94795
5:5:5,0,-1,105206,94794
6:3:3,0,-1,105207,94793
2:2:6,2,2,105205,94795
2:4:6,1,1,105204,94796
6:4:2,1,1,105203,94797
6:4:3,0,-1,105204,94796
2:1:5,1,1,105203,94797
3:5:2,1,1,105202,94798
1:4:3,0,-1,105203,94797
5:6:1,0,-1,105204,94796
2:2:5,2,2,105202,94798
6:6:4,0,-1,105203,94797
4:3:4,0,-1,105204,94796
5:6:6,0,-1,105205,94795
4:4:4,0,-1,105206,94794
1:2:4,1,1,105205,94795
2:2:1,2,2,105203,94797
5:6:2,1,1,105202,94798
5:2:6,1,1,105201,94799
5:4:2,1,1,105200,94800
1:5:1,0,-1,105201,94799
6:6:1,0,-1,105202,94798
2:3:3,1,1,105201,94799
5:3:4,0,-1,105202,94798
6:5:1,0,-1,105203,94797
5:5:6,0,-1,105204,94796
2:1:2,2,2,105202,94798
6:1:2,1,1,105201,94799
6:2:1,1,1,105200,94800
1:2:2,2,2,105198,94802
3:3:4,0,-1,105199,94801
5:5:3,0,-1,105200,94800
6:4:5,0,-1,105201,94799
5:5:1,0,-1,105202,94798
5:5:6,0,-1,105203,94797
1:2:6,1,1,105202,94798
4:1:4,0,-1,105203,94797
6:4:1,0,-1,105204,94796
4:6:6,0,-1,105205,94795
2:3:4,1,1,105204,94796
2:1:1,1,1,105203,94797
5:2:4,1,1,105202,94798
4:5:3,0,-1,105203,94797
1:3:2,1,1,105202,94798
4:2:6,1,1,105201,94799
2:3:4,1,1,105200,94800
5:5:3,0,-1,105201,94799
1:2:3,1,1,105200,94800
3:1:3,0,-1,105201,94799
5:1:5,0,-1,105202,94798
4:6:4,0,-1,105203,94797
4:6:5,0,-1,105204,94796
1:5:2,1,1,105203,94797
4:2:2,2,2,105201,94799
4:6:2,1,1,105200,94800
1:1:2,1,1,105199,94801
2:4:2,2,2,105197,94803
1:2:4,1,1,105196,94804
6:2:5,1,1,105195,94805
6:5:2,1,1,105194,94806
1:2:2,2,2,105192,94808
5:4:6,0,-1,105193,94807
2:5:6,1,1,105192,94808
3:5:6,0,-1,105193,94807
1:5:6,0,-1,105194,94806
5:6:3,0,-1,105195,94805
3:3:1,0,-1,105196,94804
6:5:1,0,-1,105197,94803
2:5:1,1,1,105196,94804
4:1:1,0,-1,105197,94803
6:1:5,0,-1,105198,94802
3:2:6,1,1,105197,94803
1:4:5,0,-1,105198,94802
3:1:2,1,1,105197,94803
5:5:5,0,-1,105198,94802
5:1:6,0,-1,105199,94801
3:4:6,0,-1,105200,94800
4:6:1,0,-1,105201,94799
3:3:1,0,-1,105202,94798
6:1:6,0,-1,105203,94797
2:1:2,2,2,105201,94799
3:3:5,0,-1,105202,94798
4:3:5,0,-1,105203,94797
1:4:4,0,-1,105204,94796
3:4:3,0,-1,105205,94795
1:4:2,1,1,105204,94796
2:4:6,1,1,105203,94797
2:5:1,1,1,105202,94798
6:5:3,0,-1,105203,94797
4:5:1,0,-1,105204,94796
3:5:2,1,1,105203,94797
5:5:6,0,-1,105204,94796
1:3:5,0,-1,105205,94795
1:3:2,1,1,105204,94796
2:3:2,2,2,105202,94798
6:4:4,0,-1,105203,94797
6:6:2,1,1,105202,94798
1:2:4,1,1,105201,94799
4:4:1,0,-1,105202,94798
1:1:2,1,1,105201,94799
4:6:2,1,1,105200,94800
2:3:5,1,1,105199,94801
3:1:4,0,-1,105200,94800
3:2:5,1,1,105199,94801
5:2:5,1,1,105198,94802
3:6:1,0,-1,105199,94801
6:4:1,0,-1,105200,94800
6:2:3,1,1,105199,94801
2:4:2,2,2,105197,94803
1:5:4,0,-1,105198,94802
2:2:1,2,2,105196,94804
2:3:5,1,1,105195,94805
5:1:1,0,-1,105196,94804
2:6:6,1,1,105195,94805
3:3:1,0,-1,105196,94804
5:6:5,0,-1,105197,94803
2:1:6,1,1,105196,94804
3:2:1,1,1,105195,94805
2:1:5,1,1,105194,94806
2:5:4,1,1,105193,94807
6:5:4,0,-1,105194,94806
3:4:6,0,-1,105195,94805
4:3:4,0,-1,105196,94804
5:3:5,0,-1,105197,94803
2:1:4,1,1,105196,94804
4:6:6,0,-1,105197,94803
2:4:3,1,1,105196,94804
5:1:3,0,-1,105197,94803
4:5:2,1,1,105196,94804
6:3:4,0,-1,105197,94803
5:1:5,0,-1,105198,94802
2:2:4,2,2,105196,94804
2:2:2,3,3,105193,94807
4:1:5,0,-1,105194,94806
3:2:5,1,1,105193,94807
5:3:6,0,-1,105194,94806
3:5:2,1,1,105193,94807
6:4:1,0,-1,105194,94806
6:3:6,0,-1,105195,94805
1:1:4,0,-1,105196,94804
5:6:4,0,-1,105197,94803
6:3:4,0,-1,105198,94802
4:3:1,0,-1,105199,94801
5:4:1,0,-1,105200,94800
4:2:3,1,1,105199,94801
1:3:2,1,1,105198,94802
1:6:5,0,-1,105199,94801
1:4:5,0,-1,105200,94800
5:6:3,0,-1,105201,94799
5:5:6,0,-1,105202,94798
3:5:5,0,-1,105203,94797
3:2:4,1,1,105202,94798
1:2:1,1,1,105201,94799
5:3:4,0,-1,105202,94798
5:1:5,0,-1,105203,94797
5:1:2,1,1,105202,94798
6:6:3,0,-1,105203,94797
4:1:5,0,-1,105204,94796
1:5:3,0,-1,105205,94795
1:6:1,0,-1,105206,94794
6:4:6,0,-1,105207,94793
4:6:5,0,-1,105208,94792
4:4:4,0,-1,105209,94791
5:6:4,0,-1,105210,94790
2:2:1,2,2,105208,94792
3:2:5,1,1,105207,94793
2:3:3,1,1,105206,94794
1:2:4,1,1,105205,94795
5:2:6,1,1,105204,94796
5:3:2,1,1,105203,94797
6:3:1,0,-1,105204,94796
4:6:4,0,-1,105205,94795
1:1:4,0,-1,105206,94794
1:6:2,1,1,105205,94795
3:1:1,0,-1,105206,94794
1:3:6,0,-1,105207,94793
5:6:6,0,-1,105208,94792
1:6:1,0,-1,105209,94791
3:4:5,0,-1,105210,94790
3:6:6,0,-1,105211,94789
1:6:1,0,-1,105212,94788
5:4:1,0,-1,105213,94787
5:4:2,1,1,105212,94788
4:3:1,0,-1,105213,94787
3:4:6,0,-1,105214,94786
5:3:4,0,-1,105215,94785
4:6:4,0,-1,105216,94784
2:2:3,2,2,105214,94786
4:2:2,2,2,105212,94788
2:4:4,1,1,105211,94789
3:6:2,1,1,105210,94790
1:1:6,0,-1,105211,94789
4:3:2,1,1,105210,94790
2:1:2,2,2,105208,94792
1:1:5,0,-1,105209,94791
2:2:2,3,3,105206,94794
5:2:4,1,1,105205,94795
4:1:6,0,-1,105206,94794
4:4:4,0,-1,105207,94793
2:1:1,1,1,105206,94794
1:2:1,1,1,105205,94795
6:5:1,0,-1,105206,94794
6:1:3,0,-1,105207,94793
2:5:5,1,1,105206,94794
6:2:3,1,1,105205,94795
5:3:1,0,-1,105206,94794
2:2:6,2,2,105204,94796
5:6:5,0,-1,105205,94795
6:5:2,1,1,105204,94796
6:2:6,1,1,105203,94797
5:5:2,1,1,105202,94798
4:1:2,1,1,105201,94799
3:4:5,0,-1,105202,94798
2:2:2,3,3,105199,94801
5:5:1,0,-1,105200,94800
6:2:4,1,1,105199,94801
6:6:2,1,1,105198,94802
5:2:3,1,1,105197,94803
6:4:2,1,1,105196,94804
3:5:5,0,-1,105197,94803
6:3:6,0,-1,105198,94802
1:6:4,0,-1,105199,94801
4:2:4,1,1,105198,94802
6:6:6,0,-1,105199,94801
5:6:3,0,-1,105200,94800
6:6:5,0,-1,105201,94799
6:5:6,0,-1,105202,94798
5:6:3,0,-1,105203,94797
2:5:1,1,1,105202,94798
3:2:1,1,1,105201,94799
4:4:4,0,-1,105202,94798
2:5:3,1,1,105201,94799
2:4:5,1,1,105200,94800
3:6:5,0,-1,105201,94799
6:1:5,0,-1,105202,94798
6:3:3,0,-1,105203,94797
6:6:3,0,-1,105204,94796
2:5:5,1,1,105203,94797
3:3:1,0,-1,105204,94796
5:5:5,0,-1,105205,94795
3:5:5,0,-1,105206,94794
3:6:2,1,1,105205,94795
4:1:6,0,-1,105206,94794
6:3:3,0,-1,105207,94793
1:5:2,1,1,105206,94794
3:2:2,2,2,105204,94796
2:5:2,2,2,105202,94798
1:4:2,1,1,105201,94799
5:5:3,0,-1,105202,94798
4:6:2,1,1,105201,94799
6:2:3,1,1,105200,94800
2:3:5,1,1,105199,94801
1:5:5,0,-1,105200,94800
3:1:5,0,-1,105201,94799
4:3:4,0,-1,105202,94798
3:6:2,1,1,105201,94799
2:2:1,2,2,105199,94801
1:5:4,0,-1,105200,94800
2:2:4,2,2,105198,94802
3:5:2,1,1,105197,94803
3:5:3,0,-1,105198,94802
2:1:6,1,1,105197,94803
5:5:2,1,1,105196,94804
6:4:2,1,1,105195,94805
3:6:2,1,1,105194,94806
2:6:3,1,1,105193,94807
2:5:5,1,1,105192,94808
6:6:4,0,-1,105193,94807
1:6:3,0,-1,105194,94806
3:6:2,1,1,105193,94807
3:2:5,1,1,105192,94808
3:3:6,0,-1,105193,94807
6:1:1,0,-1,105194,94806
5:2:5,1,1,105193,94807
3:5:3,0,-1,105194,94806
1:6:4,0,-1,105195,94805
3:4:6,0,-1,105196,94804
3:5:5,0,-1,105197,94803
3:6:4,0,-1,105198,94802
4:1:2,1,1,105197,94803
4:5:6,0,-1,105198,94802
2:6:6,1,1,105197,94803
6:3:5,0,-1,105198,94802
5:2:4,1,1,105197,94803
6:6:5,0,-1,105198,94802
3:2:3,1,1,105197,94803
4:5:1,0,-1,105198,94802
1:2:6,1,1,105197,94803
6:5:5,0,-1,105198,94802
2:6:2,2,2,105196,94804
3:1:2,1,1,105195,94805
5:2:1,1,1,105194,94806
4:2:1,1,1,105193,94807
1:4:5,0,-1,105194,94806
3:4:3,0,-1,105195,94805
6:6:2,1,1,105194,94806
3:1:3,0,-1,105195,94805
5:1:6,0,-1,105196,94804
4:3:3,0,-1,105197,94803
1:2:1,1,1,105196,94804
3:4:1,0,-1,105197,94803
2:4:5,1,1,105196,94804
3:2:3,1,1,105195,94805
1:3:1,0,-1,105196,94804
6:4:3,0,-1,105197,94803
2:2:5,2,2,105195,94805
1:6:2,1,1,105194,94806
6:6:4,0,-1,105195,94805
3:1:2,1,1,105194,94806
6:2:4,1,1,105193,94807
2:5:6,1,1,105192,94808
1:6:6,0,-1,105193,94807
2:5:6,1,1,105192,94808
4:6:6,0,-1,105193,94807
5:5:2,1,1,105192,94808
6:6:4,0,-1,105193,94807
2:4:4,1,1,105192,94808
4:2:5,1,1,105191,94809
6:3:3,0,-1,105192,94808
5:6:6,0,-1,105193,94807
5:2:2,2,2,105191,94809
3:4:4,0,-1,105192,94808
4:5:1,0,-1,105193,94807
5:3:5,0,-1,105194,94806
1:5:6,0,-1,105195,94805
3:2:3,1,1,105194,94806
5:2:2,2,2,105192,94808
2:1:4,1,1,105191,94809
2:2:4,2,2,105189,94811
4:5:2,1,1,105188,94812
4:3:3,0,-1,105189,94811
2:3:2,2,2,105187,94813
2:2:4,2,2,105185,94815
5:4:6,0,-1,105186,94814
4:1:1,0,-1,105187,94813
2:5:4,1,1,105186,94814
3:2:4,1,1,105185,94815
6:6:4,0,-1,105186,94814
2:3:1,1,1,105185,94815
5:3:3,0,-1,105186,94814
3:3:2,1,1,105185,94815
6:5:3,0,-1,105186,94814
3:6:3,0,-1,105187,94813
2:2:2,3,3,105184,94816
3:1:4,0,-1,105185,94815
6:6:2,1,1,105184,94816
5:3:4,0,-1,105185,94815
2:4:3,1,1,105184,94816
2:5:5,1,1,105183,94817
4:4:5,0,-1,105184,94816
6:1:3,0,-1,105185,94815
5:3:6,0,-1,105186,94814
6:2:3,1,1,105185,94815
6:3:5,0,-1,105186,94814
2:4:6,1,1,105185,94815
4:4:5,0,-1,105186,94814
5:5:1,0,-1,105187,94813
3:3:5,0,-1,105188,94812
3:6:3,0,-1,105189,94811
4:2:6,1,1,105188,94812
4:1:4,0,-1,105189,94811
2:6:3,1,1,105188,94812
3:2:1,1,1,105187,94813
4:4:6,0,-1,105188,94812
2:1:1,1,1,105187,94813
6:4:4,0,-1,105188,94812
4:3:5,0,-1,105189,94811
4:2:3,1,1,105188,94812
6:4:3,0,-1,105189,94811
5:3:2,1,1,105188,94812
1:3:6,0,-1,105189,94811
3:5:2,1,1,105188,94812
2:5:3,1,1,105187,94813
1:1:1,0,-1,105188,94812
1:3:3,0,-1,105189,94811
4:5:6,0,-1,105190,94810
3:1:4,0,-1,105191,94809
3:4:3,0,-1,105192,94808
1:3:3,0,-1,105193,94807
2:2:6,2,2,105191,94809
2:6:3,1,1,105190,94810
6:5:3,0,-1,105191,94809
3:1:3,0,-1,105192,94808
1:5:4,0,-1,105193,94807
6:3:1,0,-1,105194,94806
3:5:2,1,1,105193,94807
5:6:5,0,-1,105194,94806
4:6:5,0,-1,105195,94805
2:1:2,2,2,105193,94807
4:2:6,1,1,105192,94808
6:4:5,0,-1,105193,94807
4:1:3,0,-1,105194,94806
5:4:5,0,-1,105195,94805
2:4:2,2,2,105193,94807
4:5:4,0,-1,105194,94806
5:2:1,1,1,105193,94807
1:5:6,0,-1,105194,94806
2:3:5,1,1,105193,94807
5:5:2,1,1,105192,94808
1:1:3,0,-1,105193,94807
5:1:3,0,-1,105194,94806
2:4:1,1,1,105193,94807
3:1:3,0,-1,105194,94806
5:5:5,0,-1,105195,94805
3:6:1,0,-1,105196,94804
4:2:1,1,1,105195,94805
4:3:3,0,-1,105196,94804
4:2:1,1,1,105195,94805
3:2:6,1,1,105194,94806
3:1:4,0,-1,105195,94805
1:4:5,0,-1,105196,94804
5:3:4,0,-1,105197,94803
3:4:2,1,1,105196,94804
3:6:6,0,-1,105197,94803
6:5:5,0,-1,105198,94802
4:5:3,0,-1,105199,94801
2:1:6,1,1,105198,94802
1:5:2,1,1,105197,94803
4:1:5,0,-1,105198,94802
6:4:3,0,-1,105199,94801
2:1:1,1,1,105198,94802
1:4:4,0,-1,105199,94801
1:1:1,0,-1,105200,94800
4:2:4,1,1,105199,94801
1:4:1,0,-1,105200,94800
4:5:2,1,1,105199,94801
2:3:2,2,2,105197,94803
6:6:5,0,-1,105198,94802
3:4:4,0,-1,105199,94801
2:3:4,1,1,105198,94802
4:3:5,0,-1,105199,94801
4:4:5,0,-1,105200,94800
4:3:5,0,-1,105201,94799
1:1:6,0,-1,105202,94798
3:1:1,0,-1,105203,94797
1:5:3,0,-1,105204,94796
2:5:5,1,1,105203,94797
1:6:6,0,-1,105204,94796
5:5:5,0,-1,105205,94795
6:4:3,0,-1,105206,94794
2:5:4,1,1,105205,94795
4:5:4,0,-1,105206,94794
3:6:6,0,-1,105207,94793
1:4:2,1,1,105206,94794
6:1:4,0,-1,105207,94793
2:3:1,1,1,105206,94794
5:4:3,0,-1,105207,94793
2:2:2,3,3,105204,94796
3:4:5,0,-1,105205,94795
2:3:3,1,1,105204,94796
4:6:6,0,-1,105205,94795
3:2:3,1,1,105204,94796
5:3:4,0,-1,105205,94795
4:5:4,0,-1,105206,94794
1:5:2,1,1,105205,94795
2:3:4,1,1,105204,94796
1:2:4,1,1,105203,94797
1:4:1,0,-1,105204,94796
1:4:4,0,-1,105205,94795
5:3:4,0,-1,105206,94794
2:3:2,2,2,105204,94796
6:5:4,0,-1,105205,94795
5:4:5,0,-1,105206,94794
2:4:3,1,1,105205,94795
3:6:2,1,1,105204,94796
6:1:6,0,-1,105205,94795
5:6:1,0,-1,105206,94794
6:2:3,1,1,105205,94795
5:1:3,0,-1,105206,94794
4:1:4,0,-1,105207,94793
4:6:3,0,-1,105208,94792
2:4:2,2,2,105206,94794
1:2:2,2,2,105204,94796
1:1:4,0,-1,105205,94795
3:4:3,0,-1,105206,94794
5:6:5,0,-1,105207,94793
4:2:1,1,1,105206,94794
2:5:3,1,1,105205,94795
2:3:1,1,1,105204,94796
5:6:2,1,1,105203,94797
3:1:6,0,-1,105204,94796
5:6:4,0,-1,105205,94795
2:4:5,1,1,105204,94796
6:2:1,1,1,105203,94797
5:5:5,0,-1,105204,94796
1:4:1,0,-1,105205,94795
6:2:2,2,2,105203,94797
3:1:2,1,1,105202,94798
4:3:6,0,-1,105203,94797
4:6:4,0,-1,105204,94796
5:5:1,0,-1,105205,94795
2:6:3,1,1,105204,94796
2:3:4,1,1,105203,94797
2:2:1,2,2,105201,94799
6:4:5,0,-1,105202,94798
1:1:2,1,1,105201,94799
2:5:3,1,1,105200,94800
5:2:4,1,1,105199,94801
2:1:6,1,1,105198,94802
3:3:3,0,-1,105199,94801
2:6:6,1,1,105198,94802
5:1:5,0,-1,105199,94801
3:2:4,1,1,105198,94802
3:3:3,0,-1,105199,94801
6:6:2,1,1,105198,94802
5:6:6,0,-1,105199,94801
5:3:4,0,-1,105200,94800
4:3:2,1,1,105199,94801
4:3:1,0,-1,105200,94800
5:4:1,0,-1,105201,94799
3:6:3,0,-1,105202,94798
4:5:5,0,-1,105203,94797
5:2:1,1,1,105202,94798
1:2:3,1,1,105201,94799
4:2:1,1,1,105200,94800
2:5:2,2,2,105198,94802
6:6:1,0,-1,105199,94801
5:1:1,0,-1,105200,94800
3:4:6,0,-1,105201,94799
2:4:4,1,1,105200,94800
5:4:2,1,1,105199,94801
2:2:1,2,2,105197,94803
3:6:2,1,1,105196,94804
3:4:6,0,-1,105197,94803
2:3:1,1,1,105196,94804
2:1:2,2,2,105194,94806
2:3:4,1,1,105193,94807
4:6:4,0,-1,105194,94806
2:6:1,1,1,105193,94807
1:4:1,0,-1,105194,94806
3:2:6,1,1,105193,94807
3:3:2,1,1,105192,94808
3:1:4,0,-1,105193,94807
4:6:3,0,-1,105194,94806
1:2:5,1,1,105193,94807
6:1:6,0,-1,105194,94806
2:3:3,1,1,105193,94807
5:4:3,0,-1,105194,94806
1:1:4,0,-1,105195,94805
4:1:6,0,-1,105196,94804
4:6:4,0,-1,105197,94803
3:3:2,1,1,105196,94804
1:1:4,0,-1,105197,94803
5:5:6,0,-1,105198,94802
5:4:3,0,-1,105199,94801
3:3:5,0,-1,105200,94800
3:4:1,0,-1,105201,94799
2:3:4,1,1,105200,94800
6:2:1,1,1,105199,94801
2:4:3,1,1,105198,94802
3:6:4,0,-1,105199,94801
1:1:1,0,-1,105200,94800
5:3:2,1,1,105199,94801
1:1:6,0,-1,105200,94800
3:3:3,0,-1,105201,94799
5:1:1,0,-1,105202,94798
6:3:6,0,-1,105203,94797
3:3:2,1,1,105202,94798
2:2:3,2,2,105200,94800
3:1:6,0,-1,105201,94799
2:1:5,1,1,105200,94800
2:6:1,1,1,105199,94801
5:3:5,0,-1,105200,94800
4:4:4,0,-1,105201,94799
1:6:5,0,-1,105202,94798
1:6:3,0,-1,105203,94797
6:4:4,0,-1,105204,94796
1:6:4,0,-1,105205,94795
4:6:6,0,-1,105206,94794
2:6:1,1,1,105205,94795
1:3:4,0,-1,105206,94794
3:5:6,0,-1,105207,94793
4:1:5,0,-1,105208,94792
1:4:2,1,1,105207,94793
4:3:5,0,-1,105208,94792
4:4:2,1,1,105207,94793
2:1:4,1,1,105206,94794
2:6:4,1,1,105205,94795
4:5:2,1,1,105204,94796
4:2:2,2,2,105202,94798
3:3:4,0,-1,105203,94797
5:1:4,0,-1,105204,94796
5:3:6,0,-1,105205,94795
1:4:3,0,-1,105206,94794
1:2:2,2,2,105204,94796
5:6:5,0,-1,105205,94795
6:3:1,0,-1,105206,94794
5:5:4,0,-1,105207,94793
6:3:3,0,-1,105208,94792
1:5:6,0,-1,105209,94791
4:4:2,1,1,105208,94792
4:6:4,0,-1,105209,94791
6:1:2,1,1,105208,94792
2:4:5,1,1,105207,94793
4:5:2,1,1,105206,94794
5:4:6,0,-1,105207,94793
1:1:2,1,1,105206,94794
3:2:1,1,1,105205,94795
3:6:1,0,-1,105206,94794
3:6:2,1,1,105205,94795
5:5:5,0,-1,105206,94794
2:6:1,1,1,105205,94795
3:2:6,1,1,105204,94796
3:2:2,2,2,105202,94798
3:4:1,0,-1,105203,94797
4:6:1,0,-1,105204,94796
1:2:5,1,1,105203,94797
5:1:4,0,-1,105204,94796
6:5:1,0,-1,105205,94795
3:4:6,0,-1,105206,94794
4:6:3,0,-1,105207,94793
1:2:5,1,1,105206,94794
1:3:4,0,-1,105207,94793
3:4:5,0,-1,105208,94792
3:3:6,0,-1,105209,94791
6:2:2,2,2,105207,94793
2:2:1,2,2,105205,94795
4:6:1,0,-1,105206,94794
6:3:2,1,1,105205,94795
6:4:1,0,-1,105206,94794
1:6:1,0,-1,105207,94793
6:1:4,0,-1,105208,94792
4:4:1,0,-1,105209,94791
5:3:6,0,-1,105210,94790
4:4:4,0,-1,105211,94789
6:5:3,0,-1,105212,94788
6:3:3,0,-1,105213,94787
5:3:5,0,-1,105214,94786
3:6:4,0,-1,105215,94785
1:3:1,0,-1,105216,94784
4:2:6,1,1,105215,94785
5:5:2,1,1,105214,94786
6:6:5,0,-1,105215,94785
5:1:6,0,-1,105216,94784
4:2:5,1,1,105215,94785
2:4:5,1,1,105214,94786
2:2:2,3,3,105211,94789
6:3:1,0,-1,105212,94788
4:2:2,2,2,105210,94790
6:3:3,0,-1,105211,94789
4:3:1,0,-1,105212,94788
6:5:5,0,-1,105213,94787
1:3:1,0,-1,105214,94786
4:3:6,0,-1,105215,94785
1:2:6,1,1,105214,94786
2:5:5,1,1,105213,94787
4:4:4,0,-1,105214,94786
3:6:6,0,-1,105215,94785
3:6:1,0,-1,105216,94784
2:1:3,1,1,105215,94785
4:4:3,0,-1,105216,94784
3:5:6,0,-1,105217,94783
4:1:2,1,1,105216,94784
4:6:5,0,-1,105217,94783
1:3:3,0,-1,105218,94782
3:1:6,0,-1,105219,94781
4:4:5,0,-1,105220,94780
6:5:3,0,-1,105221,94779
2:1:2,2,2,105219,94781
6:3:3,0,-1,105220,94780
2:3:6,1,1,105219,94781
1:4:3,0,-1,105220,94780
1:4:6,0,-1,105221,94779
6:5:6,0,-1,105222,94778
1:6:6,0,-1,105223,94777
2:2:2,3,3,105220,94780
6:3:4,0,-1,105221,94779
2:5:1,1,1,105220,94780
1:1:4,0,-1,105221,94779
6:5:1,0,-1,105222,94778
2:1:1,1,1,105221,94779
3:2:5,1,1,105220,94780
2:3:6,1,1,105219,94781
2:1:4,1,1,105218,94782
5:1:5,0,-1,105219,94781
4:2:6,1,1,105218,94782
2:2:1,2,2,105216,94784
4:2:3,1,1,105215,94785
6:5:3,0,-1,105216,94784
1:2:4,1,1,105215,94785
3:5:5,0,-1,105216,94784
4:2:1,1,1,105215,94785
1:1:2,1,1,105214,94786
3:1:1,0,-1,105215,94785
2:5:6,1,1,105214,94786
6:6:1,0,-1,105215,94785
5:5:1,0,-1,105216,94784
1:3:2,1,1,105215,94785
5:4:5,0,-1,105216,94784
3:6:2,1,1,105215,94785
2:3:4,1,1,105214,94786
4:5:4,0,-1,105215,94785
6:2:3,1,1,105214,94786
5:3:6,0,-1,105215,94785
3:5:6,0,-1,105216,94784
4:5:2,1,1,105215,94785
3:5:1,0,-1,105216,94784
4:2:1,1,1,105215,94785
4:2:3,1,1,105214,94786
6:4:1,0,-1,105215,94785
3:6:5,0,-1,105216,94784
2:2:5,2,2,105214,94786
1:4:5,0,-1,105215,94785
1:5:2,1,1,105214,94786
6:5:5,0,-1,105215,94785
1:6:1,0,-1,105216,94784
1:5:3,0,-1,105217,94783
4:4:2,1,1,105216,94784
4:5:5,0,-1,105217,94783
3:5:2,1,1,105216,94784
4:2:1,1,1,105215,94785
6:3:3,0,-1,105216,94784
5:5:4,0,-1,105217,94783
4:2:6,1,1,105216,94784
4:3:6,0,-1,105217,94783
3:1:2,1,1,105216,94784
4:6:1,0,-1,105217,94783
6:4:4,0,-1,105218,94782
1:3:6,0,-1,105219,94781
1:4:3,0,-1,105220,94780
1:1:2,1,1,105219,94781
5:3:1,0,-1,105220,94780
1:4:1,0,-1,105221,94779
2:4:3,1,1,105220,94780
1:2:6,1,1,105219,94781
2:4:2,2,2,105217,94783
1:6:3,0,-1,105218,94782
3:5:5,0,-1,105219,94781
5:1:1,0,-1,105220,94780
4:5:1,0,-1,105221,94779
4:6:3,0,-1,105222,94778
6:4:1,0,-1,105223,94777
5:3:2,1,1,105222,94778
1:3:3,0,-1,105223,94777
5:6:4,0,-1,105224,94776
1:2:1,1,1,105223,94777
3:6:3,0,-1,105224,94776
2:6:1,1,1,105223,94777
4:3:5,0,-1,105224,94776
5:3:4,0,-1,105225,94775
6:6:5,0,-1,105226,94774
4:5:5,0,-1,105227,94773
4:3:4,0,-1,105228,94772
3:6:3,0,-1,105229,94771
5:2:4,1,1,105228,94772
2:2:3,2,2,105226,94774
2:4:5,1,1,105225,94775
2:6:6,1,1,105224,94776
6:4:5,0,-1,105225,94775
3:3:3,0,-1,105226,94774
5:5:1,0,-1,105227,94773
4:1:4,0,-1,105228,94772
1:1:4,0,-1,105229,94771
2:2:2,3,3,105226,94774
2:4:6,1,1,105225,94775
3:2:4,1,1,105224,94776
1:3:1,0,-1,105225,94775
4:2:5,1,1,105224,94776
2:3:6,1,1,105223,94777
2:6:1,1,1,105222,94778
6:6:5,0,-1,105223,94777
3:6:5,0,-1,105224,94776
2:2:2,3,3,105221,94779
6:5:3,0,-1,105222,94778
6:1:2,1,1,105221,94779
6:4:6,0,-1,105222,94778
1:3:1,0,-1,105223,94777
3:2:5,1,1,105222,94778
5:6:5,0,-1,105223,94777
6:5:1,0,-1,105224,94776
6:5:5,0,-1,105225,94775
1:4:2,1,1,105224,94776
4:6:2,1,1,105223,94777
5:3:6,0,-1,105224,94776
4:3:1,0,-1,105225,94775
5:4:3,0,-1,105226,94774
3:5:5,0,-1,105227,94773
2:1:6,1,1,105226,94774
5:3:1,0,-1,105227,94773
6:6:1,0,-1,105228,94772
3:1:3,0,-1,105229,94771
1:3:1,0,-1,105230,94770
1:2:4,1,1,105229,94771
4:4:6,0,-1,105230,94770
2:1:5,1,1,105229,94771
4:2:6,1,1,105228,94772
3:3:6,0,-1,105229,94771
1:4:2,1,1,105228,94772
2:3:6,1,1,105227,94773
1:1:2,1,1,105226,94774
4:3:4,0,-1,105227,94773
6:5:2,1,1,105226,94774
6:1:6,0,-1,105227,94773
2:3:5,1,1,105226,94774
4:5:4,0,-1,105227,94773
1:5:6,0,-1,105228,94772
2:4:2,2,2,105226,94774
2:2:4,2,2,105224,94776
1:2:5,1,1,105223,94777
6:5:2,1,1,105222,94778
2:5:5,1,1,105221,94779
4:2:2,2,2,105219,94781
6:5:4,0,-1,105220,94780
1:5:5,0,-1,105221,94779
4:3:1,0,-1,105222,94778
3:1:3,0,-1,105223,94777
4:1:4,0,-1,105224,94776
6:1:3,0,-1,105225,94775
1:2:6,1,1,105224,94776
1:2:5,1,1,105223,94777
3:4:5,0,-1,105224,94776
3:6:5,0,-1,105225,94775
4:3:4,0,-1,105226,94774
4:1:5,0,-1,105227,94773
2:4:3,1,1,105226,94774
3:2:1,1,1,105225,94775
1:4:5,0,-1,105226,94774
2:1:5,1,1,105225,94775
2:2:1,2,2,105223,94777
6:3:1,0,-1,105224,94776
5:5:3,0,-1,105225,94775
1:1:5,0,-1,105226,94774
5:6:5,0,-1,105227,94773
4:4:3,0,-1,105228,94772
5:5:6,0,-1,105229,94771
4:1:3,0,-1,105230,94770
3:2:3,1,1,105229,94771
6:3:5,0,-1,105230,94770
4:2:6,1,1,105229,94771
1:4:1,0,-1,105230,94770
4:2:4,1,1,105229,94771
4:1:4,0,-1,105230,94770
1:4:3,0,-1,105231,94769
3:1:6,0,-1,105232,94768
5:5:2,1,1,105231,94769
3:3:4,0,-1,105232,94768
1:3:2,1,1,105231,94769
1:6:4,0,-1,105232,94768
1:5:4,0,-1,105233,94767
4:3:6,0,-1,105234,94766
2:5:1,1,1,105233,94767
1:5:3,0,-1,105234,94766
3:2:3,1,1,105233,94767
4:1:3,0,-1,105234,94766
2:5:3,1,1,105233,94767
6:6:1,0,-1,105234,94766
6:6:1,0,-1,105235,94765
3:4:5,0,-1,105236,94764
2:1:6,1,1,105235,94765
4:5:1,0,-1,105236,94764
1:6:5,0,-1,105237,94763
1:2:5,1,1,105236,94764
5:3:6,0,-1,105237,94763
6:3:3,0,-1,105238,94762
3:4:3,0,-1,105239,94761
3:3:4,0,-1,105240,94760
6:1:6,0,-1,105241,94759
2:5:5,1,1,105240,94760
5:5:2,1,1,105239,94761
6:5:4,0,-1,105240,94760
3:6:6,0,-1,105241,94759
3:3:3,0,-1,105242,94758
5:5:2,1,1,105241,94759
2:3:6,1,1,105240,94760
5:3:1,0,-1,105241,94759
3:2:1,1,1,105240,94760
2:5:3,1,1,105239,94761
4:6:1,0,-1,105240,94760
1:6:3,0,-1,105241,94759
4:2:4,1,1,105240,94760
4:6:1,0,-1,105241,94759
5:1:4,0,-1,105242,94758
1:3:5,0,-1,105243,94757
4:5:2,1,1,105242,94758
4:4:6,0,-1,105243,94757
4:5:4,0,-1,105244,94756
3:2:2,2,2,105242,94758
4:2:3,1,1,105241,94759
3:2:5,1,1,105240,94760
1:2:2,2,2,105238,94762
2:1:1,1,1,105237,94763
4:6:6,0,-1,105238,94762
4:4:2,1,1,105237,94763
4:6:4,0,-1,105238,94762
3:5:6,0,-1,105239,94761
1:3:2,1,1,105238,94762
1:1:6,0,-1,105239,94761
1:2:2,2,2,105237,94763
6:2:1,1,1,105236,94764
5:4:4,0,-1,105237,94763
2:2:4,2,2,105235,94765
1:1:1,0,-1,105236,94764
5:1:3,0,-1,105237,94763
2:3:4,1,1,105236,94764
6:2:4,1,1,105235,94765
1:2:3,1,1,105234,94766
5:5:3,0,-1,105235,94765
3:4:1,0,-1,105236,94764
5:5:5,0,-1,105237,94763
1:6:2,1,1,105236,94764
3:6:1,0,-1,105237,94763
2:2:2,3,3,105234,94766
2:1:4,1,1,105233,94767
6:5:1,0,-1,105234,94766
1:5:4,0,-1,105235,94765
3:2:6,1,1,105234,94766
5:3:3,0,-1,105235,94765
1:2:1,1,1,105234,94766
5:2:5,1,1,105233,94767
5:2:3,1,1,105232,94768
2:5:3,1,1,105231,94769
5:5:3,0,-1,105232,94768
5:4:5,0,-1,105233,94767
3:1:5,0,-1,105234,94766
1:3:4,0,-1,105235,94765
5:5:2,1,1,105234,94766
6:2:1,1,1,105233,94767
5:6:2,1,1,105232,94768
3:3:3,0,-1,105233,94767
5:4:5,0,-1,105234,94766
5:1:5,0,-1,105235,94765
6:3:2,1,1,105234,94766
1:6:6,0,-1,105235,94765
1:6:1,0,-1,105236,94764
1:2:4,1,1,105235,94765
5:1:3,0,-1,105236,94764
3:2:3,1,1,105235,94765
1:4:3,0,-1,105236,94764
6:2:6,1,1,105235,94765
1:6:3,0,-1,105236,94764
2:1:4,1,1,105235,94765
2:2:2,3,3,105232,94768
2:5:2,2,2,105230,94770
4:1:6,0,-1,105231,94769
5:1:3,0,-1,105232,94768
4:5:1,0,-1,105233,94767
3:2:1,1,1,105232,94768
5:5:5,0,-1,105233,94767
3:2:4,1,1,105232,94768
2:3:5,1,1,105231,94769
1:5:1,0,-1,105232,94768
5:5:3,0,-1,105233,94767
1:3:1,0,-1,105234,94766
2:1:5,1,1,105233,94767
1:4:2,1,1,105232,94768
6:3:3,0,-1,105233,94767
1:2:3,1,1,105232,94768
6:4:6,0,-1,105233,94767
4:4:4,0,-1,105234,94766
4:1:2,1,1,105233,94767
2:1:5,1,1,105232,94768
3:1:1,0,-1,105233,94767
5:1:1,0,-1,105234,94766
5:5:1,0,-1,105235,94765
2:6:6,1,1,105234,94766
5:6:1,0,-1,105235,94765
5:3:6,0,-1,105236,94764
5:6:4,0,-1,105237,94763
4:4:2,1,1,105236,94764
6:3:3,0,-1,105237,94763
2:6:3,1,1,105236,94764
2:5:1,1,1,105235,94765
6:4:1,0,-1,105236,94764
5:4:5,0,-1,105237,94763
2:3:4,1,1,105236,94764
3:2:5,1,1,105235,94765
4:5:2,1,1,105234,94766
6:6:6,0,-1,105235,94765
4:5:2,1,1,105234,94766
6:5:6,0,-1,105235,94765
3:3:2,1,1,105234,94766
3:3:2,1,1,105233,94767
1:2:4,1,1,105232,94768
6:5:6,0,-1,105233,94767
4:3:3,0,-1,105234,94766
2:2:4,2,2,105232,94768
3:1:4,0,-1,105233,94767
1:1:4,0,-1,105234,94766
3:1:2,1,1,105233,94767
4:6:5,0,-1,105234,94766
4:3:6,0,-1,105235,94765
4:1:4,0,-1,105236,94764
1:1:1,0,-1,105237,94763
2:6:3,1,1,105236,94764
6:4:3,0,-1,105237,94763
4:2:6,1,1,105236,94764
4:2:1,1,1,105235,94765
3:4:1,0,-1,105236,94764
6:4:4,0,-1,105237,94763
2:2:2,3,3,105234,94766
5:3:4,0,-1,105235,94765
1:1:5,0,-1,105236,94764
3:4:5,0,-1,105237,94763
2:2:4,2,2,105235,94765
6:5:1,0,-1,105236,94764
2:2:1,2,2,105234,94766
6:1:4,0,-1,105235,94765
5:1:3,0,-1,105236,94764
1:1:2,1,1,105235,94765
3:2:5,1,1,105234,94766
3:2:1,1,1,105233,94767
5:5:2,1,1,105232,94768
2:1:5,1,1,105231,94769
5:4:6,0,-1,105232,94768
1:4:1,0,-1,105233,94767
1:5:3,0,-1,105234,94766
1:4:3,0,-1,105235,94765
6:3:2,1,1,105234,94766
1:6:6,0,-1,105235,94765
2:3:1,1,1,105234,94766
3:2:3,1,1,105233,94767
1:6:5,0,-1,105234,94766
6:1:5,0,-1,105235,94765
3:1:4,0,-1,105236,94764
4:5:3,0,-1,105237,94763
5:4:2,1,1,105236,94764
2:4:5,1,1,105235,94765
3:5:5,0,-1,105236,94764
6:2:5,1,1,105235,94765
5:6:6,0,-1,105236,94764
5:4:3,0,-1,105237,94763
5:5:4,0,-1,105238,94762
1:4:5,0,-1,105239,94761
2:6:6,1,1,105238,94762
4:3:4,0,-1,105239,94761
1:5:3,0,-1,105240,94760
3:4:1,0,-1,105241,94759
3:2:6,1,1,105240,94760
6:5:4,0,-1,105241,94759
1:4:6,0,-1,105242,94758
5:2:3,1,1,105241,94759
6:5:3,0,-1,105242,94758
1:6:5,0,-1,105243,94757
5:6:2,1,1,105242,94758
3:1:6,0,-1,105243,94757
4:3:1,0,-1,105244,94756
3:3:2,1,1,105243,94757
1:1:1,0,-1,105244,94756
6:5:5,0,-1,105245,94755
2:6:1,1,1,105244,94756
2:2:1,2,2,105242,94758
1:2:2,2,2,105240,94760
2:4:3,1,1,105239,94761
4:5:2,1,1,105238,94762
3:5:5,0,-1,105239,94761
1:3:2,1,1,105238,94762
5:6:4,0,-1,105239,94761
5:2:2,2,2,105237,94763
1:5:3,0,-1,105238,94762
5:1:2,1,1,105237,94763
6:6:6,0,-1,105238,94762
5:1:1,0,-1,105239,94761
5:2:4,1,1,105238,94762
3:1:3,0,-1,105239,94761
5:3:5,0,-1,105240,94760
5:2:1,1,1,105239,94761
2:2:2,3,3,105236,94764
1:2:1,1,1,105235,94765
4:3:4,0,-1,105236,94764
3:3:3,0,-1,105237,94763
3:6:6,0,-1,105238,94762
5:3:6,0,-1,105239,94761
3:3:2,1,1,105238,94762
4:5:6,0,-1,105239,94761
2:6:3,1,1,105238,94762
5:3:2,1,1,105237,94763
6:6:1,0,-1,105238,94762
1:6:4,0,-1,105239,94761
3:3:6,0,-1,105240,94760
2:1:2,2,2,105238,94762
4:5:2,1,1,105237,94763
5:1:3,0,-1,105238,94762
5:4:3,0,-1,105239,94761
2:1:6,1,1,105238,94762
5:3:3,0,-1,105239,94761
6:5:2,1,1,105238,94762
1:3:6,0,-1,105239,94761
5:5:2,1,1,105238,94762
4:3:3,0,-1,105239,94761
2:4:4,1,1,105238,94762
4:5:5,0,-1,105239,94761
4:2:1,1,1,105238,94762
2:4:1,1,1,105237,94763
6:6:6,0,-1,105238,94762
5:1:6,0,-1,105239,94761
4:2:3,1,1,105238,94762
4:4:2,1,1,105237,94763
1:2:3,1,1,105236,94764
2:2:5,2,2,105234,94766
4:3:1,0,-1,105235,94765
2:1:3,1,1,105234,94766
1:5:5,0,-1,105235,94765
5:2:3,1,1,105234,94766
4:6:1,0,-1,105235,94765
3:3:5,0,-1,105236,94764
5:5:3,0,-1,105237,94763
6:5:2,1,1,105236,94764
3:2:1,1,1,105235,94765
2:6:1,1,1,105234,94766
1:6:6,0,-1,105235,94765
5:3:3,0,-1,105236,94764
3:1:5,0,-1,105237,94763
5:6:5,0,-1,105238,94762
2:5:5,1,1,105237,94763
3:2:3,1,1,105236,94764
6:4:1,0,-1,105237,94763
5:3:4,0,-1,105238,94762
4:1:5,0,-1,105239,94761
6:3:2,1,1,105238,94762
5:2:2,2,2,105236,94764
6:1:3,0,-1,105237,94763
4:5:3,0,-1,105238,94762
2:5:3,1,1,105237,94763
1:6:3,0,-1,105238,94762
2:6:4,1,1,105237,94763
3:6:5,0,-1,105238,94762
6:1:1,0,-1,105239,94761
1:4:6,0,-1,105240,94760
4:6:3,0,-1,105241,94759
6:3:3,0,-1,105242,94758
6:1:3,0,-1,105243,94757
2:2:3,2,2,105241,94759
5:6:5,0,-1,105242,94758
4:5:6,0,-1,105243,94757
2:2:4,2,2,105241,94759
3:2:6,1,1,105240,94760
1:6:5,0,-1,105241,94759
3:3:3,0,-1,105242,94758
6:2:5,1,1,105241,94759
6:3:3,0,-1,105242,94758
5:5:5,0,-1,105243,94757
6:5:4,0,-1,105244,94756
5:2:1,1,1,105243,94757
4:1:4,0,-1,105244,94756
3:4:4,0,-1,105245,94755
5:4:2,1,1,105244,94756
6:2:3,1,1,105243,94757
2:3:6,1,1,105242,94758
6:3:2,1,1,105241,94759
1:3:2,1,1,105240,94760
1:6:2,1,1,105239,94761
5:5:6,0,-1,105240,94760
5:4:3,0,-1,105241,94759
4:4:6,0,-1,105242,94758
4:1:5,0,-1,105243,94757
1:4:3,0,-1,105244,94756
4:3:3,0,-1,105245,94755
1:2:2,2,2,105243,94757
4:3:5,0,-1,105244,94756
3:6:3,0,-1,105245,94755
5:1:1,0,-1,105246,94754
6:4:6,0,-1,105247,94753
4:5:5,0,-1,105248,94752
6:4:2,1,1,105247,94753
4:3:5,0,-1,105248,94752
6:5:2,1,1,105247,94753
2:5:5,1,1,105246,94754
6:1:3,0,-1,105247,94753
2:5:5,1,1,105246,94754
5:3:5,0,-1,105247,94753
1:2:6,1,1,105246,94754
4:4:5,0,-1,105247,94753
4:4:6,0,-1,105248,94752
3:3:1,0,-1,105249,94751
3:4:2,1,1,105248,94752
6:2:6,1,1,105247,94753
5:6:4,0,-1,105248,94752
6:3:1,0,-1,105249,94751
3:1:5,0,-1,105250,94750
3:2:5,1,1,105249,94751
4:4:2,1,1,105248,94752
4:3:2,1,1,105247,94753
2:2:4,2,2,105245,94755
6:2:3,1,1,105244,94756
2:6:3,1,1,105243,94757
5:4:3,0,-1,105244,94756
4:6:6,0,-1,105245,94755
6:3:4,0,-1,105246,94754
3:1:3,0,-1,105247,94753
2:3:5,1,1,105246,94754
5:1:1,0,-1,105247,94753
4:5:3,0,-1,105248,94752
3:2:2,2,2,105246,94754
1:3:3,0,-1,105247,94753
4:4:1,0,-1,105248,94752
2:1:1,1,1,105247,94753
2:4:3,1,1,105246,94754
3:5:2,1,1,105245,94755
6:5:4,0,-1,105246,94754
1:5:1,0,-1,105247,94753
4:5:2,1,1,105246,94754
3:3:4,0,-1,105247,94753
4:3:5,0,-1,105248,94752
1:1:5,0,-1,105249,94751
4:4:4,0,-1,105250,94750
5:3:5,0,-1,105251,94749
1:1:6,0,-1,105252,94748
5:6:6,0,-1,105253,94747
5:2:2,2,2,105251,94749
6:6:4,0,-1,105252,94748
4:4:2,1,1,105251,94749
5:3:6,0,-1,105252,94748
4:6:5,0,-1,105253,94747
2:5:3,1,1,105252,94748
4:6:6,0,-1,105253,94747
3:5:5,0,-1,105254,94746
1:4:3,0,-1,105255,94745
1:6:5,0,-1,105256,94744
5:4:4,0,-1,105257,94743
5:3:6,0,-1,105258,94742
2:5:1,1,1,105257,94743
3:3:5,0,-1,105258,94742
5:5:6,0,-1,105259,94741
3:5:5,0,-1,105260,94740
4:2:3,1,1,105259,94741
6:4:4,0,-1,105260,94740
5:4:6,0,-1,105261,94739
1:5:4,0,-1,105262,94738
3:5:5,0,-1,105263,94737
3:1:3,0,-1,105264,94736
6:6:2,1,1,105263,94737
4:1:4,0,-1,105264,94736
6:4:6,0,-1,105265,94735
2:4:4,1,1,105264,94736
5:3:6,0,-1,105265,94735
3:3:6,0,-1,105266,94734
1:3:5,0,-1,105267,94733
2:6:1,1,1,105266,94734
2:2:3,2,2,105264,94736
4:2:1,1,1,105263,94737
2:4:4,1,1,105262,94738
4:5:3,0,-1,105263,94737
5:4:1,0,-1,105264,94736
5:5:3,0,-1,105265,94735
3:2:2,2,2,105263,94737
4:6:4,0,-1,105264,94736
2:6:6,1,1,105263,94737
2:2:1,2,2,105261,94739
5:5:2,1,1,105260,94740
1:4:1,0,-1,105261,94739
3:1:2,1,1,105260,94740
3:4:2,1,1,105259,94741
6:3:4,0,-1,105260,94740
4:6:1,0,-1,105261,94739
4:2:4,1,1,105260,94740
6:4:6,0,-1,105261,94739
4:4:4,0,-1,105262,94738
2:3:6,1,1,105261,94739
4:6:6,0,-1,105262,94738
1:6:4,0,-1,105263,94737
2:2:3,2,2,105261,94739
5:1:3,0,-1,105262,94738
3:4:1,0,-1,105263,94737
2:3:2,2,2,105261,94739
3:5:4,0,-1,105262,94738
4:4:1,0,-1,105263,94737
1:1:1,0,-1,105264,94736
1:4:4,0,-1,105265,94735
6:6:6,0,-1,105266,94734
5:5:5,0,-1,105267,94733
6:5:5,0,-1,105268,94732
6:3:1,0,-1,105269,94731
6:4:4,0,-1,105270,94730
2:3:1,1,1,105269,94731
2:6:1,1,1,105268,94732
4:1:2,1,1,105267,94733
4:3:3,0,-1,105268,94732
4:2:2,2,2,105266,94734
3:3:5,0,-1,105267,94733
4:5:3,0,-1,105268,94732
3:5:6,0,-1,105269,94731
3:6:5,0,-1,105270,94730
3:4:2,1,1,105269,94731
4:4:2,1,1,105268,94732
1:2:5,1,1,105267,94733
4:6:6,0,-1,105268,94732
2:2:4,2,2,105266,94734
6:1:4,0,-1,105267,94733
6:3:4,0,-1,105268,94732
4:6:5,0,-1,105269,94731
5:4:5,0,-1,105270,94730
6:4:6,0,-1,105271,94729
2:4:5,1,1,105270,94730
5:1:5,0,-1,105271,94729
3:2:1,1,1,105270,94730
6:2:1,1,1,105269,94731
2:2:5,2,2,105267,94733
4:2:3,1,1,105266,94734
2:2:5,2,2,105264,94736
2:1:3,1,1,105263,94737
3:6:2,1,1,105262,94738
4:4:2,1,1,105261,94739
1:4:2,1,1,105260,94740
6:6:3,0,-1,105261,94739
4:1:4,0,-1,105262,94738
4:6:1,0,-1,105263,94737
4:3:4,0,-1,105264,94736
5:2:3,1,1,105263,94737
2:4:5,1,1,105262,94738
2:1:1,1,1,105261,94739
4:1:1,0,-1,105262,94738
5:1:4,0,-1,105263,94737
1:4:3,0,-1,105264,94736
6:6:2,1,1,105263,94737
3:2:3,1,1,105262,94738
2:2:5,2,2,105260,94740
4:4:4,0,-1,105261,94739
1:1:4,0,-1,105262,94738
6:1:5,0,-1,105263,94737
1:4:5,0,-1,105264,94736
5:5:6,0,-1,105265,94735
2:2:1,2,2,105263,94737
5:3:4,0,-1,105264,94736
4:4:2,1,1,105263,94737
1:1:2,1,1,105262,94738
1:2:1,1,1,105261,94739
3:5:4,0,-1,105262,94738
3:5:1,0,-1,105263,94737
3:1:3,0,-1,105264,94736
1:2:1,1,1,105263,94737
1:5:3,0,-1,105264,94736
5:3:3,0,-1,105265,94735
2:5:1,1,1,105264,94736
4:6:1,0,-1,105265,94735
6:4:4,0,-1,105266,94734
3:3:5,0,-1,105267,94733
6:3:3,0,-1,105268,94732
6:1:2,1,1,105267,94733
6:4:1,0,-1,105268,94732
3:3:1,0,-1,105269,94731
3:4:2,1,1,105268,94732
3:6:2,1,1,105267,94733
3:6:4,0,-1,105268,94732
6:5:2,1,1,105267,94733
5:6:3,0,-1,105268,94732
3:3:4,0,-1,105269,94731
2:4:4,1,1,105268,94732
3:6:3,0,-1,105269,94731
1:1:1,0,-1,105270,94730
5:3:6,0,-1,105271,94729
2:3:6,1,1,105270,94730
3:2:6,1,1,105269,94731
5:5:3,0,-1,105270,94730
1:4:6,0,-1,105271,94729
5:3:2,1,1,105270,94730
3:2:5,1,1,105269,94731
6:3:4,0,-1,105270,94730
2:6:1,1,1,105269,94731
3:2:5,1,1,105268,94732
1:6:4,0,-1,105269,94731
6:4:5,0,-1,105270,94730
3:1:3,0,-1,105271,94729
6:3:4,0,-1,105272,94728
3:6:4,0,-1,105273,94727
3:2:1,1,1,105272,94728
6:6:1,0,-1,105273,94727
1:6:3,0,-1,105274,94726
4:1:1,0,-1,105275,94725
3:5:3,0,-1,105276,94724
3:6:4,0,-1,105277,94723
4:6:2,1,1,105276,94724
6:6:2,1,1,105275,94725
5:2:1,1,1,105274,94726
6:5:2,1,1,105273,94727
1:3:1,0,-1,105274,94726
3:1:1,0,-1,105275,94725
6:4:3,0,-1,105276,94724
1:6:3,0,-1,105277,94723
5:6:1,0,-1,105278,94722
3:5:6,0,-1,105279,94721
2:6:1,1,1,105278,94722
4:3:3,0,-1,105279,94721
3:3:3,0,-1,105280,94720
6:5:4,0,-1,105281,94719
2:4:4,1,1,105280,94720
5:5:2,1,1,105279,94721
3:2:4,1,1,105278,94722
2:1:6,1,1,105277,94723
1:1:6,0,-1,105278,94722
6:3:5,0,-1,105279,94721
4:6:6,0,-1,105280,94720
5:3:4,0,-1,105281,94719
2:5:2,2,2,105279,94721
3:1:6,0,-1,105280,94720
2:3:5,1,1,105279,94721
2:4:2,2,2,105277,94723
2:3:2,2,2,105275,94725
3:1:4,0,-1,105276,94724
5:6:4,0,-1,105277,94723
1:1:6,0,-1,105278,94722
1:2:4,1,1,105277,94723
5:5:2,1,1,105276,94724
3:6:2,1,1,105275,94725
6:6:5,0,-1,105276,94724
6:4:1,0,-1,105277,94723
1:1:1,0,-1,105278,94722
1:1:2,1,1,105277,94723
4:5:4,0,-1,105278,94722
2:1:6,1,1,105277,94723
5:3:3,0,-1,105278,94722
5:1:1,0,-1,105279,94721
5:4:5,0,-1,105280,94720
1:1:6,0,-1,105281,94719
4:2:5,1,1,105280,94720
3:2:2,2,2,105278,94722
5:3:6,0,-1,105279,94721
1:5:6,0,-1,105280,94720
3:6:2,1,1,105279,94721
3:1:2,1,1,105278,94722
4:4:6,0,-1,105279,94721
2:4:4,1,1,105278,94722
3:6:2,1,1,105277,94723
6:6:5,0,-1,105278,94722
3:5:5,0,-1,105279,94721
1:1:5,0,-1,105280,94720
2:2:5,2,2,105278,94722
6:4:5,0,-1,105279,94721
3:1:2,1,1,105278,94722
3:2:5,1,1,105277,94723
5:1:6,0,-1,105278,94722
4:1:4,0,-1,105279,94721
4:6:1,0,-1,105280,94720
1:3:2,1,1,105279,94721
3:2:4,1,1,105278,94722
1:2:4,1,1,105277,94723
4:4:2,1,1,105276,94724
4:3:4,0,-1,105277,94723
2:4:2,2,2,105275,94725
5:5:4,0,-1,105276,94724
2:6:4,1,1,105275,94725
1:4:2,1,1,105274,94726
4:2:2,2,2,105272,94728
3:3:1,0,-1,105273,94727
3:1:4,0,-1,105274,94726
5:4:5,0,-1,105275,94725
4:1:6,0,-1,105276,94724
4:6:2,1,1,105275,94725
3:1:1,0,-1,105276,94724
4:1:2,1,1,105275,94725
5:4:1,0,-1,105276,94724
4:6:3,0,-1,105277,94723
1:4:4,0,-1,105278,94722
5:5:1,0,-1,105279,94721
3:6:4,0,-1,105280,94720
3:6:5,0,-1,105281,94719
2:4:5,1,1,105280,94720
1:2:5,1,1,105279,94721
1:5:5,0,-1,105280,94720
2:1:1,1,1,105279,94721
6:6:3,0,-1,105280,94720
2:6:4,1,1,105279,94721
2:4:1,1,1,105278,94722
4:2:3,1,1,105277,94723
4:3:2,1,1,105276,94724
6:3:2,1,1,105275,94725
5:6:5,0,-1,105276,94724
6:4:6,0,-1,105277,94723
6:3:4,0,-1,105278,94722
3:6:5,0,-1,105279,94721
1:4:6,0,-1,105280,94720
1:2:6,1,1,105279,94721
6:1:2,1,1,105278,94722
6:1:3,0,-1,105279,94721
4:5:1,0,-1,105280,94720
1:4:2,1,1,105279,94721
4:6:3,0,-1,105280,94720
4:6:3,0,-1,105281,94719
6:1:6,0,-1,105282,94718
2:5:5,1,1,105281,94719
3:2:6,1,1,105280,94720
6:6:4,0,-1,105281,94719
1:5:5,0,-1,105282,94718
2:4:1,1,1,105281,94719
2:5:6,1,1,105280,94720
2:1:1,1,1,105279,94721
2:2:1,2,2,105277,94723
2:1:3,1,1,105276,94724
1:6:5,0,-1,105277,94723
1:3:6,0,-1,105278,94722
4:2:6,1,1,105277,94723
4:6:6,0,-1,105278,94722
6:3:3,0,-1,105279,94721
2:2:5,2,2,105277,94723
6:5:4,0,-1,105278,94722
2:3:3,1,1,105277,94723
5:1:2,1,1,105276,94724
4:3:5,0,-1,105277,94723
2:5:3,1,1,105276,94724
2:3:5,1,1,105275,94725
3:3:4,0,-1,105276,94724
5:3:2,1,1,105275,94725
5:6:6,0,-1,105276,94724
4:1:2,1,1,105275,94725
5:5:4,0,-1,105276,94724
3:6:5,0,-1,105277,94723
2:2:1,2,2,105275,94725
5:6:2,1,1,105274,94726
1:3:4,0,-1,105275,94725
3:6:1,0,-1,105276,94724
6:1:4,0,-1,105277,94723
6:6:4,0,-1,105278,94722
1:3:2,1,1,105277,94723
1:3:2,1,1,105276,94724
6:3:2,1,1,105275,94725
5:1:6,0,-1,105276,94724
1:2:2,2,2,105274,94726
3:1:4,0,-1,105275,94725
4:5:4,0,-1,105276,94724
3:1:1,0,-1,105277,94723
3:2:5,1,1,105276,94724
6:2:4,1,1,105275,94725
6:6:3,0,-1,105276,94724
3:5:1,0,-1,105277,94723
2:5:6,1,1,105276,94724
1:6:2,1,1,105275,94725
4:6:1,0,-1,105276,94724
3:3:6,0,-1,105277,94723
3:5:2,1,1,105276,94724
1:4:6,0,-1,105277,94723
3:5:4,0,-1,105278,94722
4:4:4,0,-1,105279,94721
2:3:4,1,1,105278,94722
4:1:2,1,1,105277,94723
6:2:3,1,1,105276,94724
6:3:4,0,-1,105277,94723
3:5:4,0,-1,105278,94722
4:4:2,1,1,105277,94723
4:2:1,1,1,105276,94724
2:1:1,1,1,105275,94725
3:4:1,0,-1,105276,94724
2:4:3,1,1,105275,94725
2:1:1,1,1,105274,94726
6:3:5,0,-1,105275,94725
3:1:5,0,-1,105276,94724
3:1:5,0,-1,105277,94723
2:5:2,2,2,105275,94725
5:1:5,0,-1,105276,94724
4:1:6,0,-1,105277,94723
2:5:5,1,1,105276,94724
3:4:2,1,1,105275,94725
5:1:2,1,1,105274,94726
3:6:1,0,-1,105275,94725
1:2:3,1,1,105274,94726
4:1:1,0,-1,105275,94725
3:2:1,1,1,105274,94726
5:2:5,1,1,105273,94727
2:1:3,1,1,105272,94728
2:6:1,1,1,105271,94729
3:3:5,0,-1,105272,94728
5:1:5,0,-1,105273,94727
4:6:4,0,-1,105274,94726
1:2:5,1,1,105273,94727
4:1:6,0,-1,105274,94726
2:2:4,2,2,105272,94728
5:6:3,0,-1,105273,94727
1:1:2,1,1,105272,94728
5:3:4,0,-1,105273,94727
5:4:1,0,-1,105274,94726
2:4:1,1,1,105273,94727
5:5:6,0,-1,105274,94726
1:3:6,0,-1,105275,94725
2:5:1,1,1,105274,94726
2:3:4,1,1,105273,94727
1:2:6,1,1,105272,94728
2:1:6,1,1,105271,94729
6:4:3,0,-1,105272,94728
5:2:6,1,1,105271,94729
4:6:6,0,-1,105272,94728
5:5:1,0,-1,105273,94727
2:5:1,1,1,105272,94728
2:3:1,1,1,105271,94729
4:1:1,0,-1,105272,94728
1:5:1,0,-1,105273,94727
6:5:6,0,-1,105274,94726
1:3:3,0,-1,105275,94725
1:5:5,0,-1,105276,94724
1:5:3,0,-1,105277,94723
3:4:2,1,1,105276,94724
4:2:2,2,2,105274,94726
3:2:2,2,2,105272,94728
1:6:6,0,-1,105273,94727
3:4:4,0,-1,105274,94726
6:4:1,0,-1,105275,94725
6:3:2,1,1,105274,94726
5:3:4,0,-1,105275,94725
3:1:1,0,-1,105276,94724
6:3:1,0,-1,105277,94723
1:5:4,0,-1,105278,94722
6:1:2,1,1,105277,94723
1:5:5,0,-1,105278,94722
5:1:5,0,-1,105279,94721
3:3:5,0,-1,105280,94720
5:5:4,0,-1,105281,94719
6:3:2,1,1,105280,94720
5:3:6,0,-1,105281,94719
6:5:3,0,-1,105282,94718
1:3:5,0,-1,105283,94717
2:4:5,1,1,105282,94718
4:5:5,0,-1,105283,94717
1:2:5,1,1,105282,94718
4:3:2,1,1,105281,94719
3:5:2,1,1,105280,94720
4:4:6,0,-1,105281,94719
4:5:5,0,-1,105282,94718
3:6:4,0,-1,105283,94717
5:3:4,0,-1,105284,94716
3:5:3,0,-1,105285,94715
5:6:1,0,-1,105286,94714
5:4:1,0,-1,105287,94713
2:6:1,1,1,105286,94714
3:3:3,0,-1,105287,94713
5:3:5,0,-1,105288,94712
2:3:2,2,2,105286,94714
1:3:4,0,-1,105287,94713
4:6:1,0,-1,105288,94712
1:6:3,0,-1,105289,94711
3:4:5,0,-1,105290,94710
2:3:2,2,2,105288,94712
6:5:4,0,-1,105289,94711
6:3:4,0,-1,105290,94710
2:3:6,1,1,105289,94711
4:4:4,0,-1,105290,94710
3:5:2,1,1,105289,94711
6:5:4,0,-1,105290,94710
4:6:3,0,-1,105291,94709
1:2:1,1,1,105290,94710
4:3:2,1,1,105289,94711
5:2:1,1,1,105288,94712
2:2:6,2,2,105286,94714
6:4:2,1,1,105285,94715
5:3:2,1,1,105284,94716
6:6:5,0,-1,105285,94715
1:4:4,0,-1,105286,94714
1:3:4,0,-1,105287,94713
2:3:1,1,1,105286,94714
6:5:5,0,-1,105287,94713
4:2:1,1,1,105286,94714
4:2:4,1,1,105285,94715
6:5:5,0,-1,105286,94714
2:3:3,1,1,105285,94715
2:3:2,2,2,105283,94717
4:4:4,0,-1,105284,94716
1:2:2,2,2,105282,94718
2:4:2,2,2,105280,94720
5:2:4,1,1,105279,94721
5:2:5,1,1,105278,94722
4:5:3,0,-1,105279,94721
2:2:5,2,2,105277,94723
5:3:4,0,-1,105278,94722
1:1:3,0,-1,105279,94721
1:1:2,1,1,105278,94722
6:3:5,0,-1,105279,94721
1:1:4,0,-1,105280,94720
1:3:5,0,-1,105281,94719
3:4:3,0,-1,105282,94718
5:5:5,0,-1,105283,94717
6:4:1,0,-1,105284,94716
1:6:1,0,-1,105285,94715
1:4:1,0,-1,105286,94714
1:1:3,0,-1,105287,94713
4:5:2,1,1,105286,94714
6:4:1,0,-1,105287,94713
5:4:5,0,-1,105288,94712
1:3:5,0,-1,105289,94711
6:5:3,0,-1,105290,94710
6:3:3,0,-1,105291,94709
4:1:2,1,1,105290,94710
2:6:3,1,1,105289,94711
1:6:3,0,-1,105290,94710
2:1:1,1,1,105289,94711
2:4:1,1,1,105288,94712
3:3:1,0,-1,105289,94711
3:6:5,0,-1,105290,94710
5:5:5,0,-1,105291,94709
3:3:1,0,-1,105292,94708
1:2:4,1,1,105291,94709
4:6:2,1,1,105290,94710
4:6:3,0,-1,105291,94709
5:5:1,0,-1,105292,94708
3:6:1,0,-1,105293,94707
5:4:5,0,-1,105294,94706
4:4:3,0,-1,105295,94705
2:2:6,2,2,105293,94707
3:3:1,0,-1,105294,94706
4:4:2,1,1,105293,94707
5:5:2,1,1,105292,94708
6:6:2,1,1,105291,94709
5:3:1,0,-1,105292,94708
4:6:3,0,-1,105293,94707
5:1:5,0,-1,105294,94706
5:3:3,0,-1,105295,94705
1:3:1,0,-1,105296,94704
5:6:5,0,-1,105297,94703
3:6:3,0,-1,105298,94702
2:1:6,1,1,105297,94703
5:2:1,1,1,105296,94704
2:2:4,2,2,105294,94706
5:3:6,0,-1,105295,94705
5:6:2,1,1,105294,94706
4:3:3,0,-1,105295,94705
6:1:5,0,-1,105296,94704
1:6:1,0,-1,105297,94703
4:3:1,0,-1,105298,94702
1:3:3,0,-1,105299,94701
5:1:6,0,-1,105300,94700
2:5:3,1,1,105299,94701
3:3:3,0,-1,105300,94700
2:5:2,2,2,105298,94702
1:3:6,0,-1,105299,94701
6:3:5,0,-1,105300,94700
6:5:6,0,-1,105301,94699
1:1:4,0,-1,105302,94698
3:1:6,0,-1,105303,94697
5:4:3,0,-1,105304,94696
5:4:3,0,-1,105305,94695
3:5:1,0,-1,105306,94694
6:4:1,0,-1,105307,94693
5:2:1,1,1,105306,94694
2:6:6,1,1,105305,94695
6:2:2,2,2,105303,94697
1:3:3,0,-1,105304,94696
3:3:6,0,-1,105305,94695
6:3:4,0,-1,105306,94694
4:2:2,2,2,105304,94696
4:1:6,0,-1,105305,94695
4:4:5,0,-1,105306,94694
2:3:2,2,2,105304,94696
4:4:4,0,-1,105305,94695
2:3:2,2,2,105303,94697
2:4:2,2,2,105301,94699
2:1:4,1,1,105300,94700
6:5:3,0,-1,105301,94699
5:5:6,0,-1,105302,94698
1:1:4,0,-1,105303,94697
3:5:4,0,-1,105304,94696
6:6:5,0,-1,105305,94695
3:6:5,0,-1,105306,94694
6:5:5,0,-1,105307,94693
6:3:6,0,-1,105308,94692
5:2:3,1,1,105307,94693
1:6:2,1,1,105306,94694
4:3:2,1,1,105305,94695
4:6:4,0,-1,105306,94694
1:1:1,0,-1,105307,94693
3:1:1,0,-1,105308,94692
6:6:2,1,1,105307,94693
3:3:4,0,-1,105308,94692
3:4:2,1,1,105307,94693
2:3:5,1,1,105306,94694
3:3:2,1,1,105305,94695
3:6:3,0,-1,105306,94694
6:2:4,1,1,105305,94695
1:3:4,0,-1,105306,94694
2:1:1,1,1,105305,94695
6:5:2,1,1,105304,94696
3:1:5,0,-1,105305,94695
6:2:6,1,1,105304,94696
4:1:6,0,-1,105305,94695
1:6:2,1,1,105304,94696
3:6:5,0,-1,105305,94695
6:5:2,1,1,105304,94696
1:3:3,0,-1,105305,94695
1:2:4,1,1,105304,94696
3:5:4,0,-1,105305,94695
5:5:3,0,-1,105306,94694
1:6:4,0,-1,105307,94693
1:3:6,0,-1,105308,94692
1:4:3,0,-1,105309,94691
2:5:3,1,1,105308,94692
4:6:1,0,-1,105309,94691
4:6:6,0,-1,105310,94690
3:2:4,1,1,105309,94691
2:2:4,2,2,105307,94693
2:1:6,1,1,105306,94694
1:1:1,0,-1,105307,94693
5:5:6,0,-1,105308,94692
1:6:4,0,-1,105309,94691
2:6:5,1,1,105308,94692
4:2:6,1,1,105307,94693
6:1:6,0,-1,105308,94692
2:5:2,2,2,105306,94694
5:6:1,0,-1,105307,94693
6:1:2,1,1,105306,94694
6:6:5,0,-1,105307,94693
6:6:3,0,-1,105308,94692
4:2:5,1,1,105307,94693
5:5:6,0,-1,105308,94692
5:1:2,1,1,105307,94693
5:5:5,0,-1,105308,94692
3:4:5,0,-1,105309,94691
5:6:6,0,-1,105310,94690
1:3:3,0,-1,105311,94689
4:4:1,0,-1,105312,94688
6:3:1,0,-1,105313,94687
5:1:4,0,-1,105314,94686
4:2:5,1,1,105313,94687
5:5:3,0,-1,105314,94686
1:4:4,0,-1,105315,94685
5:6:4,0,-1,105316,94684
3:5:3,0,-1,105317,94683
3:4:4,0,-1,105318,94682
2:1:1,1,1,105317,94683
1:5:2,1,1,105316,94684
6:1:2,1,1,105315,94685
4:5:3,0,-1,105316,94684
4:4:5,0,-1,105317,94683
4:3:2,1,1,105316,94684
1:1:4,0,-1,105317,94683
5:6:5,0,-1,105318,94682
2:3:6,1,1,105317,94683
3:4:4,0,-1,105318,94682
4:3:1,0,-1,105319,94681
4:5:6,0,-1,105320,94680
4:5:1,0,-1,105321,94679
3:6:5,0,-1,105322,94678
3:1:6,0,-1,105323,94677
4:2:1,1,1,105322,94678
4:1:2,1,1,105321,94679
1:4:1,0,-1,105322,94678
3:5:3,0,-1,105323,94677
3:6:5,0,-1,105324,94676
2:4:4,1,1,105323,94677
2:6:6,1,1,105322,94678
6:5:6,0,-1,105323,94677
1:4:5,0,-1,105324,94676
5:2:1,1,1,105323,94677
1:2:3,1,1,105322,94678
2:1:1,1,1,105321,94679
1:2:5,1,1,105320,94680
3:2:4,1,1,105319,94681
6:1:1,0,-1,105320,94680
4:6:6,0,-1,105321,94679
3:5:1,0,-1,105322,94678
1:3:3,0,-1,105323,94677
4:4:1,0,-1,105324,94676
6:2:2,2,2,105322,94678
2:6:1,1,1,105321,94679
5:3:3,0,-1,105322,94678
2:6:6,1,1,105321,94679
2:4:5,1,1,105320,94680
3:4:5,0,-1,105321,94679
6:4:6,0,-1,105322,94678
4:2:4,1,1,105321,94679
6:3:1,0,-1,105322,94678
4:5:4,0,-1,105323,94677
4:4:2,1,1,105322,94678
2:3:1,1,1,105321,94679
6:5:6,0,-1,105322,94678
4:5:1,0,-1,105323,94677
6:6:5,0,-1,105324,94676
2:3:3,1,1,105323,94677
6:2:4,1,1,105322,94678
4:1:3,0,-1,105323,94677
1:5:2,1,1,105322,94678
4:1:4,0,-1,105323,94677
1:5:3,0,-1,105324,94676
6:5:5,0,-1,105325,94675
5:3:4,0,-1,105326,94674
4:1:6,0,-1,105327,94673
6:6:6,0,-1,105328,94672
2:1:3,1,1,105327,94673
2:3:5,1,1,105326,94674
4:6:4,0,-1,105327,94673
6:6:6,0,-1,105328,94672
4:3:6,0,-1,105329,94671
5:4:6,0,-1,105330,94670
6:1:3,0,-1,105331,94669
5:2:6,1,1,105330,94670
4:2:5,1,1,105329,94671
2:2:1,2,2,105327,94673
4:5:6,0,-1,105328,94672
6:1:3,0,-1,105329,94671
6:5:4,0,-1,105330,94670
3:3:4,0,-1,105331,94669
2:6:6,1,1,105330,94670
3:2:3,1,1,105329,94671
2:5:6,1,1,105328,94672
3:4:4,0,-1,105329,94671
2:5:1,1,1,105328,94672
1:3:3,0,-1,105329,94671
5:2:5,1,1,105328,94672
6:6:3,0,-1,105329,94671
5:5:1,0,-1,105330,94670
3:1:3,0,-1,105331,94669
2:3:5,1,1,105330,94670
5:6:1,0,-1,105331,94669
3:2:2,2,2,105329,94671
6:5:5,0,-1,105330,94670
1:4:6,0,-1,105331,94669
5:6:6,0,-1,105332,94668
4:2:1,1,1,105331,94669
3:3:3,0,-1,105332,94668
6:4:6,0,-1,105333,94667
3:5:5,0,-1,105334,94666
3:6:6,0,-1,105335,94665
6:4:5,0,-1,105336,94664
3:3:6,0,-1,105337,94663
1:5:5,0,-1,105338,94662
1:2:5,1,1,105337,94663
6:3:3,0,-1,105338,94662
2:3:4,1,1,105337,94663
6:5:3,0,-1,105338,94662
1:5:3,0,-1,105339,94661
1:3:6,0,-1,105340,94660
1:5:4,0,-1,105341,94659
3:1:1,0,-1,105342,94658
1:1:3,0,-1,105343,94657
6:5:3,0,-1,105344,94656
2:3:2,2,2,105342,94658
1:6:5,0,-1,105343,94657
1:2:5,1,1,105342,94658
2:6:5,1,1,105341,94659
4:6:1,0,-1,105342,94658
4:6:1,0,-1,105343,94657
3:5:5,0,-1,105344,94656
1:3:3,0,-1,105345,94655
2:5:5,1,1,105344,94656
3:3:3,0,-1,105345,94655
5:3:6,0,-1,105346,94654
3:5:2,1,1,105345,94655
1:2:3,1,1,105344,94656
4:5:2,1,1,105343,94657
4:1:2,1,1,105342,94658
2:2:4,2,2,105340,94660
5:2:1,1,1,105339,94661
6:2:3,1,1,105338,94662
1:6:4,0,-1,105339,94661
6:2:4,1,1,105338,94662
6:4:6,0,-1,105339,94661
1:5:2,1,1,105338,94662
1:6:2,1,1,105337,94663
6:2:6,1,1,105336,94664
1:5:6,0,-1,105337,94663
5:4:1,0,-1,105338,94662
3:2:2,2,2,105336,94664
5:1:2,1,1,105335,94665
6:3:5,0,-1,105336,94664
1:6:3,0,-1,105337,94663
1:5:2,1,1,105336,94664
6:1:2,1,1,105335,94665
6:6:6,0,-1,105336,94664
5:2:3,1,1,105335,94665
1:1:1,0,-1,105336,94664
5:1:1,0,-1,105337,94663
1:1:5,0,-1,105338,94662
6:4:6,0,-1,105339,94661
1:3:2,1,1,105338,94662
1:5:5,0,-1,105339,94661
2:4:1,1,1,105338,94662
5:5:1,0,-1,105339,94661
2:2:1,2,2,105337,94663
2:1:3,1,1,105336,94664
1:6:3,0,-1,105337,94663
3:2:4,1,1,105336,94664
3:2:3,1,1,105335,94665
1:6:2,1,1,105334,94666
1:3:4,0,-1,105335,94665
6:6:3,0,-1,105336,94664
5:2:6,1,1,105335,94665
4:3:5,0,-1,105336,94664
4:6:3,0,-1,105337,94663
4:5:6,0,-1,105338,94662
3:5:4,0,-1,105339,94661
1:4:1,0,-1,105340,94660
2:3:4,1,1,105339,94661
6:2:2,2,2,105337,94663
1:6:3,0,-1,105338,94662
3:4:2,1,1,105337,94663
2:1:3,1,1,105336,94664
1:2:4,1,1,105335,94665
4:4:2,1,1,105334,94666
4:2:4,1,1,105333,94667
4:4:6,0,-1,105334,94666
5:5:4,0,-1,105335,94665
1:2:1,1,1,105334,94666
2:6:6,1,1,105333,94667
6:4:2,1,1,105332,94668
5:2:6,1,1,105331,94669
6:6:6,0,-1,105332,94668
5:1:1,0,-1,105333,94667
1:2:5,1,1,105332,94668
6:3:1,0,-1,105333,94667
1:5:1,0,-1,105334,94666
2:6:4,1,1,105333,94667
4:1:2,1,1,105332,94668
1:4:3,0,-1,105333,94667
6:2:3,1,1,105332,94668
2:6:6,1,1,105331,94669
5:1:1,0,-1,105332,94668
3:3:5,0,-1,105333,94667
6:5:1,0,-1,105334,94666
5:6:1,0,-1,105335,94665
6:5:4,0,-1,105336,94664
6:1:5,0,-1,105337,94663
6:5:5,0,-1,105338,94662
1:6:3,0,-1,105339,94661
4:5:2,1,1,105338,94662
6:4:5,0,-1,105339,94661
4:4:4,0,-1,105340,94660
3:5:3,0,-1,105341,94659
6:5:6,0,-1,105342,94658
1:4:1,0,-1,105343,94657
3:3:2,1,1,105342,94658
6:2:2,2,2,105340,94660
5:5:6,0,-1,105341,94659
5:4:1,0,-1,105342,94658
5:3:4,0,-1,105343,94657
3:5:5,0,-1,105344,94656
6:2:4,1,1,105343,94657
3:5:5,0,-1,105344,94656
5:6:5,0,-1,105345,94655
1:4:4,0,-1,105346,94654
4:3:5,0,-1,105347,94653
1:1:4,0,-1,105348,94652
1:6:4,0,-1,105349,94651
1:3:6,0,-1,105350,94650
4:5:6,0,-1,105351,94649
6:3:1,0,-1,105352,94648
1:6:4,0,-1,105353,94647
5:6:6,0,-1,105354,94646
2:4:2,2,2,105352,94648
1:3:4,0,-1,105353,94647
6:6:4,0,-1,105354,94646
2:3:3,1,1,105353,94647
2:6:3,1,1,105352,94648
6:4:3,0,-1,105353,94647
1:3:4,0,-1,105354,94646
1:6:4,0,-1,105355,94645
3:2:3,1,1,105354,94646
5:3:4,0,-1,105355,94645
6:1:5,0,-1,105356,94644
6:2:5,1,1,105355,94645
5:5:4,0,-1,105356,94644
3:2:1,1,1,105355,94645
2:3:2,2,2,105353,94647
4:6:5,0,-1,105354,94646
6:3:3,0,-1,105355,94645
4:1:6,0,-1,105356,94644
3:2:1,1,1,105355,94645
6:6:4,0,-1,105356,94644
5:1:2,1,1,105355,94645
4:3:1,0,-1,105356,94644
1:6:6,0,-1,105357,94643
5:5:4,0,-1,105358,94642
3:3:4,0,-1,105359,94641
2:3:1,1,1,105358,94642
2:1:2,2,2,105356,94644
1:6:1,0,-1,105357,94643
5:4:5,0,-1,105358,94642
1:6:4,0,-1,105359,94641
5:1:6,0,-1,105360,94640
4:1:6,0,-1,105361,94639
4:6:4,0,-1,105362,94638
5:6:1,0,-1,105363,94637
1:6:6,0,-1,105364,94636
5:5:5,0,-1,105365,94635
5:2:6,1,1,105364,94636
5:5:4,0,-1,105365,94635
5:6:3,0,-1,105366,94634
5:4:4,0,-1,105367,94633
5:5:1,0,-1,105368,94632
5:6:4,0,-1,105369,94631
6:3:4,0,-1,105370,94630
6:5:4,0,-1,105371,94629
6:6:6,0,-1,105372,94628
5:4:4,0,-1,105373,94627
3:6:1,0,-1,105374,94626
6:2:3,1,1,105373,94627
6:4:3,0,-1,105374,94626
2:4:3,1,1,105373,94627
3:6:5,0,-1,105374,94626
5:4:3,0,-1,105375,94625
6:3:3,0,-1,105376,94624
5:6:1,0,-1,105377,94623
4:1:6,0,-1,105378,94622
1:1:3,0,-1,105379,94621
6:5:2,1,1,105378,94622
5:4:2,1,1,105377,94623
5:2:6,1,1,105376,94624
6:3:4,0,-1,105377,94623
2:4:2,2,2,105375,94625
4:6:2,1,1,105374,94626
5:1:3,0,-1,105375,94625
5:6:6,0,-1,105376,94624
5:5:1,0,-1,105377,94623
3:4:3,0,-1,105378,94622
3:1:6,0,-1,105379,94621
1:4:2,1,1,105378,94622
1:2:1,1,1,105377,94623
2:5:5,1,1,105376,94624
3:6:4,0,-1,105377,94623
4:2:2,2,2,105375,94625
2:3:1,1,1,105374,94626
1:5:1,0,-1,105375,94625
3:5:3,0,-1,105376,94624
6:1:6,0,-1,105377,94623
4:2:6,1,1,105376,94624
6:6:3,0,-1,105377,94623
6:1:3,0,-1,105378,94622
6:1:1,0,-1,105379,94621
5:3:1,0,-1,105380,94620
2:3:4,1,1,105379,94621
4:2:5,1,1,105378,94622
3:2:6,1,1,105377,94623
6:4:3,0,-1,105378,94622
1:1:5,0,-1,105379,94621
6:2:2,2,2,105377,94623
5:3:2,1,1,105376,94624
2:3:1,1,1,105375,94625
1:2:1,1,1,105374,94626
1:1:5,0,-1,105375,94625
4:4:6,0,-1,105376,94624
3:4:1,0,-1,105377,94623
1:4:3,0,-1,105378,94622
1:6:2,1,1,105377,94623
4:5:6,0,-1,105378,94622
5:1:2,1,1,105377,94623
2:1:1,1,1,105376,94624
1:2:5,1,1,105375,94625
2:1:5,1,1,105374,94626
2:5:2,2,2,105372,94628
4:6:6,0,-1,105373,94627
3:6:6,0,-1,105374,94626
3:1:3,0,-1,105375,94625
1:1:1,0,-1,105376,94624
4:1:4,0,-1,105377,94623
3:6:5,0,-1,105378,94622
3:6:5,0,-1,105379,94621
6:3:5,0,-1,105380,94620
1:6:1,0,-1,105381,94619
4:3:2,1,1,105380,94620
4:1:4,0,-1,105381,94619
2:6:2,2,2,105379,94621
2:2:1,2,2,105377,94623
4:3:6,0,-1,105378,94622
6:2:1,1,1,105377,94623
5:2:6,1,1,105376,94624
6:3:2,1,1,105375,94625
1:2:4,1,1,105374,94626
2:1:3,1,1,105373,94627
4:5:4,0,-1,105374,94626
6:2:5,1,1,105373,94627
3:2:2,2,2,105371,94629
2:6:5,1,1,105370,94630
4:2:2,2,2,105368,94632
5:4:5,0,-1,105369,94631
6:2:1,1,1,105368,94632
4:1:3,0,-1,105369,94631
5:2:2,2,2,105367,94633
1:4:3,0,-1,105368,94632
5:3:2,1,1,105367,94633
4:3:5,0,-1,105368,94632
6:1:1,0,-1,105369,94631
3:2:6,1,1,105368,94632
6:3:5,0,-1,105369,94631
5:1:3,0,-1,105370,94630
1:5:5,0,-1,105371,94629
6:5:5,0,-1,105372,94628
3:6:5,0,-1,105373,94627
2:6:2,2,2,105371,94629
6:5:2,1,1,105370,94630
6:3:1,0,-1,105371,94629
5:6:6,0,-1,105372,94628
2:4:2,2,2,105370,94630
6:1:6,0,-1,105371,94629
5:4:5,0,-1,105372,94628
6:4:6,0,-1,105373,94627
6:1:5,0,-1,105374,94626
5:2:1,1,1,105373,94627
4:4:4,0,-1,105374,94626
1:2:3,1,1,105373,94627
4:3:5,0,-1,105374,94626
4:4:3,0,-1,105375,94625
4:4:4,0,-1,105376,94624
6:4:3,0,-1,105377,94623
2:6:3,1,1,105376,94624
2:6:3,1,1,105375,94625
3:1:4,0,-1,105376,94624
5:5:5,0,-1,105377,94623
4:5:3,0,-1,105378,94622
3:5:6,0,-1,105379,94621
6:6:6,0,-1,105380,94620
5:2:2,2,2,105378,94622
1:3:3,0,-1,105379,94621
6:5:4,0,-1,105380,94620
6:1:3,0,-1,105381,94619
2:1:5,1,1,105380,94620
5:1:4,0,-1,105381,94619
4:1:2,1,1,105380,94620
5:1:1,0,-1,105381,94619
4:2:4,1,1,105380,94620
4:6:3,0,-1,105381,94619
5:3:5,0,-1,105382,94618
1:6:5,0,-1,105383,94617
6:5:2,1,1,105382,94618
6:1:3,0,-1,105383,94617
3:2:2,2,2,105381,94619
2:6:2,2,2,105379,94621
2:4:3,1,1,105378,94622
2:3:4,1,1,105377,94623
1:2:6,1,1,105376,94624
2:4:2,2,2,105374,94626
2:4:6,1,1,105373,94627
6:6:1,0,-1,105374,94626
6:1:3,0,-1,105375,94625
2:4:2,2,2,105373,94627
6:5:2,1,1,105372,94628
6:1:3,0,-1,105373,94627
3:6:1,0,-1,105374,94626
1:4:1,0,-1,105375,94625
3:5:6,0,-1,105376,94624
2:5:1,1,1,105375,94625
5:6:4,0,-1,105376,94624
2:6:4,1,1,105375,94625
1:4:1,0,-1,105376,94624
5:2:3,1,1,105375,94625
1:5:6,0,-1,105376,94624
4:5:1,0,-1,105377,94623
5:3:4,0,-1,105378,94622
6:2:2,2,2,105376,94624
5:3:5,0,-1,105377,94623
2:4:1,1,1,105376,94624
6:6:6,0,-1,105377,94623
3:3:4,0,-1,105378,94622
4:1:3,0,-1,105379,94621
1:1:5,0,-1,105380,94620
6:4:5,0,-1,105381,94619
2:3:2,2,2,105379,94621
6:1:6,0,-1,105380,94620
4:2:3,1,1,105379,94621
1:4:6,0,-1,105380,94620
1:3:5,0,-1,105381,94619
5:3:6,0,-1,105382,94618
3:2:5,1,1,105381,94619
6:1:3,0,-1,105382,94618
3:4:1,0,-1,105383,94617
3:4:1,0,-1,105384,94616
3:3:1,0,-1,105385,94615
5:6:5,0,-1,105386,94614
3:2:6,1,1,105385,94615
4:1:1,0,-1,105386,94614
6:2:5,1,1,105385,94615
6:4:4,0,-1,105386,94614
3:3:3,0,-1,105387,94613
3:5:3,0,-1,105388,94612
3:2:3,1,1,105387,94613
3:1:6,0,-1,105388,94612
1:6:3,0,-1,105389,94611
4:6:6,0,-1,105390,94610
2:4:2,2,2,105388,94612
5:5:6,0,-1,105389,94611
3:4:6,0,-1,105390,94610
3:3:1,0,-1,105391,94609
1:5:6,0,-1,105392,94608
6:5:1,0,-1,105393,94607
3:6:4,0,-1,105394,94606
4:5:6,0,-1,105395,94605
4:6:6,0,-1,105396,94604
3:4:4,0,-1,105397,94603
5:1:5,0,-1,105398,94602
5:1:5,0,-1,105399,94601
1:6:3,0,-1,105400,94600
5:1:3,0,-1,105401,94599
1:2:5,1,1,105400,94600
1:6:2,1,1,105399,94601
1:4:4,0,-1,105400,94600
2:1:5,1,1,105399,94601
1:6:2,1,1,105398,94602
3:2:1,1,1,105397,94603
2:2:2,3,3,105394,94606
1:3:1,0,-1,105395,94605
3:6:5,0,-1,105396,94604
3:2:6,1,1,105395,94605
5:1:5,0,-1,105396,94604
3:2:6,1,1,105395,94605
5:6:4,0,-1,105396,94604
1:2:6,1,1,105395,94605
5:2:5,1,1,105394,94606
2:4:1,1,1,105393,94607
6:3:6,0,-1,105394,94606
5:2:5,1,1,105393,94607
5:6:3,0,-1,105394,94606
2:4:1,1,1,105393,94607
2:2:6,2,2,105391,94609
6:1:3,0,-1,105392,94608
3:1:5,0,-1,105393,94607
5:1:3,0,-1,105394,94606
5:2:3,1,1,105393,94607
4:4:1,0,-1,105394,94606
5:4:6,0,-1,105395,94605
2:5:4,1,1,105394,94606
5:3:2,1,1,105393,94607
6:1:6,0,-1,105394,94606
1:6:4,0,-1,105395,94605
2:5:6,1,1,105394,94606
3:6:6,0,-1,105395,94605
4:3:5,0,-1,105396,94604
4:1:3,0,-1,105397,94603
5:4:4,0,-1,105398,94602
3:1:2,1,1,105397,94603
1:6:3,0,-1,105398,94602
1:6:3,0,-1,105399,94601
3:6:6,0,-1,105400,94600
3:5:1,0,-1,105401,94599
5:4:1,0,-1,105402,94598
5:5:1,0,-1,105403,94597
5:4:2,1,1,105402,94598
3:6:4,0,-1,105403,94597
4:5:4,0,-1,105404,94596
5:1:5,0,-1,105405,94595
2:3:6,1,1,105404,94596
5:2:2,2,2,105402,94598
6:6:4,0,-1,105403,94597
2:6:2,2,2,105401,94599
3:3:6,0,-1,105402,94598
3:2:3,1,1,105401,94599
6:5:1,0,-1,105402,94598
1:6:2,1,1,105401,94599
3:5:6,0,-1,105402,94598
6:3:4,0,-1,105403,94597
4:5:1,0,-1,105404,94596
2:5:5,1,1,105403,94597
4:5:6,0,-1,105404,94596
2:6:4,1,1,105403,94597
6:6:2,1,1,105402,94598
3:6:4,0,-1,105403,94597
6:1:4,0,-1,105404,94596
3:2:3,1,1,105403,94597
1:3:3,0,-1,105404,94596
2:4:6,1,1,105403,94597
1:4:1,0,-1,105404,94596
6:4:5,0,-1,105405,94595
4:6:3,0,-1,105406,94594
5:1:3,0,-1,105407,94593
4:6:2,1,1,105406,94594
1:2:1,1,1,105405,94595
6:4:2,1,1,105404,94596
6:3:6,0,-1,105405,94595
3:4:5,0,-1,105406,94594
4:5:4,0,-1,105407,94593
4:3:6,0,-1,105408,94592
1:4:6,0,-1,105409,94591
1:1:3,0,-1,105410,94590
5:6:5,0,-1,105411,94589
2:3:5,1,1,105410,94590
6:2:3,1,1,105409,94591
6:4:4,0,-1,105410,94590
3:1:3,0,-1,105411,94589
1:4:3,0,-1,105412,94588
3:3:4,0,-1,105413,94587
4:3:6,0,-1,105414,94586
1:4:2,1,1,105413,94587
5:2:1,1,1,105412,94588
5:1:4,0,-1,105413,94587
2:3:4,1,1,105412,94588
3:3:6,0,-1,105413,94587
1:3:1,0,-1,105414,94586
6:2:1,1,1,105413,94587
5:5:3,0,-1,105414,94586
5:3:6,0,-1,105415,94585
3:6:2,1,1,105414,94586
1:6:6,0,-1,105415,94585
6:1:2,1,1,105414,94586
1:3:3,0,-1,105415,94585
4:6:6,0,-1,105416,94584
6:2:5,1,1,105415,94585
5:4:1,0,-1,105416,94584
6:5:1,0,-1,105417,94583
1:6:5,0,-1,105418,94582
3:1:2,1,1,105417,94583
6:3:6,0,-1,105418,94582
5:6:4,0,-1,105419,94581
1:1:1,0,-1,105420,94580
6:3:5,0,-1,105421,94579
5:5:5,0,-1,105422,94578
3:5:5,0,-1,105423,94577
5:6:1,0,-1,105424,94576
4:3:2,1,1,105423,94577
2:6:5,1,1,105422,94578
5:6:6,0,-1,105423,94577
2:2:5,2,2,105421,94579
2:3:2,2,2,105419,94581
1:4:4,0,-1,105420,94580
3:6:6,0,-1,105421,94579
6:5:1,0,-1,105422,94578
1:2:5,1,1,105421,94579
5:1:4,0,-1,105422,94578
1:5:6,0,-1,105423,94577
6:1:4,0,-1,105424,94576
4:5:2,1,1,105423,94577
3:6:3,0,-1,105424,94576
5:5:4,0,-1,105425,94575
5:2:4,1,1,105424,94576
3:5:6,0,-1,105425,94575
1:2:1,1,1,105424,94576
5:3:1,0,-1,105425,94575
2:1:4,1,1,105424,94576
4:1:6,0,-1,105425,94575
2:1:6,1,1,105424,94576
1:4:2,1,1,105423,94577
2:1:4,1,1,105422,94578
5:2:3,1,1,105421,94579
1:3:3,0,-1,105422,94578
1:5:3,0,-1,105423,94577
1:3:1,0,-1,105424,94576
4:4:2,1,1,105423,94577
6:4:2,1,1,105422,94578
1:6:2,1,1,105421,94579
3:3:4,0,-1,105422,94578
5:6:5,0,-1,105423,94577
3:6:2,1,1,105422,94578
2:1:1,1,1,105421,94579
5:5:2,1,1,105420,94580
3:6:4,0,-1,105421,94579
4:2:1,1,1,105420,94580
3:6:4,0,-1,105421,94579
5:5:6,0,-1,105422,94578
3:2:3,1,1,105421,94579
3:3:1,0,-1,105422,94578
3:1:1,0,-1,105423,94577
1:5:4,0,-1,105424,94576
5:2:1,1,1,105423,94577
2:1:6,1,1,105422,94578
4:1:4,0,-1,105423,94577
6:5:6,0,-1,105424,94576
4:2:2,2,2,105422,94578
3:5:1,0,-1,105423,94577
5:5:1,0,-1,105424,94576
1:4:4,0,-1,105425,94575
3:3:2,1,1,105424,94576
6:2:5,1,1,105423,94577
5:1:5,0,-1,105424,94576
2:3:6,1,1,105423,94577
2:5:2,2,2,105421,94579
1:1:2,1,1,105420,94580
3:5:5,0,-1,105421,94579
3:3:5,0,-1,105422,94578
3:4:1,0,-1,105423,94577
2:5:4,1,1,105422,94578
1:1:2,1,1,105421,94579
5:5:4,0,-1,105422,94578
2:2:6,2,2,105420,94580
2:5:4,1,1,105419,94581
2:3:4,1,1,105418,94582
4:5:2,1,1,105417,94583
5:3:1,0,-1,105418,94582
4:6:5,0,-1,105419,94581
3:1:2,1,1,105418,94582
5:3:2,1,1,105417,94583
1:5:5,0,-1,105418,94582
6:1:1,0,-1,105419,94581
1:3:1,0,-1,105420,94580
2:6:5,1,1,105419,94581
4:4:2,1,1,105418,94582
2:2:6,2,2,105416,94584
3:3:3,0,-1,105417,94583
2:4:5,1,1,105416,94584
6:2:2,2,2,105414,94586
4:4:6,0,-1,105415,94585
2:5:2,2,2,105413,94587
1:4:4,0,-1,105414,94586
5:2:6,1,1,105413,94587
2:3:4,1,1,105412,94588
2:5:3,1,1,105411,94589
5:4:5,0,-1,105412,94588
5:4:6,0,-1,105413,94587
1:3:5,0,-1,105414,94586
3:5:5,0,-1,105415,94585
5:4:1,0,-1,105416,94584
2:6:4,1,1,105415,94585
4:1:5,0,-1,105416,94584
4:6:5,0,-1,105417,94583
2:3:4,1,1,105416,94584
3:4:5,0,-1,105417,94583
2:3:5,1,1,105416,94584
4:2:6,1,1,105415,94585
4:4:5,0,-1,105416,94584
2:5:4,1,1,105415,94585
2:6:3,1,1,105414,94586
5:2:4,1,1,105413,94587
2:2:1,2,2,105411,94589
5:1:4,0,-1,105412,94588
3:3:1,0,-1,105413,94587
5:3:3,0,-1,105414,94586
6:6:5,0,-1,105415,94585
4:6:3,0,-1,105416,94584
6:6:3,0,-1,105417,94583
1:1:6,0,-1,105418,94582
5:4:1,0,-1,105419,94581
2:4:1,1,1,105418,94582
2:6:5,1,1,105417,94583
4:3:6,0,-1,105418,94582
6:5:2,1,1,105417,94583
5:1:3,0,-1,105418,94582
3:1:6,0,-1,105419,94581
4:5:6,0,-1,105420,94580
1:4:3,0,-1,105421,94579
5:1:2,1,1,105420,94580
6:1:5,0,-1,105421,94579
6:2:4,1,1,105420,94580
4:4:6,0,-1,105421,94579
5:3:3,0,-1,105422,94578
4:6:5,0,-1,105423,94577
3:5:1,0,-1,105424,94576
5:6:5,0,-1,105425,94575
3:4:5,0,-1,105426,94574
4:1:6,0,-1,105427,94573
1:4:3,0,-1,105428,94572
5:6:1,0,-1,105429,94571
1:6:6,0,-1,105430,94570
5:1:3,0,-1,105431,94569
4:4:4,0,-1,105432,94568
1:2:1,1,1,105431,94569
5:1:4,0,-1,105432,94568
2:1:6,1,1,105431,94569
6:3:6,0,-1,105432,94568
4:6:2,1,1,105431,94569
2:5:1,1,1,105430,94570
6:5:1,0,-1,105431,94569
5:6:6,0,-1,105432,94568
2:2:6,2,2,105430,94570
4:5:1,0,-1,105431,94569
6:6:6,0,-1,105432,94568
4:3:4,0,-1,105433,94567
4:3:2,1,1,105432,94568
4:2:1,1,1,105431,94569
3:6:3,0,-1,105432,94568
3:3:3,0,-1,105433,94567
5:2:4,1,1,105432,94568
3:4:3,0,-1,105433,94567
2:4:5,1,1,105432,94568
6:4:4,0,-1,105433,94567
6:2:3,1,1,105432,94568
3:4:5,0,-1,105433,94567
2:3:6,1,1,105432,94568
4:6:3,0,-1,105433,94567
2:1:3,1,1,105432,94568
3:3:6,0,-1,105433,94567
6:4:4,0,-1,105434,94566
3:3:5,0,-1,105435,94565
1:1:3,0,-1,105436,94564
1:5:3,0,-1,105437,94563
4:2:1,1,1,105436,94564
2:2:3,2,2,105434,94566
2:4:1,1,1,105433,94567
5:1:1,0,-1,105434,94566
2:5:4,1,1,105433,94567
1:5:2,1,1,105432,94568
6:1:2,1,1,105431,94569
5:5:3,0,-1,105432,94568
6:3:3,0,-1,105433,94567
5:2:5,1,1,105432,94568
5:1:5,0,-1,105433,94567
4:1:3,0,-1,105434,94566
2:2:4,2,2,105432,94568
6:1:4,0,-1,105433,94567
3:3:4,0,-1,105434,94566
2:6:3,1,1,105433,94567
1:3:1,0,-1,105434,94566
5:4:5,0,-1,105435,94565
3:4:2,1,1,105434,94566
4:2:6,1,1,105433,94567
3:1:2,1,1,105432,94568
1:3:1,0,-1,105433,94567
5:3:2,1,1,105432,94568
5:1:6,0,-1,105433,94567
5:4:1,0,-1,105434,94566
2:6:2,2,2,105432,94568
2:6:1,1,1,105431,94569
6:2:5,1,1,105430,94570
3:6:2,1,1,105429,94571
4:3:2,1,1,105428,94572
5:4:2,1,1,105427,94573
2:1:6,1,1,105426,94574
5:3:3,0,-1,105427,94573
3:2:4,1,1,105426,94574
2:5:2,2,2,105424,94576
1:6:1,0,-1,105425,94575
4:5:3,0,-1,105426,94574
3:3:3,0,-1,105427,94573
4:2:5,1,1,105426,94574
2:6:6,1,1,105425,94575
4:2:4,1,1,105424,94576
5:3:2,1,1,105423,94577
3:1:2,1,1,105422,94578
2:1:3,1,1,105421,94579
2:5:6,1,1,105420,94580
4:4:6,0,-1,105421,94579
5:2:6,1,1,105420,94580
2:4:3,1,1,105419,94581
6:2:4,1,1,105418,94582
4:1:3,0,-1,105419,94581
5:5:3,0,-1,105420,94580
2:4:5,1,1,105419,94581
4:3:4,0,-1,105420,94580
2:6:5,1,1,105419,94581
1:6:4,0,-1,105420,94580
6:4:2,1,1,105419,94581
1:2:6,1,1,105418,94582
1:2:3,1,1,105417,94583
1:1:6,0,-1,105418,94582
1:3:5,0,-1,105419,94581
1:4:6,0,-1,105420,94580
6:4:1,0,-1,105421,94579
5:3:3,0,-1,105422,94578
6:3:5,0,-1,105423,94577
6:5:3,0,-1,105424,94576
1:3:3,0,-1,105425,94575
3:2:5,1,1,105424,94576
1:4:6,0,-1,105425,94575
3:6:1,0,-1,105426,94574
6:5:1,0,-1,105427,94573
3:5:5,0,-1,105428,94572
3:6:3,0,-1,105429,94571
4:1:3,0,-1,105430,94570
1:1:4,0,-1,105431,94569
1:1:2,1,1,105430,94570
6:4:2,1,1,105429,94571
4:6:6,0,-1,105430,94570
6:1:1,0,-1,105431,94569
3:1:4,0,-1,105432,94568
6:5:5,0,-1,105433,94567
1:4:3,0,-1,105434,94566
3:2:1,1,1,105433,94567
2:4:1,1,1,105432,94568
6:2:5,1,1,105431,94569
4:6:4,0,-1,105432,94568
6:2:3,1,1,105431,94569
4:6:4,0,-1,105432,94568
2:3:5,1,1,105431,94569
5:2:6,1,1,105430,94570
5:5:6,0,-1,105431,94569
3:1:3,0,-1,105432,94568
1:5:6,0,-1,105433,94567
4:4:2,1,1,105432,94568
1:1:6,0,-1,105433,94567
3:5:4,0,-1,105434,94566
1:5:6,0,-1,105435,94565
3:6:1,0,-1,105436,94564
2:6:1,1,1,105435,94565
2:1:2,2,2,105433,94567
3:4:2,1,1,105432,94568
4:3:1,0,-1,105433,94567
1:2:2,2,2,105431,94569
6:3:2,1,1,105430,94570
3:6:6,0,-1,105431,94569
6:1:3,0,-1,105432,94568
6:2:1,1,1,105431,94569
6:4:5,0,-1,105432,94568
6:3:4,0,-1,105433,94567
5:4:5,0,-1,105434,94566
4:3:6,0,-1,105435,94565
1:3:3,0,-1,105436,94564
3:4:6,0,-1,105437,94563
5:1:1,0,-1,105438,94562
5:5:2,1,1,105437,94563
3:1:2,1,1,105436,94564
3:4:1,0,-1,105437,94563
4:2:3,1,1,105436,94564
1:3:6,0,-1,105437,94563
5:2:5,1,1,105436,94564
6:6:5,0,-1,105437,94563
5:5:2,1,1,105436,94564
4:3:1,0,-1,105437,94563
3:4:2,1,1,105436,94564
5:5:6,0,-1,105437,94563
4:3:5,0,-1,105438,94562
5:1:1,0,-1,105439,94561
4:1:5,0,-1,105440,94560
1:1:4,0,-1,105441,94559
1:6:6,0,-1,105442,94558
2:2:6,2,2,105440,94560
2:4:4,1,1,105439,94561
4:4:2,1,1,105438,94562
4:6:5,0,-1,105439,94561
3:4:1,0,-1,105440,94560
5:6:4,0,-1,105441,94559
5:5:3,0,-1,105442,94558
5:2:1,1,1,105441,94559
4:1:2,1,1,105440,94560
6:1:5,0,-1,105441,94559
6:3:1,0,-1,105442,94558
6:6:1,0,-1,105443,94557
1:5:6,0,-1,105444,94556
4:1:5,0,-1,105445,94555
5:1:5,0,-1,105446,94554
6:5:1,0,-1,105447,94553
2:3:1,1,1,105446,94554
1:6:6,0,-1,105447,94553
3:1:2,1,1,105446,94554
2:6:3,1,1,105445,94555
1:5:1,0,-1,105446,94554
5:6:1,0,-1,105447,94553
1:5:6,0,-1,105448,94552
1:2:5,1,1,105447,94553
3:2:5,1,1,105446,94554
2:6:1,1,1,105445,94555
2:6:4,1,1,105444,94556
2:6:5,1,1,105443,94557
6:3:2,1,1,105442,94558
3:1:1,0,-1,105443,94557
6:2:1,1,1,105442,94558
5:4:5,0,-1,105443,94557
6:6:5,0,-1,105444,94556
5:5:5,0,-1,105445,94555
6:1:4,0,-1,105446,94554
5:6:6,0,-1,105447,94553
1:5:1,0,-1,105448,94552
4:1:1,0,-1,105449,94551
1:5:6,0,-1,105450,94550
4:6:1,0,-1,105451,94549
4:6:2,1,1,105450,94550
2:2:3,2,2,105448,94552
4:3:4,0,-1,105449,94551
6:3:5,0,-1,105450,94550
3:4:1,0,-1,105451,94549
6:2:3,1,1,105450,94550
4:2:1,1,1,105449,94551
1:2:2,2,2,105447,94553
3:4:3,0,-1,105448,94552
1:6:2,1,1,105447,94553
5:3:4,0,-1,105448,94552
2:6:1,1,1,105447,94553
4:4:5,0,-1,105448,94552
3:1:2,1,1,105447,94553
3:2:4,1,1,105446,94554
1:5:5,0,-1,105447,94553
2:1:6,1,1,105446,94554
5:2:3,1,1,105445,94555
3:5:3,0,-1,105446,94554
4:5:2,1,1,105445,94555
4:3:5,0,-1,105446,94554
4:5:2,1,1,105445,94555
2:4:3,1,1,105444,94556
1:2:2,2,2,105442,94558
3:5:3,0,-1,105443,94557
2:3:5,1,1,105442,94558
1:2:4,1,1,105441,94559
6:2:6,1,1,105440,94560
1:2:2,2,2,105438,94562
3:2:4,1,1,105437,94563
5:1:1,0,-1,105438,94562
6:1:6,0,-1,105439,94561
6:4:4,0,-1,105440,94560
3:2:2,2,2,105438,94562
5:3:6,0,-1,105439,94561
5:6:4,0,-1,105440,94560
5:2:3,1,1,105439,94561
2:2:4,2,2,105437,94563
6:2:5,1,1,105436,94564
6:4:2,1,1,105435,94565
6:6:5,0,-1,105436,94564
1:1:4,0,-1,105437,94563
5:6:2,1,1,105436,94564
6:5:5,0,-1,105437,94563
6:2:3,1,1,105436,94564
3:1:2,1,1,105435,94565
1:5:4,0,-1,105436,94564
6:1:5,0,-1,105437,94563
1:5:5,0,-1,105438,94562
3:4:6,0,-1,105439,94561
4:6:5,0,-1,105440,94560
6:1:1,0,-1,105441,94559
6:1:3,0,-1,105442,94558
3:5:5,0,-1,105443,94557
6:1:6,0,-1,105444,94556
3:1:2,1,1,105443,94557
6:2:1,1,1,105442,94558
2:5:5,1,1,105441,94559
5:6:6,0,-1,105442,94558
6:1:3,0,-1,105443,94557
1:2:5,1,1,105442,94558
4:4:6,0,-1,105443,94557
4:1:1,0,-1,105444,94556
2:4:3,1,1,105443,94557
4:2:1,1,1,105442,94558
5:6:2,1,1,105441,94559
5:3:1,0,-1,105442,94558
6:4:1,0,-1,105443,94557
5:2:3,1,1,105442,94558
5:1:1,0,-1,105443,94557
5:1:4,0,-1,105444,94556
4:6:1,0,-1,105445,94555
6:5:3,0,-1,105446,94554
2:4:6,1,1,105445,94555
1:6:1,0,-1,105446,94554
3:4:4,0,-1,105447,94553
3:4:6,0,-1,105448,94552
4:3:2,1,1,105447,94553
1:4:6,0,-1,105448,94552
4:3:3,0,-1,105449,94551
6:3:5,0,-1,105450,94550
1:3:2,1,1,105449,94551
1:2:1,1,1,105448,94552
6:2:4,1,1,105447,94553
5:2:3,1,1,105446,94554
6:3:2,1,1,105445,94555
5:4:5,0,-1,105446,94554
1:6:5,0,-1,105447,94553
2:4:1,1,1,105446,94554
5:3:1,0,-1,105447,94553
3:4:5,0,-1,105448,94552
4:4:3,0,-1,105449,94551
1:4:3,0,-1,105450,94550
3:3:6,0,-1,105451,94549
5:5:1,0,-1,105452,94548
6:4:1,0,-1,105453,94547
2:6:6,1,1,105452,94548
2:5:6,1,1,105451,94549
5:2:5,1,1,105450,94550
5:1:1,0,-1,105451,94549
3:6:5,0,-1,105452,94548
3:2:1,1,1,105451,94549
2:6:4,1,1,105450,94550
1:1:2,1,1,105449,94551
5:1:4,0,-1,105450,94550
2:5:3,1,1,105449,94551
2:4:1,1,1,105448,94552
2:6:2,2,2,105446,94554
3:3:4,0,-1,105447,94553
2:4:4,1,1,105446,94554
6:3:5,0,-1,105447,94553
6:4:5,0,-1,105448,94552
5:2:2,2,2,105446,94554
1:3:1,0,-1,105447,94553
6:5:2,1,1,105446,94554
3:6:5,0,-1,105447,94553
4:6:5,0,-1,105448,94552
1:3:5,0,-1,105449,94551
3:4:5,0,-1,105450,94550
2:3:5,1,1,105449,94551
5:5:2,1,1,105448,94552
4:4:6,0,-1,105449,94551
1:1:6,0,-1,105450,94550
1:6:5,0,-1,105451,94549
5:5:1,0,-1,105452,94548
3:4:6,0,-1,105453,94547
6:4:5,0,-1,105454,94546
3:2:6,1,1,105453,94547
4:2:6,1,1,105452,94548
2:6:5,1,1,105451,94549
3:2:6,1,1,105450,94550
4:3:2,1,1,105449,94551
4:6:3,0,-1,105450,94550
6:2:2,2,2,105448,94552
5:4:6,0,-1,105449,94551
3:4:4,0,-1,105450,94550
2:5:4,1,1,105449,94551
5:2:4,1,1,105448,94552
5:2:5,1,1,105447,94553
6:2:3,1,1,105446,94554
5:3:1,0,-1,105447,94553
6:2:1,1,1,105446,94554
1:2:3,1,1,105445,94555
4:5:6,0,-1,105446,94554
1:4:4,0,-1,105447,94553
2:2:6,2,2,105445,94555
5:3:1,0,-1,105446,94554
3:1:3,0,-1,105447,94553
4:1:6,0,-1,105448,94552
2:5:2,2,2,105446,94554
1:1:1,0,-1,105447,94553
4:3:4,0,-1,105448,94552
1:2:4,1,1,105447,94553
5:2:4,1,1,105446,94554
4:4:6,0,-1,105447,94553
6:4:1,0,-1,105448,94552
4:5:5,0,-1,105449,94551
2:6:4,1,1,105448,94552
1:4:6,0,-1,105449,94551
6:3:4,0,-1,105450,94550
6:1:4,0,-1,105451,94549
4:1:4,0,-1,105452,94548
6:5:6,0,-1,105453,94547
1:5:3,0,-1,105454,94546
1:5:1,0,-1,105455,94545
2:6:4,1,1,105454,94546
5:1:6,0,-1,105455,94545
2:6:5,1,1,105454,94546
5:6:3,0,-1,105455,94545
6:1:5,0,-1,105456,94544
1:2:3,1,1,105455,94545
5:2:6,1,1,105454,94546
1:6:2,1,1,105453,94547
3:2:4,1,1,105452,94548
5:1:1,0,-1,105453,94547
3:3:5,0,-1,105454,94546
1:3:6,0,-1,105455,94545
3:3:1,0,-1,105456,94544
6:6:2,1,1,105455,94545
2:4:4,1,1,105454,94546
2:2:1,2,2,105452,94548
4:6:1,0,-1,105453,94547
3:1:2,1,1,105452,94548
5:1:4,0,-1,105453,94547
2:3:1,1,1,105452,94548
5:4:3,0,-1,105453,94547
5:4:4,0,-1,105454,94546
4:3:6,0,-1,105455,94545
6:3:3,0,-1,105456,94544
1:6:2,1,1,105455,94545
5:4:3,0,-1,105456,94544
5:1:6,0,-1,105457,94543
4:2:4,1,1,105456,94544
6:2:5,1,1,105455,94545
5:5:1,0,-1,105456,94544
6:1:5,0,-1,105457,94543
1:2:3,1,1,105456,94544
2:6:2,2,2,105454,94546
4:2:5,1,1,105453,94547
1:1:6,0,-1,105454,94546
1:3:6,0,-1,105455,94545
4:3:3,0,-1,105456,94544
2:5:2,2,2,105454,94546
6:2:5,1,1,105453,94547
3:5:4,0,-1,105454,94546
1:3:3,0,-1,105455,94545
1:4:2,1,1,105454,94546
2:5:1,1,1,105453,94547
6:3:2,1,1,105452,94548
2:3:5,1,1,105451,94549
3:1:6,0,-1,105452,94548
3:1:2,1,1,105451,94549
1:1:2,1,1,105450,94550
5:1:3,0,-1,105451,94549
3:1:4,0,-1,105452,94548
1:3:5,0,-1,105453,94547
2:6:2,2,2,105451,94549
2:5:2,2,2,105449,94551
3:1:1,0,-1,105450,94550
2:3:1,1,1,105449,94551
3:2:5,1,1,105448,94552
2:3:5,1,1,105447,94553
5:2:5,1,1,105446,94554
1:6:4,0,-1,105447,94553
6:1:4,0,-1,105448,94552
6:2:1,1,1,105447,94553
3:4:1,0,-1,105448,94552
5:4:1,0,-1,105449,94551
6:4:4,0,-1,105450,94550
2:5:3,1,1,105449,94551
5:3:4,0,-1,105450,94550
4:6:5,0,-1,105451,94549
5:4:5,0,-1,105452,94548
4:1:5,0,-1,105453,94547
4:1:2,1,1,105452,94548
2:1:5,1,1,105451,94549
6:6:2,1,1,105450,94550
1:1:4,0,-1,105451,94549
2:4:5,1,1,105450,94550
2:6:4,1,1,105449,94551
1:5:4,0,-1,105450,94550
4:5:6,0,-1,105451,94549
5:4:6,0,-1,105452,94548
1:2:6,1,1,105451,94549
4:3:4,0,-1,105452,94548
3:1:5,0,-1,105453,94547
1:4:2,1,1,105452,94548
3:4:3,0,-1,105453,94547
5:2:5,1,1,105452,94548
5:3:1,0,-1,105453,94547
5:1:6,0,-1,105454,94546
3:3:2,1,1,105453,94547
3:1:2,1,1,105452,94548
3:6:5,0,-1,105453,94547
2:6:1,1,1,105452,94548
4:3:2,1,1,105451,94549
3:4:5,0,-1,105452,94548
6:4:2,1,1,105451,94549
3:2:3,1,1,105450,94550
1:4:1,0,-1,105451,94549
6:2:3,1,1,105450,94550
2:4:4,1,1,105449,94551
2:2:5,2,2,105447,94553
4:6:6,0,-1,105448,94552
3:3:2,1,1,105447,94553
5:6:3,0,-1,105448,94552
1:4:6,0,-1,105449,94551
4:6:1,0,-1,105450,94550
5:5:3,0,-1,105451,94549
1:4:1,0,-1,105452,94548
4:6:1,0,-1,105453,94547
4:5:5,0,-1,105454,94546
2:6:4,1,1,105453,94547
4:3:2,1,1,105452,94548
4:3:4,0,-1,105453,94547
6:4:2,1,1,105452,94548
6:1:1,0,-1,105453,94547
1:2:4,1,1,105452,94548
1:5:4,0,-1,105453,94547
6:2:5,1,1,105452,94548
5:4:2,1,1,105451,94549
2:6:3,1,1,105450,94550
1:4:5,0,-1,105451,94549
6:3:2,1,1,105450,94550
3:1:5,0,-1,105451,94549
6:1:5,0,-1,105452,94548
6:2:3,1,1,105451,94549
3:5:6,0,-1,105452,94548
6:1:5,0,-1,105453,94547
4:5:6,0,-1,105454,94546
5:6:6,0,-1,105455,94545
3:4:1,0,-1,105456,94544
3:6:1,0,-1,105457,94543
4:5:5,0,-1,105458,94542
6:5:1,0,-1,105459,94541
2:3:3,1,1,105458,94542
6:5:6,0,-1,105459,94541
3:3:6,0,-1,105460,94540
2:1:6,1,1,105459,94541
5:5:4,0,-1,105460,94540
1:4:1,0,-1,105461,94539
2:5:5,1,1,105460,94540
1:6:6,0,-1,105461,94539
3:5:2,1,1,105460,94540
6:4:5,0,-1,105461,94539
2:4:2,2,2,105459,94541
6:2:1,1,1,105458,94542
6:1:1,0,-1,105459,94541
1:3:4,0,-1,105460,94540
5:2:1,1,1,105459,94541
4:3:1,0,-1,105460,94540
2:5:6,1,1,105459,94541
4:3:2,1,1,105458,94542
6:3:2,1,1,105457,94543
5:6:2,1,1,105456,94544
2:6:2,2,2,105454,94546
3:1:5,0,-1,105455,94545
4:6:3,0,-1,105456,94544
2:4:2,2,2,105454,94546
3:4:1,0,-1,105455,94545
1:2:5,1,1,105454,94546
1:3:3,0,-1,105455,94545
3:5:3,0,-1,105456,94544
3:2:2,2,2,105454,94546
3:2:3,1,1,105453,94547
3:1:5,0,-1,105454,94546
4:6:3,0,-1,105455,94545
5:2:3,1,1,105454,94546
3:2:1,1,1,105453,94547
5:6:5,0,-1,105454,94546
6:6:4,0,-1,105455,94545
2:4:6,1,1,105454,94546
5:6:2,1,1,105453,94547
1:2:5,1,1,105452,94548
1:5:6,0,-1,105453,94547
1:4:2,1,1,105452,94548
4:4:6,0,-1,105453,94547
2:3:2,2,2,105451,94549
4:2:5,1,1,105450,94550
6:5:3,0,-1,105451,94549
1:3:4,0,-1,105452,94548
4:2:1,1,1,105451,94549
2:2:5,2,2,105449,94551
5:4:6,0,-1,105450,94550
2:2:6,2,2,105448,94552
1:2:4,1,1,105447,94553
5:6:6,0,-1,105448,94552
3:2:2,2,2,105446,94554
5:2:4,1,1,105445,94555
6:6:1,0,-1,105446,94554
5:1:1,0,-1,105447,94553
3:1:3,0,-1,105448,94552
6:4:1,0,-1,105449,94551
4:2:2,2,2,105447,94553
2:2:6,2,2,105445,94555
3:4:2,1,1,105444,94556
5:6:5,0,-1,105445,94555
6:2:2,2,2,105443,94557
4:2:6,1,1,105442,94558
3:6:6,0,-1,105443,94557
3:4:1,0,-1,105444,94556
2:2:4,2,2,105442,94558
4:5:1,0,-1,105443,94557
2:3:1,1,1,105442,94558
4:3:6,0,-1,105443,94557
1:1:2,1,1,105442,94558
1:5:3,0,-1,105443,94557
1:6:4,0,-1,105444,94556
6:4:5,0,-1,105445,94555
6:5:5,0,-1,105446,94554
4:3:3,0,-1,105447,94553
2:1:2,2,2,105445,94555
3:4:3,0,-1,105446,94554
2:5:1,1,1,105445,94555
6:3:4,0,-1,105446,94554
1:6:2,1,1,105445,94555
4:1:1,0,-1,105446,94554
6:4:4,0,-1,105447,94553
2:6:5,1,1,105446,94554
3:1:1,0,-1,105447,94553
5:2:2,2,2,105445,94555
5:6:4,0,-1,105446,94554
5:6:2,1,1,105445,94555
6:6:5,0,-1,105446,94554
5:3:3,0,-1,105447,94553
1:4:1,0,-1,105448,94552
4:3:4,0,-1,105449,94551
1:1:1,0,-1,105450,94550
2:6:1,1,1,105449,94551
6:1:1,0,-1,105450,94550
2:6:1,1,1,105449,94551
5:1:4,0,-1,105450,94550
2:6:5,1,1,105449,94551
2:6:2,2,2,105447,94553
4:5:2,1,1,105446,94554
1:5:1,0,-1,105447,94553
2:3:5,1,1,105446,94554
4:5:6,0,-1,105447,94553
2:2:5,2,2,105445,94555
3:1:4,0,-1,105446,94554
4:5:4,0,-1,105447,94553
3:5:5,0,-1,105448,94552
3:2:5,1,1,105447,94553
4:1:5,0,-1,105448,94552
4:2:1,1,1,105447,94553
6:2:6,1,1,105446,94554
6:2:2,2,2,105444,94556
3:3:1,0,-1,105445,94555
4:5:3,0,-1,105446,94554
4:5:4,0,-1,105447,94553
3:3:1,0,-1,105448,94552
1:3:3,0,-1,105449,94551
3:5:4,0,-1,105450,94550
2:5:5,1,1,105449,94551
6:3:2,1,1,105448,94552
1:2:3,1,1,105447,94553
2:3:2,2,2,105445,94555
2:6:2,2,2,105443,94557
6:5:4,0,-1,105444,94556
1:3:6,0,-1,105445,94555
1:2:5,1,1,105444,94556
6:5:5,0,-1,105445,94555
3:2:1,1,1,105444,94556
5:2:2,2,2,105442,94558
6:2:6,1,1,105441,94559
1:1:3,0,-1,105442,94558
5:4:2,1,1,105441,94559
2:2:4,2,2,105439,94561
5:3:3,0,-1,105440,94560
4:6:2,1,1,105439,94561
4:6:6,0,-1,105440,94560
5:2:6,1,1,105439,94561
2:6:6,1,1,105438,94562
5:5:4,0,-1,105439,94561
3:2:3,1,1,105438,94562
4:5:5,0,-1,105439,94561
6:6:5,0,-1,105440,94560
1:1:2,1,1,105439,94561
6:4:2,1,1,105438,94562
2:4:5,1,1,105437,94563
3:1:5,0,-1,105438,94562
1:5:5,0,-1,105439,94561
2:4:3,1,1,105438,94562
2:1:4,1,1,105437,94563
1:2:3,1,1,105436,94564
5:3:2,1,1,105435,94565
4:3:3,0,-1,105436,94564
5:1:2,1,1,105435,94565
3:2:3,1,1,105434,94566
1:4:1,0,-1,105435,94565
6:3:5,0,-1,105436,94564
5:4:5,0,-1,105437,94563
2:4:3,1,1,105436,94564
2:1:1,1,1,105435,94565
2:5:1,1,1,105434,94566
5:2:3,1,1,105433,94567
4:3:6,0,-1,105434,94566
5:1:4,0,-1,105435,94565
2:3:2,2,2,105433,94567
5:3:1,0,-1,105434,94566
2:4:3,1,1,105433,94567
2:6:1,1,1,105432,94568
5:2:3,1,1,105431,94569
5:5:2,1,1,105430,94570
1:3:2,1,1,105429,94571
6:5:4,0,-1,105430,94570
6:3:5,0,-1,105431,94569
1:2:3,1,1,105430,94570
1:3:1,0,-1,105431,94569
2:6:5,1,1,105430,94570
2:3:1,1,1,105429,94571
2:6:5,1,1,105428,94572
3:6:1,0,-1,105429,94571
5:5:3,0,-1,105430,94570
3:5:5,0,-1,105431,94569
5:2:5,1,1,105430,94570
6:6:5,0,-1,105431,94569
6:3:2,1,1,105430,94570
4:2:1,1,1,105429,94571
2:1:2,2,2,105427,94573
2:4:5,1,1,105426,94574
4:5:5,0,-1,105427,94573
6:3:3,0,-1,105428,94572
3:1:6,0,-1,105429,94571
6:5:1,0,-1,105430,94570
5:2:5,1,1,105429,94571
2:6:5,1,1,105428,94572
2:6:6,1,1,105427,94573
1:5:5,0,-1,105428,94572
6:5:5,0,-1,105429,94571
2:5:5,1,1,105428,94572
6:1:5,0,-1,105429,94571
1:1:5,0,-1,105430,94570
3:5:6,0,-1,105431,94569
3:2:4,1,1,105430,94570
3:3:2,1,1,105429,94571
2:5:5,1,1,105428,94572
6:2:2,2,2,105426,94574
2:2:4,2,2,105424,94576
2:5:2,2,2,105422,94578
1:4:3,0,-1,105423,94577
6:4:6,0,-1,105424,94576
2:6:6,1,1,105423,94577
4:4:6,0,-1,105424,94576
1:2:6,1,1,105423,94577
5:3:6,0,-1,105424,94576
6:1:2,1,1,105423,94577
2:1:1,1,1,105422,94578
5:5:2,1,1,105421,94579
4:4:5,0,-1,105422,94578
4:6:1,0,-1,105423,94577
6:1:4,0,-1,105424,94576
6:3:5,0,-1,105425,94575
3:4:1,0,-1,105426,94574
1:3:3,0,-1,105427,94573
5:2:6,1,1,105426,94574
1:6:4,0,-1,105427,94573
6:3:4,0,-1,105428,94572
5:2:5,1,1,105427,94573
5:3:5,0,-1,105428,94572
1:5:1,0,-1,105429,94571
4:2:5,1,1,105428,94572
4:3:3,0,-1,105429,94571
5:2:1,1,1,105428,94572
3:2:5,1,1,105427,94573
4:5:3,0,-1,105428,94572
5:5:4,0,-1,105429,94571
3:5:4,0,-1,105430,94570
3:5:6,0,-1,105431,94569
1:2:6,1,1,105430,94570
4:1:1,0,-1,105431,94569
6:1:3,0,-1,105432,94568
3:3:4,0,-1,105433,94567
4:5:4,0,-1,105434,94566
5:5:6,0,-1,105435,94565
1:2:2,2,2,105433,94567
6:2:1,1,1,105432,94568
1:5:1,0,-1,105433,94567
4:3:3,0,-1,105434,94566
5:5:6,0,-1,105435,94565
4:1:1,0,-1,105436,94564
6:2:3,1,1,105435,94565
1:1:4,0,-1,105436,94564
6:2:1,1,1,105435,94565
5:4:3,0,-1,105436,94564
3:1:1,0,-1,105437,94563
5:3:4,0,-1,105438,94562
6:1:1,0,-1,105439,94561
4:2:6,1,1,105438,94562
1:3:3,0,-1,105439,94561
3:3:1,0,-1,105440,94560
2:3:1,1,1,105439,94561
5:1:6,0,-1,105440,94560
2:3:6,1,1,105439,94561
4:6:2,1,1,105438,94562
2:6:4,1,1,105437,94563
6:1:4,0,-1,105438,94562
6:5:4,0,-1,105439,94561
6:1:3,0,-1,105440,94560
2:5:2,2,2,105438,94562
4:5:1,0,-1,105439,94561
5:6:6,0,-1,105440,94560
1:2:4,1,1,105439,94561
2:1:1,1,1,105438,94562
2:5:5,1,1,105437,94563
6:4:3,0,-1,105438,94562
5:4:1,0,-1,105439,94561
3:6:1,0,-1,105440,94560
6:4:4,0,-1,105441,94559
6:5:3,0,-1,105442,94558
6:6:6,0,-1,105443,94557
1:4:1,0,-1,105444,94556
6:3:6,0,-1,105445,94555
2:1:2,2,2,105443,94557
4:4:2,1,1,105442,94558
1:5:5,0,-1,105443,94557
5:5:5,0,-1,105444,94556
6:1:1,0,-1,105445,94555
1:4:2,1,1,105444,94556
3:5:2,1,1,105443,94557
5:5:3,0,-1,105444,94556
5:4:1,0,-1,105445,94555
6:4:6,0,-1,105446,94554
5:6:2,1,1,105445,94555
2:4:6,1,1,105444,94556
5:6:5,0,-1,105445,94555
2:3:6,1,1,105444,94556
4:5:4,0,-1,105445,94555
2:1:1,1,1,105444,94556
5:2:1,1,1,105443,94557
1:2:5,1,1,105442,94558
6:6:6,0,-1,105443,94557
3:3:4,0,-1,105444,94556
5:4:3,0,-1,105445,94555
5:5:6,0,-1,105446,94554
1:4:2,1,1,105445,94555
1:2:2,2,2,105443,94557
2:1:5,1,1,105442,94558
1:5:3,0,-1,105443,94557
6:3:6,0,-1,105444,94556
5:2:6,1,1,105443,94557
1:4:5,0,-1,105444,94556
6:2:2,2,2,105442,94558
3:6:5,0,-1,105443,94557
1:4:5,0,-1,105444,94556
1:1:3,0,-1,105445,94555
4:5:5,0,-1,105446,94554
6:3:5,0,-1,105447,94553
5:1:6,0,-1,105448,94552
3:2:6,1,1,105447,94553
4:1:2,1,1,105446,94554
2:4:4,1,1,105445,94555
4:5:6,0,-1,105446,94554
6:6:4,0,-1,105447,94553
4:3:1,0,-1,105448,94552
6:4:6,0,-1,105449,94551
4:2:2,2,2,105447,94553
6:2:5,1,1,105446,94554
6:1:3,0,-1,105447,94553
6:4:1,0,-1,105448,94552
4:5:4,0,-1,105449,94551
6:1:2,1,1,105448,94552
4:6:2,1,1,105447,94553
2:3:3,1,1,105446,94554
4:4:4,0,-1,105447,94553
1:1:2,1,1,105446,94554
1:1:2,1,1,105445,94555
5:6:2,1,1,105444,94556
1:1:6,0,-1,105445,94555
2:6:6,1,1,105444,94556
2:3:2,2,2,105442,94558
6:2:4,1,1,105441,94559
5:3:1,0,-1,105442,94558
4:3:5,0,-1,105443,94557
3:4:5,0,-1,105444,94556
3:4:3,0,-1,105445,94555
4:3:3,0,-1,105446,94554
1:2:6,1,1,105445,94555
5:2:5,1,1,105444,94556
4:5:3,0,-1,105445,94555
1:3:5,0,-1,105446,94554
1:4:6,0,-1,105447,94553
4:1:3,0,-1,105448,94552
2:1:2,2,2,105446,94554
2:2:1,2,2,105444,94556
5:4:1,0,-1,105445,94555
3:6:2,1,1,105444,94556
1:4:3,0,-1,105445,94555
2:2:4,2,2,105443,94557
3:3:1,0,-1,105444,94556
1:1:1,0,-1,105445,94555
2:6:4,1,1,105444,94556
2:1:1,1,1,105443,94557
1:3:6,0,-1,105444,94556
2:5:5,1,1,105443,94557
2:2:2,3,3,105440,94560
6:1:6,0,-1,105441,94559
2:6:2,2,2,105439,94561
6:3:6,0,-1,105440,94560
6:2:6,1,1,105439,94561
2:4:1,1,1,105438,94562
1:6:4,0,-1,105439,94561
3:5:3,0,-1,105440,94560
3:6:1,0,-1,105441,94559
5:1:6,0,-1,105442,94558
4:1:5,0,-1,105443,94557
6:4:2,1,1,105442,94558
1:4:4,0,-1,105443,94557
4:4:2,1,1,105442,94558
6:5:1,0,-1,105443,94557
4:2:1,1,1,105442,94558
5:1:3,0,-1,105443,94557
2:5:1,1,1,105442,94558
4:6:4,0,-1,105443,94557
6:6:3,0,-1,105444,94556
4:2:4,1,1,105443,94557
3:2:4,1,1,105442,94558
4:5:2,1,1,105441,94559
4:4:1,0,-1,105442,94558
4:2:2,2,2,105440,94560
6:5:3,0,-1,105441,94559
6:6:4,0,-1,105442,94558
1:4:3,0,-1,105443,94557
1:6:5,0,-1,105444,94556
6:1:1,0,-1,105445,94555
3:4:6,0,-1,105446,94554
6:1:6,0,-1,105447,94553
6:3:1,0,-1,105448,94552
5:2:6,1,1,105447,94553
1:2:1,1,1,105446,94554
1:3:3,0,-1,105447,94553
6:4:1,0,-1,105448,94552
4:4:3,0,-1,105449,94551
4:1:6,0,-1,105450,94550
2:3:5,1,1,105449,94551
1:6:2,1,1,105448,94552
5:3:5,0,-1,105449,94551
2:4:5,1,1,105448,94552
5:1:5,0,-1,105449,94551
6:5:2,1,1,105448,94552
4:6:3,0,-1,105449,94551
1:1:5,0,-1,105450,94550
5:2:2,2,2,105448,94552
6:2:1,1,1,105447,94553
3:2:4,1,1,105446,94554
6:1:5,0,-1,105447,94553
4:6:2,1,1,105446,94554
4:4:4,0,-1,105447,94553
5:3:5,0,-1,105448,94552
2:3:5,1,1,105447,94553
1:3:3,0,-1,105448,94552
6:2:1,1,1,105447,94553
4:5:5,0,-1,105448,94552
4:3:4,0,-1,105449,94551
6:2:4,1,1,105448,94552
6:4:4,0,-1,105449,94551
6:1:2,1,1,105448,94552
4:2:2,2,2,105446,94554
2:1:6,1,1,105445,94555
1:2:1,1,1,105444,94556
3:4:1,0,-1,105445,94555
3:4:6,0,-1,105446,94554
3:3:2,1,1,105445,94555
2:4:2,2,2,105443,94557
4:3:6,0,-1,105444,94556
2:3:6,1,1,105443,94557
5:1:3,0,-1,105444,94556
1:5:6,0,-1,105445,94555
1:6:1,0,-1,105446,94554
3:3:6,0,-1,105447,94553
4:6:2,1,1,105446,94554
3:3:4,0,-1,105447,94553
6:1:6,0,-1,105448,94552
6:3:6,0,-1,105449,94551
1:1:1,0,-1,105450,94550
5:2:4,1,1,105449,94551
1:5:3,0,-1,105450,94550
2:4:6,1,1,105449,94551
3:6:1,0,-1,105450,94550
4:5:1,0,-1,105451,94549
4:5:1,0,-1,105452,94548
1:6:2,1,1,105451,94549
6:3:6,0,-1,105452,94548
5:4:2,1,1,105451,94549
1:4:3,0,-1,105452,94548
4:6:2,1,1,105451,94549
4:2:5,1,1,105450,94550
2:3:1,1,1,105449,94551
2:2:5,2,2,105447,94553
4:5:3,0,-1,105448,94552
6:2:3,1,1,105447,94553
3:4:2,1,1,105446,94554
1:6:1,0,-1,105447,94553
5:5:4,0,-1,105448,94552
4:3:6,0,-1,105449,94551
5:3:5,0,-1,105450,94550
4:6:6,0,-1,105451,94549
6:3:1,0,-1,105452,94548
3:1:5,0,-1,105453,94547
2:4:4,1,1,105452,94548
2:6:6,1,1,105451,94549
5:4:6,0,-1,105452,94548
1:2:3,1,1,105451,94549
1:3:6,0,-1,105452,94548
4:6:4,0,-1,105453,94547
2:5:5,1,1,105452,94548
1:3:1,0,-1,105453,94547
1:4:4,0,-1,105454,94546
5:6:5,0,-1,105455,94545
6:4:5,0,-1,105456,94544
3:5:2,1,1,105455,94545
4:4:1,0,-1,105456,94544
4:6:6,0,-1,105457,94543
4:4:4,0,-1,105458,94542
3:6:6,0,-1,105459,94541
5:1:2,1,1,105458,94542
5:5:5,0,-1,105459,94541
3:4:4,0,-1,105460,94540
3:5:5,0,-1,105461,94539
4:1:3,0,-1,105462,94538
5:6:4,0,-1,105463,94537
3:4:6,0,-1,105464,94536
2:5:2,2,2,105462,94538
5:6:5,0,-1,105463,94537
1:2:5,1,1,105462,94538
6:5:5,0,-1,105463,94537
5:5:6,0,-1,105464,94536
3:2:4,1,1,105463,94537
3:1:4,0,-1,105464,94536
3:3:2,1,1,105463,94537
5:4:3,0,-1,105464,94536
6:4:1,0,-1,105465,94535
2:2:2,3,3,105462,94538
5:1:5,0,-1,105463,94537
6:1:5,0,-1,105464,94536
1:6:4,0,-1,105465,94535
4:3:5,0,-1,105466,94534
6:1:4,0,-1,105467,94533
3:4:2,1,1,105466,94534
5:1:4,0,-1,105467,94533
4:2:6,1,1,105466,94534
3:3:3,0,-1,105467,94533
2:4:5,1,1,105466,94534
2:3:2,2,2,105464,94536
2:4:6,1,1,105463,94537
4:4:2,1,1,105462,94538
1:1:6,0,-1,105463,94537
4:4:2,1,1,105462,94538
5:2:2,2,2,105460,94540
3:1:5,0,-1,105461,94539
6:3:3,0,-1,105462,94538
6:2:4,1,1,105461,94539
5:5:5,0,-1,105462,94538
6:2:3,1,1,105461,94539
1:3:6,0,-1,105462,94538
6:5:4,0,-1,105463,94537
4:5:4,0,-1,105464,94536
4:5:6,0,-1,105465,94535
3:6:1,0,-1,105466,94534
5:2:1,1,1,105465,94535
5:4:5,0,-1,105466,94534
1:4:4,0,-1,105467,94533
3:4:5,0,-1,105468,94532
4:5:1,0,-1,105469,94531
6:4:5,0,-1,105470,94530
2:2:4,2,2,105468,94532
3:6:1,0,-1,105469,94531
2:1:3,1,1,105468,94532
4:2:6,1,1,105467,94533
6:6:1,0,-1,105468,94532
5:3:1,0,-1,105469,94531
2:4:2,2,2,105467,94533
3:1:5,0,-1,105468,94532
3:1:5,0,-1,105469,94531
3:1:5,0,-1,105470,94530
2:5:3,1,1,105469,94531
1:1:3,0,-1,105470,94530
2:5:2,2,2,105468,94532
6:3:1,0,-1,105469,94531
3:6:4,0,-1,105470,94530
2:6:2,2,2,105468,94532
3:6:3,0,-1,105469,94531
5:6:4,0,-1,105470,94530
3:1:1,0,-1,105471,94529
5:4:2,1,1,105470,94530
6:5:2,1,1,105469,94531
3:3:6,0,-1,105470,94530
3:5:6,0,-1,105471,94529
1:2:2,2,2,105469,94531
6:2:6,1,1,105468,94532
4:4:6,0,-1,105469,94531
5:4:4,0,-1,105470,94530
3:4:5,0,-1,105471,94529
4:2:3,1,1,105470,94530
6:6:5,0,-1,105471,94529
3:2:3,1,1,105470,94530
3:5:6,0,-1,105471,94529
3:4:3,0,-1,105472,94528
4:6:5,0,-1,105473,94527
3:5:5,0,-1,105474,94526
4:6:4,0,-1,105475,94525
5:2:3,1,1,105474,94526
5:3:6,0,-1,105475,94525
1:5:4,0,-1,105476,94524
1:1:1,0,-1,105477,94523
4:3:4,0,-1,105478,94522
2:3:1,1,1,105477,94523
3:3:2,1,1,105476,94524
4:5:6,0,-1,105477,94523
4:6:6,0,-1,105478,94522
5:3:5,0,-1,105479,94521
6:3:2,1,1,105478,94522
4:2:3,1,1,105477,94523
1:6:5,0,-1,105478,94522
3:6:2,1,1,105477,94523
5:5:6,0,-1,105478,94522
1:2:3,1,1,105477,94523
5:3:6,0,-1,105478,94522
3:4:5,0,-1,105479,94521
5:5:2,1,1,105478,94522
1:3:2,1,1,105477,94523
3:4:1,0,-1,105478,94522
5:4:3,0,-1,105479,94521
4:4:6,0,-1,105480,94520
5:4:4,0,-1,105481,94519
3:5:2,1,1,105480,94520
5:5:4,0,-1,105481,94519
1:2:1,1,1,105480,94520
3:5:1,0,-1,105481,94519
3:1:1,0,-1,105482,94518
1:6:4,0,-1,105483,94517
3:1:2,1,1,105482,94518
2:6:1,1,1,105481,94519
2:1:4,1,1,105480,94520
4:3:4,0,-1,105481,94519
4:3:1,0,-1,105482,94518
4:2:5,1,1,105481,94519
2:5:5,1,1,105480,94520
3:1:4,0,-1,105481,94519
3:3:1,0,-1,105482,94518
6:1:2,1,1,105481,94519
6:1:5,0,-1,105482,94518
1:1:3,0,-1,105483,94517
6:6:6,0,-1,105484,94516
2:2:6,2,2,105482,94518
5:1:6,0,-1,105483,94517
6:1:5,0,-1,105484,94516
3:6:5,0,-1,105485,94515
3:1:3,0,-1,105486,94514
3:3:2,1,1,105485,94515
1:5:2,1,1,105484,94516
1:6:4,0,-1,105485,94515
3:2:2,2,2,105483,94517
6:3:4,0,-1,105484,94516
4:1:4,0,-1,105485,94515
4:1:1,0,-1,105486,94514
4:6:6,0,-1,105487,94513
3:5:1,0,-1,105488,94512
6:2:3,1,1,105487,94513
5:3:4,0,-1,105488,94512
4:1:1,0,-1,105489,94511
2:4:1,1,1,105488,94512
5:1:6,0,-1,105489,94511
1:3:4,0,-1,105490,94510
1:1:3,0,-1,105491,94509
3:2:4,1,1,105490,94510
5:2:3,1,1,105489,94511
2:4:3,1,1,105488,94512
2:4:5,1,1,105487,94513
2:4:3,1,1,105486,94514
6:5:5,0,-1,105487,94513
6:1:5,0,-1,105488,94512
3:4:5,0,-1,105489,94511
5:6:6,0,-1,105490,94510
1:1:1,0,-1,105491,94509
6:4:5,0,-1,105492,94508
1:1:2,1,1,105491,94509
1:6:2,1,1,105490,94510
5:1:2,1,1,105489,94511
3:6:1,0,-1,105490,94510
3:4:5,0,-1,105491,94509
4:2:6,1,1,105490,94510
5:1:6,0,-1,105491,94509
5:5:5,0,-1,105492,94508
3:4:3,0,-1,105493,94507
2:2:4,2,2,105491,94509
4:5:4,0,-1,105492,94508
6:2:3,1,1,105491,94509
2:6:5,1,1,105490,94510
3:3:2,1,1,105489,94511
2:5:3,1,1,105488,94512
1:4:5,0,-1,105489,94511
5:5:6,0,-1,105490,94510
1:2:1,1,1,105489,94511
1:4:4,0,-1,105490,94510
6:2:6,1,1,105489,94511
2:5:6,1,1,105488,94512
5:4:6,0,-1,105489,94511
3:2:4,1,1,105488,94512
2:1:4,1,1,105487,94513
4:2:4,1,1,105486,94514
3:3:4,0,-1,105487,94513
3:4:3,0,-1,105488,94512
1:1:2,1,1,105487,94513
2:2:1,2,2,105485,94515
6:6:2,1,1,105484,94516
2:1:6,1,1,105483,94517
3:6:2,1,1,105482,94518
3:1:2,1,1,105481,94519
3:5:6,0,-1,105482,94518
1:2:4,1,1,105481,94519
4:3:1,0,-1,105482,94518
4:5:4,0,-1,105483,94517
5:6:2,1,1,105482,94518
4:2:2,2,2,105480,94520
6:4:3,0,-1,105481,94519
4:3:1,0,-1,105482,94518
4:6:3,0,-1,105483,94517
5:5:5,0,-1,105484,94516
3:5:3,0,-1,105485,94515
2:1:6,1,1,105484,94516
1:6:3,0,-1,105485,94515
4:2:3,1,1,105484,94516
6:3:4,0,-1,105485,94515
5:3:1,0,-1,105486,94514
6:5:5,0,-1,105487,94513
6:5:4,0,-1,105488,94512
1:3:6,0,-1,105489,94511
4:4:5,0,-1,105490,94510
3:2:4,1,1,105489,94511
1:4:2,1,1,105488,94512
5:4:2,1,1,105487,94513
2:5:1,1,1,105486,94514
4:3:2,1,1,105485,94515
5:4:2,1,1,105484,94516
1:2:1,1,1,105483,94517
6:5:1,0,-1,105484,94516
3:6:4,0,-1,105485,94515
4:1:5,0,-1,105486,94514
6:1:3,0,-1,105487,94513
3:3:3,0,-1,105488,94512
2:2:5,2,2,105486,94514
2:3:5,1,1,105485,94515
2:1:2,2,2,105483,94517
4:1:1,0,-1,105484,94516
2:5:1,1,1,105483,94517
2:6:3,1,1,105482,94518
2:2:4,2,2,105480,94520
2:1:5,1,1,105479,94521
2:5:4,1,1,105478,94522
5:5:1,0,-1,105479,94521
3:3:3,0,-1,105480,94520
5:4:1,0,-1,105481,94519
6:6:6,0,-1,105482,94518
1:6:3,0,-1,105483,94517
5:3:6,0,-1,105484,94516
6:4:2,1,1,105483,94517
3:2:2,2,2,105481,94519
4:1:6,0,-1,105482,94518
2:1:5,1,1,105481,94519
6:3:1,0,-1,105482,94518
6:1:6,0,-1,105483,94517
6:3:6,0,-1,105484,94516
6:1:5,0,-1,105485,94515
3:6:6,0,-1,105486,94514
6:5:5,0,-1,105487,94513
5:2:6,1,1,105486,94514
2:5:5,1,1,105485,94515
6:1:2,1,1,105484,94516
4:5:5,0,-1,105485,94515
6:3:4,0,-1,105486,94514
6:5:6,0,-1,105487,94513
2:3:1,1,1,105486,94514
6:5:2,1,1,105485,94515
5:4:1,0,-1,105486,94514
5:2:2,2,2,105484,94516
2:3:4,1,1,105483,94517
5:6:3,0,-1,105484,94516
5:4:1,0,-1,105485,94515
4:2:3,1,1,105484,94516
3:6:3,0,-1,105485,94515
4:6:6,0,-1,105486,94514
3:6:3,0,-1,105487,94513
5:6:1,0,-1,105488,94512
2:6:2,2,2,105486,94514
2:4:2,2,2,105484,94516
3:4:6,0,-1,105485,94515
4:3:5,0,-1,105486,94514
4:1:2,1,1,105485,94515
4:2:6,1,1,105484,94516
1:4:4,0,-1,105485,94515
2:5:2,2,2,105483,94517
3:3:5,0,-1,105484,94516
4:1:5,0,-1,105485,94515
5:6:3,0,-1,105486,94514
6:5:2,1,1,105485,94515
2:4:4,1,1,105484,94516
4:1:2,1,1,105483,94517
5:6:5,0,-1,105484,94516
2:6:5,1,1,105483,94517
6:1:4,0,-1,105484,94516
5:6:6,0,-1,105485,94515
4:3:4,0,-1,105486,94514
4:5:3,0,-1,105487,94513
6:6:6,0,-1,105488,94512
1:6:6,0,-1,105489,94511
4:4:2,1,1,105488,94512
6:5:3,0,-1,105489,94511
4:2:5,1,1,105488,94512
2:5:1,1,1,105487,94513
2:6:6,1,1,105486,94514
4:1:4,0,-1,105487,94513
2:3:4,1,1,105486,94514
3:4:5,0,-1,105487,94513
6:6:6,0,-1,105488,94512
6:4:1,0,-1,105489,94511
6:5:1,0,-1,105490,94510
6:2:3,1,1,105489,94511
5:5:6,0,-1,105490,94510
5:4:1,0,-1,105491,94509
4:5:6,0,-1,105492,94508
3:3:6,0,-1,105493,94507
4:4:6,0,-1,105494,94506
3:6:5,0,-1,105495,94505
5:5:1,0,-1,105496,94504
4:6:5,0,-1,105497,94503
1:2:1,1,1,105496,94504
3:6:4,0,-1,105497,94503
3:5:1,0,-1,105498,94502
1:3:1,0,-1,105499,94501
3:1:4,0,-1,105500,94500
2:3:3,1,1,105499,94501
2:6:2,2,2,105497,94503
4:3:1,0,-1,105498,94502
4:2:6,1,1,105497,94503
5:4:5,0,-1,105498,94502
2:6:5,1,1,105497,94503
1:1:1,0,-1,105498,94502
5:2:2,2,2,105496,94504
3:4:5,0,-1,105497,94503
6:3:4,0,-1,105498,94502
1:1:4,0,-1,105499,94501
6:1:4,0,-1,105500,94500
5:1:4,0,-1,105501,94499
2:5:1,1,1,105500,94500
3:3:2,1,1,105499,94501
1:5:1,0,-1,105500,94500
2:5:5,1,1,105499,94501
1:2:6,1,1,105498,94502
4:3:6,0,-1,105499,94501
1:1:6,0,-1,105500,94500
4:4:5,0,-1,105501,94499
4:3:4,0,-1,105502,94498
2:3:1,1,1,105501,94499
3:6:2,1,1,105500,94500
2:3:6,1,1,105499,94501
6:6:1,0,-1,105500,94500
4:5:2,1,1,105499,94501
5:3:1,0,-1,105500,94500
2:1:2,2,2,105498,94502
5:4:2,1,1,105497,94503
3:1:2,1,1,105496,94504
3:5:2,1,1,105495,94505
1:1:3,0,-1,105496,94504
4:4:4,0,-1,105497,94503
6:6:1,0,-1,105498,94502
6:3:2,1,1,105497,94503
6:6:1,0,-1,105498,94502
6:4:3,0,-1,105499,94501
1:1:6,0,-1,105500,94500
5:6:1,0,-1,105501,94499
3:5:2,1,1,105500,94500
2:3:1,1,1,105499,94501
4:1:3,0,-1,105500,94500
6:3:5,0,-1,105501,94499
4:4:6,0,-1,105502,94498
2:3:1,1,1,105501,94499
2:3:1,1,1,105500,94500
2:6:1,1,1,105499,94501
2:6:1,1,1,105498,94502
1:2:5,1,1,105497,94503
6:4:6,0,-1,105498,94502
5:4:6,0,-1,105499,94501
4:5:6,0,-1,105500,94500
6:3:6,0,-1,105501,94499
2:3:1,1,1,105500,94500
4:6:1,0,-1,105501,94499
2:5:3,1,1,105500,94500
5:2:6,1,1,105499,94501
5:2:5,1,1,105498,94502
6:6:4,0,-1,105499,94501
3:1:5,0,-1,105500,94500
1:2:4,1,1,105499,94501
5:4:4,0,-1,105500,94500
5:6:3,0,-1,105501,94499
1:2:2,2,2,105499,94501
2:1:1,1,1,105498,94502
5:5:2,1,1,105497,94503
2:5:5,1,1,105496,94504
6:5:5,0,-1,105497,94503
2:1:4,1,1,105496,94504
3:2:1,1,1,105495,94505
5:3:5,0,-1,105496,94504
3:4:6,0,-1,105497,94503
2:5:3,1,1,105496,94504
5:3:4,0,-1,105497,94503
3:1:3,0,-1,105498,94502
2:4:1,1,1,105497,94503
5:3:4,0,-1,105498,94502
4:5:6,0,-1,105499,94501
2:1:5,1,1,105498,94502
4:6:6,0,-1,105499,94501
2:6:5,1,1,105498,94502
5:5:4,0,-1,105499,94501
5:1:2,1,1,105498,94502
6:1:6,0,-1,105499,94501
6:4:5,0,-1,105500,94500
5:3:3,0,-1,105501,94499
6:1:6,0,-1,105502,94498
3:3:1,0,-1,105503,94497
3:2:2,2,2,105501,94499
6:6:2,1,1,105500,94500
1:4:6,0,-1,105501,94499
5:2:6,1,1,105500,94500
5:5:3,0,-1,105501,94499
1:4:1,0,-1,105502,94498
1:4:4,0,-1,105503,94497
3:3:1,0,-1,105504,94496
5:2:3,1,1,105503,94497
4:1:1,0,-1,105504,94496
2:6:6,1,1,105503,94497
6:3:3,0,-1,105504,94496
3:1:4,0,-1,105505,94495
3:6:3,0,-1,105506,94494
5:4:2,1,1,105505,94495
6:4:4,0,-1,105506,94494
6:2:3,1,1,105505,94495
6:6:3,0,-1,105506,94494
4:3:2,1,1,105505,94495
4:3:3,0,-1,105506,94494
1:5:4,0,-1,105507,94493
5:3:2,1,1,105506,94494
4:3:1,0,-1,105507,94493
2:3:2,2,2,105505,94495
6:4:6,0,-1,105506,94494
4:2:2,2,2,105504,94496
1:1:6,0,-1,105505,94495
5:6:5,0,-1,105506,94494
5:1:1,0,-1,105507,94493
6:3:6,0,-1,105508,94492
3:6:5,0,-1,105509,94491
1:4:4,0,-1,105510,94490
1:4:1,0,-1,105511,94489
4:6:2,1,1,105510,94490
1:5:5,0,-1,105511,94489
3:1:5,0,-1,105512,94488
5:6:6,0,-1,105513,94487
2:4:2,2,2,105511,94489
2:2:3,2,2,105509,94491
1:3:2,1,1,105508,94492
4:1:5,0,-1,105509,94491
1:4:5,0,-1,105510,94490
5:6:4,0,-1,105511,94489
2:5:1,1,1,105510,94490
1:2:6,1,1,105509,94491
6:4:1,0,-1,105510,94490
1:4:6,0,-1,105511,94489
4:3:5,0,-1,105512,94488
2:6:1,1,1,105511,94489
6:1:2,1,1,105510,94490
5:6:2,1,1,105509,94491
1:3:4,0,-1,105510,94490
5:5:5,0,-1,105511,94489
2:1:6,1,1,105510,94490
5:5:1,0,-1,105511,94489
2:6:2,2,2,105509,94491
3:2:2,2,2,105507,94493
5:4:3,0,-1,105508,94492
3:2:4,1,1,105507,94493
4:4:1,0,-1,105508,94492
2:3:1,1,1,105507,94493
2:1:2,2,2,105505,94495
4:6:6,0,-1,105506,94494
2:4:5,1,1,105505,94495
3:5:6,0,-1,105506,94494
4:2:1,1,1,105505,94495
2:2:1,2,2,105503,94497
5:3:3,0,-1,105504,94496
4:5:3,0,-1,105505,94495
6:5:1,0,-1,105506,94494
5:3:4,0,-1,105507,94493
3:2:6,1,1,105506,94494
6:3:1,0,-1,105507,94493
2:6:5,1,1,105506,94494
5:1:4,0,-1,105507,94493
4:3:4,0,-1,105508,94492
6:4:3,0,-1,105509,94491
5:3:6,0,-1,105510,94490
1:4:4,0,-1,105511,94489
2:6:6,1,1,105510,94490
6:6:1,0,-1,105511,94489
2:4:4,1,1,105510,94490
4:6:5,0,-1,105511,94489
1:4:2,1,1,105510,94490
3:2:3,1,1,105509,94491
2:1:2,2,2,105507,94493
1:3:4,0,-1,105508,94492
5:2:6,1,1,105507,94493
5:6:2,1,1,105506,94494
6:2:5,1,1,105505,94495
3:3:1,0,-1,105506,94494
6:1:1,0,-1,105507,94493
4:1:2,1,1,105506,94494
4:3:2,1,1,105505,94495
3:1:5,0,-1,105506,94494
3:2:6,1,1,105505,94495
1:4:2,1,1,105504,94496
6:5:6,0,-1,105505,94495
4:5:3,0,-1,105506,94494
2:6:5,1,1,105505,94495
5:4:6,0,-1,105506,94494
6:5:1,0,-1,105507,94493
5:2:5,1,1,105506,94494
1:3:4,0,-1,105507,94493
4:2:3,1,1,105506,94494
4:2:1,1,1,105505,94495
1:6:2,1,1,105504,94496
2:1:3,1,1,105503,94497
6:4:1,0,-1,105504,94496
5:2:6,1,1,105503,94497
4:5:6,0,-1,105504,94496
4:5:2,1,1,105503,94497
4:4:1,0,-1,105504,94496
3:4:4,0,-1,105505,94495
6:6:1,0,-1,105506,94494
1:2:2,2,2,105504,94496
2:5:4,1,1,105503,94497
5:5:6,0,-1,105504,94496
5:6:6,0,-1,105505,94495
1:5:6,0,-1,105506,94494
2:6:6,1,1,105505,94495
4:4:5,0,-1,105506,94494
2:6:2,2,2,105504,94496
6:2:3,1,1,105503,94497
2:5:5,1,1,105502,94498
4:6:4,0,-1,105503,94497
4:4:5,0,-1,105504,94496
3:4:4,0,-1,105505,94495
1:4:1,0,-1,105506,94494
2:5:3,1,1,105505,94495
4:4:4,0,-1,105506,94494
1:4:3,0,-1,105507,94493
6:1:2,1,1,105506,94494
6:3:3,0,-1,105507,94493
6:6:4,0,-1,105508,94492
6:4:3,0,-1,105509,94491
6:5:3,0,-1,105510,94490
2:2:5,2,2,105508,94492
2:5:5,1,1,105507,94493
6:4:1,0,-1,105508,94492
5:5:5,0,-1,105509,94491
1:1:1,0,-1,105510,94490
3:3:6,0,-1,105511,94489
2:2:4,2,2,105509,94491
2:6:3,1,1,105508,94492
6:1:6,0,-1,105509,94491
2:4:3,1,1,105508,94492
4:1:6,0,-1,105509,94491
2:1:3,1,1,105508,94492
5:5:3,0,-1,105509,94491
2:3:3,1,1,105508,94492
1:3:3,0,-1,105509,94491
1:2:3,1,1,105508,94492
5:6:5,0,-1,105509,94491
2:5:1,1,1,105508,94492
3:1:4,0,-1,105509,94491
6:6:4,0,-1,105510,94490
2:6:5,1,1,105509,94491
1:3:5,0,-1,105510,94490
5:2:4,1,1,105509,94491
1:4:2,1,1,105508,94492
4:3:6,0,-1,105509,94491
5:5:4,0,-1,105510,94490
5:4:5,0,-1,105511,94489
5:3:3,0,-1,105512,94488
4:5:3,0,-1,105513,94487
4:5:2,1,1,105512,94488
4:4:2,1,1,105511,94489
6:6:1,0,-1,105512,94488
5:1:1,0,-1,105513,94487
5:3:6,0,-1,105514,94486
1:2:2,2,2,105512,94488
5:5:3,0,-1,105513,94487
5:2:5,1,1,105512,94488
3:6:4,0,-1,105513,94487
4:1:1,0,-1,105514,94486
5:6:5,0,-1,105515,94485
5:1:5,0,-1,105516,94484
4:3:5,0,-1,105517,94483
1:5:1,0,-1,105518,94482
4:6:3,0,-1,105519,94481
4:1:1,0,-1,105520,94480
5:1:4,0,-1,105521,94479
1:3:6,0,-1,105522,94478
4:3:6,0,-1,105523,94477
2:1:5,1,1,105522,94478
5:4:2,1,1,105521,94479
5:6:6,0,-1,105522,94478
5:5:4,0,-1,105523,94477
6:5:4,0,-1,105524,94476
4:4:5,0,-1,105525,94475
5:1:2,1,1,105524,94476
4:3:2,1,1,105523,94477
4:4:1,0,-1,105524,94476
1:6:2,1,1,105523,94477
5:2:1,1,1,105522,94478
3:5:4,0,-1,105523,94477
6:3:6,0,-1,105524,94476
6:6:2,1,1,105523,94477
6:6:6,0,-1,105524,94476
1:1:3,0,-1,105525,94475
1:6:4,0,-1,105526,94474
3:1:6,0,-1,105527,94473
6:6:3,0,-1,105528,94472
6:6:6,0,-1,105529,94471
3:5:1,0,-1,105530,94470
6:3:3,0,-1,105531,94469
6:5:3,0,-1,105532,94468
1:2:5,1,1,105531,94469
1:3:3,0,-1,105532,94468
4:2:3,1,1,105531,94469
6:1:6,0,-1,105532,94468
2:1:2,2,2,105530,94470
2:5:3,1,1,105529,94471
2:6:3,1,1,105528,94472
6:5:1,0,-1,105529,94471
5:4:5,0,-1,105530,94470
4:1:4,0,-1,105531,94469
2:3:5,1,1,105530,94470
2:5:1,1,1,105529,94471
1:3:3,0,-1,105530,94470
2:6:2,2,2,105528,94472
5:4:1,0,-1,105529,94471
1:2:6,1,1,105528,94472
2:6:2,2,2,105526,94474
4:6:3,0,-1,105527,94473
6:6:3,0,-1,105528,94472
3:4:2,1,1,105527,94473
2:6:5,1,1,105526,94474
3:1:2,1,1,105525,94475
2:1:6,1,1,105524,94476
2:2:2,3,3,105521,94479
5:2:2,2,2,105519,94481
2:4:1,1,1,105518,94482
3:4:5,0,-1,105519,94481
2:1:3,1,1,105518,94482
1:6:5,0,-1,105519,94481
4:6:5,0,-1,105520,94480
4:1:5,0,-1,105521,94479
5:5:3,0,-1,105522,94478
3:2:6,1,1,105521,94479
5:4:4,0,-1,105522,94478
5:6:5,0,-1,105523,94477
2:4:3,1,1,105522,94478
4:3:1,0,-1,105523,94477
3:6:5,0,-1,105524,94476
3:1:1,0,-1,105525,94475
1:5:2,1,1,105524,94476
1:1:3,0,-1,105525,94475
6:6:6,0,-1,105526,94474
6:1:1,0,-1,105527,94473
6:6:4,0,-1,105528,94472
1:2:1,1,1,105527,94473
5:1:4,0,-1,105528,94472
6:3:6,0,-1,105529,94471
4:6:6,0,-1,105530,94470
2:4:6,1,1,105529,94471
4:1:1,0,-1,105530,94470
6:5:3,0,-1,105531,94469
3:1:2,1,1,105530,94470
4:6:5,0,-1,105531,94469
5:4:2,1,1,105530,94470
5:1:2,1,1,105529,94471
5:3:5,0,-1,105530,94470
5:5:5,0,-1,105531,94469
6:6:4,0,-1,105532,94468
1:2:4,1,1,105531,94469
2:5:3,1,1,105530,94470
2:1:5,1,1,105529,94471
2:2:3,2,2,105527,94473
3:3:5,0,-1,105528,94472
6:5:5,0,-1,105529,94471
6:5:1,0,-1,105530,94470
4:1:5,0,-1,105531,94469
4:2:6,1,1,105530,94470
3:2:6,1,1,105529,94471
4:3:5,0,-1,105530,94470
3:5:3,0,-1,105531,94469
6:3:5,0,-1,105532,94468
3:5:2,1,1,105531,94469
4:3:3,0,-1,105532,94468
3:2:4,1,1,105531,94469
3:6:2,1,1,105530,94470
4:4:3,0,-1,105531,94469
6:2:4,1,1,105530,94470
4:1:4,0,-1,105531,94469
3:6:2,1,1,105530,94470
1:5:5,0,-1,105531,94469
3:1:6,0,-1,105532,94468
5:3:4,0,-1,105533,94467
6:6:2,1,1,105532,94468
6:1:1,0,-1,105533,94467
1:2:3,1,1,105532,94468
6:6:1,0,-1,105533,94467
3:3:1,0,-1,105534,94466
5:5:2,1,1,105533,94467
2:1:3,1,1,105532,94468
1:6:6,0,-1,105533,94467
3:3:3,0,-1,105534,94466
1:3:4,0,-1,105535,94465
2:4:3,1,1,105534,94466
6:1:4,0,-1,105535,94465
4:1:2,1,1,105534,94466
2:5:2,2,2,105532,94468
6:2:6,1,1,105531,94469
3:5:5,0,-1,105532,94468
1:6:3,0,-1,105533,94467
2:3:5,1,1,105532,94468
5:5:2,1,1,105531,94469
2:2:2,3,3,105528,94472
4:5:5,0,-1,105529,94471
1:1:3,0,-1,105530,94470
6:1:3,0,-1,105531,94469
3:4:1,0,-1,105532,94468
3:4:5,0,-1,105533,94467
4:1:4,0,-1,105534,94466
1:2:1,1,1,105533,94467
2:2:5,2,2,105531,94469
4:6:2,1,1,105530,94470
5:5:3,0,-1,105531,94469
4:3:5,0,-1,105532,94468
3:6:3,0,-1,105533,94467
5:4:6,0,-1,105534,94466
5:4:3,0,-1,105535,94465
2:3:4,1,1,105534,94466
5:4:1,0,-1,105535,94465
6:4:5,0,-1,105536,94464
6:6:2,1,1,105535,94465
5:1:3,0,-1,105536,94464
3:3:5,0,-1,105537,94463
1:4:1,0,-1,105538,94462
1:4:2,1,1,105537,94463
5:4:4,0,-1,105538,94462
5:6:6,0,-1,105539,94461
6:2:5,1,1,105538,94462
2:5:2,2,2,105536,94464
6:1:1,0,-1,105537,94463
4:5:1,0,-1,105538,94462
6:1:5,0,-1,105539,94461
1:2:2,2,2,105537,94463
3:4:2,1,1,105536,94464
2:3:2,2,2,105534,94466
1:2:1,1,1,105533,94467
2:5:2,2,2,105531,94469
1:2:2,2,2,105529,94471
3:4:3,0,-1,105530,94470
4:4:5,0,-1,105531,94469
1:5:6,0,-1,105532,94468
2:5:6,1,1,105531,94469
1:3:6,0,-1,105532,94468
5:2:5,1,1,105531,94469
3:6:5,0,-1,105532,94468
5:3:6,0,-1,105533,94467
4:6:2,1,1,105532,94468
2:6:2,2,2,105530,94470
2:2:1,2,2,105528,94472
3:2:1,1,1,105527,94473
2:5:4,1,1,105526,94474
2:4:6,1,1,105525,94475
2:3:3,1,1,105524,94476
1:2:2,2,2,105522,94478
3:1:5,0,-1,105523,94477
2:6:1,1,1,105522,94478
5:4:3,0,-1,105523,94477
3:6:2,1,1,105522,94478
1:3:2,1,1,105521,94479
1:4:5,0,-1,105522,94478
5:1:4,0,-1,105523,94477
6:5:3,0,-1,105524,94476
1:4:1,0,-1,105525,94475
2:4:1,1,1,105524,94476
5:4:4,0,-1,105525,94475
6:2:5,1,1,105524,94476
2:1:2,2,2,105522,94478
4:5:5,0,-1,105523,94477
4:5:5,0,-1,105524,94476
6:5:1,0,-1,105525,94475
6:2:6,1,1,105524,94476
1:1:4,0,-1,105525,94475
4:5:2,1,1,105524,94476
4:6:1,0,-1,105525,94475
5:5:2,1,1,105524,94476
1:1:4,0,-1,105525,94475
4:3:3,0,-1,105526,94474
6:4:4,0,-1,105527,94473
6:2:4,1,1,105526,94474
5:6:4,0,-1,105527,94473
1:2:6,1,1,105526,94474
1:6:6,0,-1,105527,94473
1:5:1,0,-1,105528,94472
1:2:4,1,1,105527,94473
5:5:3,0,-1,105528,94472
3:3:4,0,-1,105529,94471
2:4:1,1,1,105528,94472
2:1:4,1,1,105527,94473
5:1:4,0,-1,105528,94472
4:6:5,0,-1,105529,94471
1:2:5,1,1,105528,94472
6:5:4,0,-1,105529,94471
6:2:6,1,1,105528,94472
3:6:6,0,-1,105529,94471
2:2:3,2,2,105527,94473
1:3:5,0,-1,105528,94472
6:3:6,0,-1,105529,94471
5:1:6,0,-1,105530,94470
1:1:5,0,-1,105531,94469
1:3:2,1,1,105530,94470
6:1:1,0,-1,105531,94469
1:3:6,0,-1,105532,94468
5:3:3,0,-1,105533,94467
6:4:5,0,-1,105534,94466
3:3:4,0,-1,105535,94465
4:6:3,0,-1,105536,94464
2:1:6,1,1,105535,94465
2:4:3,1,1,105534,94466
4:1:2,1,1,105533,94467
5:3:2,1,1,105532,94468
1:2:5,1,1,105531,94469
4:1:6,0,-1,105532,94468
1:1:3,0,-1,105533,94467
3:1:6,0,-1,105534,94466
4:1:3,0,-1,105535,94465
2:4:4,1,1,105534,94466
6:6:3,0,-1,105535,94465
5:4:1,0,-1,105536,94464
4:4:3,0,-1,105537,94463
2:4:6,1,1,105536,94464
6:2:3,1,1,105535,94465
5:5:6,0,-1,105536,94464
5:2:1,1,1,105535,94465
6:6:4,0,-1,105536,94464
4:6:2,1,1,105535,94465
1:3:3,0,-1,105536,94464
2:3:5,1,1,105535,94465
5:1:6,0,-1,105536,94464
6:5:4,0,-1,105537,94463
1:1:4,0,-1,105538,94462
2:1:1,1,1,105537,94463
6:1:1,0,-1,105538,94462
4:1:3,0,-1,105539,94461
5:2:4,1,1,105538,94462
4:1:6,0,-1,105539,94461
3:2:3,1,1,105538,94462
4:4:1,0,-1,105539,94461
4:2:2,2,2,105537,94463
2:1:1,1,1,105536,94464
3:4:4,0,-1,105537,94463
2:6:5,1,1,105536,94464
5:2:6,1,1,105535,94465
2:6:1,1,1,105534,94466
6:1:2,1,1,105533,94467
2:5:1,1,1,105532,94468
5:2:5,1,1,105531,94469
2:3:6,1,1,105530,94470
1:4:1,0,-1,105531,94469
2:5:6,1,1,105530,94470
6:2:3,1,1,105529,94471
5:2:2,2,2,105527,94473
3:3:5,0,-1,105528,94472
5:3:4,0,-1,105529,94471
1:2:6,1,1,105528,94472
1:2:2,2,2,105526,94474
5:1:5,0,-1,105527,94473
1:6:1,0,-1,105528,94472
1:3:1,0,-1,105529,94471
4:3:1,0,-1,105530,94470
3:5:1,0,-1,105531,94469
1:6:2,1,1,105530,94470
2:6:3,1,1,105529,94471
1:4:6,0,-1,105530,94470
4:1:1,0,-1,105531,94469
3:6:5,0,-1,105532,94468
6:2:6,1,1,105531,94469
5:1:3,0,-1,105532,94468
2:4:6,1,1,105531,94469
2:4:4,1,1,105530,94470
3:5:6,0,-1,105531,94469
2:2:2,3,3,105528,94472
5:1:2,1,1,105527,94473
2:1:6,1,1,105526,94474
3:6:3,0,-1,105527,94473
1:4:5,0,-1,105528,94472
4:4:6,0,-1,105529,94471
4:2:3,1,1,105528,94472
5:5:4,0,-1,105529,94471
5:5:5,0,-1,105530,94470
6:3:4,0,-1,105531,94469
2:1:5,1,1,105530,94470
6:5:6,0,-1,105531,94469
5:5:6,0,-1,105532,94468
1:2:6,1,1,105531,94469
5:1:4,0,-1,105532,94468
3:3:4,0,-1,105533,94467
5:1:3,0,-1,105534,94466
5:5:5,0,-1,105535,94465
3:5:6,0,-1,105536,94464
5:5:1,0,-1,105537,94463
3:3:4,0,-1,105538,94462
1:5:2,1,1,105537,94463
2:1:3,1,1,105536,94464
3:5:3,0,-1,105537,94463
6:2:3,1,1,105536,94464
5:3:2,1,1,105535,94465
1:2:6,1,1,105534,94466
6:3:3,0,-1,105535,94465
4:6:6,0,-1,105536,94464
4:5:6,0,-1,105537,94463
6:4:3,0,-1,105538,94462
1:1:4,0,-1,105539,94461
1:6:2,1,1,105538,94462
1:5:2,1,1,105537,94463
4:6:6,0,-1,105538,94462
2:5:5,1,1,105537,94463
4:6:3,0,-1,105538,94462
5:1:5,0,-1,105539,94461
6:6:6,0,-1,105540,94460
6:2:3,1,1,105539,94461
1:4:5,0,-1,105540,94460
1:3:3,0,-1,105541,94459
4:2:4,1,1,105540,94460
3:6:2,1,1,105539,94461
3:6:4,0,-1,105540,94460
2:6:6,1,1,105539,94461
1:3:3,0,-1,105540,94460
1:1:5,0,-1,105541,94459
3:6:5,0,-1,105542,94458
4:6:3,0,-1,105543,94457
1:6:6,0,-1,105544,94456
5:5:4,0,-1,105545,94455
4:3:6,0,-1,105546,94454
1:5:3,0,-1,105547,94453
6:5:1,0,-1,105548,94452
6:5:2,1,1,105547,94453
6:5:1,0,-1,105548,94452
5:6:2,1,1,105547,94453
6:1:4,0,-1,105548,94452
5:4:3,0,-1,105549,94451
4:2:1,1,1,105548,94452
6:4:5,0,-1,105549,94451
2:6:2,2,2,105547,94453
3:6:3,0,-1,105548,94452
6:4:6,0,-1,105549,94451
2:2:1,2,2,105547,94453
5:4:3,0,-1,105548,94452
2:4:2,2,2,105546,94454
2:6:6,1,1,105545,94455
5:3:3,0,-1,105546,94454
3:6:6,0,-1,105547,94453
4:6:4,0,-1,105548,94452
3:2:4,1,1,105547,94453
2:2:4,2,2,105545,94455
6:6:4,0,-1,105546,94454
3:6:6,0,-1,105547,94453
6:6:6,0,-1,105548,94452
1:1:4,0,-1,105549,94451
5:1:2,1,1,105548,94452
3:4:5,0,-1,105549,94451
3:6:5,0,-1,105550,94450
3:1:4,0,-1,105551,94449
6:1:4,0,-1,105552,94448
2:2:4,2,2,105550,94450
1:6:6,0,-1,105551,94449
3:2:3,1,1,105550,94450
2:3:3,1,1,105549,94451
1:2:2,2,2,105547,94453
3:3:3,0,-1,105548,94452
2:1:4,1,1,105547,94453
6:3:4,0,-1,105548,94452
3:5:6,0,-1,105549,94451
3:4:2,1,1,105548,94452
3:4:6,0,-1,105549,94451
6:2:3,1,1,105548,94452
5:6:1,0,-1,105549,94451
5:1:2,1,1,105548,94452
5:4:4,0,-1,105549,94451
2:5:3,1,1,105548,94452
5:2:3,1,1,105547,94453
1:2:4,1,1,105546,94454
2:5:2,2,2,105544,94456
2:5:5,1,1,105543,94457
1:6:6,0,-1,105544,94456
3:6:3,0,-1,105545,94455
4:3:5,0,-1,105546,94454
6:3:2,1,1,105545,94455
3:4:6,0,-1,105546,94454
6:3:2,1,1,105545,94455
4:6:5,0,-1,105546,94454
6:6:2,1,1,105545,94455
2:6:2,2,2,105543,94457
6:6:2,1,1,105542,94458
4:2:5,1,1,105541,94459
4:1:5,0,-1,105542,94458
4:3:5,0,-1,105543,94457
5:6:2,1,1,105542,94458
5:4:1,0,-1,105543,94457
4:1:1,0,-1,105544,94456
2:3:5,1,1,105543,94457
6:1:5,0,-1,105544,94456
1:4:5,0,-1,105545,94455
1:4:2,1,1,105544,94456
2:6:1,1,1,105543,94457
1:5:5,0,-1,105544,94456
5:1:6,0,-1,105545,94455
1:1:5,0,-1,105546,94454
1:1:1,0,-1,105547,94453
3:3:3,0,-1,105548,94452
3:1:6,0,-1,105549,94451
3:6:4,0,-1,105550,94450
5:6:5,0,-1,105551,94449
6:3:2,1,1,105550,94450
5:5:5,0,-1,105551,94449
1:5:4,0,-1,105552,94448
2:6:2,2,2,105550,94450
4:3:6,0,-1,105551,94449
4:3:4,0,-1,105552,94448
2:3:6,1,1,105551,94449
1:4:4,0,-1,105552,94448
2:4:3,1,1,105551,94449
2:6:6,1,1,105550,94450
3:4:2,1,1,105549,94451
2:1:2,2,2,105547,94453
6:6:1,0,-1,105548,94452
4:5:5,0,-1,105549,94451
4:5:4,0,-1,105550,94450
4:2:5,1,1,105549,94451
2:5:4,1,1,105548,94452
2:3:6,1,1,105547,94453
2:1:6,1,1,105546,94454
6:6:3,0,-1,105547,94453
6:4:1,0,-1,105548,94452
6:6:3,0,-1,105549,94451
4:1:4,0,-1,105550,94450
6:5:5,0,-1,105551,94449
6:6:5,0,-1,105552,94448
4:6:6,0,-1,105553,94447
3:2:1,1,1,105552,94448
6:2:5,1,1,105551,94449
4:3:3,0,-1,105552,94448
1:3:5,0,-1,105553,94447
6:2:3,1,1,105552,94448
3:5:2,1,1,105551,94449
3:1:1,0,-1,105552,94448
1:1:5,0,-1,105553,94447
3:6:5,0,-1,105554,94446
4:3:3,0,-1,105555,94445
2:6:6,1,1,105554,94446
4:5:1,0,-1,105555,94445
3:3:5,0,-1,105556,94444
4:1:1,0,-1,105557,94443
3:2:6,1,1,105556,94444
4:4:3,0,-1,105557,94443
6:2:2,2,2,105555,94445
5:2:3,1,1,105554,94446
5:2:1,1,1,105553,94447
4:2:4,1,1,105552,94448
1:2:6,1,1,105551,94449
1:4:5,0,-1,105552,94448
1:5:5,0,-1,105553,94447
3:1:4,0,-1,105554,94446
4:2:4,1,1,105553,94447
5:6:6,0,-1,105554,94446
2:2:1,2,2,105552,94448
4:2:4,1,1,105551,94449
5:2:2,2,2,105549,94451
4:2:4,1,1,105548,94452
5:1:4,0,-1,105549,94451
3:2:4,1,1,105548,94452
5:5:1,0,-1,105549,94451
3:5:1,0,-1,105550,94450
6:4:3,0,-1,105551,94449
6:6:4,0,-1,105552,94448
5:2:5,1,1,105551,94449
6:2:2,2,2,105549,94451
2:4:5,1,1,105548,94452
3:1:3,0,-1,105549,94451
3:2:2,2,2,105547,94453
4:1:3,0,-1,105548,94452
5:4:1,0,-1,105549,94451
1:2:2,2,2,105547,94453
4:2:3,1,1,105546,94454
2:6:4,1,1,105545,94455
3:3:3,0,-1,105546,94454
1:2:1,1,1,105545,94455
5:5:3,0,-1,105546,94454
5:4:6,0,-1,105547,94453
2:6:1,1,1,105546,94454
6:5:4,0,-1,105547,94453
4:3:6,0,-1,105548,94452
4:5:6,0,-1,105549,94451
2:5:3,1,1,105548,94452
4:4:5,0,-1,105549,94451
3:5:5,0,-1,105550,94450
6:3:5,0,-1,105551,94449
4:1:6,0,-1,105552,94448
2:4:1,1,1,105551,94449
1:3:6,0,-1,105552,94448
1:3:5,0,-1,105553,94447
4:6:4,0,-1,105554,94446
5:4:3,0,-1,105555,94445
5:4:1,0,-1,105556,94444
2:2:3,2,2,105554,94446
3:3:6,0,-1,105555,94445
4:4:3,0,-1,105556,94444
6:5:3,0,-1,105557,94443
2:4:3,1,1,105556,94444
2:6:3,1,1,105555,94445
1:5:6,0,-1,105556,94444
3:5:1,0,-1,105557,94443
1:5:5,0,-1,105558,94442
3:4:3,0,-1,105559,94441
2:3:6,1,1,105558,94442
6:2:4,1,1,105557,94443
1:2:3,1,1,105556,94444
4:5:4,0,-1,105557,94443
4:5:2,1,1,105556,94444
1:4:1,0,-1,105557,94443
6:5:1,0,-1,105558,94442
6:4:1,0,-1,105559,94441
3:5:4,0,-1,105560,94440
2:2:6,2,2,105558,94442
3:3:6,0,-1,105559,94441
4:3:2,1,1,105558,94442
5:4:3,0,-1,105559,94441
5:2:3,1,1,105558,94442
5:2:3,1,1,105557,94443
5:3:6,0,-1,105558,94442
4:2:6,1,1,105557,94443
3:5:3,0,-1,105558,94442
1:6:1,0,-1,105559,94441
4:6:3,0,-1,105560,94440
5:2:4,1,1,105559,94441
3:1:2,1,1,105558,94442
5:3:2,1,1,105557,94443
1:6:4,0,-1,105558,94442
5:4:6,0,-1,105559,94441
3:6:5,0,-1,105560,94440
6:2:5,1,1,105559,94441
3:2:3,1,1,105558,94442
5:5:6,0,-1,105559,94441
5:1:6,0,-1,105560,94440
3:6:2,1,1,105559,94441
6:3:4,0,-1,105560,94440
6:6:5,0,-1,105561,94439
6:6:4,0,-1,105562,94438
1:1:1,0,-1,105563,94437
3:4:1,0,-1,105564,94436
1:2:5,1,1,105563,94437
1:5:1,0,-1,105564,94436
6:3:3,0,-1,105565,94435
6:2:6,1,1,105564,94436
3:4:3,0,-1,105565,94435
6:1:6,0,-1,105566,94434
5:6:3,0,-1,105567,94433
6:2:3,1,1,105566,94434
2:3:5,1,1,105565,94435
6:1:6,0,-1,105566,94434
6:1:3,0,-1,105567,94433
3:5:5,0,-1,105568,94432
4:5:3,0,-1,105569,94431
5:1:1,0,-1,105570,94430
5:4:6,0,-1,105571,94429
1:1:2,1,1,105570,94430
5:2:3,1,1,105569,94431
4:3:5,0,-1,105570,94430
4:5:5,0,-1,105571,94429
5:4:4,0,-1,105572,94428
5:5:5,0,-1,105573,94427
1:6:6,0,-1,105574,94426
5:3:4,0,-1,105575,94425
6:4:6,0,-1,105576,94424
3:1:6,0,-1,105577,94423
1:4:3,0,-1,105578,94422
2:2:3,2,2,105576,94424
6:1:4,0,-1,105577,94423
2:2:6,2,2,105575,94425
2:1:6,1,1,105574,94426
4:4:3,0,-1,105575,94425
2:6:5,1,1,105574,94426
1:6:2,1,1,105573,94427
6:5:1,0,-1,105574,94426
1:6:4,0,-1,105575,94425
4:1:6,0,-1,105576,94424
2:5:2,2,2,105574,94426
1:5:2,1,1,105573,94427
5:2:5,1,1,105572,94428
2:2:6,2,2,105570,94430
4:6:5,0,-1,105571,94429
4:6:4,0,-1,105572,94428
4:3:1,0,-1,105573,94427
5:6:4,0,-1,105574,94426
1:6:5,0,-1,105575,94425
3:3:3,0,-1,105576,94424
3:5:1,0,-1,105577,94423
4:1:4,0,-1,105578,94422
1:1:2,1,1,105577,94423
2:1:4,1,1,105576,94424
1:5:5,0,-1,105577,94423
4:3:3,0,-1,105578,94422
1:1:4,0,-1,105579,94421
2:3:3,1,1,105578,94422
3:6:5,0,-1,105579,94421
2:1:5,1,1,105578,94422
5:1:4,0,-1,105579,94421
2:5:5,1,1,105578,94422
5:2:4,1,1,105577,94423
2:6:1,1,1,105576,94424
5:3:5,0,-1,105577,94423
5:5:1,0,-1,105578,94422
2:6:1,1,1,105577,94423
1:4:6,0,-1,105578,94422
4:1:1,0,-1,105579,94421
4:3:2,1,1,105578,94422
5:2:1,1,1,105577,94423
4:4:2,1,1,105576,94424
2:6:3,1,1,105575,94425
1:2:6,1,1,105574,94426
2:4:2,2,2,105572,94428
2:3:1,1,1,105571,94429
2:4:3,1,1,105570,94430
2:6:2,2,2,105568,94432
3:6:1,0,-1,105569,94431
3:6:5,0,-1,105570,94430
3:4:1,0,-1,105571,94429
1:3:4,0,-1,105572,94428
3:6:3,0,-1,105573,94427
4:2:1,1,1,105572,94428
4:1:5,0,-1,105573,94427
2:2:3,2,2,105571,94429
2:1:1,1,1,105570,94430
5:1:1,0,-1,105571,94429
2:6:5,1,1,105570,94430
5:4:2,1,1,105569,94431
2:5:2,2,2,105567,94433
4:3:1,0,-1,105568,94432
2:2:3,2,2,105566,94434
4:1:4,0,-1,105567,94433
5:2:5,1,1,105566,94434
4:1:6,0,-1,105567,94433
3:1:5,0,-1,105568,94432
6:5:1,0,-1,105569,94431
4:3:3,0,-1,105570,94430
4:5:6,0,-1,105571,94429
4:3:6,0,-1,105572,94428
4:3:2,1,1,105571,94429
3:5:3,0,-1,105572,94428
1:2:2,2,2,105570,94430
4:1:1,0,-1,105571,94429
2:3:1,1,1,105570,94430
3:4:4,0,-1,105571,94429
5:5:4,0,-1,105572,94428
5:1:4,0,-1,105573,94427
4:6:2,1,1,105572,94428
2:2:4,2,2,105570,94430
2:5:1,1,1,105569,94431
4:3:6,0,-1,105570,94430
5:5:4,0,-1,105571,94429
2:6:6,1,1,105570,94430
1:4:1,0,-1,105571,94429
3:6:1,0,-1,105572,94428
4:3:2,1,1,105571,94429
4:4:5,0,-1,105572,94428
6:6:4,0,-1,105573,94427
5:4:2,1,1,105572,94428
6:5:4,0,-1,105573,94427
1:5:2,1,1,105572,94428
5:1:5,0,-1,105573,94427
6:2:6,1,1,105572,94428
4:1:1,0,-1,105573,94427
1:4:3,0,-1,105574,94426
3:4:6,0,-1,105575,94425
6:2:2,2,2,105573,94427
1:5:2,1,1,105572,94428
1:3:1,0,-1,105573,94427
5:5:5,0,-1,105574,94426
3:5:6,0,-1,105575,94425
1:5:1,0,-1,105576,94424
2:4:2,2,2,105574,94426
5:3:6,0,-1,105575,94425
2:3:6,1,1,105574,94426
3:3:5,0,-1,105575,94425
4:5:6,0,-1,105576,94424
5:5:5,0,-1,105577,94423
1:2:2,2,2,105575,94425
6:2:3,1,1,105574,94426
1:6:1,0,-1,105575,94425
6:5:5,0,-1,105576,94424
2:1:2,2,2,105574,94426
5:4:4,0,-1,105575,94425
6:4:2,1,1,105574,94426
4:2:4,1,1,105573,94427
1:6:1,0,-1,105574,94426
3:2:6,1,1,105573,94427
4:5:2,1,1,105572,94428
4:1:4,0,-1,105573,94427
1:5:4,0,-1,105574,94426
3:6:2,1,1,105573,94427
2:4:4,1,1,105572,94428
4:5:3,0,-1,105573,94427
5:6:2,1,1,105572,94428
5:3:3,0,-1,105573,94427
1:1:1,0,-1,105574,94426
2:3:1,1,1,105573,94427
4:4:1,0,-1,105574,94426
5:6:3,0,-1,105575,94425
2:4:6,1,1,105574,94426
1:1:5,0,-1,105575,94425
6:3:3,0,-1,105576,94424
4:2:3,1,1,105575,94425
6:1:5,0,-1,105576,94424
5:6:3,0,-1,105577,94423
3:4:6,0,-1,105578,94422
3:5:3,0,-1,105579,94421
1:2:2,2,2,105577,94423
1:6:5,0,-1,105578,94422
2:3:6,1,1,105577,94423
1:5:4,0,-1,105578,94422
5:5:3,0,-1,105579,94421
1:3:3,0,-1,105580,94420
4:6:1,0,-1,105581,94419
3:2:4,1,1,105580,94420
4:4:6,0,-1,105581,94419
5:2:3,1,1,105580,94420
1:2:6,1,1,105579,94421
2:4:2,2,2,105577,94423
3:4:6,0,-1,105578,94422
1:4:6,0,-1,105579,94421
3:4:6,0,-1,105580,94420
4:5:2,1,1,105579,94421
5:4:5,0,-1,105580,94420
3:6:2,1,1,105579,94421
3:2:1,1,1,105578,94422
4:3:4,0,-1,105579,94421
3:2:4,1,1,105578,94422
5:1:4,0,-1,105579,94421
5:6:6,0,-1,105580,94420
5:1:4,0,-1,105581,94419
1:2:5,1,1,105580,94420
4:5:1,0,-1,105581,94419
5:6:4,0,-1,105582,94418
6:6:4,0,-1,105583,94417
4:5:2,1,1,105582,94418
4:5:2,1,1,105581,94419
4:1:4,0,-1,105582,94418
4:6:1,0,-1,105583,94417
4:1:4,0,-1,105584,94416
2:4:6,1,1,105583,94417
5:1:5,0,-1,105584,94416
5:2:1,1,1,105583,94417
5:6:5,0,-1,105584,94416
3:5:4,0,-1,105585,94415
4:2:6,1,1,105584,94416
1:5:5,0,-1,105585,94415
2:6:5,1,1,105584,94416
6:5:5,0,-1,105585,94415
3:1:6,0,-1,105586,94414
5:5:4,0,-1,105587,94413
3:2:2,2,2,105585,94415
1:3:4,0,-1,105586,94414
2:3:1,1,1,105585,94415
5:5:1,0,-1,105586,94414
3:3:6,0,-1,105587,94413
6:4:4,0,-1,105588,94412
2:2:2,3,3,105585,94415
5:5:3,0,-1,105586,94414
2:2:5,2,2,105584,94416
6:5:5,0,-1,105585,94415
3:4:1,0,-1,105586,94414
3:3:1,0,-1,105587,94413
2:1:4,1,1,105586,94414
2:3:2,2,2,105584,94416
2:5:5,1,1,105583,94417
6:6:4,0,-1,105584,94416
5:4:6,0,-1,105585,94415
4:5:3,0,-1,105586,94414
5:5:2,1,1,105585,94415
3:3:2,1,1,105584,94416
3:3:2,1,1,105583,94417
3:3:3,0,-1,105584,94416
3:5:5,0,-1,105585,94415
4:2:4,1,1,105584,94416
2:5:6,1,1,105583,94417
6:3:2,1,1,105582,94418
6:6:3,0,-1,105583,94417
3:1:3,0,-1,105584,94416
4:1:1,0,-1,105585,94415
3:4:1,0,-1,105586,94414
2:2:1,2,2,105584,94416
5:2:2,2,2,105582,94418
2:4:3,1,1,105581,94419
3:4:5,0,-1,105582,94418
5:3:5,0,-1,105583,94417
6:5:3,0,-1,105584,94416
1:6:3,0,-1,105585,94415
4:5:4,0,-1,105586,94414
1:6:6,0,-1,105587,94413
3:5:3,0,-1,105588,94412
6:4:4,0,-1,105589,94411
1:4:1,0,-1,105590,94410
5:1:5,0,-1,105591,94409
1:5:6,0,-1,105592,94408
6:3:6,0,-1,105593,94407
3:5:6,0,-1,105594,94406
2:4:3,1,1,105593,94407
6:2:3,1,1,105592,94408
2:3:1,1,1,105591,94409
3:4:1,0,-1,105592,94408
6:1:6,0,-1,105593,94407
2:6:2,2,2,105591,94409
4:2:5,1,1,105590,94410
4:6:3,0,-1,105591,94409
3:2:4,1,1,105590,94410
5:6:5,0,-1,105591,94409
1:4:2,1,1,105590,94410
6:5:5,0,-1,105591,94409
6:5:5,0,-1,105592,94408
3:6:5,0,-1,105593,94407
1:5:5,0,-1,105594,94406
6:2:3,1,1,105593,94407
2:2:5,2,2,105591,94409
6:1:2,1,1,105590,94410
1:6:3,0,-1,105591,94409
6:5:4,0,-1,105592,94408
2:5:3,1,1,105591,94409
1:6:4,0,-1,105592,94408
5:6:5,0,-1,105593,94407
3:5:2,1,1,105592,94408
4:5:2,1,1,105591,94409
3:4:2,1,1,105590,94410
4:3:5,0,-1,105591,94409
3:1:4,0,-1,105592,94408
2:1:5,1,1,105591,94409
2:6:2,2,2,105589,94411
3:5:4,0,-1,105590,94410
5:2:3,1,1,105589,94411
3:5:2,1,1,105588,94412
1:5:3,0,-1,105589,94411
2:6:2,2,2,105587,94413
5:1:5,0,-1,105588,94412
3:1:4,0,-1,105589,94411
5:3:1,0,-1,105590,94410
1:1:6,0,-1,105591,94409
5:5:2,1,1,105590,94410
3:5:4,0,-1,105591,94409
1:3:4,0,-1,105592,94408
6:5:6,0,-1,105593,94407
3:3:1,0,-1,105594,94406
1:2:3,1,1,105593,94407
6:1:3,0,-1,105594,94406
3:6:6,0,-1,105595,94405
6:3:5,0,-1,105596,94404
6:6:6,0,-1,105597,94403
4:2:3,1,1,105596,94404
4:4:2,1,1,105595,94405
2:2:5,2,2,105593,94407
2:4:3,1,1,105592,94408
5:3:5,0,-1,105593,94407
1:6:5,0,-1,105594,94406
5:1:3,0,-1,105595,94405
5:1:3,0,-1,105596,94404
1:2:3,1,1,105595,94405
3:6:3,0,-1,105596,94404
1:4:3,0,-1,105597,94403
3:4:6,0,-1,105598,94402
6:4:6,0,-1,105599,94401
2:1:2,2,2,105597,94403
2:6:4,1,1,105596,94404
2:3:3,1,1,105595,94405
2:3:3,1,1,105594,94406
2:3:4,1,1,105593,94407
1:1:2,1,1,105592,94408
3:6:4,0,-1,105593,94407
5:3:1,0,-1,105594,94406
6:6:6,0,-1,105595,94405
6:1:4,0,-1,105596,94404
5:5:6,0,-1,105597,94403
2:2:4,2,2,105595,94405
5:6:4,0,-1,105596,94404
6:4:2,1,1,105595,94405
6:5:6,0,-1,105596,94404
5:1:3,0,-1,105597,94403
4:5:5,0,-1,105598,94402
3:1:5,0,-1,105599,94401
5:1:2,1,1,105598,94402
3:2:4,1,1,105597,94403
1:5:3,0,-1,105598,94402
4:3:3,0,-1,105599,94401
5:2:6,1,1,105598,94402
3:4:2,1,1,105597,94403
1:2:1,1,1,105596,94404
2:4:6,1,1,105595,94405
4:4:2,1,1,105594,94406
6:4:6,0,-1,105595,94405
2:4:6,1,1,105594,94406
4:1:4,0,-1,105595,94405
1:3:4,0,-1,105596,94404
1:2:1,1,1,105595,94405
1:1:5,0,-1,105596,94404
6:6:5,0,-1,105597,94403
2:6:2,2,2,105595,94405
1:2:1,1,1,105594,94406
2:2:4,2,2,105592,94408
2:6:3,1,1,105591,94409
1:3:2,1,1,105590,94410
6:3:1,0,-1,105591,94409
2:3:3,1,1,105590,94410
3:6:2,1,1,105589,94411
5:4:4,0,-1,105590,94410
6:4:3,0,-1,105591,94409
5:5:4,0,-1,105592,94408
3:6:6,0,-1,105593,94407
1:4:6,0,-1,105594,94406
6:1:1,0,-1,105595,94405
5:3:6,0,-1,105596,94404
4:4:3,0,-1,105597,94403
3:6:6,0,-1,105598,94402
6:5:2,1,1,105597,94403
1:6:4,0,-1,105598,94402
5:6:6,0,-1,105599,94401
4:6:1,0,-1,105600,94400
3:1:4,0,-1,105601,94399
1:1:2,1,1,105600,94400
4:5:5,0,-1,105601,94399
6:6:1,0,-1,105602,94398
3:5:3,0,-1,105603,94397
3:5:4,0,-1,105604,94396
2:2:4,2,2,105602,94398
5:3:4,0,-1,105603,94397
4:3:5,0,-1,105604,94396
6:2:2,2,2,105602,94398
2:3:4,1,1,105601,94399
3:5:3,0,-1,105602,94398
1:2:3,1,1,105601,94399
1:1:6,0,-1,105602,94398
5:6:4,0,-1,105603,94397
3:2:4,1,1,105602,94398
4:5:1,0,-1,105603,94397
4:1:6,0,-1,105604,94396
3:4:6,0,-1,105605,94395
3:6:3,0,-1,105606,94394
3:5:1,0,-1,105607,94393
5:3:4,0,-1,105608,94392
4:2:4,1,1,105607,94393
5:2:1,1,1,105606,94394
4:2:2,2,2,105604,94396
6:2:2,2,2,105602,94398
3:4:3,0,-1,105603,94397
4:4:4,0,-1,105604,94396
3:6:6,0,-1,105605,94395
5:2:1,1,1,105604,94396
2:6:2,2,2,105602,94398
3:4:3,0,-1,105603,94397
6:6:3,0,-1,105604,94396
4:5:6,0,-1,105605,94395
5:3:2,1,1,105604,94396
1:3:4,0,-1,105605,94395
3:5:2,1,1,105604,94396
5:5:2,1,1,105603,94397
6:2:2,2,2,105601,94399
6:3:2,1,1,105600,94400
3:5:5,0,-1,105601,94399
4:6:6,0,-1,105602,94398
2:4:5,1,1,105601,94399
1:3:2,1,1,105600,94400
1:3:6,0,-1,105601,94399
5:4:1,0,-1,105602,94398
1:5:2,1,1,105601,94399
4:5:4,0,-1,105602,94398
2:2:1,2,2,105600,94400
4:2:2,2,2,105598,94402
1:5:4,0,-1,105599,94401
2:5:6,1,1,105598,94402
2:3:3,1,1,105597,94403
4:3:5,0,-1,105598,94402
4:1:2,1,1,105597,94403
3:4:3,0,-1,105598,94402
1:6:5,0,-1,105599,94401
4:1:4,0,-1,105600,94400
5:4:1,0,-1,105601,94399
1:6:6,0,-1,105602,94398
4:4:3,0,-1,105603,94397
6:1:2,1,1,105602,94398
6:6:1,0,-1,105603,94397
5:6:3,0,-1,105604,94396
6:3:5,0,-1,105605,94395
6:5:3,0,-1,105606,94394
6:2:2,2,2,105604,94396
5:6:2,1,1,105603,94397
4:5:6,0,-1,105604,94396
2:1:3,1,1,105603,94397
4:4:6,0,-1,105604,94396
5:2:4,1,1,105603,94397
4:3:1,0,-1,105604,94396
1:2:5,1,1,105603,94397
1:2:5,1,1,105602,94398
5:1:6,0,-1,105603,94397
4:2:6,1,1,105602,94398
6:1:6,0,-1,105603,94397
1:2:6,1,1,105602,94398
6:6:6,0,-1,105603,94397
3:4:4,0,-1,105604,94396
6:2:4,1,1,105603,94397
3:5:6,0,-1,105604,94396
3:1:4,0,-1,105605,94395
6:5:2,1,1,105604,94396
6:2:4,1,1,105603,94397
6:3:6,0,-1,105604,94396
4:2:4,1,1,105603,94397
3:1:3,0,-1,105604,94396
2:1:1,1,1,105603,94397
5:2:3,1,1,105602,94398
4:2:1,1,1,105601,94399
1:2:4,1,1,105600,94400
3:2:1,1,1,105599,94401
5:1:6,0,-1,105600,94400
6:3:2,1,1,105599,94401
2:6:3,1,1,105598,94402
6:4:3,0,-1,105599,94401
6:2:2,2,2,105597,94403
6:5:4,0,-1,105598,94402
5:5:4,0,-1,105599,94401
6:3:6,0,-1,105600,94400
2:4:2,2,2,105598,94402
6:5:2,1,1,105597,94403
6:3:3,0,-1,105598,94402
5:6:1,0,-1,105599,94401
6:1:3,0,-1,105600,94400
3:6:5,0,-1,105601,94399
1:6:1,0,-1,105602,94398
5:1:5,0,-1,105603,94397
4:3:4,0,-1,105604,94396
2:4:1,1,1,105603,94397
4:3:2,1,1,105602,94398
1:5:5,0,-1,105603,94397
5:4:2,1,1,105602,94398
6:6:1,0,-1,105603,94397
1:5:4,0,-1,105604,94396
4:1:2,1,1,105603,94397
6:2:3,1,1,105602,94398
1:2:4,1,1,105601,94399
4:1:6,0,-1,105602,94398
3:6:5,0,-1,105603,94397
4:6:5,0,-1,105604,94396
5:6:5,0,-1,105605,94395
5:2:3,1,1,105604,94396
4:2:3,1,1,105603,94397
4:5:5,0,-1,105604,94396
6:4:2,1,1,105603,94397
3:2:2,2,2,105601,94399
6:5:3,0,-1,105602,94398
5:6:5,0,-1,105603,94397
4:2:2,2,2,105601,94399
3:5:3,0,-1,105602,94398
3:5:4,0,-1,105603,94397
6:2:1,1,1,105602,94398
2:4:2,2,2,105600,94400
2:3:4,1,1,105599,94401
3:1:5,0,-1,105600,94400
5:3:4,0,-1,105601,94399
6:3:2,1,1,105600,94400
6:2:6,1,1,105599,94401
1:4:2,1,1,105598,94402
2:2:5,2,2,105596,94404
5:5:3,0,-1,105597,94403
4:5:3,0,-1,105598,94402
2:6:3,1,1,105597,94403
3:5:6,0,-1,105598,94402
4:1:6,0,-1,105599,94401
1:1:5,0,-1,105600,94400
1:3:6,0,-1,105601,94399
2:1:1,1,1,105600,94400
4:1:5,0,-1,105601,94399
2:1:6,1,1,105600,94400
1:1:2,1,1,105599,94401
2:5:3,1,1,105598,94402
4:4:1,0,-1,105599,94401
3:2:5,1,1,105598,94402
2:6:6,1,1,105597,94403
4:3:2,1,1,105596,94404
1:5:2,1,1,105595,94405
3:2:2,2,2,105593,94407
1:4:3,0,-1,105594,94406
5:1:3,0,-1,105595,94405
3:3:5,0,-1,105596,94404
2:6:5,1,1,105595,94405
2:2:4,2,2,105593,94407
5:3:6,0,-1,105594,94406
5:1:2,1,1,105593,94407
3:4:5,0,-1,105594,94406
2:1:3,1,1,105593,94407
1:3:1,0,-1,105594,94406
1:3:4,0,-1,105595,94405
3:5:3,0,-1,105596,94404
5:1:5,0,-1,105597,94403
5:5:6,0,-1,105598,94402
5:2:2,2,2,105596,94404
3:1:1,0,-1,105597,94403
3:5:3,0,-1,105598,94402
3:1:3,0,-1,105599,94401
2:1:6,1,1,105598,94402
2:5:2,2,2,105596,94404
3:5:3,0,-1,105597,94403
6:6:6,0,-1,105598,94402
5:4:5,0,-1,105599,94401
2:2:2,3,3,105596,94404
6:2:5,1,1,105595,94405
3:4:6,0,-1,105596,94404
4:6:5,0,-1,105597,94403
4:1:2,1,1,105596,94404
1:2:4,1,1,105595,94405
2:2:2,3,3,105592,94408
1:6:6,0,-1,105593,94407
1:4:6,0,-1,105594,94406
6:4:3,0,-1,105595,94405
5:2:3,1,1,105594,94406
5:3:3,0,-1,105595,94405
4:4:2,1,1,105594,94406
5:2:6,1,1,105593,94407
6:5:5,0,-1,105594,94406
4:4:5,0,-1,105595,94405
3:3:3,0,-1,105596,94404
3:5:6,0,-1,105597,94403
4:6:4,0,-1,105598,94402
5:5:6,0,-1,105599,94401
1:2:1,1,1,105598,94402
5:2:5,1,1,105597,94403
6:6:1,0,-1,105598,94402
3:4:1,0,-1,105599,94401
3:6:6,0,-1,105600,94400
2:4:4,1,1,105599,94401
3:3:6,0,-1,105600,94400
2:3:2,2,2,105598,94402
1:5:5,0,-1,105599,94401
6:2:6,1,1,105598,94402
3:4:1,0,-1,105599,94401
3:6:6,0,-1,105600,94400
6:4:6,0,-1,105601,94399
3:4:3,0,-1,105602,94398
1:5:6,0,-1,105603,94397
2:4:1,1,1,105602,94398
1:2:1,1,1,105601,94399
6:5:3,0,-1,105602,94398
2:2:6,2,2,105600,94400
2:5:2,2,2,105598,94402
5:4:6,0,-1,105599,94401
3:3:5,0,-1,105600,94400
2:2:3,2,2,105598,94402
2:1:4,1,1,105597,94403
1:6:2,1,1,105596,94404
3:5:5,0,-1,105597,94403
2:1:4,1,1,105596,94404
5:2:2,2,2,105594,94406
3:1:3,0,-1,105595,94405
5:2:5,1,1,105594,94406
3:3:5,0,-1,105595,94405
2:3:5,1,1,105594,94406
6:5:2,1,1,105593,94407
6:5:2,1,1,105592,94408
2:6:1,1,1,105591,94409
6:4:2,1,1,105590,94410
4:1:5,0,-1,105591,94409
6:5:4,0,-1,105592,94408
5:2:4,1,1,105591,94409
5:6:5,0,-1,105592,94408
6:4:1,0,-1,105593,94407
4:1:4,0,-1,105594,94406
1:6:4,0,-1,105595,94405
4:1:1,0,-1,105596,94404
6:3:1,0,-1,105597,94403
4:2:1,1,1,105596,94404
1:2:1,1,1,105595,94405
3:3:2,1,1,105594,94406
1:6:3,0,-1,105595,94405
2:3:5,1,1,105594,94406
5:4:3,0,-1,105595,94405
1:5:3,0,-1,105596,94404
1:6:5,0,-1,105597,94403
2:1:3,1,1,105596,94404
3:6:5,0,-1,105597,94403
3:6:4,0,-1,105598,94402
2:2:1,2,2,105596,94404
6:6:6,0,-1,105597,94403
2:6:1,1,1,105596,94404
1:6:4,0,-1,105597,94403
6:1:6,0,-1,105598,94402
2:1:1,1,1,105597,94403
5:3:4,0,-1,105598,94402
6:5:4,0,-1,105599,94401
2:3:6,1,1,105598,94402
6:3:2,1,1,105597,94403
2:5:1,1,1,105596,94404
1:6:5,0,-1,105597,94403
6:5:1,0,-1,105598,94402
6:6:5,0,-1,105599,94401
5:1:6,0,-1,105600,94400
1:4:6,0,-1,105601,94399
5:6:2,1,1,105600,94400
5:1:5,0,-1,105601,94399
4:5:4,0,-1,105602,94398
6:6:4,0,-1,105603,94397
2:5:5,1,1,105602,94398
5:5:1,0,-1,105603,94397
1:2:5,1,1,105602,94398
5:3:5,0,-1,105603,94397
2:3:4,1,1,105602,94398
5:1:5,0,-1,105603,94397
6:4:4,0,-1,105604,94396
1:4:1,0,-1,105605,94395
3:3:3,0,-1,105606,94394
1:6:3,0,-1,105607,94393
6:3:3,0,-1,105608,94392
1:4:1,0,-1,105609,94391
1:1:5,0,-1,105610,94390
1:2:1,1,1,105609,94391
1:3:5,0,-1,105610,94390
3:1:4,0,-1,105611,94389
6:6:6,0,-1,105612,94388
5:4:3,0,-1,105613,94387
1:6:3,0,-1,105614,94386
2:5:5,1,1,105613,94387
4:3:6,0,-1,105614,94386
5:3:6,0,-1,105615,94385
4:1:4,0,-1,105616,94384
4:1:4,0,-1,105617,94383
1:6:6,0,-1,105618,94382
2:1:4,1,1,105617,94383
1:5:1,0,-1,105618,94382
6:2:5,1,1,105617,94383
2:4:5,1,1,105616,94384
6:6:2,1,1,105615,94385
1:2:5,1,1,105614,94386
3:4:3,0,-1,105615,94385
4:3:2,1,1,105614,94386
6:3:3,0,-1,105615,94385
4:6:4,0,-1,105616,94384
4:1:2,1,1,105615,94385
3:5:1,0,-1,105616,94384
4:2:4,1,1,105615,94385
3:4:1,0,-1,105616,94384
1:2:3,1,1,105615,94385
3:2:1,1,1,105614,94386
2:6:1,1,1,105613,94387
5:1:5,0,-1,105614,94386
1:2:2,2,2,105612,94388
4:3:2,1,1,105611,94389
5:5:1,0,-1,105612,94388
1:6:3,0,-1,105613,94387
6:5:3,0,-1,105614,94386
1:4:6,0,-1,105615,94385
4:2:3,1,1,105614,94386
1:3:4,0,-1,105615,94385
2:3:3,1,1,105614,94386
1:3:5,0,-1,105615,94385
6:1:1,0,-1,105616,94384
3:4:2,1,1,105615,94385
6:4:3,0,-1,105616,94384
6:2:5,1,1,105615,94385
4:1:5,0,-1,105616,94384
1:3:5,0,-1,105617,94383
3:5:6,0,-1,105618,94382
1:3:4,0,-1,105619,94381
2:4:4,1,1,105618,94382
4:1:4,0,-1,105619,94381
2:2:3,2,2,105617,94383
4:1:2,1,1,105616,94384
1:4:3,0,-1,105617,94383
1:6:2,1,1,105616,94384
5:3:3,0,-1,105617,94383
6:5:5,0,-1,105618,94382
3:2:6,1,1,105617,94383
3:3:6,0,-1,105618,94382
5:3:1,0,-1,105619,94381
4:3:1,0,-1,105620,94380
3:2:4,1,1,105619,94381
6:5:2,1,1,105618,94382
3:5:4,0,-1,105619,94381
2:2:1,2,2,105617,94383
5:2:3,1,1,105616,94384
2:4:3,1,1,105615,94385
5:6:4,0,-1,105616,94384
2:1:5,1,1,105615,94385
5:4:2,1,1,105614,94386
1:6:2,1,1,105613,94387
5:2:1,1,1,105612,94388
4:6:4,0,-1,105613,94387
2:3:3,1,1,105612,94388
6:1:2,1,1,105611,94389
5:4:2,1,1,105610,94390
2:1:6,1,1,105609,94391
4:1:6,0,-1,105610,94390
5:3:4,0,-1,105611,94389
4:4:6,0,-1,105612,94388
4:5:4,0,-1,105613,94387
6:6:4,0,-1,105614,94386
4:3:2,1,1,105613,94387
1:3:4,0,-1,105614,94386
1:2:5,1,1,105613,94387
6:2:1,1,1,105612,94388
1:2:3,1,1,105611,94389
2:4:1,1,1,105610,94390
3:1:6,0,-1,105611,94389
4:3:5,0,-1,105612,94388
5:4:2,1,1,105611,94389
2:2:5,2,2,105609,94391
2:4:3,1,1,105608,94392
2:6:4,1,1,105607,94393
5:6:2,1,1,105606,94394
5:4:4,0,-1,105607,94393
5:4:3,0,-1,105608,94392
3:5:6,0,-1,105609,94391
2:3:3,1,1,105608,94392
1:1:1,0,-1,105609,94391
6:2:2,2,2,105607,94393
5:3:4,0,-1,105608,94392
4:2:6,1,1,105607,94393
5:2:5,1,1,105606,94394
1:5:6,0,-1,105607,94393
1:3:1,0,-1,105608,94392
2:5:5,1,1,105607,94393
2:1:4,1,1,105606,94394
4:3:4,0,-1,105607,94393
1:4:6,0,-1,105608,94392
4:1:6,0,-1,105609,94391
6:3:4,0,-1,105610,94390
2:1:3,1,1,105609,94391
4:4:1,0,-1,105610,94390
2:3:5,1,1,105609,94391
6:1:1,0,-1,105610,94390
4:4:2,1,1,105609,94391
5:1:2,1,1,105608,94392
6:3:2,1,1,105607,94393
3:6:3,0,-1,105608,94392
6:3:1,0,-1,105609,94391
5:2:5,1,1,105608,94392
1:3:4,0,-1,105609,94391
1:3:1,0,-1,105610,94390
2:3:4,1,1,105609,94391
6:6:2,1,1,105608,94392
2:2:5,2,2,105606,94394
3:1:6,0,-1,105607,94393
6:4:3,0,-1,105608,94392
6:6:6,0,-1,105609,94391
4:4:4,0,-1,105610,94390
1:1:4,0,-1,105611,94389
5:4:5,0,-1,105612,94388
4:1:1,0,-1,105613,94387
6:2:1,1,1,105612,94388
6:5:4,0,-1,105613,94387
2:1:6,1,1,105612,94388
5:3:1,0,-1,105613,94387
1:5:3,0,-1,105614,94386
5:6:2,1,1,105613,94387
4:2:4,1,1,105612,94388
6:3:1,0,-1,105613,94387
3:4:3,0,-1,105614,94386
4:5:6,0,-1,105615,94385
1:5:3,0,-1,105616,94384
1:1:2,1,1,105615,94385
2:3:1,1,1,105614,94386
4:5:3,0,-1,105615,94385
4:6:2,1,1,105614,94386
6:6:5,0,-1,105615,94385
6:1:5,0,-1,105616,94384
4:6:1,0,-1,105617,94383
4:4:6,0,-1,105618,94382
2:5:5,1,1,105617,94383
2:2:1,2,2,105615,94385
4:6:5,0,-1,105616,94384
3:5:1,0,-1,105617,94383
1:3:4,0,-1,105618,94382
5:5:4,0,-1,105619,94381
3:3:2,1,1,105618,94382
3:5:6,0,-1,105619,94381
3:6:5,0,-1,105620,94380
4:6:5,0,-1,105621,94379
6:3:4,0,-1,105622,94378
1:1:4,0,-1,105623,94377
1:4:2,1,1,105622,94378
5:2:4,1,1,105621,94379
5:2:3,1,1,105620,94380
2:2:3,2,2,105618,94382
3:5:1,0,-1,105619,94381
4:1:5,0,-1,105620,94380
5:4:4,0,-1,105621,94379
4:6:1,0,-1,105622,94378
5:6:3,0,-1,105623,94377
6:5:5,0,-1,105624,94376
2:4:6,1,1,105623,94377
6:4:3,0,-1,105624,94376
4:1:1,0,-1,105625,94375
1:5:6,0,-1,105626,94374
1:1:3,0,-1,105627,94373
5:4:5,0,-1,105628,94372
3:5:1,0,-1,105629,94371
3:2:3,1,1,105628,94372
2:6:6,1,1,105627,94373
5:4:6,0,-1,105628,94372
1:1:5,0,-1,105629,94371
6:2:1,1,1,105628,94372
4:3:4,0,-1,105629,94371
1:3:5,0,-1,105630,94370
2:5:5,1,1,105629,94371
6:6:4,0,-1,105630,94370
5:3:4,0,-1,105631,94369
6:2:2,2,2,105629,94371
3:6:4,0,-1,105630,94370
3:1:1,0,-1,105631,94369
3:4:5,0,-1,105632,94368
5:3:5,0,-1,105633,94367
4:4:3,0,-1,105634,94366
1:2:5,1,1,105633,94367
2:4:2,2,2,105631,94369
4:5:6,0,-1,105632,94368
1:3:5,0,-1,105633,94367
1:2:4,1,1,105632,94368
6:4:3,0,-1,105633,94367
4:1:4,0,-1,105634,94366
2:3:4,1,1,105633,94367
6:1:2,1,1,105632,94368
2:6:1,1,1,105631,94369
4:4:6,0,-1,105632,94368
6:1:6,0,-1,105633,94367
2:4:3,1,1,105632,94368
4:1:4,0,-1,105633,94367
1:1:3,0,-1,105634,94366
2:5:2,2,2,105632,94368
4:6:4,0,-1,105633,94367
6:5:4,0,-1,105634,94366
2:1:3,1,1,105633,94367
5:2:3,1,1,105632,94368
2:5:4,1,1,105631,94369
1:3:5,0,-1,105632,94368
3:3:6,0,-1,105633,94367
2:3:3,1,1,105632,94368
1:4:4,0,-1,105633,94367
5:4:5,0,-1,105634,94366
2:4:6,1,1,105633,94367
1:6:3,0,-1,105634,94366
3:5:2,1,1,105633,94367
3:6:1,0,-1,105634,94366
5:4:4,0,-1,105635,94365
3:4:3,0,-1,105636,94364
4:2:4,1,1,105635,94365
1:6:6,0,-1,105636,94364
4:6:4,0,-1,105637,94363
4:6:1,0,-1,105638,94362
4:4:2,1,1,105637,94363
1:5:3,0,-1,105638,94362
3:3:2,1,1,105637,94363
1:6:5,0,-1,105638,94362
5:5:6,0,-1,105639,94361
5:4:2,1,1,105638,94362
2:4:6,1,1,105637,94363
4:4:1,0,-1,105638,94362
4:5:1,0,-1,105639,94361
3:1:2,1,1,105638,94362
3:2:3,1,1,105637,94363
3:1:6,0,-1,105638,94362
4:4:5,0,-1,105639,94361
6:4:3,0,-1,105640,94360
1:1:2,1,1,105639,94361
4:4:4,0,-1,105640,94360
1:1:5,0,-1,105641,94359
1:6:5,0,-1,105642,94358
5:4:6,0,-1,105643,94357
5:3:6,0,-1,105644,94356
2:5:2,2,2,105642,94358
1:1:5,0,-1,105643,94357
2:1:3,1,1,105642,94358
6:6:5,0,-1,105643,94357
5:4:4,0,-1,105644,94356
5:3:1,0,-1,105645,94355
1:1:1,0,-1,105646,94354
5:5:2,1,1,105645,94355
3:6:1,0,-1,105646,94354
1:6:4,0,-1,105647,94353
5:6:5,0,-1,105648,94352
2:2:3,2,2,105646,94354
5:5:6,0,-1,105647,94353
2:5:3,1,1,105646,94354
1:4:2,1,1,105645,94355
2:5:2,2,2,105643,94357
1:3:3,0,-1,105644,94356
5:2:5,1,1,105643,94357
5:2:2,2,2,105641,94359
4:2:4,1,1,105640,94360
2:6:2,2,2,105638,94362
2:2:6,2,2,105636,94364
3:1:3,0,-1,105637,94363
6:4:4,0,-1,105638,94362
1:3:4,0,-1,105639,94361
3:1:1,0,-1,105640,94360
1:1:1,0,-1,105641,94359
2:2:2,3,3,105638,94362
2:6:3,1,1,105637,94363
1:5:5,0,-1,105638,94362
1:4:4,0,-1,105639,94361
6:2:1,1,1,105638,94362
1:4:6,0,-1,105639,94361
5:5:5,0,-1,105640,94360
2:6:4,1,1,105639,94361
3:4:1,0,-1,105640,94360
6:2:6,1,1,105639,94361
3:6:4,0,-1,105640,94360
1:4:2,1,1,105639,94361
4:6:2,1,1,105638,94362
4:5:3,0,-1,105639,94361
3:4:1,0,-1,105640,94360
2:1:6,1,1,105639,94361
4:1:2,1,1,105638,94362
6:1:5,0,-1,105639,94361
3:1:5,0,-1,105640,94360
5:4:1,0,-1,105641,94359
5:4:2,1,1,105640,94360
4:5:1,0,-1,105641,94359
5:6:6,0,-1,105642,94358
4:2:3,1,1,105641,94359
4:2:5,1,1,105640,94360
5:5:4,0,-1,105641,94359
4:5:5,0,-1,105642,94358
4:4:3,0,-1,105643,94357
1:1:4,0,-1,105644,94356
4:2:4,1,1,105643,94357
2:6:6,1,1,105642,94358
6:3:2,1,1,105641,94359
3:3:2,1,1,105640,94360
6:4:1,0,-1,105641,94359
5:2:6,1,1,105640,94360
1:6:6,0,-1,105641,94359
5:5:3,0,-1,105642,94358
4:1:4,0,-1,105643,94357
4:6:2,1,1,105642,94358
5:6:2,1,1,105641,94359
6:1:5,0,-1,105642,94358
2:3:6,1,1,105641,94359
5:4:4,0,-1,105642,94358
1:4:3,0,-1,105643,94357
3:3:3,0,-1,105644,94356
2:5:1,1,1,105643,94357
5:5:5,0,-1,105644,94356
4:6:1,0,-1,105645,94355
3:1:1,0,-1,105646,94354
5:6:2,1,1,105645,94355
5:4:6,0,-1,105646,94354
4:3:3,0,-1,105647,94353
2:5:5,1,1,105646,94354
1:1:2,1,1,105645,94355
1:1:5,0,-1,105646,94354
4:2:3,1,1,105645,94355
1:5:3,0,-1,105646,94354
2:4:1,1,1,105645,94355
5:3:1,0,-1,105646,94354
6:3:3,0,-1,105647,94353
1:4:1,0,-1,105648,94352
2:3:2,2,2,105646,94354
6:2:3,1,1,105645,94355
4:3:6,0,-1,105646,94354
5:5:4,0,-1,105647,94353
4:2:4,1,1,105646,94354
1:4:6,0,-1,105647,94353
4:3:5,0,-1,105648,94352
5:2:4,1,1,105647,94353
1:6:3,0,-1,105648,94352
1:6:5,0,-1,105649,94351
6:2:2,2,2,105647,94353
1:6:4,0,-1,105648,94352
3:1:6,0,-1,105649,94351
3:5:6,0,-1,105650,94350
2:4:2,2,2,105648,94352
5:2:6,1,1,105647,94353
5:5:2,1,1,105646,94354
2:4:1,1,1,105645,94355
1:3:6,0,-1,105646,94354
3:1:3,0,-1,105647,94353
2:1:4,1,1,105646,94354
3:2:6,1,1,105645,94355
3:4:6,0,-1,105646,94354
5:2:1,1,1,105645,94355
2:2:3,2,2,105643,94357
4:6:4,0,-1,105644,94356
4:5:1,0,-1,105645,94355
5:3:3,0,-1,105646,94354
3:1:2,1,1,105645,94355
1:1:1,0,-1,105646,94354
5:2:3,1,1,105645,94355
1:2:4,1,1,105644,94356
4:2:2,2,2,105642,94358
1:2:2,2,2,105640,94360
3:2:6,1,1,105639,94361
1:4:4,0,-1,105640,94360
5:6:4,0,-1,105641,94359
4:6:2,1,1,105640,94360
5:5:6,0,-1,105641,94359
2:5:6,1,1,105640,94360
3:5:5,0,-1,105641,94359
1:4:2,1,1,105640,94360
6:4:6,0,-1,105641,94359
6:6:3,0,-1,105642,94358
5:3:3,0,-1,105643,94357
4:1:6,0,-1,105644,94356
1:5:3,0,-1,105645,94355
1:4:1,0,-1,105646,94354
2:3:6,1,1,105645,94355
3:4:3,0,-1,105646,94354
3:6:3,0,-1,105647,94353
6:1:3,0,-1,105648,94352
6:2:6,1,1,105647,94353
4:5:2,1,1,105646,94354
4:2:3,1,1,105645,94355
3:6:2,1,1,105644,94356
2:4:4,1,1,105643,94357
1:2:3,1,1,105642,94358
5:1:2,1,1,105641,94359
6:3:4,0,-1,105642,94358
1:4:5,0,-1,105643,94357
4:5:1,0,-1,105644,94356
2:5:3,1,1,105643,94357
1:1:4,0,-1,105644,94356
3:1:5,0,-1,105645,94355
4:6:3,0,-1,105646,94354
5:1:6,0,-1,105647,94353
5:1:3,0,-1,105648,94352
4:3:6,0,-1,105649,94351
6:4:6,0,-1,105650,94350
2:2:5,2,2,105648,94352
4:6:6,0,-1,105649,94351
4:4:5,0,-1,105650,94350
4:2:3,1,1,105649,94351
6:6:6,0,-1,105650,94350
5:5:5,0,-1,105651,94349
6:4:5,0,-1,105652,94348
1:3:6,0,-1,105653,94347
3:3:4,0,-1,105654,94346
1:4:4,0,-1,105655,94345
1:3:4,0,-1,105656,94344
6:1:5,0,-1,105657,94343
4:1:1,0,-1,105658,94342
5:6:5,0,-1,105659,94341
1:5:2,1,1,105658,94342
3:2:6,1,1,105657,94343
2:5:4,1,1,105656,94344
5:5:2,1,1,105655,94345
5:5:4,0,-1,105656,94344
4:4:4,0,-1,105657,94343
5:1:6,0,-1,105658,94342
5:1:3,0,-1,105659,94341
6:4:4,0,-1,105660,94340
6:4:6,0,-1,105661,94339
6:4:4,0,-1,105662,94338
1:3:3,0,-1,105663,94337
1:1:1,0,-1,105664,94336
3:5:2,1,1,105663,94337
6:4:4,0,-1,105664,94336
3:4:1,0,-1,105665,94335
6:6:5,0,-1,105666,94334
6:4:2,1,1,105665,94335
6:5:4,0,-1,105666,94334
2:1:4,1,1,105665,94335
2:3:1,1,1,105664,94336
1:1:3,0,-1,105665,94335
5:2:2,2,2,105663,94337
4:3:3,0,-1,105664,94336
1:3:6,0,-1,105665,94335
1:5:1,0,-1,105666,94334
5:5:3,0,-1,105667,94333
1:5:3,0,-1,105668,94332
3:3:6,0,-1,105669,94331
1:3:2,1,1,105668,94332
6:2:3,1,1,105667,94333
2:4:6,1,1,105666,94334
6:6:2,1,1,105665,94335
4:1:4,0,-1,105666,94334
2:3:4,1,1,105665,94335
3:4:5,0,-1,105666,94334
5:1:6,0,-1,105667,94333
4:5:6,0,-1,105668,94332
1:5:3,0,-1,105669,94331
3:2:6,1,1,105668,94332
1:4:2,1,1,105667,94333
2:6:3,1,1,105666,94334
4:5:6,0,-1,105667,94333
2:4:4,1,1,105666,94334
3:4:4,0,-1,105667,94333
2:2:1,2,2,105665,94335
3:4:5,0,-1,105666,94334
6:6:2,1,1,105665,94335
3:2:3,1,1,105664,94336
3:2:3,1,1,105663,94337
4:6:3,0,-1,105664,94336
4:4:6,0,-1,105665,94335
5:4:6,0,-1,105666,94334
2:5:3,1,1,105665,94335
4:6:6,0,-1,105666,94334
4:3:2,1,1,105665,94335
2:1:6,1,1,105664,94336
6:5:2,1,1,105663,94337
1:3:1,0,-1,105664,94336
5:2:5,1,1,105663,94337
2:6:3,1,1,105662,94338
1:2:4,1,1,105661,94339
4:5:4,0,-1,105662,94338
5:2:5,1,1,105661,94339
3:6:6,0,-1,105662,94338
3:3:2,1,1,105661,94339
3:2:2,2,2,105659,94341
6:5:6,0,-1,105660,94340
5:5:4,0,-1,105661,94339
2:2:3,2,2,105659,94341
4:6:6,0,-1,105660,94340
6:5:4,0,-1,105661,94339
6:2:3,1,1,105660,94340
5:5:4,0,-1,105661,94339
6:5:5,0,-1,105662,94338
1:6:3,0,-1,105663,94337
2:6:1,1,1,105662,94338
5:6:2,1,1,105661,94339
4:3:2,1,1,105660,94340
4:2:5,1,1,105659,94341
6:1:4,0,-1,105660,94340
3:6:3,0,-1,105661,94339
5:1:5,0,-1,105662,94338
2:2:2,3,3,105659,94341
2:1:5,1,1,105658,94342
2:5:2,2,2,105656,94344
6:3:2,1,1,105655,94345
4:5:5,0,-1,105656,94344
3:6:5,0,-1,105657,94343
2:1:5,1,1,105656,94344
1:6:3,0,-1,105657,94343
6:4:4,0,-1,105658,94342
4:2:5,1,1,105657,94343
3:2:4,1,1,105656,94344
3:3:1,0,-1,105657,94343
4:4:4,0,-1,105658,94342
2:6:3,1,1,105657,94343
6:1:6,0,-1,105658,94342
4:5:4,0,-1,105659,94341
2:3:4,1,1,105658,94342
1:2:2,2,2,105656,94344
6:6:5,0,-1,105657,94343
4:5:4,0,-1,105658,94342
2:4:6,1,1,105657,94343
2:1:1,1,1,105656,94344
5:2:2,2,2,105654,94346
4:3:1,0,-1,105655,94345
1:4:6,0,-1,105656,94344
3:4:6,0,-1,105657,94343
6:5:6,0,-1,105658,94342
5:6:5,0,-1,105659,94341
6:3:2,1,1,105658,94342
5:4:3,0,-1,105659,94341
1:1:1,0,-1,105660,94340
5:4:6,0,-1,105661,94339
1:2:6,1,1,105660,94340
2:6:5,1,1,105659,94341
4:2:4,1,1,105658,94342
5:5:3,0,-1,105659,94341
6:4:6,0,-1,105660,94340
6:4:2,1,1,105659,94341
1:1:3,0,-1,105660,94340
1:4:5,0,-1,105661,94339
6:4:3,0,-1,105662,94338
5:1:3,0,-1,105663,94337
2:6:6,1,1,105662,94338
6:1:4,0,-1,105663,94337
5:3:3,0,-1,105664,94336
6:3:5,0,-1,105665,94335
1:1:1,0,-1,105666,94334
5:6:5,0,-1,105667,94333
4:2:4,1,1,105666,94334
5:2:3,1,1,105665,94335
5:6:2,1,1,105664,94336
4:4:5,0,-1,105665,94335
5:2:1,1,1,105664,94336
5:1:3,0,-1,105665,94335
2:5:5,1,1,105664,94336
4:3:1,0,-1,105665,94335
4:4:6,0,-1,105666,94334
6:5:5,0,-1,105667,94333
4:3:1,0,-1,105668,94332
3:4:2,1,1,105667,94333
5:3:3,0,-1,105668,94332
3:5:6,0,-1,105669,94331
6:2:2,2,2,105667,94333
6:5:3,0,-1,105668,94332
2:3:4,1,1,105667,94333
6:1:3,0,-1,105668,94332
6:3:5,0,-1,105669,94331
5:1:5,0,-1,105670,94330
3:4:3,0,-1,105671,94329
4:2:2,2,2,105669,94331
3:4:3,0,-1,105670,94330
5:4:2,1,1,105669,94331
3:2:3,1,1,105668,94332
2:1:3,1,1,105667,94333
2:4:4,1,1,105666,94334
5:3:3,0,-1,105667,94333
6:4:6,0,-1,105668,94332
5:2:4,1,1,105667,94333
3:4:3,0,-1,105668,94332
1:1:3,0,-1,105669,94331
6:1:6,0,-1,105670,94330
6:5:1,0,-1,105671,94329
1:3:5,0,-1,105672,94328
1:5:5,0,-1,105673,94327
2:3:4,1,1,105672,94328
4:3:3,0,-1,105673,94327
6:2:5,1,1,105672,94328
4:2:2,2,2,105670,94330
3:4:4,0,-1,105671,94329
5:5:1,0,-1,105672,94328
2:3:2,2,2,105670,94330
6:3:1,0,-1,105671,94329
1:6:3,0,-1,105672,94328
5:3:2,1,1,105671,94329
3:2:6,1,1,105670,94330
5:6:5,0,-1,105671,94329
1:3:5,0,-1,105672,94328
1:6:1,0,-1,105673,94327
5:6:1,0,-1,105674,94326
3:5:5,0,-1,105675,94325
2:3:2,2,2,105673,94327
6:4:3,0,-1,105674,94326
6:2:1,1,1,105673,94327
5:1:1,0,-1,105674,94326
2:6:6,1,1,105673,94327
1:3:6,0,-1,105674,94326
2:2:4,2,2,105672,94328
5:4:1,0,-1,105673,94327
2:1:1,1,1,105672,94328
4:3:4,0,-1,105673,94327
2:3:4,1,1,105672,94328
5:1:6,0,-1,105673,94327
3:6:6,0,-1,105674,94326
1:2:3,1,1,105673,94327
6:2:4,1,1,105672,94328
6:2:1,1,1,105671,94329
6:4:1,0,-1,105672,94328
2:1:3,1,1,105671,94329
4:1:4,0,-1,105672,94328
3:3:5,0,-1,105673,94327
3:1:1,0,-1,105674,94326
2:2:2,3,3,105671,94329
2:4:4,1,1,105670,94330
3:3:6,0,-1,105671,94329
2:1:3,1,1,105670,94330
6:5:5,0,-1,105671,94329
4:6:6,0,-1,105672,94328
4:4:4,0,-1,105673,94327
1:6:5,0,-1,105674,94326
5:1:3,0,-1,105675,94325
1:4:6,0,-1,105676,94324
1:3:6,0,-1,105677,94323
6:1:4,0,-1,105678,94322
3:1:4,0,-1,105679,94321
5:3:5,0,-1,105680,94320
4:1:2,1,1,105679,94321
6:1:3,0,-1,105680,94320
1:4:6,0,-1,105681,94319
5:6:3,0,-1,105682,94318
3:5:6,0,-1,105683,94317
4:5:1,0,-1,105684,94316
1:4:6,0,-1,105685,94315
6:6:4,0,-1,105686,94314
5:1:5,0,-1,105687,94313
6:1:5,0,-1,105688,94312
2:5:2,2,2,105686,94314
4:6:2,1,1,105685,94315
6:1:4,0,-1,105686,94314
1:4:4,0,-1,105687,94313
4:3:6,0,-1,105688,94312
6:4:5,0,-1,105689,94311
1:6:3,0,-1,105690,94310
2:3:1,1,1,105689,94311
3:6:2,1,1,105688,94312
5:3:2,1,1,105687,94313
4:3:1,0,-1,105688,94312
3:3:3,0,-1,105689,94311
4:6:3,0,-1,105690,94310
6:4:4,0,-1,105691,94309
2:5:5,1,1,105690,94310
3:4:5,0,-1,105691,94309
1:5:4,0,-1,105692,94308
1:1:2,1,1,105691,94309
3:3:1,0,-1,105692,94308
1:5:4,0,-1,105693,94307
4:6:6,0,-1,105694,94306
4:3:5,0,-1,105695,94305
6:1:6,0,-1,105696,94304
1:2:4,1,1,105695,94305
5:1:3,0,-1,105696,94304
5:6:4,0,-1,105697,94303
4:5:4,0,-1,105698,94302
3:5:3,0,-1,105699,94301
1:3:5,0,-1,105700,94300
6:2:4,1,1,105699,94301
4:6:5,0,-1,105700,94300
4:1:1,0,-1,105701,94299
4:2:5,1,1,105700,94300
2:3:3,1,1,105699,94301
1:4:4,0,-1,105700,94300
5:3:5,0,-1,105701,94299
4:2:4,1,1,105700,94300
4:6:4,0,-1,105701,94299
3:4:6,0,-1,105702,94298
2:4:2,2,2,105700,94300
4:4:2,1,1,105699,94301
6:5:2,1,1,105698,94302
4:1:1,0,-1,105699,94301
3:4:3,0,-1,105700,94300
1:1:1,0,-1,105701,94299
2:1:6,1,1,105700,94300
4:3:1,0,-1,105701,94299
6:2:2,2,2,105699,94301
6:1:2,1,1,105698,94302
2:3:2,2,2,105696,94304
3:1:6,0,-1,105697,94303
1:6:4,0,-1,105698,94302
3:3:2,1,1,105697,94303
1:1:3,0,-1,105698,94302
4:3:2,1,1,105697,94303
1:5:1,0,-1,105698,94302
3:4:1,0,-1,105699,94301
2:3:1,1,1,105698,94302
1:3:3,0,-1,105699,94301
4:6:6,0,-1,105700,94300
6:6:6,0,-1,105701,94299
3:2:1,1,1,105700,94300
4:3:4,0,-1,105701,94299
6:5:5,0,-1,105702,94298
2:2:4,2,2,105700,94300
3:3:2,1,1,105699,94301
5:5:6,0,-1,105700,94300
1:6:3,0,-1,105701,94299
5:1:2,1,1,105700,94300
6:3:5,0,-1,105701,94299
1:1:5,0,-1,105702,94298
2:2:6,2,2,105700,94300
1:3:2,1,1,105699,94301
2:3:2,2,2,105697,94303
6:5:3,0,-1,105698,94302
3:6:1,0,-1,105699,94301
3:5:4,0,-1,105700,94300
3:3:6,0,-1,105701,94299
4:4:2,1,1,105700,94300
4:2:1,1,1,105699,94301
1:3:5,0,-1,105700,94300
2:3:2,2,2,105698,94302
5:5:6,0,-1,105699,94301
6:6:1,0,-1,105700,94300
1:6:2,1,1,105699,94301
6:4:5,0,-1,105700,94300
4:6:6,0,-1,105701,94299
4:5:6,0,-1,105702,94298
1:2:4,1,1,105701,94299
2:3:4,1,1,105700,94300
4:3:2,1,1,105699,94301
2:6:2,2,2,105697,94303
6:5:1,0,-1,105698,94302
6:4:2,1,1,105697,94303
6:3:5,0,-1,105698,94302
5:6:2,1,1,105697,94303
5:2:2,2,2,105695,94305
2:5:3,1,1,105694,94306
4:3:2,1,1,105693,94307
3:2:1,1,1,105692,94308
3:5:2,1,1,105691,94309
6:5:5,0,-1,105692,94308
3:1:6,0,-1,105693,94307
6:1:1,0,-1,105694,94306
2:1:5,1,1,105693,94307
5:4:1,0,-1,105694,94306
1:6:1,0,-1,105695,94305
6:5:2,1,1,105694,94306
6:1:4,0,-1,105695,94305
3:5:2,1,1,105694,94306
4:3:2,1,1,105693,94307
2:2:2,3,3,105690,94310
5:5:6,0,-1,105691,94309
5:3:3,0,-1,105692,94308
3:5:6,0,-1,105693,94307
5:2:1,1,1,105692,94308
1:2:2,2,2,105690,94310
1:4:5,0,-1,105691,94309
1:3:3,0,-1,105692,94308
6:1:1,0,-1,105693,94307
6:6:4,0,-1,105694,94306
3:2:2,2,2,105692,94308
6:2:5,1,1,105691,94309
4:2:6,1,1,105690,94310
1:1:5,0,-1,105691,94309
3:6:2,1,1,105690,94310
2:6:5,1,1,105689,94311
1:2:1,1,1,105688,94312
1:1:3,0,-1,105689,94311
4:2:2,2,2,105687,94313
6:2:6,1,1,105686,94314
5:6:1,0,-1,105687,94313
3:2:2,2,2,105685,94315
1:5:4,0,-1,105686,94314
4:5:3,0,-1,105687,94313
6:6:3,0,-1,105688,94312
6:4:5,0,-1,105689,94311
3:3:4,0,-1,105690,94310
4:6:2,1,1,105689,94311
5:2:1,1,1,105688,94312
6:5:4,0,-1,105689,94311
5:6:5,0,-1,105690,94310
1:6:5,0,-1,105691,94309
2:3:1,1,1,105690,94310
2:4:4,1,1,105689,94311
2:4:3,1,1,105688,94312
3:6:1,0,-1,105689,94311
5:6:1,0,-1,105690,94310
4:4:5,0,-1,105691,94309
1:1:5,0,-1,105692,94308
1:5:1,0,-1,105693,94307
3:6:1,0,-1,105694,94306
4:5:2,1,1,105693,94307
3:1:4,0,-1,105694,94306
4:2:3,1,1,105693,94307
2:6:4,1,1,105692,94308
6:2:6,1,1,105691,94309
4:4:1,0,-1,105692,94308
3:3:6,0,-1,105693,94307
3:1:1,0,-1,105694,94306
1:5:1,0,-1,105695,94305
4:1:5,0,-1,105696,94304
1:4:5,0,-1,105697,94303
2:1:1,1,1,105696,94304
6:2:2,2,2,105694,94306
5:4:5,0,-1,105695,94305
5:4:5,0,-1,105696,94304
6:3:4,0,-1,105697,94303
3:1:1,0,-1,105698,94302
3:5:6,0,-1,105699,94301
2:5:1,1,1,105698,94302
5:4:2,1,1,105697,94303
1:3:4,0,-1,105698,94302
3:2:5,1,1,105697,94303
1:3:5,0,-1,105698,94302
2:6:5,1,1,105697,94303
3:1:6,0,-1,105698,94302
1:5:4,0,-1,105699,94301
5:6:3,0,-1,105700,94300
6:4:2,1,1,105699,94301
1:4:6,0,-1,105700,94300
3:6:1,0,-1,105701,94299
1:1:6,0,-1,105702,94298
4:2:5,1,1,105701,94299
1:5:2,1,1,105700,94300
1:1:6,0,-1,105701,94299
1:2:6,1,1,105700,94300
3:1:2,1,1,105699,94301
3:5:6,0,-1,105700,94300
3:3:1,0,-1,105701,94299
1:5:3,0,-1,105702,94298
3:6:3,0,-1,105703,94297
4:4:6,0,-1,105704,94296
1:6:6,0,-1,105705,94295
5:3:2,1,1,105704,94296
1:4:1,0,-1,105705,94295
3:3:5,0,-1,105706,94294
2:6:4,1,1,105705,94295
5:6:3,0,-1,105706,94294
4:4:3,0,-1,105707,94293
5:5:4,0,-1,105708,94292
4:4:1,0,-1,105709,94291
3:5:3,0,-1,105710,94290
1:5:1,0,-1,105711,94289
5:5:3,0,-1,105712,94288
2:3:5,1,1,105711,94289
4:1:2,1,1,105710,94290
2:2:1,2,2,105708,94292
3:3:4,0,-1,105709,94291
3:3:3,0,-1,105710,94290
3:3:1,0,-1,105711,94289
3:5:5,0,-1,105712,94288
1:2:6,1,1,105711,94289
4:2:4,1,1,105710,94290
3:1:2,1,1,105709,94291
5:1:2,1,1,105708,94292
3:6:5,0,-1,105709,94291
5:3:3,0,-1,105710,94290
5:3:3,0,-1,105711,94289
4:1:3,0,-1,105712,94288
5:3:5,0,-1,105713,94287
3:4:2,1,1,105712,94288
1:4:3,0,-1,105713,94287
1:6:2,1,1,105712,94288
6:2:6,1,1,105711,94289
5:3:2,1,1,105710,94290
5:4:5,0,-1,105711,94289
3:4:3,0,-1,105712,94288
2:4:3,1,1,105711,94289
2:5:1,1,1,105710,94290
2:1:3,1,1,105709,94291
3:6:4,0,-1,105710,94290
1:5:1,0,-1,105711,94289
6:1:1,0,-1,105712,94288
1:5:6,0,-1,105713,94287
2:3:6,1,1,105712,94288
6:2:1,1,1,105711,94289
1:2:1,1,1,105710,94290
6:4:4,0,-1,105711,94289
4:2:5,1,1,105710,94290
6:6:3,0,-1,105711,94289
2:3:5,1,1,105710,94290
2:2:3,2,2,105708,94292
4:1:5,0,-1,105709,94291
3:3:3,0,-1,105710,94290
3:5:5,0,-1,105711,94289
5:3:1,0,-1,105712,94288
5:2:5,1,1,105711,94289
6:3:3,0,-1,105712,94288
6:2:5,1,1,105711,94289
2:6:5,1,1,105710,94290
3:3:5,0,-1,105711,94289
2:5:5,1,1,105710,94290
4:1:6,0,-1,105711,94289
3:3:1,0,-1,105712,94288
3:3:5,0,-1,105713,94287
3:2:1,1,1,105712,94288
6:6:5,0,-1,105713,94287
3:1:6,0,-1,105714,94286
6:2:2,2,2,105712,94288
2:3:1,1,1,105711,94289
1:4:4,0,-1,105712,94288
5:1:4,0,-1,105713,94287
4:1:1,0,-1,105714,94286
3:2:1,1,1,105713,94287
2:1:2,2,2,105711,94289
5:5:3,0,-1,105712,94288
2:5:4,1,1,105711,94289
4:2:6,1,1,105710,94290
6:4:4,0,-1,105711,94289
1:6:2,1,1,105710,94290
6:2:1,1,1,105709,94291
6:3:3,0,-1,105710,94290
4:1:5,0,-1,105711,94289
3:4:5,0,-1,105712,94288
4:6:4,0,-1,105713,94287
2:4:6,1,1,105712,94288
3:6:4,0,-1,105713,94287
5:1:6,0,-1,105714,94286
4:2:3,1,1,105713,94287
2:1:4,1,1,105712,94288
1:1:1,0,-1,105713,94287
4:4:6,0,-1,105714,94286
4:3:3,0,-1,105715,94285
5:1:1,0,-1,105716,94284
2:5:2,2,2,105714,94286
5:1:3,0,-1,105715,94285
2:1:6,1,1,105714,94286
3:3:2,1,1,105713,94287
4:1:2,1,1,105712,94288
4:3:1,0,-1,105713,94287
3:6:2,1,1,105712,94288
5:4:1,0,-1,105713,94287
1:6:1,0,-1,105714,94286
4:6:5,0,-1,105715,94285
1:6:2,1,1,105714,94286
4:5:3,0,-1,105715,94285
6:1:6,0,-1,105716,94284
4:2:2,2,2,105714,94286
5:5:2,1,1,105713,94287
1:2:5,1,1,105712,94288
3:4:2,1,1,105711,94289
2:5:5,1,1,105710,94290
3:2:3,1,1,105709,94291
5:6:4,0,-1,105710,94290
1:2:6,1,1,105709,94291
4:3:4,0,-1,105710,94290
2:1:4,1,1,105709,94291
4:1:1,0,-1,105710,94290
6:5:3,0,-1,105711,94289
6:5:3,0,-1,105712,94288
2:6:4,1,1,105711,94289
6:5:1,0,-1,105712,94288
4:3:3,0,-1,105713,94287
1:5:1,0,-1,105714,94286
6:4:5,0,-1,105715,94285
3:2:1,1,1,105714,94286
4:3:1,0,-1,105715,94285
5:1:1,0,-1,105716,94284
6:4:4,0,-1,105717,94283
4:5:3,0,-1,105718,94282
3:5:4,0,-1,105719,94281
4:2:2,2,2,105717,94283
3:6:5,0,-1,105718,94282
5:3:2,1,1,105717,94283
1:3:2,1,1,105716,94284
1:5:1,0,-1,105717,94283
2:5:3,1,1,105716,94284
5:1:1,0,-1,105717,94283
6:4:1,0,-1,105718,94282
6:2:4,1,1,105717,94283
2:5:1,1,1,105716,94284
3:1:1,0,-1,105717,94283
2:6:5,1,1,105716,94284
2:2:2,3,3,105713,94287
1:6:3,0,-1,105714,94286
1:6:4,0,-1,105715,94285
2:3:4,1,1,105714,94286
3:6:1,0,-1,105715,94285
6:6:6,0,-1,105716,94284
6:4:5,0,-1,105717,94283
4:1:1,0,-1,105718,94282
1:3:2,1,1,105717,94283
4:3:3,0,-1,105718,94282
5:5:1,0,-1,105719,94281
3:5:2,1,1,105718,94282
2:2:3,2,2,105716,94284
3:2:5,1,1,105715,94285
4:5:4,0,-1,105716,94284
5:1:4,0,-1,105717,94283
5:6:2,1,1,105716,94284
6:6:5,0,-1,105717,94283
1:4:4,0,-1,105718,94282
3:6:1,0,-1,105719,94281
5:4:3,0,-1,105720,94280
3:6:1,0,-1,105721,94279
6:1:5,0,-1,105722,94278
6:6:2,1,1,105721,94279
6:3:2,1,1,105720,94280
2:3:3,1,1,105719,94281
6:1:1,0,-1,105720,94280
6:3:3,0,-1,105721,94279
5:4:4,0,-1,105722,94278
1:5:6,0,-1,105723,94277
6:2:4,1,1,105722,94278
3:1:4,0,-1,105723,94277
6:3:4,0,-1,105724,94276
6:4:2,1,1,105723,94277
6:5:3,0,-1,105724,94276
1:2:4,1,1,105723,94277
2:6:4,1,1,105722,94278
3:4:5,0,-1,105723,94277
5:4:1,0,-1,105724,94276
3:5:2,1,1,105723,94277
4:2:2,2,2,105721,94279
4:1:3,0,-1,105722,94278
3:4:5,0,-1,105723,94277
4:2:3,1,1,105722,94278
6:3:6,0,-1,105723,94277
6:1:4,0,-1,105724,94276
3:5:1,0,-1,105725,94275
2:3:2,2,2,105723,94277
3:3:5,0,-1,105724,94276
6:4:4,0,-1,105725,94275
2:3:4,1,1,105724,94276
5:6:1,0,-1,105725,94275
3:3:3,0,-1,105726,94274
3:1:3,0,-1,105727,94273
1:1:4,0,-1,105728,94272
5:4:1,0,-1,105729,94271
3:2:1,1,1,105728,94272
3:2:2,2,2,105726,94274
1:6:2,1,1,105725,94275
4:4:3,0,-1,105726,94274
4:5:1,0,-1,105727,94273
6:1:1,0,-1,105728,94272
2:6:4,1,1,105727,94273
1:3:4,0,-1,105728,94272
3:1:3,0,-1,105729,94271
4:5:4,0,-1,105730,94270
4:6:1,0,-1,105731,94269
3:3:2,1,1,105730,94270
6:5:4,0,-1,105731,94269
1:1:1,0,-1,105732,94268
6:6:6,0,-1,105733,94267
4:6:1,0,-1,105734,94266
5:6:2,1,1,105733,94267
2:3:6,1,1,105732,94268
3:3:5,0,-1,105733,94267
6:3:2,1,1,105732,94268
1:3:6,0,-1,105733,94267
5:5:5,0,-1,105734,94266
5:1:5,0,-1,105735,94265
2:1:5,1,1,105734,94266
2:1:6,1,1,105733,94267
5:5:5,0,-1,105734,94266
3:2:6,1,1,105733,94267
5:2:6,1,1,105732,94268
6:2:5,1,1,105731,94269
5:3:1,0,-1,105732,94268
5:6:2,1,1,105731,94269
3:1:5,0,-1,105732,94268
5:1:3,0,-1,105733,94267
6:4:1,0,-1,105734,94266
6:4:1,0,-1,105735,94265
6:6:5,0,-1,105736,94264
3:3:4,0,-1,105737,94263
1:3:5,0,-1,105738,94262
1:4:2,1,1,105737,94263
1:3:3,0,-1,105738,94262
3:1:2,1,1,105737,94263
2:4:2,2,2,105735,94265
6:1:6,0,-1,105736,94264
6:3:2,1,1,105735,94265
1:6:3,0,-1,105736,94264
5:4:3,0,-1,105737,94263
5:6:3,0,-1,105738,94262
6:4:6,0,-1,105739,94261
5:3:4,0,-1,105740,94260
3:5:5,0,-1,105741,94259
4:6:2,1,1,105740,94260
1:5:6,0,-1,105741,94259
2:1:3,1,1,105740,94260
5:2:5,1,1,105739,94261
4:5:2,1,1,105738,94262
3:5:5,0,-1,105739,94261
3:4:4,0,-1,105740,94260
3:3:1,0,-1,105741,94259
1:2:3,1,1,105740,94260
2:5:5,1,1,105739,94261
3:3:5,0,-1,105740,94260
6:6:5,0,-1,105741,94259
3:6:3,0,-1,105742,94258
6:6:3,0,-1,105743,94257
3:4:4,0,-1,105744,94256
3:1:3,0,-1,105745,94255
5:4:4,0,-1,105746,94254
6:4:4,0,-1,105747,94253
4:4:2,1,1,105746,94254
3:2:3,1,1,105745,94255
1:5:3,0,-1,105746,94254
4:4:1,0,-1,105747,94253
3:3:1,0,-1,105748,94252
5:1:2,1,1,105747,94253
3:3:3,0,-1,105748,94252
5:1:2,1,1,105747,94253
5:6:5,0,-1,105748,94252
6:4:3,0,-1,105749,94251
6:3:2,1,1,105748,94252
2:2:3,2,2,105746,94254
5:2:2,2,2,105744,94256
2:3:1,1,1,105743,94257
4:2:4,1,1,105742,94258
1:6:6,0,-1,105743,94257
3:4:1,0,-1,105744,94256
6:6:5,0,-1,105745,94255
1:6:1,0,-1,105746,94254
2:3:3,1,1,105745,94255
6:5:5,0,-1,105746,94254
1:3:3,0,-1,105747,94253
6:5:2,1,1,105746,94254
6:1:2,1,1,105745,94255
2:6:2,2,2,105743,94257
4:1:6,0,-1,105744,94256
6:5:2,1,1,105743,94257
6:4:2,1,1,105742,94258
3:1:6,0,-1,105743,94257
2:1:1,1,1,105742,94258
1:1:1,0,-1,105743,94257
1:1:3,0,-1,105744,94256
6:1:1,0,-1,105745,94255
5:3:5,0,-1,105746,94254
5:1:4,0,-1,105747,94253
3:3:3,0,-1,105748,94252
1:6:2,1,1,105747,94253
3:6:2,1,1,105746,94254
3:4:5,0,-1,105747,94253
6:5:3,0,-1,105748,94252
2:2:6,2,2,105746,94254
3:2:4,1,1,105745,94255
5:2:3,1,1,105744,94256
3:4:5,0,-1,105745,94255
4:3:4,0,-1,105746,94254
1:6:3,0,-1,105747,94253
3:1:5,0,-1,105748,94252
1:5:3,0,-1,105749,94251
6:3:4,0,-1,105750,94250
4:3:4,0,-1,105751,94249
1:1:4,0,-1,105752,94248
4:4:1,0,-1,105753,94247
3:4:1,0,-1,105754,94246
1:5:6,0,-1,105755,94245
5:4:1,0,-1,105756,94244
6:3:4,0,-1,105757,94243
5:6:2,1,1,105756,94244
3:5:2,1,1,105755,94245
1:6:6,0,-1,105756,94244
6:5:3,0,-1,105757,94243
3:3:3,0,-1,105758,94242
6:6:2,1,1,105757,94243
5:5:6,0,-1,105758,94242
5:3:6,0,-1,105759,94241
4:4:4,0,-1,105760,94240
4:5:1,0,-1,105761,94239
3:4:4,0,-1,105762,94238
3:5:3,0,-1,105763,94237
4:2:6,1,1,105762,94238
6:2:1,1,1,105761,94239
6:4:6,0,-1,105762,94238
2:6:1,1,1,105761,94239
2:3:6,1,1,105760,94240
3:6:1,0,-1,105761,94239
1:4:1,0,-1,105762,94238
3:2:2,2,2,105760,94240
1:2:4,1,1,105759,94241
4:5:5,0,-1,105760,94240
2:3:4,1,1,105759,94241
3:3:4,0,-1,105760,94240
4:5:3,0,-1,105761,94239
1:5:1,0,-1,105762,94238
4:5:5,0,-1,105763,94237
2:6:6,1,1,105762,94238
3:1:4,0,-1,105763,94237
6:1:2,1,1,105762,94238
2:2:2,3,3,105759,94241
4:5:2,1,1,105758,94242
6:3:1,0,-1,105759,94241
2:3:6,1,1,105758,94242
4:1:1,0,-1,105759,94241
3:5:2,1,1,105758,94242
1:2:4,1,1,105757,94243
1:6:3,0,-1,105758,94242
3:3:3,0,-1,105759,94241
3:5:3,0,-1,105760,94240
3:4:3,0,-1,105761,94239
2:4:4,1,1,105760,94240
6:4:4,0,-1,105761,94239
5:4:3,0,-1,105762,94238
6:5:1,0,-1,105763,94237
4:4:1,0,-1,105764,94236
6:3:4,0,-1,105765,94235
1:4:5,0,-1,105766,94234
5:4:1,0,-1,105767,94233
2:4:5,1,1,105766,94234
3:2:1,1,1,105765,94235
4:1:1,0,-1,105766,94234
2:1:3,1,1,105765,94235
3:1:1,0,-1,105766,94234
6:6:4,0,-1,105767,94233
1:1:2,1,1,105766,94234
4:2:6,1,1,105765,94235
3:3:3,0,-1,105766,94234
6:2:3,1,1,105765,94235
3:3:5,0,-1,105766,94234
3:4:1,0,-1,105767,94233
4:1:5,0,-1,105768,94232
3:3:4,0,-1,105769,94231
5:5:1,0,-1,105770,94230
4:3:5,0,-1,105771,94229
6:3:5,0,-1,105772,94228
6:6:5,0,-1,105773,94227
2:5:6,1,1,105772,94228
3:3:5,0,-1,105773,94227
4:5:5,0,-1,105774,94226
4:4:2,1,1,105773,94227
2:2:6,2,2,105771,94229
3:2:6,1,1,105770,94230
6:4:4,0,-1,105771,94229
6:1:2,1,1,105770,94230
2:1:2,2,2,105768,94232
5:5:3,0,-1,105769,94231
5:3:6,0,-1,105770,94230
1:2:6,1,1,105769,94231
3:1:1,0,-1,105770,94230
4:2:6,1,1,105769,94231
2:4:4,1,1,105768,94232
4:5:3,0,-1,105769,94231
1:3:4,0,-1,105770,94230
3:3:6,0,-1,105771,94229
4:3:3,0,-1,105772,94228
5:2:5,1,1,105771,94229
5:2:4,1,1,105770,94230
2:1:4,1,1,105769,94231
6:6:1,0,-1,105770,94230
4:1:6,0,-1,105771,94229
5:4:6,0,-1,105772,94228
2:1:4,1,1,105771,94229
2:2:1,2,2,105769,94231
1:4:5,0,-1,105770,94230
2:2:5,2,2,105768,94232
2:1:3,1,1,105767,94233
2:5:1,1,1,105766,94234
6:5:1,0,-1,105767,94233
2:2:6,2,2,105765,94235
6:5:2,1,1,105764,94236
6:3:6,0,-1,105765,94235
2:4:1,1,1,105764,94236
5:6:1,0,-1,105765,94235
4:3:3,0,-1,105766,94234
3:5:5,0,-1,105767,94233
1:1:5,0,-1,105768,94232
4:3:1,0,-1,105769,94231
4:5:1,0,-1,105770,94230
2:3:2,2,2,105768,94232
6:4:6,0,-1,105769,94231
2:5:2,2,2,105767,94233
3:2:3,1,1,105766,94234
2:6:6,1,1,105765,94235
5:2:6,1,1,105764,94236
6:2:1,1,1,105763,94237
4:5:2,1,1,105762,94238
1:6:5,0,-1,105763,94237
3:4:1,0,-1,105764,94236
2:4:3,1,1,105763,94237
6:4:2,1,1,105762,94238
3:1:6,0,-1,105763,94237
1:3:4,0,-1,105764,94236
5:2:4,1,1,105763,94237
4:6:5,0,-1,105764,94236
6:3:5,0,-1,105765,94235
1:2:6,1,1,105764,94236
2:3:2,2,2,105762,94238
3:1:5,0,-1,105763,94237
5:4:6,0,-1,105764,94236
3:6:3,0,-1,105765,94235
3:4:4,0,-1,105766,94234
3:2:2,2,2,105764,94236
1:3:2,1,1,105763,94237
3:6:4,0,-1,105764,94236
6:2:2,2,2,105762,94238
2:6:5,1,1,105761,94239
4:6:5,0,-1,105762,94238
5:2:1,1,1,105761,94239
4:1:2,1,1,105760,94240
6:4:5,0,-1,105761,94239
5:6:2,1,1,105760,94240
5:6:3,0,-1,105761,94239
1:3:2,1,1,105760,94240
4:5:4,0,-1,105761,94239
3:4:5,0,-1,105762,94238
1:2:2,2,2,105760,94240
3:3:2,1,1,105759,94241
2:6:4,1,1,105758,94242
2:2:2,3,3,105755,94245
2:1:3,1,1,105754,94246
3:1:5,0,-1,105755,94245
2:6:2,2,2,105753,94247
4:1:1,0,-1,105754,94246
2:6:6,1,1,105753,94247
6:6:2,1,1,105752,94248
4:4:1,0,-1,105753,94247
2:4:6,1,1,105752,94248
6:6:6,0,-1,105753,94247
5:6:2,1,1,105752,94248
4:6:3,0,-1,105753,94247
3:2:1,1,1,105752,94248
2:4:5,1,1,105751,94249
2:4:1,1,1,105750,94250
1:5:5,0,-1,105751,94249
1:2:4,1,1,105750,94250
4:3:4,0,-1,105751,94249
1:3:2,1,1,105750,94250
2:4:4,1,1,105749,94251
2:4:1,1,1,105748,94252
5:6:1,0,-1,105749,94251
3:2:1,1,1,105748,94252
1:6:3,0,-1,105749,94251
1:5:6,0,-1,105750,94250
2:1:4,1,1,105749,94251
1:5:5,0,-1,105750,94250
6:6:3,0,-1,105751,94249
2:1:4,1,1,105750,94250
6:6:2,1,1,105749,94251
2:6:5,1,1,105748,94252
1:2:4,1,1,105747,94253
5:2:6,1,1,105746,94254
6:1:3,0,-1,105747,94253
4:1:4,0,-1,105748,94252
4:1:4,0,-1,105749,94251
2:2:4,2,2,105747,94253
4:2:5,1,1,105746,94254
1:4:4,0,-1,105747,94253
5:4:6,0,-1,105748,94252
3:2:4,1,1,105747,94253
3:4:6,0,-1,105748,94252
2:6:3,1,1,105747,94253
3:1:6,0,-1,105748,94252
3:4:5,0,-1,105749,94251
1:1:6,0,-1,105750,94250
2:4:2,2,2,105748,94252
2:2:4,2,2,105746,94254
1:4:6,0,-1,105747,94253
1:6:4,0,-1,105748,94252
4:2:6,1,1,105747,94253
1:3:3,0,-1,105748,94252
4:2:6,1,1,105747,94253
6:4:4,0,-1,105748,94252
3:4:6,0,-1,105749,94251
2:5:3,1,1,105748,94252
1:1:6,0,-1,105749,94251
4:3:2,1,1,105748,94252
3:2:4,1,1,105747,94253
2:3:5,1,1,105746,94254
1:4:5,0,-1,105747,94253
5:1:1,0,-1,105748,94252
2:3:6,1,1,105747,94253
4:1:6,0,-1,105748,94252
3:6:2,1,1,105747,94253
2:4:2,2,2,105745,94255
6:3:4,0,-1,105746,94254
1:1:2,1,1,105745,94255
2:4:1,1,1,105744,94256
1:3:3,0,-1,105745,94255
4:4:1,0,-1,105746,94254
3:5:2,1,1,105745,94255
1:5:6,0,-1,105746,94254
6:6:1,0,-1,105747,94253
2:1:5,1,1,105746,94254
3:2:2,2,2,105744,94256
6:6:4,0,-1,105745,94255
3:6:3,0,-1,105746,94254
4:3:5,0,-1,105747,94253
6:3:2,1,1,105746,94254
2:5:4,1,1,105745,94255
1:4:2,1,1,105744,94256
1:5:6,0,-1,105745,94255
1:2:3,1,1,105744,94256
4:3:4,0,-1,105745,94255
2:3:3,1,1,105744,94256
2:3:5,1,1,105743,94257
3:4:6,0,-1,105744,94256
6:4:1,0,-1,105745,94255
5:6:5,0,-1,105746,94254
6:5:5,0,-1,105747,94253
4:4:4,0,-1,105748,94252
1:4:6,0,-1,105749,94251
5:5:2,1,1,105748,94252
4:5:4,0,-1,105749,94251
4:2:1,1,1,105748,94252
3:3:5,0,-1,105749,94251
5:4:6,0,-1,105750,94250
5:3:4,0,-1,105751,94249
1:4:5,0,-1,105752,94248
5:4:4,0,-1,105753,94247
5:2:3,1,1,105752,94248
3:6:4,0,-1,105753,94247
4:1:1,0,-1,105754,94246
1:2:5,1,1,105753,94247
4:6:6,0,-1,105754,94246
5:2:1,1,1,105753,94247
3:6:1,0,-1,105754,94246
5:6:1,0,-1,105755,94245
5:6:5,0,-1,105756,94244
5:1:1,0,-1,105757,94243
2:5:4,1,1,105756,94244
2:1:5,1,1,105755,94245
5:1:1,0,-1,105756,94244
6:3:4,0,-1,105757,94243
3:6:2,1,1,105756,94244
3:2:3,1,1,105755,94245
5:2:6,1,1,105754,94246
6:4:4,0,-1,105755,94245
2:3:2,2,2,105753,94247
2:4:4,1,1,105752,94248
1:5:6,0,-1,105753,94247
2:1:3,1,1,105752,94248
2:2:6,2,2,105750,94250
6:4:2,1,1,105749,94251
4:4:1,0,-1,105750,94250
1:6:2,1,1,105749,94251
2:2:5,2,2,105747,94253
2:4:3,1,1,105746,94254
4:4:5,0,-1,105747,94253
2:5:3,1,1,105746,94254
2:2:2,3,3,105743,94257
6:6:5,0,-1,105744,94256
4:3:3,0,-1,105745,94255
6:4:4,0,-1,105746,94254
2:3:3,1,1,105745,94255
3:4:1,0,-1,105746,94254
4:1:3,0,-1,105747,94253
2:1:4,1,1,105746,94254
4:4:2,1,1,105745,94255
3:4:1,0,-1,105746,94254
5:3:6,0,-1,105747,94253
1:5:6,0,-1,105748,94252
4:6:3,0,-1,105749,94251
6:4:4,0,-1,105750,94250
6:6:4,0,-1,105751,94249
2:6:5,1,1,105750,94250
1:2:6,1,1,105749,94251
6:2:6,1,1,105748,94252
5:2:3,1,1,105747,94253
2:2:4,2,2,105745,94255
1:3:4,0,-1,105746,94254
2:4:2,2,2,105744,94256
4:1:2,1,1,105743,94257
6:2:2,2,2,105741,94259
1:3:2,1,1,105740,94260
2:1:5,1,1,105739,94261
6:3:2,1,1,105738,94262
1:3:3,0,-1,105739,94261
4:5:2,1,1,105738,94262
5:5:3,0,-1,105739,94261
1:4:3,0,-1,105740,94260
2:4:4,1,1,105739,94261
1:6:4,0,-1,105740,94260
6:2:1,1,1,105739,94261
5:2:2,2,2,105737,94263
3:5:3,0,-1,105738,94262
2:5:4,1,1,105737,94263
3:2:4,1,1,105736,94264
2:5:6,1,1,105735,94265
4:4:3,0,-1,105736,94264
3:4:3,0,-1,105737,94263
2:5:3,1,1,105736,94264
6:2:6,1,1,105735,94265
1:4:2,1,1,105734,94266
3:1:2,1,1,105733,94267
1:4:6,0,-1,105734,94266
2:1:4,1,1,105733,94267
5:2:6,1,1,105732,94268
6:6:5,0,-1,105733,94267
1:3:6,0,-1,105734,94266
4:2:3,1,1,105733,94267
6:3:6,0,-1,105734,94266
3:5:5,0,-1,105735,94265
4:4:1,0,-1,105736,94264
3:2:4,1,1,105735,94265
6:1:2,1,1,105734,94266
3:3:6,0,-1,105735,94265
5:6:1,0,-1,105736,94264
1:5:6,0,-1,105737,94263
4:3:4,0,-1,105738,94262
4:4:6,0,-1,105739,94261
6:1:1,0,-1,105740,94260
5:4:2,1,1,105739,94261
2:3:3,1,1,105738,94262
3:2:5,1,1,105737,94263
5:2:1,1,1,105736,94264
6:3:1,0,-1,105737,94263
5:1:3,0,-1,105738,94262
3:1:4,0,-1,105739,94261
2:1:4,1,1,105738,94262
6:6:5,0,-1,105739,94261
4:6:2,1,1,105738,94262
3:2:6,1,1,105737,94263
4:3:6,0,-1,105738,94262
4:4:6,0,-1,105739,94261
5:3:4,0,-1,105740,94260
3:5:1,0,-1,105741,94259
4:6:6,0,-1,105742,94258
1:4:3,0,-1,105743,94257
1:4:6,0,-1,105744,94256
6:3:1,0,-1,105745,94255
3:3:2,1,1,105744,94256
1:3:2,1,1,105743,94257
4:6:5,0,-1,105744,94256
6:1:1,0,-1,105745,94255
1:1:1,0,-1,105746,94254
1:1:1,0,-1,105747,94253
1:3:6,0,-1,105748,94252
1:5:4,0,-1,105749,94251
6:5:6,0,-1,105750,94250
2:1:1,1,1,105749,94251
6:1:1,0,-1,105750,94250
6:4:4,0,-1,105751,94249
2:6:5,1,1,105750,94250
1:2:4,1,1,105749,94251
1:6:2,1,1,105748,94252
6:3:1,0,-1,105749,94251
1:5:5,0,-1,105750,94250
5:5:5,0,-1,105751,94249
1:5:4,0,-1,105752,94248
3:6:4,0,-1,105753,94247
1:2:5,1,1,105752,94248
5:6:6,0,-1,105753,94247
6:5:6,0,-1,105754,94246
5:6:3,0,-1,105755,94245
6:4:5,0,-1,105756,94244
5:3:3,0,-1,105757,94243
3:5:2,1,1,105756,94244
6:1:1,0,-1,105757,94243
4:4:4,0,-1,105758,94242
4:4:5,0,-1,105759,94241
6:5:4,0,-1,105760,94240
6:6:6,0,-1,105761,94239
4:3:1,0,-1,105762,94238
1:5:6,0,-1,105763,94237
6:2:4,1,1,105762,94238
1:2:6,1,1,105761,94239
2:5:3,1,1,105760,94240
3:4:6,0,-1,105761,94239
2:2:1,2,2,105759,94241
5:3:6,0,-1,105760,94240
4:5:6,0,-1,105761,94239
2:3:1,1,1,105760,94240
1:2:5,1,1,105759,94241
3:1:6,0,-1,105760,94240
2:3:5,1,1,105759,94241
5:5:6,0,-1,105760,94240
1:6:1,0,-1,105761,94239
6:2:4,1,1,105760,94240
6:1:2,1,1,105759,94241
6:4:6,0,-1,105760,94240
1:4:5,0,-1,105761,94239
2:6:5,1,1,105760,94240
1:4:4,0,-1,105761,94239
5:1:6,0,-1,105762,94238
4:6:3,0,-1,105763,94237
1:6:2,1,1,105762,94238
4:6:6,0,-1,105763,94237
5:3:2,1,1,105762,94238
6:1:3,0,-1,105763,94237
4:2:4,1,1,105762,94238
1:6:5,0,-1,105763,94237
5:6:4,0,-1,105764,94236
3:3:1,0,-1,105765,94235
3:5:3,0,-1,105766,94234
5:1:2,1,1,105765,94235
3:5:5,0,-1,105766,94234
6:1:4,0,-1,105767,94233
4:2:2,2,2,105765,94235
6:3:2,1,1,105764,94236
6:6:6,0,-1,105765,94235
4:2:4,1,1,105764,94236
2:1:3,1,1,105763,94237
5:5:5,0,-1,105764,94236
2:4:2,2,2,105762,94238
3:5:5,0,-1,105763,94237
2:6:1,1,1,105762,94238
1:6:6,0,-1,105763,94237
4:1:5,0,-1,105764,94236
6:2:1,1,1,105763,94237
1:5:1,0,-1,105764,94236
3:4:1,0,-1,105765,94235
3:1:4,0,-1,105766,94234
2:1:6,1,1,105765,94235
2:1:3,1,1,105764,94236
5:4:4,0,-1,105765,94235
3:6:4,0,-1,105766,94234
3:5:4,0,-1,105767,94233
1:1:5,0,-1,105768,94232
1:3:4,0,-1,105769,94231
4:6:3,0,-1,105770,94230
1:2:6,1,1,105769,94231
1:2:3,1,1,105768,94232
6:4:2,1,1,105767,94233
1:6:1,0,-1,105768,94232
4:3:1,0,-1,105769,94231
3:6:6,0,-1,105770,94230
2:4:1,1,1,105769,94231
6:4:5,0,-1,105770,94230
4:1:3,0,-1,105771,94229
1:3:4,0,-1,105772,94228
3:5:4,0,-1,105773,94227
4:2:4,1,1,105772,94228
3:1:3,0,-1,105773,94227
6:2:1,1,1,105772,94228
6:3:4,0,-1,105773,94227
6:2:1,1,1,105772,94228
5:2:4,1,1,105771,94229
1:5:4,0,-1,105772,94228
2:2:5,2,2,105770,94230
3:1:2,1,1,105769,94231
4:1:3,0,-1,105770,94230
3:3:5,0,-1,105771,94229
1:2:1,1,1,105770,94230
5:2:3,1,1,105769,94231
5:4:5,0,-1,105770,94230
3:3:5,0,-1,105771,94229
4:1:6,0,-1,105772,94228
6:3:3,0,-1,105773,94227
5:1:2,1,1,105772,94228
5:3:5,0,-1,105773,94227
3:4:2,1,1,105772,94228
1:3:1,0,-1,105773,94227
1:5:5,0,-1,105774,94226
1:6:4,0,-1,105775,94225
2:6:1,1,1,105774,94226
5:4:1,0,-1,105775,94225
6:5:6,0,-1,105776,94224
1:1:5,0,-1,105777,94223
2:4:1,1,1,105776,94224
4:6:5,0,-1,105777,94223
4:1:1,0,-1,105778,94222
5:4:4,0,-1,105779,94221
2:6:1,1,1,105778,94222
6:3:3,0,-1,105779,94221
6:3:4,0,-1,105780,94220
4:1:5,0,-1,105781,94219
3:5:6,0,-1,105782,94218
4:5:6,0,-1,105783,94217
6:5:3,0,-1,105784,94216
1:6:3,0,-1,105785,94215
3:2:6,1,1,105784,94216
1:6:1,0,-1,105785,94215
1:5:2,1,1,105784,94216
6:2:3,1,1,105783,94217
5:1:2,1,1,105782,94218
1:4:5,0,-1,105783,94217
2:4:3,1,1,105782,94218
6:1:2,1,1,105781,94219
3:1:6,0,-1,105782,94218
4:5:1,0,-1,105783,94217
2:4:6,1,1,105782,94218
6:3:5,0,-1,105783,94217
6:1:1,0,-1,105784,94216
5:2:3,1,1,105783,94217
6:2:1,1,1,105782,94218
6:2:5,1,1,105781,94219
5:1:4,0,-1,105782,94218
5:4:5,0,-1,105783,94217
1:1:2,1,1,105782,94218
5:2:3,1,1,105781,94219
2:6:3,1,1,105780,94220
2:5:4,1,1,105779,94221
3:5:5,0,-1,105780,94220
6:6:4,0,-1,105781,94219
6:3:5,0,-1,105782,94218
3:3:2,1,1,105781,94219
3:4:5,0,-1,105782,94218
2:5:4,1,1,105781,94219
6:2:6,1,1,105780,94220
1:3:1,0,-1,105781,94219
2:6:3,1,1,105780,94220
6:5:2,1,1,105779,94221
4:5:1,0,-1,105780,94220
5:1:3,0,-1,105781,94219
5:3:2,1,1,105780,94220
1:2:3,1,1,105779,94221
5:6:4,0,-1,105780,94220
4:5:3,0,-1,105781,94219
2:2:5,2,2,105779,94221
3:5:5,0,-1,105780,94220
6:6:5,0,-1,105781,94219
3:3:2,1,1,105780,94220
2:4:4,1,1,105779,94221
6:1:4,0,-1,105780,94220
6:2:5,1,1,105779,94221
3:6:5,0,-1,105780,94220
2:2:6,2,2,105778,94222
3:3:3,0,-1,105779,94221
5:3:4,0,-1,105780,94220
5:5:4,0,-1,105781,94219
6:5:4,0,-1,105782,94218
6:2:4,1,1,105781,94219
3:5:6,0,-1,105782,94218
2:6:4,1,1,105781,94219
5:1:4,0,-1,105782,94218
4:4:4,0,-1,105783,94217
3:4:2,1,1,105782,94218
5:3:5,0,-1,105783,94217
2:2:4,2,2,105781,94219
3:6:6,0,-1,105782,94218
1:5:5,0,-1,105783,94217
4:4:4,0,-1,105784,94216
3:5:2,1,1,105783,94217
3:3:4,0,-1,105784,94216
6:4:5,0,-1,105785,94215
1:2:6,1,1,105784,94216
5:1:4,0,-1,105785,94215
6:5:2,1,1,105784,94216
1:3:3,0,-1,105785,94215
5:4:4,0,-1,105786,94214
3:2:6,1,1,105785,94215
6:4:5,0,-1,105786,94214
2:1:3,1,1,105785,94215
1:6:6,0,-1,105786,94214
4:4:4,0,-1,105787,94213
4:1:6,0,-1,105788,94212
1:3:6,0,-1,105789,94211
2:1:3,1,1,105788,94212
4:5:3,0,-1,105789,94211
2:3:5,1,1,105788,94212
4:6:1,0,-1,105789,94211
4:5:4,0,-1,105790,94210
6:5:2,1,1,105789,94211
5:4:1,0,-1,105790,94210
4:3:2,1,1,105789,94211
1:5:4,0,-1,105790,94210
3:2:5,1,1,105789,94211
2:2:5,2,2,105787,94213
1:5:6,0,-1,105788,94212
1:6:5,0,-1,105789,94211
4:6:1,0,-1,105790,94210
5:1:3,0,-1,105791,94209
6:6:6,0,-1,105792,94208
2:5:2,2,2,105790,94210
4:6:4,0,-1,105791,94209
6:3:4,0,-1,105792,94208
4:4:5,0,-1,105793,94207
5:2:3,1,1,105792,94208
5:4:3,0,-1,105793,94207
4:3:3,0,-1,105794,94206
2:6:3,1,1,105793,94207
3:1:3,0,-1,105794,94206
2:2:3,2,2,105792,94208
3:1:3,0,-1,105793,94207
2:5:6,1,1,105792,94208
3:4:3,0,-1,105793,94207
2:6:4,1,1,105792,94208
2:4:5,1,1,105791,94209
4:5:4,0,-1,105792,94208
3:6:3,0,-1,105793,94207
3:3:6,0,-1,105794,94206
4:1:5,0,-1,105795,94205
4:4:6,0,-1,105796,94204
6:3:5,0,-1,105797,94203
5:6:4,0,-1,105798,94202
6:6:3,0,-1,105799,94201
3:3:4,0,-1,105800,94200
5:6:1,0,-1,105801,94199
2:6:4,1,1,105800,94200
2:2:1,2,2,105798,94202
4:6:3,0,-1,105799,94201
4:6:2,1,1,105798,94202
3:3:5,0,-1,105799,94201
4:6:6,0,-1,105800,94200
2:1:3,1,1,105799,94201
6:5:6,0,-1,105800,94200
5:3:2,1,1,105799,94201
3:4:5,0,-1,105800,94200
5:5:5,0,-1,105801,94199
5:5:4,0,-1,105802,94198
3:5:1,0,-1,105803,94197
6:2:1,1,1,105802,94198
4:2:4,1,1,105801,94199
4:6:3,0,-1,105802,94198
3:1:5,0,-1,105803,94197
2:5:3,1,1,105802,94198
3:4:1,0,-1,105803,94197
3:2:3,1,1,105802,94198
1:3:4,0,-1,105803,94197
3:6:6,0,-1,105804,94196
3:6:2,1,1,105803,94197
5:5:2,1,1,105802,94198
3:3:3,0,-1,105803,94197
3:6:1,0,-1,105804,94196
2:3:3,1,1,105803,94197
1:5:5,0,-1,105804,94196
3:2:1,1,1,105803,94197
3:1:2,1,1,105802,94198
2:3:2,2,2,105800,94200
5:4:4,0,-1,105801,94199
6:2:4,1,1,105800,94200
2:4:5,1,1,105799,94201
6:3:1,0,-1,105800,94200
5:4:2,1,1,105799,94201
2:4:4,1,1,105798,94202
5:4:5,0,-1,105799,94201
3:4:3,0,-1,105800,94200
1:6:1,0,-1,105801,94199
3:4:4,0,-1,105802,94198
2:3:6,1,1,105801,94199
3:4:4,0,-1,105802,94198
2:6:1,1,1,105801,94199
5:1:1,0,-1,105802,94198
3:2:1,1,1,105801,94199
4:6:1,0,-1,105802,94198
2:2:6,2,2,105800,94200
4:6:1,0,-1,105801,94199
6:1:5,0,-1,105802,94198
6:6:1,0,-1,105803,94197
4:4:4,0,-1,105804,94196
3:5:6,0,-1,105805,94195
2:6:5,1,1,105804,94196
3:5:4,0,-1,105805,94195
4:4:5,0,-1,105806,94194
2:2:3,2,2,105804,94196
5:6:1,0,-1,105805,94195
5:6:2,1,1,105804,94196
3:4:3,0,-1,105805,94195
4:2:1,1,1,105804,94196
5:5:4,0,-1,105805,94195
2:3:6,1,1,105804,94196
2:4:2,2,2,105802,94198
3:3:3,0,-1,105803,94197
5:6:6,0,-1,105804,94196
4:6:4,0,-1,105805,94195
4:1:4,0,-1,105806,94194
6:3:2,1,1,105805,94195
6:6:3,0,-1,105806,94194
5:1:5,0,-1,105807,94193
1:4:5,0,-1,105808,94192
1:2:3,1,1,105807,94193
5:4:1,0,-1,105808,94192
5:2:3,1,1,105807,94193
2:2:6,2,2,105805,94195
2:2:1,2,2,105803,94197
2:5:4,1,1,105802,94198
3:5:3,0,-1,105803,94197
1:2:3,1,1,105802,94198
2:3:2,2,2,105800,94200
4:3:6,0,-1,105801,94199
4:5:1,0,-1,105802,94198
1:4:4,0,-1,105803,94197
5:5:6,0,-1,105804,94196
6:5:2,1,1,105803,94197
2:5:4,1,1,105802,94198
6:6:5,0,-1,105803,94197
4:4:1,0,-1,105804,94196
5:1:1,0,-1,105805,94195
5:4:6,0,-1,105806,94194
1:6:4,0,-1,105807,94193
5:3:5,0,-1,105808,94192
6:4:1,0,-1,105809,94191
4:3:2,1,1,105808,94192
6:2:2,2,2,105806,94194
2:6:6,1,1,105805,94195
6:3:5,0,-1,105806,94194
2:5:5,1,1,105805,94195
5:6:5,0,-1,105806,94194
6:5:4,0,-1,105807,94193
5:3:6,0,-1,105808,94192
1:6:4,0,-1,105809,94191
3:1:5,0,-1,105810,94190
1:2:3,1,1,105809,94191
1:3:3,0,-1,105810,94190
5:2:5,1,1,105809,94191
2:6:2,2,2,105807,94193
3:1:2,1,1,105806,94194
4:3:1,0,-1,105807,94193
3:3:4,0,-1,105808,94192
3:6:5,0,-1,105809,94191
5:6:3,0,-1,105810,94190
4:6:5,0,-1,105811,94189
5:1:1,0,-1,105812,94188
2:1:6,1,1,105811,94189
6:4:1,0,-1,105812,94188
3:6:3,0,-1,105813,94187
5:6:4,0,-1,105814,94186
5:4:1,0,-1,105815,94185
4:5:3,0,-1,105816,94184
2:3:4,1,1,105815,94185
6:3:5,0,-1,105816,94184
2:5:4,1,1,105815,94185
4:1:4,0,-1,105816,94184
4:3:1,0,-1,105817,94183
5:3:1,0,-1,105818,94182
1:4:1,0,-1,105819,94181
1:5:4,0,-1,105820,94180
4:2:3,1,1,105819,94181
5:1:4,0,-1,105820,94180
2:1:6,1,1,105819,94181
1:2:3,1,1,105818,94182
1:1:1,0,-1,105819,94181
3:6:5,0,-1,105820,94180
4:1:6,0,-1,105821,94179
2:2:5,2,2,105819,94181
4:4:6,0,-1,105820,94180
3:1:2,1,1,105819,94181
1:1:3,0,-1,105820,94180
3:3:1,0,-1,105821,94179
1:3:6,0,-1,105822,94178
5:4:6,0,-1,105823,94177
6:3:2,1,1,105822,94178
1:3:1,0,-1,105823,94177
1:4:1,0,-1,105824,94176
2:1:4,1,1,105823,94177
4:1:3,0,-1,105824,94176
1:3:2,1,1,105823,94177
4:1:5,0,-1,105824,94176
5:5:4,0,-1,105825,94175
5:3:5,0,-1,105826,94174
4:2:5,1,1,105825,94175
4:1:1,0,-1,105826,94174
3:3:3,0,-1,105827,94173
2:5:1,1,1,105826,94174
3:6:3,0,-1,105827,94173
6:3:4,0,-1,105828,94172
5:3:1,0,-1,105829,94171
2:4:2,2,2,105827,94173
1:4:2,1,1,105826,94174
5:5:1,0,-1,105827,94173
1:2:5,1,1,105826,94174
2:5:3,1,1,105825,94175
3:2:2,2,2,105823,94177
4:5:6,0,-1,105824,94176
4:5:5,0,-1,105825,94175
6:2:2,2,2,105823,94177
1:4:3,0,-1,105824,94176
1:6:6,0,-1,105825,94175
6:3:4,0,-1,105826,94174
4:3:4,0,-1,105827,94173
2:2:4,2,2,105825,94175
2:6:4,1,1,105824,94176
2:3:1,1,1,105823,94177
3:4:1,0,-1,105824,94176
4:3:1,0,-1,105825,94175
5:6:6,0,-1,105826,94174
4:3:5,0,-1,105827,94173
3:1:3,0,-1,105828,94172
3:4:2,1,1,105827,94173
5:3:5,0,-1,105828,94172
3:6:2,1,1,105827,94173
1:4:3,0,-1,105828,94172
5:3:2,1,1,105827,94173
6:2:2,2,2,105825,94175
6:5:1,0,-1,105826,94174
1:4:5,0,-1,105827,94173
1:2:1,1,1,105826,94174
3:5:2,1,1,105825,94175
3:2:1,1,1,105824,94176
5:1:5,0,-1,105825,94175
1:3:2,1,1,105824,94176
1:5:4,0,-1,105825,94175
3:6:5,0,-1,105826,94174
1:6:6,0,-1,105827,94173
1:6:2,1,1,105826,94174
2:6:2,2,2,105824,94176
4:3:5,0,-1,105825,94175
5:6:5,0,-1,105826,94174
2:5:6,1,1,105825,94175
4:3:3,0,-1,105826,94174
6:4:5,0,-1,105827,94173
2:4:3,1,1,105826,94174
2:3:1,1,1,105825,94175
6:6:6,0,-1,105826,94174
3:5:5,0,-1,105827,94173
5:2:2,2,2,105825,94175
3:3:6,0,-1,105826,94174
1:2:5,1,1,105825,94175
6:2:5,1,1,105824,94176
4:1:6,0,-1,105825,94175
2:1:6,1,1,105824,94176
3:6:1,0,-1,105825,94175
2:5:1,1,1,105824,94176
2:3:3,1,1,105823,94177
3:6:6,0,-1,105824,94176
4:6:4,0,-1,105825,94175
2:1:2,2,2,105823,94177
1:1:6,0,-1,105824,94176
3:5:2,1,1,105823,94177
1:5:1,0,-1,105824,94176
6:2:6,1,1,105823,94177
3:5:2,1,1,105822,94178
3:4:5,0,-1,105823,94177
4:1:4,0,-1,105824,94176
2:4:2,2,2,105822,94178
4:3:6,0,-1,105823,94177
3:4:4,0,-1,105824,94176
3:2:2,2,2,105822,94178
2:3:5,1,1,105821,94179
2:1:1,1,1,105820,94180
2:5:1,1,1,105819,94181
1:4:1,0,-1,105820,94180
5:1:4,0,-1,105821,94179
4:2:1,1,1,105820,94180
4:1:5,0,-1,105821,94179
2:3:4,1,1,105820,94180
5:1:1,0,-1,105821,94179
3:2:1,1,1,105820,94180
2:5:6,1,1,105819,94181
1:4:1,0,-1,105820,94180
2:1:6,1,1,105819,94181
1:5:6,0,-1,105820,94180
1:1:6,0,-1,105821,94179
2:6:5,1,1,105820,94180
4:5:4,0,-1,105821,94179
5:6:5,0,-1,105822,94178
1:5:6,0,-1,105823,94177
5:3:1,0,-1,105824,94176
6:5:6,0,-1,105825,94175
3:5:3,0,-1,105826,94174
4:3:4,0,-1,105827,94173
4:6:2,1,1,105826,94174
2:3:3,1,1,105825,94175
6:1:4,0,-1,105826,94174
1:1:4,0,-1,105827,94173
2:4:1,1,1,105826,94174
5:4:4,0,-1,105827,94173
4:5:3,0,-1,105828,94172
5:4:5,0,-1,105829,94171
1:6:6,0,-1,105830,94170
3:3:4,0,-1,105831,94169
4:2:2,2,2,105829,94171
6:3:3,0,-1,105830,94170
6:5:2,1,1,105829,94171
6:6:2,1,1,105828,94172
4:6:3,0,-1,105829,94171
1:4:2,1,1,105828,94172
5:2:4,1,1,105827,94173
5:4:3,0,-1,105828,94172
2:5:6,1,1,105827,94173
5:3:4,0,-1,105828,94172
4:4:2,1,1,105827,94173
4:4:5,0,-1,105828,94172
4:5:1,0,-1,105829,94171
3:3:3,0,-1,105830,94170
4:6:3,0,-1,105831,94169
5:6:2,1,1,105830,94170
3:1:4,0,-1,105831,94169
4:5:2,1,1,105830,94170
6:3:4,0,-1,105831,94169
3:4:2,1,1,105830,94170
1:1:3,0,-1,105831,94169
3:3:1,0,-1,105832,94168
5:1:5,0,-1,105833,94167
1:1:3,0,-1,105834,94166
3:5:4,0,-1,105835,94165
4:2:6,1,1,105834,94166
5:2:5,1,1,105833,94167
4:4:1,0,-1,105834,94166
2:3:2,2,2,105832,94168
1:4:2,1,1,105831,94169
5:3:4,0,-1,105832,94168
4:1:3,0,-1,105833,94167
1:4:5,0,-1,105834,94166
6:6:6,0,-1,105835,94165
2:3:2,2,2,105833,94167
1:5:1,0,-1,105834,94166
1:1:2,1,1,105833,94167
6:3:1,0,-1,105834,94166
5:4:1,0,-1,105835,94165
2:1:5,1,1,105834,94166
3:2:4,1,1,105833,94167
1:6:3,0,-1,105834,94166
6:3:3,0,-1,105835,94165
4:6:4,0,-1,105836,94164
1:5:2,1,1,105835,94165
3:2:4,1,1,105834,94166
1:1:4,0,-1,105835,94165
4:2:5,1,1,105834,94166
2:5:4,1,1,105833,94167
6:1:3,0,-1,105834,94166
5:4:6,0,-1,105835,94165
3:3:3,0,-1,105836,94164
5:3:5,0,-1,105837,94163
2:1:2,2,2,105835,94165
5:3:5,0,-1,105836,94164
5:4:2,1,1,105835,94165
5:6:5,0,-1,105836,94164
2:4:2,2,2,105834,94166
3:1:5,0,-1,105835,94165
1:3:6,0,-1,105836,94164
1:4:2,1,1,105835,94165
2:6:3,1,1,105834,94166
6:4:2,1,1,105833,94167
3:6:1,0,-1,105834,94166
4:1:4,0,-1,105835,94165
4:6:4,0,-1,105836,94164
6:1:4,0,-1,105837,94163
5:6:6,0,-1,105838,94162
5:4:6,0,-1,105839,94161
4:5:1,0,-1,105840,94160
4:5:4,0,-1,105841,94159
3:2:6,1,1,105840,94160
2:6:3,1,1,105839,94161
4:4:5,0,-1,105840,94160
5:5:2,1,1,105839,94161
2:3:2,2,2,105837,94163
3:2:4,1,1,105836,94164
5:3:6,0,-1,105837,94163
2:4:2,2,2,105835,94165
3:6:1,0,-1,105836,94164
1:3:2,1,1,105835,94165
2:6:5,1,1,105834,94166
2:4:3,1,1,105833,94167
6:2:2,2,2,105831,94169
3:1:5,0,-1,105832,94168
5:6:5,0,-1,105833,94167
6:1:6,0,-1,105834,94166
6:3:1,0,-1,105835,94165
4:2:4,1,1,105834,94166
6:6:6,0,-1,105835,94165
6:2:1,1,1,105834,94166
5:2:5,1,1,105833,94167
1:4:2,1,1,105832,94168
4:6:4,0,-1,105833,94167
6:3:5,0,-1,105834,94166
4:2:1,1,1,105833,94167
3:5:4,0,-1,105834,94166
1:5:2,1,1,105833,94167
6:6:6,0,-1,105834,94166
2:5:4,1,1,105833,94167
2:6:3,1,1,105832,94168
4:1:1,0,-1,105833,94167
1:6:2,1,1,105832,94168
1:1:5,0,-1,105833,94167
6:1:5,0,-1,105834,94166
3:4:5,0,-1,105835,94165
2:2:6,2,2,105833,94167
3:2:4,1,1,105832,94168
3:3:6,0,-1,105833,94167
5:4:2,1,1,105832,94168
6:4:6,0,-1,105833,94167
3:2:5,1,1,105832,94168
3:1:5,0,-1,105833,94167
6:4:4,0,-1,105834,94166
1:4:6,0,-1,105835,94165
4:3:4,0,-1,105836,94164
5:5:2,1,1,105835,94165
3:3:5,0,-1,105836,94164
2:3:2,2,2,105834,94166
2:1:3,1,1,105833,94167
4:5:2,1,1,105832,94168
5:3:4,0,-1,105833,94167
1:3:2,1,1,105832,94168
6:4:1,0,-1,105833,94167
3:4:2,1,1,105832,94168
4:2:6,1,1,105831,94169
2:2:5,2,2,105829,94171
2:5:5,1,1,105828,94172
3:4:6,0,-1,105829,94171
1:3:2,1,1,105828,94172
4:2:2,2,2,105826,94174
4:1:1,0,-1,105827,94173
6:6:3,0,-1,105828,94172
3:6:3,0,-1,105829,94171
2:1:3,1,1,105828,94172
3:1:1,0,-1,105829,94171
4:2:2,2,2,105827,94173
2:2:5,2,2,105825,94175
3:1:5,0,-1,105826,94174
5:3:6,0,-1,105827,94173
6:2:4,1,1,105826,94174
4:4:4,0,-1,105827,94173
5:4:1,0,-1,105828,94172
2:4:1,1,1,105827,94173
2:4:5,1,1,105826,94174
1:5:1,0,-1,105827,94173
1:2:4,1,1,105826,94174
4:2:5,1,1,105825,94175
2:1:5,1,1,105824,94176
2:4:1,1,1,105823,94177
6:3:5,0,-1,105824,94176
4:6:3,0,-1,105825,94175
5:1:6,0,-1,105826,94174
2:3:1,1,1,105825,94175
6:4:3,0,-1,105826,94174
2:2:4,2,2,105824,94176
3:5:4,0,-1,105825,94175
6:4:3,0,-1,105826,94174
2:3:6,1,1,105825,94175
6:4:1,0,-1,105826,94174
3:3:4,0,-1,105827,94173
5:1:4,0,-1,105828,94172
1:5:5,0,-1,105829,94171
5:3:5,0,-1,105830,94170
5:6:3,0,-1,105831,94169
3:3:5,0,-1,105832,94168
6:3:3,0,-1,105833,94167
2:2:3,2,2,105831,94169
4:2:6,1,1,105830,94170
3:2:6,1,1,105829,94171
3:5:5,0,-1,105830,94170
6:3:3,0,-1,105831,94169
4:5:4,0,-1,105832,94168
3:3:6,0,-1,105833,94167
2:6:1,1,1,105832,94168
5:2:4,1,1,105831,94169
6:5:6,0,-1,105832,94168
5:5:3,0,-1,105833,94167
2:6:2,2,2,105831,94169
1:1:1,0,-1,105832,94168
4:2:4,1,1,105831,94169
1:2:5,1,1,105830,94170
2:4:4,1,1,105829,94171
3:6:1,0,-1,105830,94170
3:1:4,0,-1,105831,94169
2:1:4,1,1,105830,94170
3:1:1,0,-1,105831,94169
5:6:6,0,-1,105832,94168
2:6:4,1,1,105831,94169
6:2:2,2,2,105829,94171
1:2:5,1,1,105828,94172
2:5:4,1,1,105827,94173
2:1:5,1,1,105826,94174
3:4:2,1,1,105825,94175
3:1:6,0,-1,105826,94174
5:1:1,0,-1,105827,94173
4:5:5,0,-1,105828,94172
5:4:1,0,-1,105829,94171
6:5:2,1,1,105828,94172
2:5:2,2,2,105826,94174
5:3:1,0,-1,105827,94173
5:3:3,0,-1,105828,94172
5:3:1,0,-1,105829,94171
3:4:6,0,-1,105830,94170
1:5:1,0,-1,105831,94169
3:2:6,1,1,105830,94170
1:3:4,0,-1,105831,94169
4:2:2,2,2,105829,94171
3:5:6,0,-1,105830,94170
3:3:5,0,-1,105831,94169
4:6:6,0,-1,105832,94168
1:1:5,0,-1,105833,94167
6:6:1,0,-1,105834,94166
6:3:6,0,-1,105835,94165
1:2:1,1,1,105834,94166
5:4:4,0,-1,105835,94165
5:6:6,0,-1,105836,94164
5:6:4,0,-1,105837,94163
5:4:2,1,1,105836,94164
2:6:2,2,2,105834,94166
3:1:6,0,-1,105835,94165
6:4:3,0,-1,105836,94164
5:2:5,1,1,105835,94165
1:6:3,0,-1,105836,94164
2:6:2,2,2,105834,94166
2:1:6,1,1,105833,94167
4:5:3,0,-1,105834,94166
5:4:3,0,-1,105835,94165
6:4:5,0,-1,105836,94164
6:4:4,0,-1,105837,94163
1:1:6,0,-1,105838,94162
4:6:1,0,-1,105839,94161
5:6:4,0,-1,105840,94160
4:6:1,0,-1,105841,94159
5:1:4,0,-1,105842,94158
2:1:6,1,1,105841,94159
5:2:6,1,1,105840,94160
1:4:2,1,1,105839,94161
6:4:2,1,1,105838,94162
5:1:2,1,1,105837,94163
4:4:5,0,-1,105838,94162
5:2:6,1,1,105837,94163
1:4:2,1,1,105836,94164
1:2:5,1,1,105835,94165
1:4:5,0,-1,105836,94164
4:2:2,2,2,105834,94166
6:4:3,0,-1,105835,94165
5:6:3,0,-1,105836,94164
3:2:5,1,1,105835,94165
6:1:5,0,-1,105836,94164
5:6:2,1,1,105835,94165
5:4:5,0,-1,105836,94164
6:1:3,0,-1,105837,94163
2:1:5,1,1,105836,94164
1:5:6,0,-1,105837,94163
3:5:5,0,-1,105838,94162
2:2:3,2,2,105836,94164
4:2:3,1,1,105835,94165
5:5:2,1,1,105834,94166
6:6:6,0,-1,105835,94165
5:3:6,0,-1,105836,94164
5:2:4,1,1,105835,94165
2:1:4,1,1,105834,94166
3:2:5,1,1,105833,94167
1:2:4,1,1,105832,94168
4:3:2,1,1,105831,94169
3:3:6,0,-1,105832,94168
5:3:5,0,-1,105833,94167
5:6:4,0,-1,105834,94166
5:2:5,1,1,105833,94167
2:3:2,2,2,105831,94169
2:4:6,1,1,105830,94170
1:5:4,0,-1,105831,94169
1:1:2,1,1,105830,94170
4:2:6,1,1,105829,94171
2:4:2,2,2,105827,94173
1:1:1,0,-1,105828,94172
1:4:1,0,-1,105829,94171
1:2:2,2,2,105827,94173
6:5:5,0,-1,105828,94172
1:4:4,0,-1,105829,94171
4:2:1,1,1,105828,94172
6:5:4,0,-1,105829,94171
6:6:1,0,-1,105830,94170
6:4:1,0,-1,105831,94169
4:3:6,0,-1,105832,94168
5:3:1,0,-1,105833,94167
2:6:1,1,1,105832,94168
1:3:3,0,-1,105833,94167
6:1:2,1,1,105832,94168
1:4:5,0,-1,105833,94167
1:2:5,1,1,105832,94168
1:5:5,0,-1,105833,94167
1:2:4,1,1,105832,94168
2:3:1,1,1,105831,94169
6:1:1,0,-1,105832,94168
4:4:4,0,-1,105833,94167
6:6:6,0,-1,105834,94166
2:1:6,1,1,105833,94167
1:6:1,0,-1,105834,94166
2:2:5,2,2,105832,94168
1:5:3,0,-1,105833,94167
2:2:6,2,2,105831,94169
2:5:1,1,1,105830,94170
4:4:2,1,1,105829,94171
1:2:6,1,1,105828,94172
5:6:2,1,1,105827,94173
3:1:5,0,-1,105828,94172
2:2:2,3,3,105825,94175
3:4:1,0,-1,105826,94174
4:5:1,0,-1,105827,94173
4:3:6,0,-1,105828,94172
3:3:4,0,-1,105829,94171
5:6:4,0,-1,105830,94170
4:2:2,2,2,105828,94172
5:3:4,0,-1,105829,94171
3:1:6,0,-1,105830,94170
2:3:5,1,1,105829,94171
2:4:5,1,1,105828,94172
2:4:4,1,1,105827,94173
1:2:4,1,1,105826,94174
6:3:4,0,-1,105827,94173
3:2:5,1,1,105826,94174
5:2:2,2,2,105824,94176
1:3:2,1,1,105823,94177
4:5:2,1,1,105822,94178
5:4:2,1,1,105821,94179
5:6:5,0,-1,105822,94178
3:5:6,0,-1,105823,94177
1:6:5,0,-1,105824,94176
3:4:1,0,-1,105825,94175
1:6:6,0,-1,105826,94174
4:6:3,0,-1,105827,94173
6:6:4,0,-1,105828,94172
1:1:4,0,-1,105829,94171
5:5:4,0,-1,105830,94170
2:6:1,1,1,105829,94171
3:5:6,0,-1,105830,94170
4:1:3,0,-1,105831,94169
2:3:5,1,1,105830,94170
3:2:3,1,1,105829,94171
5:6:2,1,1,105828,94172
3:2:2,2,2,105826,94174
5:1:2,1,1,105825,94175
3:2:4,1,1,105824,94176
4:5:1,0,-1,105825,94175
2:6:6,1,1,105824,94176
6:3:1,0,-1,105825,94175
6:6:1,0,-1,105826,94174
3:1:3,0,-1,105827,94173
1:1:2,1,1,105826,94174
5:6:2,1,1,105825,94175
6:3:4,0,-1,105826,94174
1:6:5,0,-1,105827,94173
6:6:6,0,-1,105828,94172
2:4:3,1,1,105827,94173
1:5:6,0,-1,105828,94172
4:6:1,0,-1,105829,94171
1:6:1,0,-1,105830,94170
5:6:6,0,-1,105831,94169
6:2:5,1,1,105830,94170
3:1:3,0,-1,105831,94169
6:2:1,1,1,105830,94170
3:5:2,1,1,105829,94171
1:2:3,1,1,105828,94172
1:6:2,1,1,105827,94173
1:1:4,0,-1,105828,94172
6:2:2,2,2,105826,94174
6:6:3,0,-1,105827,94173
3:1:2,1,1,105826,94174
5:6:4,0,-1,105827,94173
6:2:4,1,1,105826,94174
3:6:4,0,-1,105827,94173
2:2:4,2,2,105825,94175
6:1:5,0,-1,105826,94174
1:6:2,1,1,105825,94175
2:3:5,1,1,105824,94176
2:1:4,1,1,105823,94177
6:5:2,1,1,105822,94178
1:6:3,0,-1,105823,94177
4:6:3,0,-1,105824,94176
4:2:6,1,1,105823,94177
6:5:2,1,1,105822,94178
4:3:3,0,-1,105823,94177
5:3:3,0,-1,105824,94176
2:3:6,1,1,105823,94177
6:1:6,0,-1,105824,94176
2:3:1,1,1,105823,94177
1:6:6,0,-1,105824,94176
1:3:3,0,-1,105825,94175
5:2:4,1,1,105824,94176
6:2:4,1,1,105823,94177
4:6:5,0,-1,105824,94176
4:2:6,1,1,105823,94177
5:6:2,1,1,105822,94178
4:6:3,0,-1,105823,94177
4:2:3,1,1,105822,94178
3:1:5,0,-1,105823,94177
2:2:2,3,3,105820,94180
6:2:4,1,1,105819,94181
6:2:5,1,1,105818,94182
4:6:5,0,-1,105819,94181
1:3:3,0,-1,105820,94180
5:4:1,0,-1,105821,94179
1:3:6,0,-1,105822,94178
5:4:4,0,-1,105823,94177
5:3:4,0,-1,105824,94176
3:1:1,0,-1,105825,94175
3:5:2,1,1,105824,94176
1:1:3,0,-1,105825,94175
2:1:1,1,1,105824,94176
2:2:3,2,2,105822,94178
5:2:5,1,1,105821,94179
2:5:4,1,1,105820,94180
1:4:6,0,-1,105821,94179
3:5:2,1,1,105820,94180
4:2:1,1,1,105819,94181
5:2:6,1,1,105818,94182
2:4:4,1,1,105817,94183
6:1:5,0,-1,105818,94182
2:1:4,1,1,105817,94183
3:4:5,0,-1,105818,94182
5:5:6,0,-1,105819,94181
4:2:6,1,1,105818,94182
5:2:2,2,2,105816,94184
4:6:5,0,-1,105817,94183
5:4:1,0,-1,105818,94182
1:5:5,0,-1,105819,94181
2:4:1,1,1,105818,94182
6:3:1,0,-1,105819,94181
4:1:3,0,-1,105820,94180
3:2:5,1,1,105819,94181
4:4:4,0,-1,105820,94180
1:2:6,1,1,105819,94181
3:3:5,0,-1,105820,94180
1:5:2,1,1,105819,94181
2:3:5,1,1,105818,94182
1:6:6,0,-1,105819,94181
1:2:1,1,1,105818,94182
4:3:2,1,1,105817,94183
2:6:6,1,1,105816,94184
2:1:3,1,1,105815,94185
3:3:3,0,-1,105816,94184
6:6:5,0,-1,105817,94183
1:1:4,0,-1,105818,94182
1:4:5,0,-1,105819,94181
5:4:5,0,-1,105820,94180
6:4:3,0,-1,105821,94179
3:3:2,1,1,105820,94180
3:4:4,0,-1,105821,94179
6:5:3,0,-1,105822,94178
4:4:5,0,-1,105823,94177
4:5:4,0,-1,105824,94176
4:4:5,0,-1,105825,94175
5:2:5,1,1,105824,94176
1:1:2,1,1,105823,94177
1:1:3,0,-1,105824,94176
5:2:4,1,1,105823,94177
6:6:5,0,-1,105824,94176
4:3:6,0,-1,105825,94175
6:2:1,1,1,105824,94176
5:1:4,0,-1,105825,94175
2:5:3,1,1,105824,94176
2:5:5,1,1,105823,94177
6:1:3,0,-1,105824,94176
4:2:6,1,1,105823,94177
4:5:3,0,-1,105824,94176
1:3:4,0,-1,105825,94175
2:3:6,1,1,105824,94176
3:4:3,0,-1,105825,94175
2:6:4,1,1,105824,94176
2:3:5,1,1,105823,94177
2:6:1,1,1,105822,94178
6:2:5,1,1,105821,94179
3:6:4,0,-1,105822,94178
1:5:3,0,-1,105823,94177
6:2:6,1,1,105822,94178
6:4:2,1,1,105821,94179
1:5:4,0,-1,105822,94178
3:4:4,0,-1,105823,94177
1:5:4,0,-1,105824,94176
3:5:4,0,-1,105825,94175
6:3:6,0,-1,105826,94174
4:4:1,0,-1,105827,94173
5:5:6,0,-1,105828,94172
1:5:1,0,-1,105829,94171
1:4:4,0,-1,105830,94170
1:2:2,2,2,105828,94172
1:1:4,0,-1,105829,94171
3:6:5,0,-1,105830,94170
1:2:5,1,1,105829,94171
4:3:3,0,-1,105830,94170
2:3:4,1,1,105829,94171
4:3:2,1,1,105828,94172
4:2:1,1,1,105827,94173
1:6:4,0,-1,105828,94172
4:1:1,0,-1,105829,94171
5:1:5,0,-1,105830,94170
3:5:2,1,1,105829,94171
1:1:3,0,-1,105830,94170
5:6:5,0,-1,105831,94169
1:1:2,1,1,105830,94170
5:6:1,0,-1,105831,94169
3:5:1,0,-1,105832,94168
2:1:4,1,1,105831,94169
6:6:6,0,-1,105832,94168
6:1:3,0,-1,105833,94167
4:2:2,2,2,105831,94169
4:3:4,0,-1,105832,94168
5:2:3,1,1,105831,94169
4:3:1,0,-1,105832,94168
5:3:3,0,-1,105833,94167
6:1:5,0,-1,105834,94166
3:3:5,0,-1,105835,94165
2:1:3,1,1,105834,94166
2:3:1,1,1,105833,94167
6:3:3,0,-1,105834,94166
1:3:5,0,-1,105835,94165
6:1:2,1,1,105834,94166
5:6:6,0,-1,105835,94165
3:5:2,1,1,105834,94166
5:2:1,1,1,105833,94167
1:5:4,0,-1,105834,94166
6:2:1,1,1,105833,94167
1:4:6,0,-1,105834,94166
4:6:1,0,-1,105835,94165
5:3:3,0,-1,105836,94164
2:3:2,2,2,105834,94166
5:4:5,0,-1,105835,94165
4:6:1,0,-1,105836,94164
5:3:2,1,1,105835,94165
2:6:4,1,1,105834,94166
3:1:2,1,1,105833,94167
4:4:5,0,-1,105834,94166
2:4:1,1,1,105833,94167
5:5:2,1,1,105832,94168
4:2:2,2,2,105830,94170
2:3:5,1,1,105829,94171
4:2:2,2,2,105827,94173
4:3:5,0,-1,105828,94172
4:4:1,0,-1,105829,94171
5:3:4,0,-1,105830,94170
5:2:6,1,1,105829,94171
4:3:3,0,-1,105830,94170
6:4:2,1,1,105829,94171
5:3:1,0,-1,105830,94170
1:6:4,0,-1,105831,94169
6:3:1,0,-1,105832,94168
3:1:2,1,1,105831,94169
6:1:4,0,-1,105832,94168
1:4:2,1,1,105831,94169
6:1:1,0,-1,105832,94168
4:1:2,1,1,105831,94169
6:6:5,0,-1,105832,94168
3:5:4,0,-1,105833,94167
2:4:4,1,1,105832,94168
5:6:6,0,-1,105833,94167
5:6:2,1,1,105832,94168
1:4:4,0,-1,105833,94167
5:4:2,1,1,105832,94168
2:1:1,1,1,105831,94169
4:4:4,0,-1,105832,94168
2:6:1,1,1,105831,94169
2:2:3,2,2,105829,94171
6:2:1,1,1,105828,94172
5:2:4,1,1,105827,94173
4:4:5,0,-1,105828,94172
3:6:2,1,1,105827,94173
4:6:2,1,1,105826,94174
6:1:2,1,1,105825,94175
3:3:3,0,-1,105826,94174
4:3:3,0,-1,105827,94173
2:4:5,1,1,105826,94174
1:4:2,1,1,105825,94175
6:6:3,0,-1,105826,94174
1:5:5,0,-1,105827,94173
5:1:5,0,-1,105828,94172
5:1:2,1,1,105827,94173
1:2:1,1,1,105826,94174
2:6:2,2,2,105824,94176
1:4:1,0,-1,105825,94175
5:2:5,1,1,105824,94176
5:3:2,1,1,105823,94177
4:5:6,0,-1,105824,94176
2:6:6,1,1,105823,94177
4:4:1,0,-1,105824,94176
2:2:2,3,3,105821,94179
1:6:2,1,1,105820,94180
5:5:1,0,-1,105821,94179
5:3:4,0,-1,105822,94178
6:1:4,0,-1,105823,94177
1:3:5,0,-1,105824,94176
2:1:1,1,1,105823,94177
1:5:3,0,-1,105824,94176
3:1:2,1,1,105823,94177
3:5:5,0,-1,105824,94176
3:6:3,0,-1,105825,94175
3:3:3,0,-1,105826,94174
5:3:3,0,-1,105827,94173
5:4:5,0,-1,105828,94172
4:1:1,0,-1,105829,94171
4:4:1,0,-1,105830,94170
3:4:1,0,-1,105831,94169
5:3:4,0,-1,105832,94168
4:2:5,1,1,105831,94169
4:1:2,1,1,105830,94170
4:6:5,0,-1,105831,94169
2:6:5,1,1,105830,94170
6:3:5,0,-1,105831,94169
2:2:6,2,2,105829,94171
5:2:5,1,1,105828,94172
5:4:3,0,-1,105829,94171
6:2:5,1,1,105828,94172
6:3:6,0,-1,105829,94171
4:6:3,0,-1,105830,94170
2:2:2,3,3,105827,94173
6:4:2,1,1,105826,94174
1:4:5,0,-1,105827,94173
5:5:4,0,-1,105828,94172
5:2:6,1,1,105827,94173
5:4:2,1,1,105826,94174
3:4:5,0,-1,105827,94173
5:1:1,0,-1,105828,94172
3:6:3,0,-1,105829,94171
3:4:3,0,-1,105830,94170
2:5:6,1,1,105829,94171
1:4:6,0,-1,105830,94170
2:4:6,1,1,105829,94171
2:4:5,1,1,105828,94172
2:4:3,1,1,105827,94173
4:1:4,0,-1,105828,94172
6:4:3,0,-1,105829,94171
1:5:2,1,1,105828,94172
2:6:2,2,2,105826,94174
3:5:2,1,1,105825,94175
1:2:5,1,1,105824,94176
1:6:2,1,1,105823,94177
3:5:6,0,-1,105824,94176
1:2:2,2,2,105822,94178
6:4:3,0,-1,105823,94177
3:1:4,0,-1,105824,94176
6:3:6,0,-1,105825,94175
1:5:5,0,-1,105826,94174
3:4:6,0,-1,105827,94173
6:5:4,0,-1,105828,94172
3:2:3,1,1,105827,94173
1:4:3,0,-1,105828,94172
2:4:1,1,1,105827,94173
6:3:4,0,-1,105828,94172
1:5:4,0,-1,105829,94171
5:6:1,0,-1,105830,94170
2:2:2,3,3,105827,94173
1:4:4,0,-1,105828,94172
1:2:3,1,1,105827,94173
1:2:6,1,1,105826,94174
6:5:1,0,-1,105827,94173
6:2:3,1,1,105826,94174
5:6:6,0,-1,105827,94173
2:6:4,1,1,105826,94174
6:5:2,1,1,105825,94175
2:5:1,1,1,105824,94176
4:4:2,1,1,105823,94177
6:4:4,0,-1,105824,94176
3:6:4,0,-1,105825,94175
5:1:6,0,-1,105826,94174
4:6:1,0,-1,105827,94173
1:6:2,1,1,105826,94174
4:6:5,0,-1,105827,94173
5:2:3,1,1,105826,94174
6:1:5,0,-1,105827,94173
6:4:4,0,-1,105828,94172
1:4:2,1,1,105827,94173
5:5:6,0,-1,105828,94172
3:5:6,0,-1,105829,94171
5:3:6,0,-1,105830,94170
5:2:5,1,1,105829,94171
3:5:1,0,-1,105830,94170
1:6:2,1,1,105829,94171
1:4:2,1,1,105828,94172
6:5:4,0,-1,105829,94171
6:4:1,0,-1,105830,94170
5:6:5,0,-1,105831,94169
3:4:6,0,-1,105832,94168
4:2:3,1,1,105831,94169
1:3:6,0,-1,105832,94168
6:4:6,0,-1,105833,94167
1:5:5,0,-1,105834,94166
3:6:2,1,1,105833,94167
1:3:6,0,-1,105834,94166
5:4:3,0,-1,105835,94165
4:6:5,0,-1,105836,94164
3:5:6,0,-1,105837,94163
6:3:4,0,-1,105838,94162
3:3:2,1,1,105837,94163
6:3:1,0,-1,105838,94162
1:4:3,0,-1,105839,94161
1:4:4,0,-1,105840,94160
2:5:4,1,1,105839,94161
6:4:5,0,-1,105840,94160
2:4:2,2,2,105838,94162
2:6:1,1,1,105837,94163
4:3:3,0,-1,105838,94162
3:6:6,0,-1,105839,94161
2:3:4,1,1,105838,94162
2:6:2,2,2,105836,94164
5:4:3,0,-1,105837,94163
4:3:5,0,-1,105838,94162
4:1:2,1,1,105837,94163
5:2:6,1,1,105836,94164
6:2:1,1,1,105835,94165
1:4:5,0,-1,105836,94164
1:4:6,0,-1,105837,94163
3:6:3,0,-1,105838,94162
5:5:1,0,-1,105839,94161
6:4:6,0,-1,105840,94160
2:1:4,1,1,105839,94161
6:6:6,0,-1,105840,94160
3:3:2,1,1,105839,94161
3:2:4,1,1,105838,94162
3:3:3,0,-1,105839,94161
3:5:4,0,-1,105840,94160
5:4:2,1,1,105839,94161
2:2:4,2,2,105837,94163
5:2:5,1,1,105836,94164
4:4:5,0,-1,105837,94163
3:6:5,0,-1,105838,94162
5:3:1,0,-1,105839,94161
6:6:2,1,1,105838,94162
6:5:6,0,-1,105839,94161
1:1:5,0,-1,105840,94160
2:2:1,2,2,105838,94162
4:1:1,0,-1,105839,94161
5:3:6,0,-1,105840,94160
1:6:1,0,-1,105841,94159
5:1:1,0,-1,105842,94158
4:2:6,1,1,105841,94159
5:5:5,0,-1,105842,94158
6:1:2,1,1,105841,94159
3:4:3,0,-1,105842,94158
2:6:6,1,1,105841,94159
5:5:6,0,-1,105842,94158
4:4:3,0,-1,105843,94157
6:6:5,0,-1,105844,94156
4:5:2,1,1,105843,94157
4:2:5,1,1,105842,94158
3:4:1,0,-1,105843,94157
2:4:2,2,2,105841,94159
6:2:4,1,1,105840,94160
4:6:5,0,-1,105841,94159
1:5:2,1,1,105840,94160
4:4:3,0,-1,105841,94159
5:6:1,0,-1,105842,94158
5:5:3,0,-1,105843,94157
2:5:4,1,1,105842,94158
2:4:4,1,1,105841,94159
5:2:6,1,1,105840,94160
2:3:6,1,1,105839,94161
2:6:2,2,2,105837,94163
3:4:6,0,-1,105838,94162
3:5:1,0,-1,105839,94161
3:4:6,0,-1,105840,94160
4:1:1,0,-1,105841,94159
6:3:1,0,-1,105842,94158
6:2:6,1,1,105841,94159
2:6:1,1,1,105840,94160
1:4:3,0,-1,105841,94159
2:6:5,1,1,105840,94160
2:1:6,1,1,105839,94161
5:3:6,0,-1,105840,94160
3:1:3,0,-1,105841,94159
1:5:4,0,-1,105842,94158
6:5:6,0,-1,105843,94157
5:2:2,2,2,105841,94159
4:6:4,0,-1,105842,94158
1:4:6,0,-1,105843,94157
2:3:2,2,2,105841,94159
3:1:1,0,-1,105842,94158
3:5:5,0,-1,105843,94157
2:4:5,1,1,105842,94158
2:6:5,1,1,105841,94159
4:4:3,0,-1,105842,94158
5:4:2,1,1,105841,94159
5:1:4,0,-1,105842,94158
2:2:2,3,3,105839,94161
6:3:1,0,-1,105840,94160
1:1:1,0,-1,105841,94159
5:4:3,0,-1,105842,94158
2:2:2,3,3,105839,94161
4:6:5,0,-1,105840,94160
5:2:5,1,1,105839,94161
1:5:4,0,-1,105840,94160
3:6:3,0,-1,105841,94159
5:2:2,2,2,105839,94161
2:2:3,2,2,105837,94163
1:6:4,0,-1,105838,94162
5:6:4,0,-1,105839,94161
3:5:5,0,-1,105840,94160
6:5:2,1,1,105839,94161
1:5:2,1,1,105838,94162
5:4:2,1,1,105837,94163
3:5:5,0,-1,105838,94162
4:5:4,0,-1,105839,94161
1:5:1,0,-1,105840,94160
4:1:3,0,-1,105841,94159
3:2:5,1,1,105840,94160
5:4:2,1,1,105839,94161
6:5:2,1,1,105838,94162
6:5:5,0,-1,105839,94161
1:2:1,1,1,105838,94162
3:1:2,1,1,105837,94163
3:3:5,0,-1,105838,94162
3:3:1,0,-1,105839,94161
5:5:1,0,-1,105840,94160
6:2:2,2,2,105838,94162
5:5:1,0,-1,105839,94161
4:5:5,0,-1,105840,94160
3:4:4,0,-1,105841,94159
4:1:5,0,-1,105842,94158
5:6:5,0,-1,105843,94157
1:4:1,0,-1,105844,94156
3:1:1,0,-1,105845,94155
3:3:1,0,-1,105846,94154
5:5:1,0,-1,105847,94153
2:2:3,2,2,105845,94155
1:3:6,0,-1,105846,94154
1:1:2,1,1,105845,94155
2:4:2,2,2,105843,94157
6:2:3,1,1,105842,94158
3:1:3,0,-1,105843,94157
6:1:5,0,-1,105844,94156
5:1:1,0,-1,105845,94155
2:3:3,1,1,105844,94156
3:2:3,1,1,105843,94157
5:2:3,1,1,105842,94158
6:3:3,0,-1,105843,94157
5:5:1,0,-1,105844,94156
1:1:2,1,1,105843,94157
5:3:4,0,-1,105844,94156
3:5:4,0,-1,105845,94155
1:2:4,1,1,105844,94156
4:4:4,0,-1,105845,94155
1:1:4,0,-1,105846,94154
3:1:6,0,-1,105847,94153
2:3:2,2,2,105845,94155
2:5:1,1,1,105844,94156
3:4:1,0,-1,105845,94155
5:4:3,0,-1,105846,94154
4:2:5,1,1,105845,94155
5:6:4,0,-1,105846,94154
1:6:6,0,-1,105847,94153
3:6:6,0,-1,105848,94152
3:5:2,1,1,105847,94153
1:4:2,1,1,105846,94154
2:2:1,2,2,105844,94156
6:6:5,0,-1,105845,94155
5:6:3,0,-1,105846,94154
1:3:5,0,-1,105847,94153
1:4:5,0,-1,105848,94152
2:2:3,2,2,105846,94154
6:3:4,0,-1,105847,94153
1:6:1,0,-1,105848,94152
6:5:5,0,-1,105849,94151
3:1:2,1,1,105848,94152
1:1:5,0,-1,105849,94151
2:2:1,2,2,105847,94153
1:6:1,0,-1,105848,94152
5:3:4,0,-1,105849,94151
1:4:2,1,1,105848,94152
4:1:2,1,1,105847,94153
4:6:5,0,-1,105848,94152
4:5:6,0,-1,105849,94151
5:6:1,0,-1,105850,94150
5:4:4,0,-1,105851,94149
3:1:1,0,-1,105852,94148
2:4:3,1,1,105851,94149
3:5:1,0,-1,105852,94148
3:5:1,0,-1,105853,94147
3:6:5,0,-1,105854,94146
5:4:6,0,-1,105855,94145
2:3:5,1,1,105854,94146
4:5:3,0,-1,105855,94145
4:1:3,0,-1,105856,94144
4:2:1,1,1,105855,94145
5:5:6,0,-1,105856,94144
5:3:4,0,-1,105857,94143
1:2:2,2,2,105855,94145
1:4:3,0,-1,105856,94144
2:4:2,2,2,105854,94146
4:1:4,0,-1,105855,94145
6:3:6,0,-1,105856,94144
3:2:6,1,1,105855,94145
5:3:5,0,-1,105856,94144
2:2:3,2,2,105854,94146
3:6:4,0,-1,105855,94145
6:3:4,0,-1,105856,94144
5:2:1,1,1,105855,94145
6:2:1,1,1,105854,94146
4:4:4,0,-1,105855,94145
4:2:5,1,1,105854,94146
3:1:6,0,-1,105855,94145
2:2:1,2,2,105853,94147
5:4:6,0,-1,105854,94146
2:5:4,1,1,105853,94147
6:5:1,0,-1,105854,94146
4:1:1,0,-1,105855,94145
4:2:4,1,1,105854,94146
2:4:2,2,2,105852,94148
5:4:6,0,-1,105853,94147
5:1:1,0,-1,105854,94146
5:2:1,1,1,105853,94147
2:4:5,1,1,105852,94148
2:3:2,2,2,105850,94150
2:1:4,1,1,105849,94151
6:3:5,0,-1,105850,94150
1:2:2,2,2,105848,94152
1:4:5,0,-1,105849,94151
5:3:3,0,-1,105850,94150
2:1:1,1,1,105849,94151
2:6:3,1,1,105848,94152
5:3:6,0,-1,105849,94151
4:2:1,1,1,105848,94152
6:4:1,0,-1,105849,94151
3:6:6,0,-1,105850,94150
5:4:1,0,-1,105851,94149
1:1:1,0,-1,105852,94148
1:2:6,1,1,105851,94149
3:3:2,1,1,105850,94150
3:2:4,1,1,105849,94151
2:2:3,2,2,105847,94153
4:3:2,1,1,105846,94154
4:5:6,0,-1,105847,94153
1:6:1,0,-1,105848,94152
2:5:2,2,2,105846,94154
5:4:1,0,-1,105847,94153
5:2:6,1,1,105846,94154
1:4:1,0,-1,105847,94153
2:4:4,1,1,105846,94154
6:5:6,0,-1,105847,94153
2:4:6,1,1,105846,94154
4:5:1,0,-1,105847,94153
3:3:4,0,-1,105848,94152
6:5:6,0,-1,105849,94151
3:1:6,0,-1,105850,94150
5:5:1,0,-1,105851,94149
3:6:2,1,1,105850,94150
3:3:5,0,-1,105851,94149
3:2:3,1,1,105850,94150
5:5:1,0,-1,105851,94149
6:5:6,0,-1,105852,94148
3:6:1,0,-1,105853,94147
3:1:4,0,-1,105854,94146
4:6:2,1,1,105853,94147
2:2:3,2,2,105851,94149
4:6:2,1,1,105850,94150
5:3:1,0,-1,105851,94149
6:4:4,0,-1,105852,94148
4:2:6,1,1,105851,94149
6:5:4,0,-1,105852,94148
6:2:2,2,2,105850,94150
4:5:2,1,1,105849,94151
5:2:3,1,1,105848,94152
3:4:1,0,-1,105849,94151
4:6:3,0,-1,105850,94150
6:6:5,0,-1,105851,94149
2:1:1,1,1,105850,94150
2:2:3,2,2,105848,94152
6:1:5,0,-1,105849,94151
2:2:4,2,2,105847,94153
2:2:5,2,2,105845,94155
5:5:1,0,-1,105846,94154
1:5:1,0,-1,105847,94153
2:6:5,1,1,105846,94154
3:1:4,0,-1,105847,94153
6:4:5,0,-1,105848,94152
1:1:3,0,-1,105849,94151
2:1:4,1,1,105848,94152
6:4:5,0,-1,105849,94151
3:1:6,0,-1,105850,94150
6:2:2,2,2,105848,94152
1:2:6,1,1,105847,94153
4:2:3,1,1,105846,94154
4:1:6,0,-1,105847,94153
1:5:3,0,-1,105848,94152
6:4:1,0,-1,105849,94151
2:5:3,1,1,105848,94152
5:6:6,0,-1,105849,94151
5:5:5,0,-1,105850,94150
5:1:6,0,-1,105851,94149
5:1:3,0,-1,105852,94148
2:5:3,1,1,105851,94149
3:5:5,0,-1,105852,94148
1:5:5,0,-1,105853,94147
2:6:2,2,2,105851,94149
4:4:5,0,-1,105852,94148
1:4:6,0,-1,105853,94147
4:4:2,1,1,105852,94148
2:6:4,1,1,105851,94149
3:2:4,1,1,105850,94150
1:4:1,0,-1,105851,94149
5:1:4,0,-1,105852,94148
4:6:4,0,-1,105853,94147
5:2:5,1,1,105852,94148
5:3:6,0,-1,105853,94147
4:3:5,0,-1,105854,94146
6:3:5,0,-1,105855,94145
4:6:2,1,1,105854,94146
3:1:4,0,-1,105855,94145
5:2:2,2,2,105853,94147
2:5:5,1,1,105852,94148
4:2:5,1,1,105851,94149
4:3:4,0,-1,105852,94148
6:4:5,0,-1,105853,94147
5:4:3,0,-1,105854,94146
2:5:2,2,2,105852,94148
6:5:3,0,-1,105853,94147
2:6:3,1,1,105852,94148
3:5:2,1,1,105851,94149
2:5:3,1,1,105850,94150
2:4:3,1,1,105849,94151
2:1:1,1,1,105848,94152
4:6:6,0,-1,105849,94151
2:3:3,1,1,105848,94152
4:6:1,0,-1,105849,94151
3:3:2,1,1,105848,94152
1:5:1,0,-1,105849,94151
5:2:2,2,2,105847,94153
5:1:4,0,-1,105848,94152
1:4:3,0,-1,105849,94151
1:6:1,0,-1,105850,94150
5:5:2,1,1,105849,94151
4:5:1,0,-1,105850,94150
1:1:4,0,-1,105851,94149
4:3:5,0,-1,105852,94148
6:2:1,1,1,105851,94149
6:2:6,1,1,105850,94150
5:5:4,0,-1,105851,94149
3:2:2,2,2,105849,94151
1:1:1,0,-1,105850,94150
3:1:5,0,-1,105851,94149
6:3:4,0,-1,105852,94148
2:4:3,1,1,105851,94149
2:5:6,1,1,105850,94150
6:4:3,0,-1,105851,94149
5:4:2,1,1,105850,94150
4:6:6,0,-1,105851,94149
3:2:4,1,1,105850,94150
5:6:3,0,-1,105851,94149
4:4:2,1,1,105850,94150
3:4:4,0,-1,105851,94149
5:6:4,0,-1,105852,94148
1:5:4,0,-1,105853,94147
4:4:6,0,-1,105854,94146
4:5:2,1,1,105853,94147
5:3:2,1,1,105852,94148
4:6:4,0,-1,105853,94147
2:3:5,1,1,105852,94148
1:4:5,0,-1,105853,94147
1:3:5,0,-1,105854,94146
5:6:1,0,-1,105855,94145
2:3:5,1,1,105854,94146
1:3:2,1,1,105853,94147
6:1:1,0,-1,105854,94146
4:5:6,0,-1,105855,94145
4:4:2,1,1,105854,94146
6:5:4,0,-1,105855,94145
6:6:6,0,-1,105856,94144
4:3:6,0,-1,105857,94143
5:2:3,1,1,105856,94144
3:4:6,0,-1,105857,94143
1:1:5,0,-1,105858,94142
4:1:5,0,-1,105859,94141
3:2:5,1,1,105858,94142
3:5:5,0,-1,105859,94141
5:2:5,1,1,105858,94142
3:2:5,1,1,105857,94143
1:1:6,0,-1,105858,94142
2:2:1,2,2,105856,94144
4:3:6,0,-1,105857,94143
2:4:3,1,1,105856,94144
4:6:3,0,-1,105857,94143
4:2:4,1,1,105856,94144
4:3:4,0,-1,105857,94143
5:4:3,0,-1,105858,94142
4:2:1,1,1,105857,94143
2:6:4,1,1,105856,94144
1:1:4,0,-1,105857,94143
6:6:3,0,-1,105858,94142
4:5:2,1,1,105857,94143
5:6:6,0,-1,105858,94142
3:5:4,0,-1,105859,94141
2:2:1,2,2,105857,94143
4:6:4,0,-1,105858,94142
3:3:3,0,-1,105859,94141
4:3:6,0,-1,105860,94140
4:4:2,1,1,105859,94141
3:4:3,0,-1,105860,94140
2:4:1,1,1,105859,94141
1:5:4,0,-1,105860,94140
1:2:1,1,1,105859,94141
3:4:1,0,-1,105860,94140
4:2:3,1,1,105859,94141
4:5:4,0,-1,105860,94140
6:1:3,0,-1,105861,94139
4:2:5,1,1,105860,94140
2:3:1,1,1,105859,94141
4:3:3,0,-1,105860,94140
4:5:6,0,-1,105861,94139
3:5:6,0,-1,105862,94138
3:6:6,0,-1,105863,94137
6:3:2,1,1,105862,94138
3:4:5,0,-1,105863,94137
5:3:4,0,-1,105864,94136
6:4:1,0,-1,105865,94135
4:2:2,2,2,105863,94137
6:1:2,1,1,105862,94138
1:2:5,1,1,105861,94139
2:1:4,1,1,105860,94140
3:3:3,0,-1,105861,94139
3:6:1,0,-1,105862,94138
2:5:2,2,2,105860,94140
6:3:4,0,-1,105861,94139
1:2:5,1,1,105860,94140
2:5:6,1,1,105859,94141
1:5:4,0,-1,105860,94140
4:6:1,0,-1,105861,94139
2:1:1,1,1,105860,94140
1:5:6,0,-1,105861,94139
4:4:2,1,1,105860,94140
4:5:2,1,1,105859,94141
3:2:1,1,1,105858,94142
1:2:4,1,1,105857,94143
5:6:4,0,-1,105858,94142
2:2:5,2,2,105856,94144
3:4:2,1,1,105855,94145
2:3:4,1,1,105854,94146
5:6:2,1,1,105853,94147
3:4:6,0,-1,105854,94146
3:5:5,0,-1,105855,94145
6:3:6,0,-1,105856,94144
5:1:4,0,-1,105857,94143
5:5:5,0,-1,105858,94142
6:3:3,0,-1,105859,94141
3:1:5,0,-1,105860,94140
6:4:2,1,1,105859,94141
6:4:1,0,-1,105860,94140
3:2:3,1,1,105859,94141
2:6:6,1,1,105858,94142
6:2:4,1,1,105857,94143
6:6:3,0,-1,105858,94142
2:6:1,1,1,105857,94143
3:2:1,1,1,105856,94144
3:3:5,0,-1,105857,94143
4:3:2,1,1,105856,94144
6:5:5,0,-1,105857,94143
5:4:1,0,-1,105858,94142
6:6:3,0,-1,105859,94141
5:1:4,0,-1,105860,94140
4:4:1,0,-1,105861,94139
1:4:1,0,-1,105862,94138
3:4:3,0,-1,105863,94137
6:3:4,0,-1,105864,94136
1:1:3,0,-1,105865,94135
6:1:2,1,1,105864,94136
3:2:4,1,1,105863,94137
1:6:4,0,-1,105864,94136
5:3:2,1,1,105863,94137
1:1:1,0,-1,105864,94136
6:6:1,0,-1,105865,94135
6:5:4,0,-1,105866,94134
2:6:1,1,1,105865,94135
4:2:3,1,1,105864,94136
5:4:3,0,-1,105865,94135
4:2:6,1,1,105864,94136
3:1:4,0,-1,105865,94135
1:5:4,0,-1,105866,94134
5:2:6,1,1,105865,94135
4:2:2,2,2,105863,94137
4:3:5,0,-1,105864,94136
5:5:1,0,-1,105865,94135
1:2:5,1,1,105864,94136
1:3:5,0,-1,105865,94135
2:3:4,1,1,105864,94136
5:3:4,0,-1,105865,94135
4:5:2,1,1,105864,94136
6:6:6,0,-1,105865,94135
2:4:1,1,1,105864,94136
1:2:6,1,1,105863,94137
5:5:5,0,-1,105864,94136
6:3:4,0,-1,105865,94135
2:4:4,1,1,105864,94136
6:6:5,0,-1,105865,94135
4:1:2,1,1,105864,94136
5:5:4,0,-1,105865,94135
1:1:2,1,1,105864,94136
4:2:5,1,1,105863,94137
5:2:1,1,1,105862,94138
1:5:5,0,-1,105863,94137
6:6:6,0,-1,105864,94136
5:4:1,0,-1,105865,94135
4:2:1,1,1,105864,94136
6:3:5,0,-1,105865,94135
6:1:2,1,1,105864,94136
2:1:3,1,1,105863,94137
5:6:4,0,-1,105864,94136
4:1:3,0,-1,105865,94135
6:4:2,1,1,105864,94136
6:5:2,1,1,105863,94137
6:2:5,1,1,105862,94138
4:4:6,0,-1,105863,94137
3:5:4,0,-1,105864,94136
5:2:1,1,1,105863,94137
3:1:4,0,-1,105864,94136
4:2:4,1,1,105863,94137
2:4:6,1,1,105862,94138
4:3:2,1,1,105861,94139
2:2:1,2,2,105859,94141
6:3:4,0,-1,105860,94140
4:3:5,0,-1,105861,94139
4:4:6,0,-1,105862,94138
3:1:4,0,-1,105863,94137
1:2:6,1,1,105862,94138
3:3:6,0,-1,105863,94137
2:5:5,1,1,105862,94138
3:2:2,2,2,105860,94140
4:4:4,0,-1,105861,94139
1:3:3,0,-1,105862,94138
1:4:2,1,1,105861,94139
3:3:4,0,-1,105862,94138
5:4:3,0,-1,105863,94137
2:2:5,2,2,105861,94139
3:1:6,0,-1,105862,94138
4:4:3,0,-1,105863,94137
4:2:3,1,1,105862,94138
2:2:4,2,2,105860,94140
3:2:6,1,1,105859,94141
3:5:3,0,-1,105860,94140
5:4:6,0,-1,105861,94139
2:1:1,1,1,105860,94140
5:5:6,0,-1,105861,94139
1:3:1,0,-1,105862,94138
1:5:3,0,-1,105863,94137
2:5:2,2,2,105861,94139
4:2:1,1,1,105860,94140
3:4:4,0,-1,105861,94139
5:1:4,0,-1,105862,94138
4:6:2,1,1,105861,94139
3:4:5,0,-1,105862,94138
4:6:6,0,-1,105863,94137
5:3:6,0,-1,105864,94136
2:5:3,1,1,105863,94137
2:1:3,1,1,105862,94138
6:1:1,0,-1,105863,94137
6:2:2,2,2,105861,94139
1:6:2,1,1,105860,94140
3:6:5,0,-1,105861,94139
3:6:5,0,-1,105862,94138
5:1:4,0,-1,105863,94137
4:4:2,1,1,105862,94138
1:5:3,0,-1,105863,94137
6:6:4,0,-1,105864,94136
6:6:6,0,-1,105865,94135
4:5:6,0,-1,105866,94134
4:6:1,0,-1,105867,94133
3:3:4,0,-1,105868,94132
3:5:2,1,1,105867,94133
6:2:5,1,1,105866,94134
2:6:2,2,2,105864,94136
1:6:4,0,-1,105865,94135
3:4:3,0,-1,105866,94134
2:4:3,1,1,105865,94135
4:4:2,1,1,105864,94136
3:6:5,0,-1,105865,94135
6:3:1,0,-1,105866,94134
4:5:6,0,-1,105867,94133
5:3:1,0,-1,105868,94132
4:5:5,0,-1,105869,94131
5:3:4,0,-1,105870,94130
5:1:2,1,1,105869,94131
4:1:2,1,1,105868,94132
3:1:2,1,1,105867,94133
4:6:4,0,-1,105868,94132
1:3:5,0,-1,105869,94131
4:5:4,0,-1,105870,94130
2:3:5,1,1,105869,94131
5:3:1,0,-1,105870,94130
3:1:6,0,-1,105871,94129
1:1:1,0,-1,105872,94128
1:5:1,0,-1,105873,94127
4:3:6,0,-1,105874,94126
2:1:3,1,1,105873,94127
3:3:2,1,1,105872,94128
2:4:2,2,2,105870,94130
4:4:5,0,-1,105871,94129
1:3:1,0,-1,105872,94128
6:1:1,0,-1,105873,94127
6:2:5,1,1,105872,94128
6:5:6,0,-1,105873,94127
6:4:3,0,-1,105874,94126
4:6:2,1,1,105873,94127
6:1:1,0,-1,105874,94126
4:5:4,0,-1,105875,94125
5:6:3,0,-1,105876,94124
2:3:3,1,1,105875,94125
6:1:5,0,-1,105876,94124
1:1:4,0,-1,105877,94123
4:5:5,0,-1,105878,94122
4:2:6,1,1,105877,94123
4:5:6,0,-1,105878,94122
5:4:5,0,-1,105879,94121
2:6:2,2,2,105877,94123
6:6:2,1,1,105876,94124
3:6:2,1,1,105875,94125
2:5:2,2,2,105873,94127
3:3:2,1,1,105872,94128
2:5:2,2,2,105870,94130
6:5:3,0,-1,105871,94129
2:3:2,2,2,105869,94131
1:5:3,0,-1,105870,94130
5:1:3,0,-1,105871,94129
4:4:2,1,1,105870,94130
5:6:4,0,-1,105871,94129
5:6:6,0,-1,105872,94128
4:1:5,0,-1,105873,94127
4:1:5,0,-1,105874,94126
3:2:2,2,2,105872,94128
1:3:2,1,1,105871,94129
3:6:3,0,-1,105872,94128
6:1:5,0,-1,105873,94127
3:4:5,0,-1,105874,94126
5:2:2,2,2,105872,94128
6:3:3,0,-1,105873,94127
2:1:1,1,1,105872,94128
4:3:3,0,-1,105873,94127
1:2:5,1,1,105872,94128
2:2:3,2,2,105870,94130
5:6:3,0,-1,105871,94129
1:2:2,2,2,105869,94131
5:5:1,0,-1,105870,94130
6:6:1,0,-1,105871,94129
5:4:3,0,-1,105872,94128
1:5:2,1,1,105871,94129
6:1:1,0,-1,105872,94128
2:4:4,1,1,105871,94129
2:1:5,1,1,105870,94130
2:5:6,1,1,105869,94131
2:1:2,2,2,105867,94133
4:6:6,0,-1,105868,94132
6:2:4,1,1,105867,94133
3:1:6,0,-1,105868,94132
2:5:5,1,1,105867,94133
3:5:6,0,-1,105868,94132
4:5:2,1,1,105867,94133
2:4:4,1,1,105866,94134
4:4:4,0,-1,105867,94133
1:2:2,2,2,105865,94135
6:3:1,0,-1,105866,94134
4:3:3,0,-1,105867,94133
2:4:4,1,1,105866,94134
6:4:3,0,-1,105867,94133
3:6:2,1,1,105866,94134
4:6:1,0,-1,105867,94133
3:3:5,0,-1,105868,94132
2:3:4,1,1,105867,94133
6:6:6,0,-1,105868,94132
5:6:2,1,1,105867,94133
3:3:4,0,-1,105868,94132
3:2:6,1,1,105867,94133
3:6:1,0,-1,105868,94132
5:6:1,0,-1,105869,94131
4:2:2,2,2,105867,94133
1:1:3,0,-1,105868,94132
6:6:1,0,-1,105869,94131
5:3:6,0,-1,105870,94130
5:1:5,0,-1,105871,94129
2:4:2,2,2,105869,94131
1:4:1,0,-1,105870,94130
2:4:5,1,1,105869,94131
2:6:6,1,1,105868,94132
3:2:4,1,1,105867,94133
1:6:5,0,-1,105868,94132
4:1:1,0,-1,105869,94131
4:1:2,1,1,105868,94132
1:4:1,0,-1,105869,94131
3:5:3,0,-1,105870,94130
5:3:1,0,-1,105871,94129
3:5:3,0,-1,105872,94128
5:6:4,0,-1,105873,94127
6:4:1,0,-1,105874,94126
2:2:1,2,2,105872,94128
2:3:5,1,1,105871,94129
5:2:6,1,1,105870,94130
5:1:3,0,-1,105871,94129
4:2:2,2,2,105869,94131
2:2:6,2,2,105867,94133
3:2:6,1,1,105866,94134
5:3:6,0,-1,105867,94133
3:5:2,1,1,105866,94134
6:5:2,1,1,105865,94135
5:3:4,0,-1,105866,94134
5:3:1,0,-1,105867,94133
1:1:1,0,-1,105868,94132
4:1:3,0,-1,105869,94131
6:2:1,1,1,105868,94132
3:2:6,1,1,105867,94133
6:5:5,0,-1,105868,94132
4:6:5,0,-1,105869,94131
2:3:2,2,2,105867,94133
4:2:5,1,1,105866,94134
6:6:4,0,-1,105867,94133
4:4:2,1,1,105866,94134
5:1:6,0,-1,105867,94133
6:3:2,1,1,105866,94134
3:1:1,0,-1,105867,94133
2:5:3,1,1,105866,94134
1:5:5,0,-1,105867,94133
3:2:6,1,1,105866,94134
1:1:6,0,-1,105867,94133
5:6:3,0,-1,105868,94132
5:2:2,2,2,105866,94134
4:6:2,1,1,105865,94135
6:2:5,1,1,105864,94136
6:2:6,1,1,105863,94137
1:6:2,1,1,105862,94138
2:4:3,1,1,105861,94139
1:6:3,0,-1,105862,94138
1:2:2,2,2,105860,94140
2:3:5,1,1,105859,94141
1:5:5,0,-1,105860,94140
4:5:4,0,-1,105861,94139
4:2:5,1,1,105860,94140
1:2:1,1,1,105859,94141
3:5:5,0,-1,105860,94140
2:4:2,2,2,105858,94142
3:1:4,0,-1,105859,94141
3:3:3,0,-1,105860,94140
4:3:2,1,1,105859,94141
4:2:6,1,1,105858,94142
2:5:2,2,2,105856,94144
6:2:4,1,1,105855,94145
2:2:2,3,3,105852,94148
4:3:5,0,-1,105853,94147
5:5:5,0,-1,105854,94146
4:6:3,0,-1,105855,94145
4:3:6,0,-1,105856,94144
4:6:3,0,-1,105857,94143
4:3:5,0,-1,105858,94142
3:1:1,0,-1,105859,94141
5:4:3,0,-1,105860,94140
6:5:4,0,-1,105861,94139
2:6:3,1,1,105860,94140
5:5:6,0,-1,105861,94139
5:4:2,1,1,105860,94140
2:5:5,1,1,105859,94141
6:3:1,0,-1,105860,94140
1:6:6,0,-1,105861,94139
6:5:3,0,-1,105862,94138
2:5:6,1,1,105861,94139
4:4:1,0,-1,105862,94138
5:5:3,0,-1,105863,94137
2:6:1,1,1,105862,94138
5:1:1,0,-1,105863,94137
4:6:5,0,-1,105864,94136
1:3:3,0,-1,105865,94135
1:2:6,1,1,105864,94136
3:2:3,1,1,105863,94137
4:2:4,1,1,105862,94138
2:4:2,2,2,105860,94140
3:6:3,0,-1,105861,94139
4:3:3,0,-1,105862,94138
4:3:6,0,-1,105863,94137
4:1:6,0,-1,105864,94136
4:4:4,0,-1,105865,94135
6:5:1,0,-1,105866,94134
5:5:6,0,-1,105867,94133
4:5:4,0,-1,105868,94132
5:3:2,1,1,105867,94133
4:6:3,0,-1,105868,94132
1:5:1,0,-1,105869,94131
6:3:3,0,-1,105870,94130
6:5:5,0,-1,105871,94129
1:6:4,0,-1,105872,94128
2:5:3,1,1,105871,94129
6:1:3,0,-1,105872,94128
6:1:3,0,-1,105873,94127
5:6:3,0,-1,105874,94126
6:1:1,0,-1,105875,94125
5:4:5,0,-1,105876,94124
5:3:1,0,-1,105877,94123
1:2:5,1,1,105876,94124
6:2:4,1,1,105875,94125
6:4:6,0,-1,105876,94124
5:4:3,0,-1,105877,94123
4:5:5,0,-1,105878,94122
5:3:6,0,-1,105879,94121
1:3:1,0,-1,105880,94120
5:1:3,0,-1,105881,94119
6:3:3,0,-1,105882,94118
5:5:2,1,1,105881,94119
2:4:3,1,1,105880,94120
3:3:2,1,1,105879,94121
3:4:4,0,-1,105880,94120
2:6:3,1,1,105879,94121
1:1:1,0,-1,105880,94120
5:5:3,0,-1,105881,94119
4:2:6,1,1,105880,94120
1:3:3,0,-1,105881,94119
4:5:4,0,-1,105882,94118
5:3:6,0,-1,105883,94117
3:3:2,1,1,105882,94118
1:4:1,0,-1,105883,94117
5:4:5,0,-1,105884,94116
4:6:1,0,-1,105885,94115
2:5:6,1,1,105884,94116
4:5:5,0,-1,105885,94115
6:5:5,0,-1,105886,94114
2:1:2,2,2,105884,94116
3:1:5,0,-1,105885,94115
5:3:4,0,-1,105886,94114
4:2:6,1,1,105885,94115
6:1:4,0,-1,105886,94114
2:4:5,1,1,105885,94115
1:5:6,0,-1,105886,94114
6:3:6,0,-1,105887,94113
2:5:6,1,1,105886,94114
4:5:6,0,-1,105887,94113
5:4:1,0,-1,105888,94112
5:2:1,1,1,105887,94113
1:4:4,0,-1,105888,94112
5:5:3,0,-1,105889,94111
2:3:5,1,1,105888,94112
6:1:2,1,1,105887,94113
6:4:1,0,-1,105888,94112
2:5:2,2,2,105886,94114
6:4:2,1,1,105885,94115
2:3:4,1,1,105884,94116
5:2:1,1,1,105883,94117
4:6:5,0,-1,105884,94116
5:1:3,0,-1,105885,94115
6:1:4,0,-1,105886,94114
5:5:5,0,-1,105887,94113
5:3:1,0,-1,105888,94112
1:3:6,0,-1,105889,94111
5:3:1,0,-1,105890,94110
2:5:6,1,1,105889,94111
5:2:6,1,1,105888,94112
5:6:4,0,-1,105889,94111
3:6:5,0,-1,105890,94110
6:5:2,1,1,105889,94111
3:4:1,0,-1,105890,94110
5:4:5,0,-1,105891,94109
1:2:4,1,1,105890,94110
3:4:6,0,-1,105891,94109
1:1:3,0,-1,105892,94108
3:4:4,0,-1,105893,94107
6:3:2,1,1,105892,94108
1:5:2,1,1,105891,94109
6:5:6,0,-1,105892,94108
3:1:6,0,-1,105893,94107
6:3:3,0,-1,105894,94106
1:6:1,0,-1,105895,94105
2:5:3,1,1,105894,94106
3:4:1,0,-1,105895,94105
6:2:6,1,1,105894,94106
6:4:2,1,1,105893,94107
4:4:5,0,-1,105894,94106
6:4:5,0,-1,105895,94105
3:2:1,1,1,105894,94106
4:2:6,1,1,105893,94107
4:1:3,0,-1,105894,94106
4:4:2,1,1,105893,94107
3:5:5,0,-1,105894,94106
2:5:3,1,1,105893,94107
6:6:6,0,-1,105894,94106
4:4:6,0,-1,105895,94105
5:2:2,2,2,105893,94107
6:5:6,0,-1,105894,94106
4:6:2,1,1,105893,94107
5:6:2,1,1,105892,94108
3:3:6,0,-1,105893,94107
3:2:3,1,1,105892,94108
4:6:4,0,-1,105893,94107
1:1:1,0,-1,105894,94106
2:1:1,1,1,105893,94107
4:5:3,0,-1,105894,94106
3:6:6,0,-1,105895,94105
3:3:3,0,-1,105896,94104
1:1:5,0,-1,105897,94103
6:5:5,0,-1,105898,94102
3:1:4,0,-1,105899,94101
4:1:1,0,-1,105900,94100
6:1:2,1,1,105899,94101
4:3:5,0,-1,105900,94100
1:6:1,0,-1,105901,94099
6:2:2,2,2,105899,94101
4:3:4,0,-1,105900,94100
4:6:6,0,-1,105901,94099
4:6:6,0,-1,105902,94098
1:3:3,0,-1,105903,94097
3:6:2,1,1,105902,94098
6:3:1,0,-1,105903,94097
1:1:4,0,-1,105904,94096
5:5:2,1,1,105903,94097
4:3:2,1,1,105902,94098
3:2:6,1,1,105901,94099
1:1:2,1,1,105900,94100
4:4:6,0,-1,105901,94099
5:4:4,0,-1,105902,94098
5:2:1,1,1,105901,94099
5:4:2,1,1,105900,94100
1:3:1,0,-1,105901,94099
2:3:3,1,1,105900,94100
2:3:6,1,1,105899,94101
4:3:6,0,-1,105900,94100
6:5:5,0,-1,105901,94099
1:1:3,0,-1,105902,94098
5:6:2,1,1,105901,94099
2:4:3,1,1,105900,94100
4:6:2,1,1,105899,94101
2:4:5,1,1,105898,94102
4:6:6,0,-1,105899,94101
2:6:2,2,2,105897,94103
3:3:5,0,-1,105898,94102
3:5:1,0,-1,105899,94101
3:5:1,0,-1,105900,94100
2:1:4,1,1,105899,94101
5:2:3,1,1,105898,94102
3:4:1,0,-1,105899,94101
2:3:5,1,1,105898,94102
4:3:5,0,-1,105899,94101
2:5:3,1,1,105898,94102
5:1:6,0,-1,105899,94101
6:1:6,0,-1,105900,94100
2:2:1,2,2,105898,94102
5:4:4,0,-1,105899,94101
5:5:1,0,-1,105900,94100
6:5:6,0,-1,105901,94099
2:2:4,2,2,105899,94101
1:2:4,1,1,105898,94102
6:4:6,0,-1,105899,94101
2:5:5,1,1,105898,94102
5:2:3,1,1,105897,94103
4:2:5,1,1,105896,94104
6:6:3,0,-1,105897,94103
2:2:2,3,3,105894,94106
4:6:3,0,-1,105895,94105
5:6:2,1,1,105894,94106
4:6:2,1,1,105893,94107
6:3:6,0,-1,105894,94106
1:2:5,1,1,105893,94107
2:3:6,1,1,105892,94108
1:6:2,1,1,105891,94109
2:2:4,2,2,105889,94111
3:2:4,1,1,105888,94112
5:2:2,2,2,105886,94114
5:1:5,0,-1,105887,94113
2:5:4,1,1,105886,94114
3:1:2,1,1,105885,94115
5:2:5,1,1,105884,94116
2:3:5,1,1,105883,94117
3:6:4,0,-1,105884,94116
3:6:4,0,-1,105885,94115
3:5:1,0,-1,105886,94114
6:1:3,0,-1,105887,94113
4:4:1,0,-1,105888,94112
5:3:1,0,-1,105889,94111
1:1:6,0,-1,105890,94110
1:2:1,1,1,105889,94111
5:3:4,0,-1,105890,94110
5:3:1,0,-1,105891,94109
3:4:1,0,-1,105892,94108
5:4:3,0,-1,105893,94107
6:1:3,0,-1,105894,94106
4:4:4,0,-1,105895,94105
1:1:3,0,-1,105896,94104
2:5:1,1,1,105895,94105
2:2:3,2,2,105893,94107
3:1:4,0,-1,105894,94106
5:6:6,0,-1,105895,94105
4:5:3,0,-1,105896,94104
6:1:3,0,-1,105897,94103
6:3:5,0,-1,105898,94102
5:6:4,0,-1,105899,94101
4:4:1,0,-1,105900,94100
5:2:1,1,1,105899,94101
4:3:1,0,-1,105900,94100
2:3:6,1,1,105899,94101
6:5:5,0,-1,105900,94100
1:5:6,0,-1,105901,94099
2:1:6,1,1,105900,94100
6:3:3,0,-1,105901,94099
2:6:1,1,1,105900,94100
5:5:2,1,1,105899,94101
4:1:6,0,-1,105900,94100
3:6:3,0,-1,105901,94099
5:3:6,0,-1,105902,94098
5:4:3,0,-1,105903,94097
4:2:2,2,2,105901,94099
4:6:4,0,-1,105902,94098
1:5:1,0,-1,105903,94097
5:1:5,0,-1,105904,94096
3:5:4,0,-1,105905,94095
4:5:3,0,-1,105906,94094
5:3:6,0,-1,105907,94093
4:5:5,0,-1,105908,94092
1:1:1,0,-1,105909,94091
2:5:1,1,1,105908,94092
5:5:4,0,-1,105909,94091
3:1:5,0,-1,105910,94090
5:2:4,1,1,105909,94091
4:5:1,0,-1,105910,94090
4:5:2,1,1,105909,94091
1:1:3,0,-1,105910,94090
3:6:5,0,-1,105911,94089
3:2:2,2,2,105909,94091
4:3:1,0,-1,105910,94090
2:1:3,1,1,105909,94091
5:3:5,0,-1,105910,94090
2:2:2,3,3,105907,94093
6:5:4,0,-1,105908,94092
2:2:5,2,2,105906,94094
5:6:3,0,-1,105907,94093
2:4:5,1,1,105906,94094
1:2:1,1,1,105905,94095
5:6:6,0,-1,105906,94094
5:6:3,0,-1,105907,94093
3:3:1,0,-1,105908,94092
3:4:4,0,-1,105909,94091
2:6:4,1,1,105908,94092
2:3:3,1,1,105907,94093
2:6:4,1,1,105906,94094
1:6:3,0,-1,105907,94093
6:2:4,1,1,105906,94094
2:5:1,1,1,105905,94095
3:6:1,0,-1,105906,94094
5:1:1,0,-1,105907,94093
4:2:1,1,1,105906,94094
2:1:2,2,2,105904,94096
5:3:6,0,-1,105905,94095
5:1:3,0,-1,105906,94094
2:2:6,2,2,105904,94096
2:4:5,1,1,105903,94097
1:5:5,0,-1,105904,94096
2:1:4,1,1,105903,94097
1:1:1,0,-1,105904,94096
2:4:1,1,1,105903,94097
3:6:5,0,-1,105904,94096
5:5:1,0,-1,105905,94095
1:3:2,1,1,105904,94096
5:3:2,1,1,105903,94097
4:3:1,0,-1,105904,94096
1:1:1,0,-1,105905,94095
2:2:5,2,2,105903,94097
5:3:6,0,-1,105904,94096
4:3:4,0,-1,105905,94095
5:4:6,0,-1,105906,94094
3:6:5,0,-1,105907,94093
1:4:4,0,-1,105908,94092
5:4:6,0,-1,105909,94091
1:5:6,0,-1,105910,94090
3:6:4,0,-1,105911,94089
1:4:2,1,1,105910,94090
1:6:3,0,-1,105911,94089
3:3:4,0,-1,105912,94088
4:3:6,0,-1,105913,94087
3:4:1,0,-1,105914,94086
4:1:6,0,-1,105915,94085
5:5:1,0,-1,105916,94084
3:2:1,1,1,105915,94085
2:3:1,1,1,105914,94086
4:3:4,0,-1,105915,94085
3:6:2,1,1,105914,94086
4:5:2,1,1,105913,94087
1:6:6,0,-1,105914,94086
5:5:1,0,-1,105915,94085
5:6:5,0,-1,105916,94084
5:3:1,0,-1,105917,94083
4:3:1,0,-1,105918,94082
6:4:6,0,-1,105919,94081
4:5:2,1,1,105918,94082
4:5:2,1,1,105917,94083
4:2:1,1,1,105916,94084
1:3:3,0,-1,105917,94083
4:2:5,1,1,105916,94084
6:1:2,1,1,105915,94085
2:3:6,1,1,105914,94086
4:6:5,0,-1,105915,94085
6:5:2,1,1,105914,94086
3:1:5,0,-1,105915,94085
2:4:2,2,2,105913,94087
3:1:6,0,-1,105914,94086
2:3:4,1,1,105913,94087
3:2:2,2,2,105911,94089
5:2:6,1,1,105910,94090
1:1:2,1,1,105909,94091
2:6:4,1,1,105908,94092
3:2:5,1,1,105907,94093
6:4:1,0,-1,105908,94092
5:6:6,0,-1,105909,94091
5:6:6,0,-1,105910,94090
2:5:5,1,1,105909,94091
1:5:6,0,-1,105910,94090
3:3:4,0,-1,105911,94089
6:2:1,1,1,105910,94090
6:6:1,0,-1,105911,94089
3:2:1,1,1,105910,94090
2:4:5,1,1,105909,94091
4:3:3,0,-1,105910,94090
1:6:6,0,-1,105911,94089
4:5:5,0,-1,105912,94088
3:1:3,0,-1,105913,94087
1:2:2,2,2,105911,94089
1:6:2,1,1,105910,94090
3:4:3,0,-1,105911,94089
6:6:2,1,1,105910,94090
3:3:5,0,-1,105911,94089
5:2:2,2,2,105909,94091
1:1:4,0,-1,105910,94090
4:5:1,0,-1,105911,94089
4:6:3,0,-1,105912,94088
3:6:1,0,-1,105913,94087
4:6:5,0,-1,105914,94086
6:5:4,0,-1,105915,94085
1:6:6,0,-1,105916,94084
2:5:4,1,1,105915,94085
5:5:1,0,-1,105916,94084
6:3:4,0,-1,105917,94083
3:1:6,0,-1,105918,94082
6:2:3,1,1,105917,94083
1:2:1,1,1,105916,94084
1:4:6,0,-1,105917,94083
4:6:1,0,-1,105918,94082
5:6:4,0,-1,105919,94081
3:6:5,0,-1,105920,94080
6:6:1,0,-1,105921,94079
6:5:4,0,-1,105922,94078
1:4:4,0,-1,105923,94077
1:2:3,1,1,105922,94078
6:3:5,0,-1,105923,94077
5:5:1,0,-1,105924,94076
3:6:3,0,-1,105925,94075
3:3:3,0,-1,105926,94074
4:1:6,0,-1,105927,94073
4:6:2,1,1,105926,94074
4:5:6,0,-1,105927,94073
6:4:4,0,-1,105928,94072
6:4:4,0,-1,105929,94071
5:5:4,0,-1,105930,94070
5:5:6,0,-1,105931,94069
1:2:1,1,1,105930,94070
6:1:3,0,-1,105931,94069
2:3:2,2,2,105929,94071
4:6:1,0,-1,105930,94070
4:3:3,0,-1,105931,94069
5:1:1,0,-1,105932,94068
3:6:3,0,-1,105933,94067
1:1:5,0,-1,105934,94066
2:2:3,2,2,105932,94068
5:1:5,0,-1,105933,94067
5:4:4,0,-1,105934,94066
3:6:1,0,-1,105935,94065
4:6:1,0,-1,105936,94064
5:6:1,0,-1,105937,94063
6:4:1,0,-1,105938,94062
2:6:6,1,1,105937,94063
4:5:3,0,-1,105938,94062
5:4:2,1,1,105937,94063
1:6:6,0,-1,105938,94062
3:2:2,2,2,105936,94064
3:4:1,0,-1,105937,94063
4:3:4,0,-1,105938,94062
6:1:5,0,-1,105939,94061
3:5:4,0,-1,105940,94060
6:1:3,0,-1,105941,94059
4:2:2,2,2,105939,94061
2:2:5,2,2,105937,94063
5:4:3,0,-1,105938,94062
6:5:6,0,-1,105939,94061
2:6:1,1,1,105938,94062
2:4:4,1,1,105937,94063
6:2:1,1,1,105936,94064
1:4:6,0,-1,105937,94063
5:4:4,0,-1,105938,94062
4:4:2,1,1,105937,94063
4:2:4,1,1,105936,94064
6:4:3,0,-1,105937,94063
1:5:5,0,-1,105938,94062
2:1:3,1,1,105937,94063
5:6:4,0,-1,105938,94062
4:2:1,1,1,105937,94063
2:4:5,1,1,105936,94064
5:5:2,1,1,105935,94065
3:6:6,0,-1,105936,94064
2:4:3,1,1,105935,94065
5:1:2,1,1,105934,94066
3:6:1,0,-1,105935,94065
1:3:4,0,-1,105936,94064
2:4:5,1,1,105935,94065
6:2:4,1,1,105934,94066
5:5:5,0,-1,105935,94065
6:1:2,1,1,105934,94066
3:4:4,0,-1,105935,94065
1:1:4,0,-1,105936,94064
4:5:5,0,-1,105937,94063
6:5:1,0,-1,105938,94062
3:2:6,1,1,105937,94063
4:1:5,0,-1,105938,94062
3:6:1,0,-1,105939,94061
5:4:6,0,-1,105940,94060
3:6:3,0,-1,105941,94059
1:4:1,0,-1,105942,94058
5:2:5,1,1,105941,94059
4:4:4,0,-1,105942,94058
2:6:4,1,1,105941,94059
3:1:1,0,-1,105942,94058
4:2:5,1,1,105941,94059
2:2:6,2,2,105939,94061
5:5:5,0,-1,105940,94060
4:1:5,0,-1,105941,94059
1:5:2,1,1,105940,94060
6:4:6,0,-1,105941,94059
5:4:1,0,-1,105942,94058
5:4:4,0,-1,105943,94057
2:6:2,2,2,105941,94059
4:6:1,0,-1,105942,94058
2:5:6,1,1,105941,94059
4:6:1,0,-1,105942,94058
5:1:5,0,-1,105943,94057
3:4:1,0,-1,105944,94056
6:6:2,1,1,105943,94057
6:4:4,0,-1,105944,94056
2:1:6,1,1,105943,94057
5:1:6,0,-1,105944,94056
3:1:2,1,1,105943,94057
3:1:5,0,-1,105944,94056
5:3:2,1,1,105943,94057
6:3:3,0,-1,105944,94056
4:5:6,0,-1,105945,94055
1:5:2,1,1,105944,94056
5:6:1,0,-1,105945,94055
4:1:3,0,-1,105946,94054
4:3:2,1,1,105945,94055
2:5:3,1,1,105944,94056
3:1:3,0,-1,105945,94055
3:2:6,1,1,105944,94056
2:2:4,2,2,105942,94058
6:6:5,0,-1,105943,94057
6:1:6,0,-1,105944,94056
5:2:2,2,2,105942,94058
4:2:5,1,1,105941,94059
3:2:3,1,1,105940,94060
2:5:4,1,1,105939,94061
6:5:2,1,1,105938,94062
5:1:1,0,-1,105939,94061
4:5:3,0,-1,105940,94060
4:6:6,0,-1,105941,94059
6:6:1,0,-1,105942,94058
1:2:5,1,1,105941,94059
5:1:1,0,-1,105942,94058
5:1:3,0,-1,105943,94057
2:1:3,1,1,105942,94058
3:1:2,1,1,105941,94059
4:3:4,0,-1,105942,94058
2:2:6,2,2,105940,94060
4:2:1,1,1,105939,94061
4:6:3,0,-1,105940,94060
1:1:4,0,-1,105941,94059
3:3:5,0,-1,105942,94058
1:2:3,1,1,105941,94059
5:6:3,0,-1,105942,94058
2:1:4,1,1,105941,94059
6:1:1,0,-1,105942,94058
1:6:5,0,-1,105943,94057
5:5:3,0,-1,105944,94056
3:4:5,0,-1,105945,94055
4:4:2,1,1,105944,94056
2:5:1,1,1,105943,94057
6:1:2,1,1,105942,94058
5:6:1,0,-1,105943,94057
4:5:3,0,-1,105944,94056
3:6:6,0,-1,105945,94055
1:6:6,0,-1,105946,94054
6:4:6,0,-1,105947,94053
1:3:3,0,-1,105948,94052
1:6:3,0,-1,105949,94051
3:5:6,0,-1,105950,94050
5:1:2,1,1,105949,94051
3:3:6,0,-1,105950,94050
1:1:2,1,1,105949,94051
6:3:6,0,-1,105950,94050
2:1:6,1,1,105949,94051
1:2:1,1,1,105948,94052
5:6:1,0,-1,105949,94051
4:1:4,0,-1,105950,94050
3:1:4,0,-1,105951,94049
6:3:3,0,-1,105952,94048
1:1:3,0,-1,105953,94047
4:2:5,1,1,105952,94048
4:3:6,0,-1,105953,94047
4:4:3,0,-1,105954,94046
1:1:4,0,-1,105955,94045
4:4:4,0,-1,105956,94044
5:5:2,1,1,105955,94045
2:1:3,1,1,105954,94046
6:1:5,0,-1,105955,94045
3:6:5,0,-1,105956,94044
6:3:1,0,-1,105957,94043
5:3:1,0,-1,105958,94042
4:5:4,0,-1,105959,94041
6:6:6,0,-1,105960,94040
3:3:6,0,-1,105961,94039
6:5:6,0,-1,105962,94038
1:4:6,0,-1,105963,94037
5:1:4,0,-1,105964,94036
4:2:3,1,1,105963,94037
2:5:2,2,2,105961,94039
5:4:3,0,-1,105962,94038
1:1:2,1,1,105961,94039
4:4:6,0,-1,105962,94038
1:5:5,0,-1,105963,94037
4:3:2,1,1,105962,94038
2:2:4,2,2,105960,94040
1:1:2,1,1,105959,94041
5:6:3,0,-1,105960,94040
5:2:4,1,1,105959,94041
5:5:2,1,1,105958,94042
5:2:1,1,1,105957,94043
3:6:2,1,1,105956,94044
5:5:6,0,-1,105957,94043
6:6:2,1,1,105956,94044
4:1:3,0,-1,105957,94043
2:6:5,1,1,105956,94044
3:2:6,1,1,105955,94045
5:4:1,0,-1,105956,94044
2:1:3,1,1,105955,94045
1:3:2,1,1,105954,94046
3:4:4,0,-1,105955,94045
4:5:2,1,1,105954,94046
3:3:5,0,-1,105955,94045
3:4:5,0,-1,105956,94044
3:3:5,0,-1,105957,94043
3:4:2,1,1,105956,94044
2:3:1,1,1,105955,94045
5:3:2,1,1,105954,94046
1:5:3,0,-1,105955,94045
3:3:2,1,1,105954,94046
5:4:1,0,-1,105955,94045
3:1:4,0,-1,105956,94044
3:3:4,0,-1,105957,94043
4:5:2,1,1,105956,94044
6:4:3,0,-1,105957,94043
2:6:2,2,2,105955,94045
5:3:5,0,-1,105956,94044
3:2:2,2,2,105954,94046
4:4:3,0,-1,105955,94045
3:5:1,0,-1,105956,94044
5:3:1,0,-1,105957,94043
1:5:1,0,-1,105958,94042
4:5:4,0,-1,105959,94041
1:5:4,0,-1,105960,94040
1:3:4,0,-1,105961,94039
2:4:2,2,2,105959,94041
2:5:6,1,1,105958,94042
6:6:5,0,-1,105959,94041
2:4:4,1,1,105958,94042
3:1:3,0,-1,105959,94041
1:2:5,1,1,105958,94042
6:3:6,0,-1,105959,94041
1:4:1,0,-1,105960,94040
4:5:4,0,-1,105961,94039
2:2:1,2,2,105959,94041
1:1:2,1,1,105958,94042
2:3:3,1,1,105957,94043
1:3:2,1,1,105956,94044
6:5:3,0,-1,105957,94043
6:4:1,0,-1,105958,94042
5:3:2,1,1,105957,94043
2:3:1,1,1,105956,94044
5:6:1,0,-1,105957,94043
3:2:5,1,1,105956,94044
4:6:2,1,1,105955,94045
2:2:2,3,3,105952,94048
1:2:3,1,1,105951,94049
5:5:4,0,-1,105952,94048
5:1:6,0,-1,105953,94047
1:5:1,0,-1,105954,94046
6:4:5,0,-1,105955,94045
3:2:6,1,1,105954,94046
6:5:5,0,-1,105955,94045
2:3:5,1,1,105954,94046
1:3:5,0,-1,105955,94045
6:3:6,0,-1,105956,94044
2:3:5,1,1,105955,94045
1:2:2,2,2,105953,94047
2:6:5,1,1,105952,94048
3:3:2,1,1,105951,94049
1:5:2,1,1,105950,94050
5:5:6,0,-1,105951,94049
3:3:2,1,1,105950,94050
5:1:6,0,-1,105951,94049
1:4:6,0,-1,105952,94048
4:6:2,1,1,105951,94049
6:4:2,1,1,105950,94050
3:3:3,0,-1,105951,94049
3:1:2,1,1,105950,94050
1:6:1,0,-1,105951,94049
3:1:2,1,1,105950,94050
1:5:3,0,-1,105951,94049
2:5:3,1,1,105950,94050
4:1:4,0,-1,105951,94049
6:4:4,0,-1,105952,94048
5:4:6,0,-1,105953,94047
1:3:3,0,-1,105954,94046
3:5:3,0,-1,105955,94045
4:2:1,1,1,105954,94046
4:3:3,0,-1,105955,94045
2:3:3,1,1,105954,94046
4:5:3,0,-1,105955,94045
1:2:1,1,1,105954,94046
3:3:5,0,-1,105955,94045
6:3:2,1,1,105954,94046
5:2:4,1,1,105953,94047
3:1:2,1,1,105952,94048
1:2:4,1,1,105951,94049
5:1:6,0,-1,105952,94048
4:6:1,0,-1,105953,94047
6:3:6,0,-1,105954,94046
5:5:1,0,-1,105955,94045
1:1:4,0,-1,105956,94044
3:5:3,0,-1,105957,94043
6:5:4,0,-1,105958,94042
1:6:4,0,-1,105959,94041
4:6:2,1,1,105958,94042
4:5:1,0,-1,105959,94041
1:2:2,2,2,105957,94043
4:2:5,1,1,105956,94044
6:1:3,0,-1,105957,94043
4:2:6,1,1,105956,94044
4:4:5,0,-1,105957,94043
3:2:3,1,1,105956,94044
3:3:3,0,-1,105957,94043
1:6:1,0,-1,105958,94042
2:1:5,1,1,105957,94043
6:2:6,1,1,105956,94044
5:5:1,0,-1,105957,94043
4:3:6,0,-1,105958,94042
2:3:1,1,1,105957,94043
2:3:2,2,2,105955,94045
6:2:2,2,2,105953,94047
3:5:5,0,-1,105954,94046
5:1:1,0,-1,105955,94045
6:3:2,1,1,105954,94046
4:1:6,0,-1,105955,94045
5:1:2,1,1,105954,94046
1:5:5,0,-1,105955,94045
2:5:4,1,1,105954,94046
3:1:6,0,-1,105955,94045
5:5:2,1,1,105954,94046
3:2:6,1,1,105953,94047
3:1:1,0,-1,105954,94046
3:1:1,0,-1,105955,94045
1:3:4,0,-1,105956,94044
5:1:3,0,-1,105957,94043
4:4:3,0,-1,105958,94042
6:5:3,0,-1,105959,94041
3:3:1,0,-1,105960,94040
4:4:2,1,1,105959,94041
4:6:6,0,-1,105960,94040
5:3:1,0,-1,105961,94039
5:1:5,0,-1,105962,94038
1:1:3,0,-1,105963,94037
1:6:4,0,-1,105964,94036
5:5:1,0,-1,105965,94035
1:3:3,0,-1,105966,94034
5:1:3,0,-1,105967,94033
4:6:5,0,-1,105968,94032
3:6:4,0,-1,105969,94031
6:4:2,1,1,105968,94032
5:5:3,0,-1,105969,94031
1:2:1,1,1,105968,94032
5:4:5,0,-1,105969,94031
3:1:1,0,-1,105970,94030
1:1:4,0,-1,105971,94029
3:5:5,0,-1,105972,94028
5:6:5,0,-1,105973,94027
1:5:2,1,1,105972,94028
1:2:6,1,1,105971,94029
5:6:5,0,-1,105972,94028
1:6:5,0,-1,105973,94027
6:1:6,0,-1,105974,94026
4:4:6,0,-1,105975,94025
1:1:1,0,-1,105976,94024
1:2:6,1,1,105975,94025
6:2:4,1,1,105974,94026
5:2:3,1,1,105973,94027
6:3:2,1,1,105972,94028
5:5:6,0,-1,105973,94027
5:4:4,0,-1,105974,94026
1:3:3,0,-1,105975,94025
1:1:1,0,-1,105976,94024
4:6:2,1,1,105975,94025
3:2:5,1,1,105974,94026
5:5:2,1,1,105973,94027
4:1:3,0,-1,105974,94026
6:1:4,0,-1,105975,94025
5:6:1,0,-1,105976,94024
2:3:1,1,1,105975,94025
5:5:5,0,-1,105976,94024
5:6:6,0,-1,105977,94023
2:5:2,2,2,105975,94025
5:4:2,1,1,105974,94026
1:1:4,0,-1,105975,94025
3:4:1,0,-1,105976,94024
3:4:2,1,1,105975,94025
4:5:3,0,-1,105976,94024
4:3:5,0,-1,105977,94023
3:6:2,1,1,105976,94024
4:4:6,0,-1,105977,94023
6:2:6,1,1,105976,94024
5:5:4,0,-1,105977,94023
6:2:5,1,1,105976,94024
3:5:1,0,-1,105977,94023
6:5:5,0,-1,105978,94022
3:1:1,0,-1,105979,94021
4:6:1,0,-1,105980,94020
4:5:6,0,-1,105981,94019
6:4:3,0,-1,105982,94018
6:3:6,0,-1,105983,94017
5:2:4,1,1,105982,94018
4:5:6,0,-1,105983,94017
1:4:1,0,-1,105984,94016
5:4:1,0,-1,105985,94015
6:3:2,1,1,105984,94016
4:3:4,0,-1,105985,94015
1:6:2,1,1,105984,94016
5:5:6,0,-1,105985,94015
4:3:3,0,-1,105986,94014
2:1:6,1,1,105985,94015
1:6:6,0,-1,105986,94014
3:3:5,0,-1,105987,94013
1:2:5,1,1,105986,94014
1:4:4,0,-1,105987,94013
1:4:5,0,-1,105988,94012
2:5:2,2,2,105986,94014
1:2:2,2,2,105984,94016
4:4:1,0,-1,105985,94015
2:6:6,1,1,105984,94016
4:2:3,1,1,105983,94017
6:1:6,0,-1,105984,94016
5:6:5,0,-1,105985,94015
3:6:2,1,1,105984,94016
5:1:3,0,-1,105985,94015
3:5:4,0,-1,105986,94014
1:1:2,1,1,105985,94015
4:1:3,0,-1,105986,94014
1:1:6,0,-1,105987,94013
6:3:5,0,-1,105988,94012
1:5:6,0,-1,105989,94011
3:4:1,0,-1,105990,94010
1:4:1,0,-1,105991,94009
3:4:2,1,1,105990,94010
4:5:5,0,-1,105991,94009
5:1:5,0,-1,105992,94008
6:4:6,0,-1,105993,94007
2:3:3,1,1,105992,94008
4:5:4,0,-1,105993,94007
2:4:2,2,2,105991,94009
1:1:4,0,-1,105992,94008
6:3:5,0,-1,105993,94007
4:3:1,0,-1,105994,94006
3:6:6,0,-1,105995,94005
5:4:2,1,1,105994,94006
1:5:5,0,-1,105995,94005
5:4:2,1,1,105994,94006
6:6:2,1,1,105993,94007
6:5:2,1,1,105992,94008
6:6:4,0,-1,105993,94007
2:3:6,1,1,105992,94008
4:3:5,0,-1,105993,94007
4:3:3,0,-1,105994,94006
3:1:3,0,-1,105995,94005
3:4:2,1,1,105994,94006
2:3:5,1,1,105993,94007
4:4:4,0,-1,105994,94006
2:2:5,2,2,105992,94008
1:2:5,1,1,105991,94009
5:1:2,1,1,105990,94010
6:2:2,2,2,105988,94012
1:4:2,1,1,105987,94013
1:2:5,1,1,105986,94014
1:2:4,1,1,105985,94015
2:2:5,2,2,105983,94017
4:5:3,0,-1,105984,94016
3:3:3,0,-1,105985,94015
1:2:3,1,1,105984,94016
1:1:3,0,-1,105985,94015
6:6:1,0,-1,105986,94014
4:4:5,0,-1,105987,94013
5:1:4,0,-1,105988,94012
6:5:5,0,-1,105989,94011
6:2:5,1,1,105988,94012
4:2:4,1,1,105987,94013
5:3:2,1,1,105986,94014
1:5:6,0,-1,105987,94013
2:6:6,1,1,105986,94014
3:2:4,1,1,105985,94015
5:6:3,0,-1,105986,94014
1:1:4,0,-1,105987,94013
1:1:1,0,-1,105988,94012
5:6:3,0,-1,105989,94011
6:3:2,1,1,105988,94012
1:6:6,0,-1,105989,94011
3:2:2,2,2,105987,94013
5:5:5,0,-1,105988,94012
4:3:1,0,-1,105989,94011
6:1:3,0,-1,105990,94010
1:4:2,1,1,105989,94011
6:5:2,1,1,105988,94012
3:3:3,0,-1,105989,94011
5:5:1,0,-1,105990,94010
5:2:4,1,1,105989,94011
1:1:5,0,-1,105990,94010
6:5:5,0,-1,105991,94009
5:5:4,0,-1,105992,94008
1:1:6,0,-1,105993,94007
2:1:4,1,1,105992,94008
2:3:1,1,1,105991,94009
5:2:5,1,1,105990,94010
3:6:6,0,-1,105991,94009
3:2:1,1,1,105990,94010
3:1:5,0,-1,105991,94009
3:5:1,0,-1,105992,94008
5:3:4,0,-1,105993,94007
5:2:5,1,1,105992,94008
3:4:3,0,-1,105993,94007
1:5:1,0,-1,105994,94006
2:4:5,1,1,105993,94007
4:4:2,1,1,105992,94008
3:4:6,0,-1,105993,94007
3:5:6,0,-1,105994,94006
5:6:6,0,-1,105995,94005
2:4:4,1,1,105994,94006
1:1:4,0,-1,105995,94005
6:4:5,0,-1,105996,94004
3:1:1,0,-1,105997,94003
4:1:5,0,-1,105998,94002
6:1:6,0,-1,105999,94001
2:6:1,1,1,105998,94002
5:3:5,0,-1,105999,94001
6:1:5,0,-1,106000,94000
3:5:5,0,-1,106001,93999
5:5:6,0,-1,106002,93998
2:1:2,2,2,106000,94000
5:3:1,0,-1,106001,93999
3:2:1,1,1,106000,94000
4:2:2,2,2,105998,94002
2:3:6,1,1,105997,94003
3:3:3,0,-1,105998,94002
2:2:4,2,2,105996,94004
4:3:1,0,-1,105997,94003
5:3:3,0,-1,105998,94002
1:6:6,0,-1,105999,94001
6:1:4,0,-1,106000,94000
5:5:4,0,-1,106001,93999
2:5:4,1,1,106000,94000
2:3:6,1,1,105999,94001
2:1:4,1,1,105998,94002
6:5:1,0,-1,105999,94001
4:3:3,0,-1,106000,94000
6:1:2,1,1,105999,94001
3:4:2,1,1,105998,94002
4:5:5,0,-1,105999,94001
5:2:2,2,2,105997,94003
4:6:3,0,-1,105998,94002
5:3:1,0,-1,105999,94001
6:6:5,0,-1,106000,94000
6:6:1,0,-1,106001,93999
3:5:5,0,-1,106002,93998
4:2:6,1,1,106001,93999
3:3:4,0,-1,106002,93998
5:6:4,0,-1,106003,93997
5:6:5,0,-1,106004,93996
4:5:6,0,-1,106005,93995
4:1:2,1,1,106004,93996
5:5:5,0,-1,106005,93995
1:2:3,1,1,106004,93996
6:6:2,1,1,106003,93997
1:4:4,0,-1,106004,93996
5:4:4,0,-1,106005,93995
3:3:5,0,-1,106006,93994
1:1:6,0,-1,106007,93993
1:2:4,1,1,106006,93994
2:1:5,1,1,106005,93995
6:6:2,1,1,106004,93996
6:1:4,0,-1,106005,93995
4:5:2,1,1,106004,93996
3:2:5,1,1,106003,93997
6:4:5,0,-1,106004,93996
2:6:2,2,2,106002,93998
5:5:2,1,1,106001,93999
6:3:4,0,-1,106002,93998
6:4:2,1,1,106001,93999
4:4:5,0,-1,106002,93998
4:4:1,0,-1,106003,93997
4:6:4,0,-1,106004,93996
3:3:1,0,-1,106005,93995
2:2:5,2,2,106003,93997
3:4:5,0,-1,106004,93996
6:5:1,0,-1,106005,93995
3:1:3,0,-1,106006,93994
3:5:5,0,-1,106007,93993
6:6:4,0,-1,106008,93992
4:4:4,0,-1,106009,93991
2:2:5,2,2,106007,93993
4:6:5,0,-1,106008,93992
6:6:5,0,-1,106009,93991
4:1:3,0,-1,106010,93990
6:4:2,1,1,106009,93991
1:5:2,1,1,106008,93992
2:2:1,2,2,106006,93994
6:1:1,0,-1,106007,93993
4:3:3,0,-1,106008,93992
2:5:1,1,1,106007,93993
1:1:2,1,1,106006,93994
5:5:2,1,1,106005,93995
3:5:6,0,-1,106006,93994
1:3:4,0,-1,106007,93993
4:2:4,1,1,106006,93994
4:1:6,0,-1,106007,93993
6:5:3,0,-1,106008,93992
4:3:2,1,1,106007,93993
2:1:4,1,1,106006,93994
4:5:6,0,-1,106007,93993
5:6:3,0,-1,106008,93992
1:2:2,2,2,106006,93994
3:6:2,1,1,106005,93995
2:6:2,2,2,106003,93997
2:5:5,1,1,106002,93998
5:4:2,1,1,106001,93999
5:2:4,1,1,106000,94000
6:6:1,0,-1,106001,93999
6:4:5,0,-1,106002,93998
1:1:4,0,-1,106003,93997
6:5:3,0,-1,106004,93996
2:2:3,2,2,106002,93998
6:4:2,1,1,106001,93999
4:4:5,0,-1,106002,93998
1:5:2,1,1,106001,93999
6:4:4,0,-1,106002,93998
1:1:3,0,-1,106003,93997
3:6:2,1,1,106002,93998
4:3:1,0,-1,106003,93997
1:5:4,0,-1,106004,93996
1:6:3,0,-1,106005,93995
6:5:6,0,-1,106006,93994
4:4:1,0,-1,106007,93993
5:1:3,0,-1,106008,93992
4:5:3,0,-1,106009,93991
6:1:2,1,1,106008,93992
1:6:5,0,-1,106009,93991
4:6:1,0,-1,106010,93990
3:6:2,1,1,106009,93991
6:4:6,0,-1,106010,93990
3:1:4,0,-1,106011,93989
6:1:3,0,-1,106012,93988
3:3:6,0,-1,106013,93987
3:6:1,0,-1,106014,93986
2:1:4,1,1,106013,93987
6:4:6,0,-1,106014,93986
1:5:4,0,-1,106015,93985
5:5:4,0,-1,106016,93984
3:6:4,0,-1,106017,93983
2:1:6,1,1,106016,93984
3:5:3,0,-1,106017,93983
4:6:1,0,-1,106018,93982
1:5:4,0,-1,106019,93981
1:6:3,0,-1,106020,93980
6:2:1,1,1,106019,93981
6:6:2,1,1,106018,93982
2:4:1,1,1,106017,93983
1:3:4,0,-1,106018,93982
2:5:5,1,1,106017,93983
1:2:4,1,1,106016,93984
2:6:4,1,1,106015,93985
5:5:5,0,-1,106016,93984
1:6:1,0,-1,106017,93983
3:3:5,0,-1,106018,93982
6:2:5,1,1,106017,93983
1:1:2,1,1,106016,93984
2:3:3,1,1,106015,93985
5:1:4,0,-1,106016,93984
6:5:6,0,-1,106017,93983
5:6:5,0,-1,106018,93982
2:4:3,1,1,106017,93983
5:5:3,0,-1,106018,93982
1:1:1,0,-1,106019,93981
2:4:4,1,1,106018,93982
6:1:2,1,1,106017,93983
3:5:1,0,-1,106018,93982
3:5:5,0,-1,106019,93981
5:6:5,0,-1,106020,93980
2:1:5,1,1,106019,93981
1:2:5,1,1,106018,93982
4:5:3,0,-1,106019,93981
1:6:2,1,1,106018,93982
6:5:6,0,-1,106019,93981
3:1:3,0,-1,106020,93980
3:1:5,0,-1,106021,93979
2:1:2,2,2,106019,93981
4:2:1,1,1,106018,93982
1:2:1,1,1,106017,93983
3:2:2,2,2,106015,93985
3:6:4,0,-1,106016,93984
2:3:2,2,2,106014,93986
5:1:4,0,-1,106015,93985
2:5:6,1,1,106014,93986
6:3:2,1,1,106013,93987
5:1:3,0,-1,106014,93986
5:5:1,0,-1,106015,93985
6:6:3,0,-1,106016,93984
6:3:6,0,-1,106017,93983
6:3:2,1,1,106016,93984
4:4:2,1,1,106015,93985
3:6:6,0,-1,106016,93984
6:1:2,1,1,106015,93985
4:4:3,0,-1,106016,93984
4:6:5,0,-1,106017,93983
1:2:6,1,1,106016,93984
1:1:5,0,-1,106017,93983
3:2:1,1,1,106016,93984
1:1:6,0,-1,106017,93983
2:4:3,1,1,106016,93984
4:4:4,0,-1,106017,93983
5:1:4,0,-1,106018,93982
4:5:4,0,-1,106019,93981
5:4:5,0,-1,106020,93980
3:4:5,0,-1,106021,93979
5:3:1,0,-1,106022,93978
3:1:2,1,1,106021,93979
2:2:2,3,3,106018,93982
2:4:5,1,1,106017,93983
4:1:2,1,1,106016,93984
6:1:5,0,-1,106017,93983
4:6:1,0,-1,106018,93982
3:5:1,0,-1,106019,93981
2:3:3,1,1,106018,93982
4:1:3,0,-1,106019,93981
1:4:5,0,-1,106020,93980
5:2:3,1,1,106019,93981
4:4:5,0,-1,106020,93980
5:3:6,0,-1,106021,93979
6:3:4,0,-1,106022,93978
3:4:5,0,-1,106023,93977
2:5:4,1,1,106022,93978
1:3:2,1,1,106021,93979
2:1:1,1,1,106020,93980
5:5:5,0,-1,106021,93979
3:6:5,0,-1,106022,93978
1:4:4,0,-1,106023,93977
5:2:5,1,1,106022,93978
5:2:5,1,1,106021,93979
5:5:2,1,1,106020,93980
6:4:5,0,-1,106021,93979
6:3:3,0,-1,106022,93978
2:4:4,1,1,106021,93979
4:1:5,0,-1,106022,93978
4:3:2,1,1,106021,93979
4:3:2,1,1,106020,93980
4:2:1,1,1,106019,93981
4:6:4,0,-1,106020,93980
3:3:2,1,1,106019,93981
1:2:5,1,1,106018,93982
2:2:3,2,2,106016,93984
2:5:2,2,2,106014,93986
1:1:4,0,-1,106015,93985
2:2:2,3,3,106012,93988
1:3:3,0,-1,106013,93987
4:5:1,0,-1,106014,93986
6:5:3,0,-1,106015,93985
3:2:4,1,1,106014,93986
3:4:6,0,-1,106015,93985
3:1:4,0,-1,106016,93984
6:3:2,1,1,106015,93985
6:6:2,1,1,106014,93986
3:4:6,0,-1,106015,93985
4:4:2,1,1,106014,93986
3:5:5,0,-1,106015,93985
1:3:4,0,-1,106016,93984
2:3:2,2,2,106014,93986
3:1:3,0,-1,106015,93985
1:4:4,0,-1,106016,93984
5:4:3,0,-1,106017,93983
2:2:1,2,2,106015,93985
1:4:2,1,1,106014,93986
1:2:1,1,1,106013,93987
3:3:6,0,-1,106014,93986
1:5:6,0,-1,106015,93985
6:5:6,0,-1,106016,93984
4:6:3,0,-1,106017,93983
1:6:4,0,-1,106018,93982
5:1:6,0,-1,106019,93981
5:5:3,0,-1,106020,93980
5:5:2,1,1,106019,93981
3:3:5,0,-1,106020,93980
5:3:5,0,-1,106021,93979
3:2:4,1,1,106020,93980
6:6:3,0,-1,106021,93979
4:4:2,1,1,106020,93980
2:2:3,2,2,106018,93982
2:2:2,3,3,106015,93985
4:5:1,0,-1,106016,93984
5:1:4,0,-1,106017,93983
3:6:6,0,-1,106018,93982
4:2:6,1,1,106017,93983
2:5:1,1,1,106016,93984
3:4:2,1,1,106015,93985
3:2:5,1,1,106014,93986
4:2:4,1,1,106013,93987
4:6:6,0,-1,106014,93986
1:6:3,0,-1,106015,93985
3:5:3,0,-1,106016,93984
1:4:2,1,1,106015,93985
1:3:1,0,-1,106016,93984
6:1:5,0,-1,106017,93983
3:6:4,0,-1,106018,93982
3:3:3,0,-1,106019,93981
4:3:4,0,-1,106020,93980
5:5:1,0,-1,106021,93979
2:1:2,2,2,106019,93981
5:1:3,0,-1,106020,93980
1:2:1,1,1,106019,93981
3:4:6,0,-1,106020,93980
1:6:4,0,-1,106021,93979
3:3:6,0,-1,106022,93978
6:1:2,1,1,106021,93979
5:1:6,0,-1,106022,93978
5:1:6,0,-1,106023,93977
3:6:3,0,-1,106024,93976
5:5:4,0,-1,106025,93975
1:3:4,0,-1,106026,93974
2:2:4,2,2,106024,93976
1:5:1,0,-1,106025,93975
3:6:1,0,-1,106026,93974
2:4:2,2,2,106024,93976
1:6:1,0,-1,106025,93975
1:1:5,0,-1,106026,93974
5:1:6,0,-1,106027,93973
6:3:4,0,-1,106028,93972
2:5:2,2,2,106026,93974
5:5:5,0,-1,106027,93973
5:3:4,0,-1,106028,93972
3:6:5,0,-1,106029,93971
4:4:3,0,-1,106030,93970
6:2:2,2,2,106028,93972
3:3:3,0,-1,106029,93971
1:5:2,1,1,106028,93972
2:2:4,2,2,106026,93974
6:2:5,1,1,106025,93975
5:2:6,1,1,106024,93976
6:5:2,1,1,106023,93977
3:2:2,2,2,106021,93979
4:1:4,0,-1,106022,93978
6:1:6,0,-1,106023,93977
6:5:5,0,-1,106024,93976
5:3:5,0,-1,106025,93975
5:6:1,0,-1,106026,93974
4:3:2,1,1,106025,93975
4:5:2,1,1,106024,93976
2:3:4,1,1,106023,93977
3:4:5,0,-1,106024,93976
2:3:3,1,1,106023,93977
3:1:6,0,-1,106024,93976
3:5:5,0,-1,106025,93975
2:1:1,1,1,106024,93976
5:4:5,0,-1,106025,93975
2:6:2,2,2,106023,93977
2:1:3,1,1,106022,93978
1:2:3,1,1,106021,93979
2:5:6,1,1,106020,93980
5:2:6,1,1,106019,93981
3:5:1,0,-1,106020,93980
2:6:5,1,1,106019,93981
5:2:4,1,1,106018,93982
2:1:2,2,2,106016,93984
6:6:4,0,-1,106017,93983
1:4:6,0,-1,106018,93982
6:6:2,1,1,106017,93983
3:2:5,1,1,106016,93984
5:1:2,1,1,106015,93985
4:4:4,0,-1,106016,93984
3:3:2,1,1,106015,93985
2:2:2,3,3,106012,93988
4:2:3,1,1,106011,93989
5:3:3,0,-1,106012,93988
2:2:2,3,3,106009,93991
2:2:2,3,3,106006,93994
1:6:6,0,-1,106007,93993
3:1:1,0,-1,106008,93992
4:1:4,0,-1,106009,93991
4:6:1,0,-1,106010,93990
2:1:3,1,1,106009,93991
1:6:1,0,-1,106010,93990
5:6:1,0,-1,106011,93989
6:1:3,0,-1,106012,93988
1:6:1,0,-1,106013,93987
5:6:5,0,-1,106014,93986
1:3:5,0,-1,106015,93985
2:2:1,2,2,106013,93987
3:3:3,0,-1,106014,93986
6:3:5,0,-1,106015,93985
3:6:1,0,-1,106016,93984
3:1:2,1,1,106015,93985
2:3:6,1,1,106014,93986
3:2:3,1,1,106013,93987
6:3:3,0,-1,106014,93986
2:3:3,1,1,106013,93987
5:2:6,1,1,106012,93988
5:1:4,0,-1,106013,93987
4:3:3,0,-1,106014,93986
3:6:5,0,-1,106015,93985
5:3:5,0,-1,106016,93984
4:6:5,0,-1,106017,93983
5:1:2,1,1,106016,93984
6:5:2,1,1,106015,93985
6:1:5,0,-1,106016,93984
1:3:1,0,-1,106017,93983
6:5:5,0,-1,106018,93982
3:2:6,1,1,106017,93983
4:3:2,1,1,106016,93984
3:6:3,0,-1,106017,93983
2:3:4,1,1,106016,93984
6:4:3,0,-1,106017,93983
5:5:1,0,-1,106018,93982
2:4:3,1,1,106017,93983
6:3:3,0,-1,106018,93982
2:4:2,2,2,106016,93984
2:2:2,3,3,106013,93987
2:3:6,1,1,106012,93988
4:2:2,2,2,106010,93990
3:3:1,0,-1,106011,93989
3:3:3,0,-1,106012,93988
5:4:2,1,1,106011,93989
2:5:6,1,1,106010,93990
2:1:5,1,1,106009,93991
4:5:6,0,-1,106010,93990
5:4:3,0,-1,106011,93989
5:2:3,1,1,106010,93990
5:1:2,1,1,106009,93991
1:6:1,0,-1,106010,93990
5:1:2,1,1,106009,93991
4:5:4,0,-1,106010,93990
5:2:4,1,1,106009,93991
6:4:4,0,-1,106010,93990
1:1:2,1,1,106009,93991
1:5:2,1,1,106008,93992
3:2:4,1,1,106007,93993
2:3:4,1,1,106006,93994
4:3:2,1,1,106005,93995
3:6:3,0,-1,106006,93994
6:2:1,1,1,106005,93995
1:6:6,0,-1,106006,93994
6:3:5,0,-1,106007,93993
1:3:4,0,-1,106008,93992
4:1:2,1,1,106007,93993
5:6:1,0,-1,106008,93992
3:1:6,0,-1,106009,93991
1:2:4,1,1,106008,93992
4:4:5,0,-1,106009,93991
5:5:4,0,-1,106010,93990
5:5:2,1,1,106009,93991
1:3:5,0,-1,106010,93990
5:3:4,0,-1,106011,93989
3:1:4,0,-1,106012,93988
5:3:2,1,1,106011,93989
3:2:5,1,1,106010,93990
6:1:4,0,-1,106011,93989
3:1:6,0,-1,106012,93988
5:1:1,0,-1,106013,93987
6:6:6,0,-1,106014,93986
6:3:2,1,1,106013,93987
6:5:6,0,-1,106014,93986
1:5:1,0,-1,106015,93985
6:4:3,0,-1,106016,93984
3:1:4,0,-1,106017,93983
3:5:6,0,-1,106018,93982
6:5:6,0,-1,106019,93981
2:1:6,1,1,106018,93982
4:1:5,0,-1,106019,93981
4:1:6,0,-1,106020,93980
2:1:2,2,2,106018,93982
1:4:1,0,-1,106019,93981
1:4:2,1,1,106018,93982
4:3:1,0,-1,106019,93981
1:1:1,0,-1,106020,93980
3:4:2,1,1,106019,93981
5:5:5,0,-1,106020,93980
3:3:1,0,-1,106021,93979
4:1:1,0,-1,106022,93978
3:2:1,1,1,106021,93979
4:1:3,0,-1,106022,93978
2:3:5,1,1,106021,93979
6:4:6,0,-1,106022,93978
3:1:2,1,1,106021,93979
2:6:5,1,1,106020,93980
1:1:4,0,-1,106021,93979
6:4:1,0,-1,106022,93978
2:1:2,2,2,106020,93980
2:2:4,2,2,106018,93982
3:1:6,0,-1,106019,93981
2:6:1,1,1,106018,93982
6:4:2,1,1,106017,93983
6:2:3,1,1,106016,93984
2:6:5,1,1,106015,93985
3:5:2,1,1,106014,93986
3:1:4,0,-1,106015,93985
5:5:4,0,-1,106016,93984
2:4:6,1,1,106015,93985
6:2:6,1,1,106014,93986
1:4:2,1,1,106013,93987
2:2:2,3,3,106010,93990
4:5:5,0,-1,106011,93989
5:4:4,0,-1,106012,93988
3:6:2,1,1,106011,93989
1:4:5,0,-1,106012,93988
4:1:6,0,-1,106013,93987
3:3:4,0,-1,106014,93986
6:1:4,0,-1,106015,93985
5:6:6,0,-1,106016,93984
4:6:2,1,1,106015,93985
5:2:2,2,2,106013,93987
6:1:6,0,-1,106014,93986
4:3:6,0,-1,106015,93985
1:3:3,0,-1,106016,93984
2:6:3,1,1,106015,93985
1:1:3,0,-1,106016,93984
5:5:5,0,-1,106017,93983
1:1:4,0,-1,106018,93982
3:6:3,0,-1,106019,93981
5:4:3,0,-1,106020,93980
5:5:1,0,-1,106021,93979
5:1:6,0,-1,106022,93978
2:4:1,1,1,106021,93979
6:3:1,0,-1,106022,93978
5:5:1,0,-1,106023,93977
4:6:1,0,-1,106024,93976
1:2:4,1,1,106023,93977
5:4:3,0,-1,106024,93976
5:4:6,0,-1,106025,93975
6:5:5,0,-1,106026,93974
6:3:3,0,-1,106027,93973
6:6:4,0,-1,106028,93972
3:4:4,0,-1,106029,93971
1:5:5,0,-1,106030,93970
4:4:5,0,-1,106031,93969
5:3:3,0,-1,106032,93968
3:1:1,0,-1,106033,93967
5:4:2,1,1,106032,93968
5:5:5,0,-1,106033,93967
2:6:4,1,1,106032,93968
1:5:3,0,-1,106033,93967
4:4:1,0,-1,106034,93966
2:6:1,1,1,106033,93967
6:1:2,1,1,106032,93968
4:3:6,0,-1,106033,93967
3:5:1,0,-1,106034,93966
6:6:4,0,-1,106035,93965
6:2:3,1,1,106034,93966
1:5:6,0,-1,106035,93965
4:1:3,0,-1,106036,93964
3:6:4,0,-1,106037,93963
1:6:5,0,-1,106038,93962
2:2:6,2,2,106036,93964
4:6:2,1,1,106035,93965
3:5:2,1,1,106034,93966
4:1:1,0,-1,106035,93965
3:5:1,0,-1,106036,93964
3:4:6,0,-1,106037,93963
5:3:1,0,-1,106038,93962
2:5:6,1,1,106037,93963
6:5:1,0,-1,106038,93962
3:5:1,0,-1,106039,93961
4:4:6,0,-1,106040,93960
5:4:2,1,1,106039,93961
5:5:3,0,-1,106040,93960
4:5:6,0,-1,106041,93959
1:1:2,1,1,106040,93960
1:4:2,1,1,106039,93961
1:2:1,1,1,106038,93962
5:6:3,0,-1,106039,93961
5:1:5,0,-1,106040,93960
2:2:5,2,2,106038,93962
3:3:1,0,-1,106039,93961
6:6:6,0,-1,106040,93960
3:2:2,2,2,106038,93962
6:1:3,0,-1,106039,93961
6:4:5,0,-1,106040,93960
1:2:3,1,1,106039,93961
1:5:1,0,-1,106040,93960
1:6:2,1,1,106039,93961
4:3:6,0,-1,106040,93960
1:5:2,1,1,106039,93961
2:3:1,1,1,106038,93962
3:5:3,0,-1,106039,93961
5:6:6,0,-1,106040,93960
2:4:1,1,1,106039,93961
3:6:1,0,-1,106040,93960
4:5:5,0,-1,106041,93959
5:3:5,0,-1,106042,93958
6:5:2,1,1,106041,93959
1:5:1,0,-1,106042,93958
6:1:1,0,-1,106043,93957
4:3:1,0,-1,106044,93956
5:2:2,2,2,106042,93958
5:4:1,0,-1,106043,93957
3:3:6,0,-1,106044,93956
3:4:6,0,-1,106045,93955
6:5:4,0,-1,106046,93954
6:2:6,1,1,106045,93955
4:3:3,0,-1,106046,93954
4:5:1,0,-1,106047,93953
4:1:6,0,-1,106048,93952
6:6:4,0,-1,106049,93951
4:2:6,1,1,106048,93952
6:1:4,0,-1,106049,93951
5:3:6,0,-1,106050,93950
1:5:2,1,1,106049,93951
2:3:6,1,1,106048,93952
6:4:1,0,-1,106049,93951
1:3:6,0,-1,106050,93950
6:2:2,2,2,106048,93952
6:1:4,0,-1,106049,93951
3:2:6,1,1,106048,93952
5:4:4,0,-1,106049,93951
6:2:2,2,2,106047,93953
1:6:3,0,-1,106048,93952
5:1:4,0,-1,106049,93951
2:3:1,1,1,106048,93952
5:6:5,0,-1,106049,93951
3:4:4,0,-1,106050,93950
2:3:2,2,2,106048,93952
4:4:3,0,-1,106049,93951
3:1:5,0,-1,106050,93950
6:6:1,0,-1,106051,93949
3:2:2,2,2,106049,93951
5:4:5,0,-1,106050,93950
4:1:5,0,-1,106051,93949
4:1:5,0,-1,106052,93948
2:6:2,2,2,106050,93950
1:5:1,0,-1,106051,93949
4:2:5,1,1,106050,93950
6:5:3,0,-1,106051,93949
1:1:4,0,-1,106052,93948
1:4:6,0,-1,106053,93947
1:2:6,1,1,106052,93948
1:6:5,0,-1,106053,93947
1:1:6,0,-1,106054,93946
4:1:2,1,1,106053,93947
6:4:6,0,-1,106054,93946
2:3:4,1,1,106053,93947
6:6:6,0,-1,106054,93946
1:6:3,0,-1,106055,93945
6:4:6,0,-1,106056,93944
4:5:4,0,-1,106057,93943
4:3:1,0,-1,106058,93942
2:4:4,1,1,106057,93943
5:3:3,0,-1,106058,93942
4:3:3,0,-1,106059,93941
1:1:3,0,-1,106060,93940
5:5:4,0,-1,106061,93939
1:4:6,0,-1,106062,93938
2:5:5,1,1,106061,93939
2:1:6,1,1,106060,93940
4:4:5,0,-1,106061,93939
3:3:4,0,-1,106062,93938
2:1:6,1,1,106061,93939
3:5:5,0,-1,106062,93938
2:1:1,1,1,106061,93939
2:2:2,3,3,106058,93942
4:5:1,0,-1,106059,93941
6:2:1,1,1,106058,93942
2:1:2,2,2,106056,93944
2:1:2,2,2,106054,93946
1:3:2,1,1,106053,93947
5:4:4,0,-1,106054,93946
5:3:4,0,-1,106055,93945
2:1:2,2,2,106053,93947
6:1:3,0,-1,106054,93946
4:3:6,0,-1,106055,93945
5:5:6,0,-1,106056,93944
6:1:4,0,-1,106057,93943
6:4:1,0,-1,106058,93942
3:4:2,1,1,106057,93943
3:6:1,0,-1,106058,93942
2:5:6,1,1,106057,93943
4:4:5,0,-1,106058,93942
5:1:5,0,-1,106059,93941
6:5:6,0,-1,106060,93940
1:6:5,0,-1,106061,93939
3:2:5,1,1,106060,93940
3:5:3,0,-1,106061,93939
2:5:5,1,1,106060,93940
3:6:1,0,-1,106061,93939
2:2:4,2,2,106059,93941
6:2:2,2,2,106057,93943
1:3:1,0,-1,106058,93942
3:3:5,0,-1,106059,93941
2:1:6,1,1,106058,93942
3:3:2,1,1,106057,93943
6:1:2,1,1,106056,93944
1:2:4,1,1,106055,93945
5:1:1,0,-1,106056,93944
5:6:2,1,1,106055,93945
1:6:3,0,-1,106056,93944
3:6:2,1,1,106055,93945
3:1:2,1,1,106054,93946
4:2:4,1,1,106053,93947
4:3:3,0,-1,106054,93946
6:3:1,0,-1,106055,93945
2:2:4,2,2,106053,93947
3:2:1,1,1,106052,93948
2:1:4,1,1,106051,93949
6:6:4,0,-1,106052,93948
1:5:2,1,1,106051,93949
5:2:3,1,1,106050,93950
1:6:5,0,-1,106051,93949
4:5:2,1,1,106050,93950
4:2:1,1,1,106049,93951
2:1:1,1,1,106048,93952
4:5:4,0,-1,106049,93951
3:1:4,0,-1,106050,93950
5:3:5,0,-1,106051,93949
4:4:1,0,-1,106052,93948
3:2:4,1,1,106051,93949
2:1:1,1,1,106050,93950
6:6:1,0,-1,106051,93949
5:4:1,0,-1,106052,93948
6:5:1,0,-1,106053,93947
3:5:4,0,-1,106054,93946
5:4:6,0,-1,106055,93945
6:2:4,1,1,106054,93946
1:5:6,0,-1,106055,93945
4:5:6,0,-1,106056,93944
2:3:3,1,1,106055,93945
3:6:1,0,-1,106056,93944
6:1:2,1,1,106055,93945
1:1:4,0,-1,106056,93944
6:2:2,2,2,106054,93946
6:5:1,0,-1,106055,93945
5:3:6,0,-1,106056,93944
3:5:2,1,1,106055,93945
5:5:6,0,-1,106056,93944
6:5:4,0,-1,106057,93943
5:5:5,0,-1,106058,93942
4:1:4,0,-1,106059,93941
1:6:4,0,-1,106060,93940
3:6:1,0,-1,106061,93939
4:2:2,2,2,106059,93941
2:4:2,2,2,106057,93943
1:6:4,0,-1,106058,93942
3:1:5,0,-1,106059,93941
1:3:4,0,-1,106060,93940
6:1:4,0,-1,106061,93939
5:6:6,0,-1,106062,93938
3:2:3,1,1,106061,93939
2:5:3,1,1,106060,93940
4:4:1,0,-1,106061,93939
6:6:5,0,-1,106062,93938
4:3:5,0,-1,106063,93937
6:2:3,1,1,106062,93938
6:4:5,0,-1,106063,93937
1:2:6,1,1,106062,93938
3:6:1,0,-1,106063,93937
1:1:6,0,-1,106064,93936
6:1:4,0,-1,106065,93935
6:5:3,0,-1,106066,93934
3:3:4,0,-1,106067,93933
4:6:5,0,-1,106068,93932
3:1:3,0,-1,106069,93931
2:6:4,1,1,106068,93932
5:2:1,1,1,106067,93933
6:3:1,0,-1,106068,93932
1:5:2,1,1,106067,93933
1:4:3,0,-1,106068,93932
5:1:3,0,-1,106069,93931
3:5:5,0,-1,106070,93930
3:2:1,1,1,106069,93931
2:6:4,1,1,106068,93932
5:1:2,1,1,106067,93933
1:2:1,1,1,106066,93934
4:3:1,0,-1,106067,93933
6:4:2,1,1,106066,93934
6:2:3,1,1,106065,93935
2:5:6,1,1,106064,93936
5:4:4,0,-1,106065,93935
2:1:5,1,1,106064,93936
1:1:2,1,1,106063,93937
1:2:3,1,1,106062,93938
4:2:6,1,1,106061,93939
3:4:1,0,-1,106062,93938
4:3:2,1,1,106061,93939
5:1:5,0,-1,106062,93938
3:3:6,0,-1,106063,93937
2:4:3,1,1,106062,93938
6:1:1,0,-1,106063,93937
6:3:3,0,-1,106064,93936
5:4:6,0,-1,106065,93935
5:2:5,1,1,106064,93936
4:4:4,0,-1,106065,93935
2:4:5,1,1,106064,93936
1:2:5,1,1,106063,93937
6:6:3,0,-1,106064,93936
4:2:5,1,1,106063,93937
3:1:2,1,1,106062,93938
6:2:5,1,1,106061,93939
1:5:3,0,-1,106062,93938
3:4:3,0,-1,106063,93937
5:3:6,0,-1,106064,93936
4:1:3,0,-1,106065,93935
4:1:2,1,1,106064,93936
6:2:4,1,1,106063,93937
6:2:5,1,1,106062,93938
4:2:5,1,1,106061,93939
6:2:2,2,2,106059,93941
1:6:1,0,-1,106060,93940
3:6:3,0,-1,106061,93939
4:1:4,0,-1,106062,93938
3:3:6,0,-1,106063,93937
4:1:6,0,-1,106064,93936
2:1:5,1,1,106063,93937
6:4:6,0,-1,106064,93936
2:4:5,1,1,106063,93937
6:3:6,0,-1,106064,93936
3:1:6,0,-1,106065,93935
1:6:1,0,-1,106066,93934
5:5:2,1,1,106065,93935
6:1:6,0,-1,106066,93934
6:6:2,1,1,106065,93935
6:1:4,0,-1,106066,93934
6:3:6,0,-1,106067,93933
4:1:6,0,-1,106068,93932
6:1:1,0,-1,106069,93931
1:4:1,0,-1,106070,93930
6:4:2,1,1,106069,93931
1:3:4,0,-1,106070,93930
5:5:1,0,-1,106071,93929
3:3:5,0,-1,106072,93928
2:2:2,3,3,106069,93931
3:4:1,0,-1,106070,93930
2:2:3,2,2,106068,93932
3:4:6,0,-1,106069,93931
5:6:5,0,-1,106070,93930
2:6:6,1,1,106069,93931
6:2:6,1,1,106068,93932
6:1:2,1,1,106067,93933
6:5:6,0,-1,106068,93932
3:3:3,0,-1,106069,93931
3:2:4,1,1,106068,93932
6:1:6,0,-1,106069,93931
1:3:6,0,-1,106070,93930
2:6:2,2,2,106068,93932
2:2:1,2,2,106066,93934
1:5:1,0,-1,106067,93933
1:6:4,0,-1,106068,93932
3:2:3,1,1,106067,93933
6:5:5,0,-1,106068,93932
4:3:5,0,-1,106069,93931
3:4:1,0,-1,106070,93930
3:4:4,0,-1,106071,93929
5:1:5,0,-1,106072,93928
2:2:2,3,3,106069,93931
4:4:2,1,1,106068,93932
1:5:3,0,-1,106069,93931
3:3:2,1,1,106068,93932
5:2:5,1,1,106067,93933
4:2:1,1,1,106066,93934
5:4:6,0,-1,106067,93933
3:1:2,1,1,106066,93934
1:2:1,1,1,106065,93935
1:5:4,0,-1,106066,93934
6:4:4,0,-1,106067,93933
4:1:5,0,-1,106068,93932
5:5:4,0,-1,106069,93931
4:6:1,0,-1,106070,93930
1:6:6,0,-1,106071,93929
4:2:1,1,1,106070,93930
6:4:6,0,-1,106071,93929
6:6:4,0,-1,106072,93928
3:1:3,0,-1,106073,93927
6:2:6,1,1,106072,93928
5:5:4,0,-1,106073,93927
2:4:3,1,1,106072,93928
2:4:4,1,1,106071,93929
3:5:6,0,-1,106072,93928
3:4:5,0,-1,106073,93927
2:4:1,1,1,106072,93928
5:2:4,1,1,106071,93929
3:4:3,0,-1,106072,93928
3:1:3,0,-1,106073,93927
4:5:4,0,-1,106074,93926
6:5:3,0,-1,106075,93925
1:2:6,1,1,106074,93926
3:6:6,0,-1,106075,93925
4:5:6,0,-1,106076,93924
2:1:1,1,1,106075,93925
1:4:2,1,1,106074,93926
5:4:4,0,-1,106075,93925
5:5:4,0,-1,106076,93924
4:5:3,0,-1,106077,93923
2:6:6,1,1,106076,93924
2:2:3,2,2,106074,93926
2:5:5,1,1,106073,93927
4:3:1,0,-1,106074,93926
3:2:6,1,1,106073,93927
1:6:1,0,-1,106074,93926
6:2:6,1,1,106073,93927
5:1:2,1,1,106072,93928
1:4:4,0,-1,106073,93927
4:5:1,0,-1,106074,93926
2:4:1,1,1,106073,93927
6:3:6,0,-1,106074,93926
5:2:6,1,1,106073,93927
4:1:1,0,-1,106074,93926
6:3:6,0,-1,106075,93925
2:6:2,2,2,106073,93927
4:3:3,0,-1,106074,93926
3:2:6,1,1,106073,93927
3:5:4,0,-1,106074,93926
6:5:2,1,1,106073,93927
4:6:3,0,-1,106074,93926
2:3:6,1,1,106073,93927
6:6:1,0,-1,106074,93926
4:3:1,0,-1,106075,93925
4:5:6,0,-1,106076,93924
4:3:6,0,-1,106077,93923
2:5:5,1,1,106076,93924
2:1:2,2,2,106074,93926
2:1:1,1,1,106073,93927
4:5:5,0,-1,106074,93926
2:3:2,2,2,106072,93928
6:1:3,0,-1,106073,93927
5:2:6,1,1,106072,93928
2:4:4,1,1,106071,93929
6:3:4,0,-1,106072,93928
2:4:3,1,1,106071,93929
1:6:1,0,-1,106072,93928
1:2:2,2,2,106070,93930
6:5:1,0,-1,106071,93929
2:4:2,2,2,106069,93931
3:6:4,0,-1,106070,93930
1:6:4,0,-1,106071,93929
6:1:5,0,-1,106072,93928
6:2:4,1,1,106071,93929
5:6:5,0,-1,106072,93928
6:3:2,1,1,106071,93929
3:4:6,0,-1,106072,93928
6:3:2,1,1,106071,93929
4:6:2,1,1,106070,93930
4:5:6,0,-1,106071,93929
2:4:5,1,1,106070,93930
6:1:1,0,-1,106071,93929
5:6:6,0,-1,106072,93928
6:2:4,1,1,106071,93929
2:3:1,1,1,106070,93930
5:4:1,0,-1,106071,93929
3:5:6,0,-1,106072,93928
3:1:4,0,-1,106073,93927
1:1:6,0,-1,106074,93926
5:1:2,1,1,106073,93927
6:3:6,0,-1,106074,93926
1:1:1,0,-1,106075,93925
1:2:4,1,1,106074,93926
3:2:3,1,1,106073,93927
6:3:5,0,-1,106074,93926
4:4:6,0,-1,106075,93925
1:3:1,0,-1,106076,93924
3:5:3,0,-1,106077,93923
4:2:6,1,1,106076,93924
2:3:1,1,1,106075,93925
3:5:5,0,-1,106076,93924
3:4:1,0,-1,106077,93923
4:1:1,0,-1,106078,93922
1:6:4,0,-1,106079,93921
5:2:4,1,1,106078,93922
4:1:5,0,-1,106079,93921
4:6:5,0,-1,106080,93920
3:1:2,1,1,106079,93921
6:5:3,0,-1,106080,93920
6:2:2,2,2,106078,93922
5:6:3,0,-1,106079,93921
5:6:6,0,-1,106080,93920
1:4:3,0,-1,106081,93919
1:5:5,0,-1,106082,93918
6:3:5,0,-1,106083,93917
6:4:5,0,-1,106084,93916
3:2:2,2,2,106082,93918
2:2:3,2,2,106080,93920
2:1:3,1,1,106079,93921
5:6:3,0,-1,106080,93920
5:2:3,1,1,106079,93921
3:1:2,1,1,106078,93922
3:3:2,1,1,106077,93923
3:2:2,2,2,106075,93925
4:3:6,0,-1,106076,93924
2:5:3,1,1,106075,93925
6:6:5,0,-1,106076,93924
4:1:1,0,-1,106077,93923
4:3:4,0,-1,106078,93922
3:3:4,0,-1,106079,93921
1:3:6,0,-1,106080,93920
2:3:5,1,1,106079,93921
4:1:3,0,-1,106080,93920
2:4:6,1,1,106079,93921
3:1:5,0,-1,106080,93920
3:5:6,0,-1,106081,93919
6:1:5,0,-1,106082,93918
5:1:1,0,-1,106083,93917
3:4:2,1,1,106082,93918
5:2:5,1,1,106081,93919
3:2:1,1,1,106080,93920
2:1:4,1,1,106079,93921
6:3:4,0,-1,106080,93920
3:5:4,0,-1,106081,93919
6:5:2,1,1,106080,93920
5:3:4,0,-1,106081,93919
1:4:2,1,1,106080,93920
1:2:1,1,1,106079,93921
1:4:5,0,-1,106080,93920
5:6:2,1,1,106079,93921
3:4:1,0,-1,106080,93920
3:2:3,1,1,106079,93921
2:1:2,2,2,106077,93923
6:1:2,1,1,106076,93924
3:1:3,0,-1,106077,93923
4:4:1,0,-1,106078,93922
4:6:2,1,1,106077,93923
3:2:6,1,1,106076,93924
5:1:3,0,-1,106077,93923
4:6:2,1,1,106076,93924
1:6:3,0,-1,106077,93923
3:4:3,0,-1,106078,93922
4:5:3,0,-1,106079,93921
2:6:1,1,1,106078,93922
4:1:6,0,-1,106079,93921
3:1:3,0,-1,106080,93920
3:5:1,0,-1,106081,93919
2:5:4,1,1,106080,93920
4:3:5,0,-1,106081,93919
5:2:2,2,2,106079,93921
3:6:4,0,-1,106080,93920
4:6:5,0,-1,106081,93919
1:2:3,1,1,106080,93920
6:6:1,0,-1,106081,93919
6:4:2,1,1,106080,93920
4:5:6,0,-1,106081,93919
6:1:5,0,-1,106082,93918
5:1:5,0,-1,106083,93917
6:3:6,0,-1,106084,93916
3:4:3,0,-1,106085,93915
3:5:3,0,-1,106086,93914
6:3:1,0,-1,106087,93913
3:5:5,0,-1,106088,93912
1:4:3,0,-1,106089,93911
6:3:4,0,-1,106090,93910
2:5:6,1,1,106089,93911
2:6:6,1,1,106088,93912
2:3:6,1,1,106087,93913
4:6:4,0,-1,106088,93912
1:2:5,1,1,106087,93913
6:4:4,0,-1,106088,93912
4:4:6,0,-1,106089,93911
1:2:1,1,1,106088,93912
6:3:6,0,-1,106089,93911
5:3:5,0,-1,106090,93910
4:6:6,0,-1,106091,93909
5:6:6,0,-1,106092,93908
6:6:1,0,-1,106093,93907
6:3:5,0,-1,106094,93906
6:5:2,1,1,106093,93907
2:5:1,1,1,106092,93908
6:1:2,1,1,106091,93909
1:2:3,1,1,106090,93910
4:2:2,2,2,106088,93912
5:1:6,0,-1,106089,93911
3:6:1,0,-1,106090,93910
2:2:5,2,2,106088,93912
5:6:1,0,-1,106089,93911
2:3:3,1,1,106088,93912
4:3:3,0,-1,106089,93911
1:6:6,0,-1,106090,93910
1:5:2,1,1,106089,93911
4:5:6,0,-1,106090,93910
4:6:5,0,-1,106091,93909
6:5:1,0,-1,106092,93908
6:1:6,0,-1,106093,93907
1:4:1,0,-1,106094,93906
4:5:5,0,-1,106095,93905
3:5:6,0,-1,106096,93904
4:2:3,1,1,106095,93905
2:5:1,1,1,106094,93906
1:5:4,0,-1,106095,93905
6:4:1,0,-1,106096,93904
2:3:3,1,1,106095,93905
2:4:6,1,1,106094,93906
6:1:3,0,-1,106095,93905
1:4:1,0,-1,106096,93904
5:4:2,1,1,106095,93905
4:3:2,1,1,106094,93906
5:6:5,0,-1,106095,93905
4:1:1,0,-1,106096,93904
2:6:4,1,1,106095,93905
6:4:1,0,-1,106096,93904
2:6:5,1,1,106095,93905
4:5:1,0,-1,106096,93904
2:6:1,1,1,106095,93905
1:5:2,1,1,106094,93906
6:1:3,0,-1,106095,93905
6:2:6,1,1,106094,93906
2:4:6,1,1,106093,93907
2:3:2,2,2,106091,93909
5:5:2,1,1,106090,93910
3:2:5,1,1,106089,93911
6:5:3,0,-1,106090,93910
2:1:4,1,1,106089,93911
4:5:1,0,-1,106090,93910
5:3:5,0,-1,106091,93909
3:4:4,0,-1,106092,93908
2:6:3,1,1,106091,93909
6:3:1,0,-1,106092,93908
1:5:5,0,-1,106093,93907
1:4:6,0,-1,106094,93906
4:2:2,2,2,106092,93908
4:4:6,0,-1,106093,93907
6:4:2,1,1,106092,93908
1:6:6,0,-1,106093,93907
6:5:4,0,-1,106094,93906
3:2:6,1,1,106093,93907
1:4:5,0,-1,106094,93906
2:6:4,1,1,106093,93907
4:5:1,0,-1,106094,93906
1:4:3,0,-1,106095,93905
1:2:5,1,1,106094,93906
6:6:2,1,1,106093,93907
3:3:4,0,-1,106094,93906
4:3:4,0,-1,106095,93905
6:2:4,1,1,106094,93906
2:3:1,1,1,106093,93907
6:1:4,0,-1,106094,93906
2:3:5,1,1,106093,93907
2:2:1,2,2,106091,93909
3:4:6,0,-1,106092,93908
1:2:1,1,1,106091,93909
6:3:1,0,-1,106092,93908
2:3:5,1,1,106091,93909
4:1:4,0,-1,106092,93908
3:4:6,0,-1,106093,93907
1:4:6,0,-1,106094,93906
2:6:5,1,1,106093,93907
4:4:2,1,1,106092,93908
3:2:4,1,1,106091,93909
4:4:6,0,-1,106092,93908
4:4:5,0,-1,106093,93907
4:6:5,0,-1,106094,93906
3:3:2,1,1,106093,93907
5:6:1,0,-1,106094,93906
5:6:6,0,-1,106095,93905
4:1:5,0,-1,106096,93904
4:5:4,0,-1,106097,93903
1:5:3,0,-1,106098,93902
3:1:4,0,-1,106099,93901
6:5:6,0,-1,106100,93900
3:5:3,0,-1,106101,93899
2:4:1,1,1,106100,93900
4:4:2,1,1,106099,93901
5:3:3,0,-1,106100,93900
3:4:5,0,-1,106101,93899
6:1:3,0,-1,106102,93898
5:3:5,0,-1,106103,93897
1:4:5,0,-1,106104,93896
4:2:6,1,1,106103,93897
5:5:3,0,-1,106104,93896
4:1:5,0,-1,106105,93895
3:5:2,1,1,106104,93896
5:2:3,1,1,106103,93897
1:2:1,1,1,106102,93898
1:6:2,1,1,106101,93899
4:5:3,0,-1,106102,93898
4:3:5,0,-1,106103,93897
3:5:1,0,-1,106104,93896
2:3:5,1,1,106103,93897
6:3:1,0,-1,106104,93896
4:6:5,0,-1,106105,93895
4:3:5,0,-1,106106,93894
5:6:4,0,-1,106107,93893
5:3:6,0,-1,106108,93892
6:3:3,0,-1,106109,93891
6:4:2,1,1,106108,93892
2:4:6,1,1,106107,93893
5:1:6,0,-1,106108,93892
3:3:6,0,-1,106109,93891
4:6:4,0,-1,106110,93890
6:2:4,1,1,106109,93891
2:1:6,1,1,106108,93892
2:5:4,1,1,106107,93893
4:6:3,0,-1,106108,93892
4:4:4,0,-1,106109,93891
1:5:1,0,-1,106110,93890
5:1:4,0,-1,106111,93889
5:1:4,0,-1,106112,93888
2:1:4,1,1,106111,93889
5:6:3,0,-1,106112,93888
5:1:1,0,-1,106113,93887
3:1:3,0,-1,106114,93886
2:4:6,1,1,106113,93887
5:5:2,1,1,106112,93888
4:5:5,0,-1,106113,93887
1:1:3,0,-1,106114,93886
2:3:1,1,1,106113,93887
6:6:3,0,-1,106114,93886
4:5:3,0,-1,106115,93885
1:2:6,1,1,106114,93886
4:6:3,0,-1,106115,93885
3:1:1,0,-1,106116,93884
4:2:5,1,1,106115,93885
2:3:5,1,1,106114,93886
4:3:4,0,-1,106115,93885
3:4:5,0,-1,106116,93884
5:2:4,1,1,106115,93885
5:5:3,0,-1,106116,93884
3:5:6,0,-1,106117,93883
5:1:2,1,1,106116,93884
6:2:1,1,1,106115,93885
1:1:2,1,1,106114,93886
4:3:2,1,1,106113,93887
1:1:6,0,-1,106114,93886
4:5:6,0,-1,106115,93885
6:1:6,0,-1,106116,93884
3:6:5,0,-1,106117,93883
6:6:3,0,-1,106118,93882
4:2:4,1,1,106117,93883
3:1:2,1,1,106116,93884
1:5:2,1,1,106115,93885
4:3:3,0,-1,106116,93884
3:2:2,2,2,106114,93886
1:4:2,1,1,106113,93887
6:6:3,0,-1,106114,93886
6:1:4,0,-1,106115,93885
6:3:2,1,1,106114,93886
3:5:6,0,-1,106115,93885
1:2:6,1,1,106114,93886
5:6:3,0,-1,106115,93885
5:1:6,0,-1,106116,93884
5:1:4,0,-1,106117,93883
1:6:2,1,1,106116,93884
6:1:5,0,-1,106117,93883
4:6:3,0,-1,106118,93882
2:5:2,2,2,106116,93884
4:3:5,0,-1,106117,93883
3:4:4,0,-1,106118,93882
2:6:5,1,1,106117,93883
1:2:2,2,2,106115,93885
5:5:5,0,-1,106116,93884
2:6:6,1,1,106115,93885
2:3:5,1,1,106114,93886
5:2:2,2,2,106112,93888
2:1:2,2,2,106110,93890
1:4:1,0,-1,106111,93889
4:6:6,0,-1,106112,93888
4:2:6,1,1,106111,93889
1:6:5,0,-1,106112,93888
4:4:4,0,-1,106113,93887
1:3:4,0,-1,106114,93886
4:1:6,0,-1,106115,93885
1:2:2,2,2,106113,93887
2:4:5,1,1,106112,93888
4:1:2,1,1,106111,93889
1:3:3,0,-1,106112,93888
4:3:3,0,-1,106113,93887
2:6:1,1,1,106112,93888
2:2:2,3,3,106109,93891
4:6:4,0,-1,106110,93890
1:5:2,1,1,106109,93891
1:4:6,0,-1,106110,93890
4:5:2,1,1,106109,93891
6:2:3,1,1,106108,93892
3:4:2,1,1,106107,93893
6:3:5,0,-1,106108,93892
6:1:3,0,-1,106109,93891
3:1:4,0,-1,106110,93890
3:2:2,2,2,106108,93892
5:1:2,1,1,106107,93893
1:5:4,0,-1,106108,93892
5:6:1,0,-1,106109,93891
4:1:3,0,-1,106110,93890
1:4:5,0,-1,106111,93889
3:4:6,0,-1,106112,93888
4:3:6,0,-1,106113,93887
5:6:3,0,-1,106114,93886
4:3:3,0,-1,106115,93885
2:5:2,2,2,106113,93887
6:3:4,0,-1,106114,93886
1:6:5,0,-1,106115,93885
6:1:3,0,-1,106116,93884
1:5:1,0,-1,106117,93883
5:2:5,1,1,106116,93884
4:5:5,0,-1,106117,93883
2:1:3,1,1,106116,93884
3:4:3,0,-1,106117,93883
3:1:6,0,-1,106118,93882
4:2:3,1,1,106117,93883
5:6:6,0,-1,106118,93882
1:4:2,1,1,106117,93883
1:6:5,0,-1,106118,93882
3:4:1,0,-1,106119,93881
4:6:1,0,-1,106120,93880
4:4:1,0,-1,106121,93879
4:5:3,0,-1,106122,93878
2:3:1,1,1,106121,93879
1:1:6,0,-1,106122,93878
6:1:3,0,-1,106123,93877
6:6:4,0,-1,106124,93876
5:1:4,0,-1,106125,93875
6:6:5,0,-1,106126,93874
4:6:5,0,-1,106127,93873
6:6:2,1,1,106126,93874
1:4:2,1,1,106125,93875
5:4:3,0,-1,106126,93874
3:3:6,0,-1,106127,93873
6:4:2,1,1,106126,93874
5:1:6,0,-1,106127,93873
3:5:6,0,-1,106128,93872
2:2:2,3,3,106125,93875
5:1:4,0,-1,106126,93874
5:6:1,0,-1,106127,93873
6:2:5,1,1,106126,93874
4:1:6,0,-1,106127,93873
5:6:3,0,-1,106128,93872
4:6:3,0,-1,106129,93871
1:1:4,0,-1,106130,93870
6:5:3,0,-1,106131,93869
4:4:2,1,1,106130,93870
1:4:4,0,-1,106131,93869
2:6:4,1,1,106130,93870
5:3:4,0,-1,106131,93869
6:5:2,1,1,106130,93870
3:4:1,0,-1,106131,93869
4:6:6,0,-1,106132,93868
2:5:1,1,1,106131,93869
6:6:6,0,-1,106132,93868
1:1:6,0,-1,106133,93867
4:1:1,0,-1,106134,93866
2:1:4,1,1,106133,93867
2:2:4,2,2,106131,93869
5:5:5,0,-1,106132,93868
4:3:4,0,-1,106133,93867
4:2:5,1,1,106132,93868
5:4:4,0,-1,106133,93867
3:4:5,0,-1,106134,93866
2:5:5,1,1,106133,93867
4:1:5,0,-1,106134,93866
3:4:2,1,1,106133,93867
2:3:2,2,2,106131,93869
3:2:2,2,2,106129,93871
1:5:1,0,-1,106130,93870
2:1:4,1,1,106129,93871
3:1:6,0,-1,106130,93870
2:1:4,1,1,106129,93871
6:6:4,0,-1,106130,93870
5:1:1,0,-1,106131,93869
2:5:1,1,1,106130,93870
2:1:4,1,1,106129,93871
6:6:4,0,-1,106130,93870
3:4:4,0,-1,106131,93869
6:2:3,1,1,106130,93870
5:6:3,0,-1,106131,93869
2:1:3,1,1,106130,93870
5:4:5,0,-1,106131,93869
2:2:4,2,2,106129,93871
2:3:2,2,2,106127,93873
3:6:3,0,-1,106128,93872
3:1:1,0,-1,106129,93871
3:6:6,0,-1,106130,93870
3:1:5,0,-1,106131,93869
6:4:4,0,-1,106132,93868
5:4:3,0,-1,106133,93867
2:5:1,1,1,106132,93868
6:5:1,0,-1,106133,93867
5:1:4,0,-1,106134,93866
4:2:2,2,2,106132,93868
1:4:2,1,1,106131,93869
6:4:6,0,-1,106132,93868
6:4:2,1,1,106131,93869
4:4:3,0,-1,106132,93868
3:3:6,0,-1,106133,93867
5:2:3,1,1,106132,93868
2:4:6,1,1,106131,93869
2:1:5,1,1,106130,93870
6:6:2,1,1,106129,93871
5:5:5,0,-1,106130,93870
5:6:2,1,1,106129,93871
2:2:6,2,2,106127,93873
2:1:1,1,1,106126,93874
5:3:5,0,-1,106127,93873
6:4:2,1,1,106126,93874
6:3:2,1,1,106125,93875
4:2:1,1,1,106124,93876
4:6:6,0,-1,106125,93875
6:3:5,0,-1,106126,93874
1:2:4,1,1,106125,93875
2:4:2,2,2,106123,93877
3:5:1,0,-1,106124,93876
1:2:5,1,1,106123,93877
1:2:4,1,1,106122,93878
2:3:5,1,1,106121,93879
6:6:5,0,-1,106122,93878
1:1:3,0,-1,106123,93877
6:6:3,0,-1,106124,93876
2:6:3,1,1,106123,93877
2:3:2,2,2,106121,93879
4:6:1,0,-1,106122,93878
4:2:6,1,1,106121,93879
6:5:4,0,-1,106122,93878
5:3:5,0,-1,106123,93877
1:1:3,0,-1,106124,93876
3:2:6,1,1,106123,93877
1:4:3,0,-1,106124,93876
5:5:4,0,-1,106125,93875
1:4:4,0,-1,106126,93874
6:5:2,1,1,106125,93875
3:6:2,1,1,106124,93876
1:5:1,0,-1,106125,93875
2:2:2,3,3,106122,93878
3:5:6,0,-1,106123,93877
5:1:2,1,1,106122,93878
6:3:1,0,-1,106123,93877
3:6:1,0,-1,106124,93876
1:4:3,0,-1,106125,93875
4:4:3,0,-1,106126,93874
6:1:5,0,-1,106127,93873
2:1:5,1,1,106126,93874
6:5:3,0,-1,106127,93873
6:3:4,0,-1,106128,93872
1:3:3,0,-1,106129,93871
4:3:2,1,1,106128,93872
1:3:4,0,-1,106129,93871
4:1:2,1,1,106128,93872
3:4:6,0,-1,106129,93871
1:4:4,0,-1,106130,93870
5:6:6,0,-1,106131,93869
4:1:6,0,-1,106132,93868
4:3:1,0,-1,106133,93867
1:2:5,1,1,106132,93868
1:5:5,0,-1,106133,93867
3:1:3,0,-1,106134,93866
5:6:1,0,-1,106135,93865
5:2:6,1,1,106134,93866
2:1:1,1,1,106133,93867
2:3:6,1,1,106132,93868
6:3:5,0,-1,106133,93867
2:6:6,1,1,106132,93868
2:3:5,1,1,106131,93869
1:3:1,0,-1,106132,93868
3:1:1,0,-1,106133,93867
6:5:2,1,1,106132,93868
6:2:2,2,2,106130,93870
3:6:4,0,-1,106131,93869
3:6:3,0,-1,106132,93868
3:5:4,0,-1,106133,93867
3:6:1,0,-1,106134,93866
4:4:6,0,-1,106135,93865
4:5:3,0,-1,106136,93864
6:4:2,1,1,106135,93865
5:4:1,0,-1,106136,93864
6:2:3,1,1,106135,93865
6:6:6,0,-1,106136,93864
1:3:2,1,1,106135,93865
1:4:6,0,-1,106136,93864
6:1:2,1,1,106135,93865
2:3:1,1,1,106134,93866
3:2:1,1,1,106133,93867
5:4:1,0,-1,106134,93866
3:6:2,1,1,106133,93867
4:6:4,0,-1,106134,93866
1:1:6,0,-1,106135,93865
4:1:3,0,-1,106136,93864
4:1:2,1,1,106135,93865
2:3:4,1,1,106134,93866
2:6:3,1,1,106133,93867
1:6:3,0,-1,106134,93866
5:3:6,0,-1,106135,93865
5:1:4,0,-1,106136,93864
2:6:5,1,1,106135,93865
1:6:2,1,1,106134,93866
2:1:3,1,1,106133,93867
5:1:6,0,-1,106134,93866
6:2:5,1,1,106133,93867
3:5:4,0,-1,106134,93866
4:5:1,0,-1,106135,93865
4:1:4,0,-1,106136,93864
2:3:5,1,1,106135,93865
3:6:3,0,-1,106136,93864
4:6:1,0,-1,106137,93863
4:5:3,0,-1,106138,93862
2:3:3,1,1,106137,93863
4:1:1,0,-1,106138,93862
3:6:6,0,-1,106139,93861
6:1:5,0,-1,106140,93860
2:4:2,2,2,106138,93862
1:3:6,0,-1,106139,93861
1:6:6,0,-1,106140,93860
2:2:6,2,2,106138,93862
3:6:4,0,-1,106139,93861
3:5:2,1,1,106138,93862
2:6:4,1,1,106137,93863
4:5:1,0,-1,106138,93862
2:4:2,2,2,106136,93864
1:1:2,1,1,106135,93865
5:1:3,0,-1,106136,93864
5:1:5,0,-1,106137,93863
3:3:1,0,-1,106138,93862
3:1:4,0,-1,106139,93861
4:3:2,1,1,106138,93862
1:5:1,0,-1,106139,93861
6:2:6,1,1,106138,93862
3:6:4,0,-1,106139,93861
4:3:6,0,-1,106140,93860
2:1:3,1,1,106139,93861
4:5:4,0,-1,106140,93860
2:1:4,1,1,106139,93861
5:1:2,1,1,106138,93862
5:2:5,1,1,106137,93863
5:6:2,1,1,106136,93864
4:1:1,0,-1,106137,93863
6:2:4,1,1,106136,93864
2:1:6,1,1,106135,93865
6:5:3,0,-1,106136,93864
6:4:5,0,-1,106137,93863
1:3:3,0,-1,106138,93862
3:4:5,0,-1,106139,93861
5:6:5,0,-1,106140,93860
6:2:1,1,1,106139,93861
4:1:1,0,-1,106140,93860
3:1:3,0,-1,106141,93859
5:4:2,1,1,106140,93860
2:4:5,1,1,106139,93861
2:1:5,1,1,106138,93862
5:6:3,0,-1,106139,93861
2:6:4,1,1,106138,93862
5:2:6,1,1,106137,93863
5:5:3,0,-1,106138,93862
5:3:5,0,-1,106139,93861
1:6:1,0,-1,106140,93860
3:1:1,0,-1,106141,93859
2:1:5,1,1,106140,93860
2:4:4,1,1,106139,93861
3:3:6,0,-1,106140,93860
2:1:3,1,1,106139,93861
2:6:2,2,2,106137,93863
1:3:3,0,-1,106138,93862
3:6:5,0,-1,106139,93861
5:1:1,0,-1,106140,93860
5:6:4,0,-1,106141,93859
1:5:1,0,-1,106142,93858
5:5:6,0,-1,106143,93857
1:2:1,1,1,106142,93858
2:4:2,2,2,106140,93860
2:4:4,1,1,106139,93861
5:4:2,1,1,106138,93862
2:4:5,1,1,106137,93863
5:6:4,0,-1,106138,93862
1:1:2,1,1,106137,93863
5:1:2,1,1,106136,93864
4:6:3,0,-1,106137,93863
6:6:3,0,-1,106138,93862
6:4:6,0,-1,106139,93861
4:2:2,2,2,106137,93863
1:3:4,0,-1,106138,93862
5:5:3,0,-1,106139,93861
6:4:5,0,-1,106140,93860
2:5:2,2,2,106138,93862
2:5:2,2,2,106136,93864
1:1:4,0,-1,106137,93863
6:1:5,0,-1,106138,93862
4:1:1,0,-1,106139,93861
2:5:1,1,1,106138,93862
1:6:5,0,-1,106139,93861
2:4:4,1,1,106138,93862
5:1:2,1,1,106137,93863
2:4:5,1,1,106136,93864
2:6:4,1,1,106135,93865
5:3:4,0,-1,106136,93864
4:1:4,0,-1,106137,93863
3:5:6,0,-1,106138,93862
6:5:5,0,-1,106139,93861
5:3:5,0,-1,106140,93860
5:5:2,1,1,106139,93861
2:4:5,1,1,106138,93862
3:2:5,1,1,106137,93863
5:2:2,2,2,106135,93865
5:3:5,0,-1,106136,93864
2:5:1,1,1,106135,93865
1:6:2,1,1,106134,93866
2:3:6,1,1,106133,93867
6:5:4,0,-1,106134,93866
4:4:4,0,-1,106135,93865
4:5:1,0,-1,106136,93864
6:4:2,1,1,106135,93865
2:4:4,1,1,106134,93866
1:5:6,0,-1,106135,93865
3:4:6,0,-1,106136,93864
1:2:6,1,1,106135,93865
1:2:6,1,1,106134,93866
6:1:5,0,-1,106135,93865
1:2:6,1,1,106134,93866
4:1:4,0,-1,106135,93865
3:2:5,1,1,106134,93866
2:3:5,1,1,106133,93867
2:6:2,2,2,106131,93869
6:2:5,1,1,106130,93870
4:6:4,0,-1,106131,93869
4:3:3,0,-1,106132,93868
4:3:1,0,-1,106133,93867
2:5:2,2,2,106131,93869
2:1:1,1,1,106130,93870
5:3:4,0,-1,106131,93869
2:4:1,1,1,106130,93870
1:5:5,0,-1,106131,93869
2:4:2,2,2,106129,93871
4:5:5,0,-1,106130,93870
4:2:4,1,1,106129,93871
4:3:6,0,-1,106130,93870
3:5:6,0,-1,106131,93869
1:2:4,1,1,106130,93870
2:6:5,1,1,106129,93871
1:1:2,1,1,106128,93872
4:4:2,1,1,106127,93873
5:6:4,0,-1,106128,93872
5:1:5,0,-1,106129,93871
5:3:1,0,-1,106130,93870
3:4:5,0,-1,106131,93869
4:2:1,1,1,106130,93870
3:3:1,0,-1,106131,93869
6:3:4,0,-1,106132,93868
6:2:4,1,1,106131,93869
4:1:1,0,-1,106132,93868
2:3:4,1,1,106131,93869
5:5:4,0,-1,106132,93868
4:4:2,1,1,106131,93869
2:4:2,2,2,106129,93871
2:1:4,1,1,106128,93872
5:6:1,0,-1,106129,93871
3:5:3,0,-1,106130,93870
5:6:5,0,-1,106131,93869
6:2:5,1,1,106130,93870
3:4:6,0,-1,106131,93869
4:4:5,0,-1,106132,93868
6:1:5,0,-1,106133,93867
3:6:4,0,-1,106134,93866
6:2:3,1,1,106133,93867
4:4:2,1,1,106132,93868
3:5:2,1,1,106131,93869
2:6:6,1,1,106130,93870
4:5:4,0,-1,106131,93869
5:5:5,0,-1,106132,93868
5:2:2,2,2,106130,93870
2:3:4,1,1,106129,93871
4:5:5,0,-1,106130,93870
5:3:6,0,-1,106131,93869
2:1:5,1,1,106130,93870
1:5:5,0,-1,106131,93869
3:6:1,0,-1,106132,93868
3:4:5,0,-1,106133,93867
4:1:3,0,-1,106134,93866
5:6:2,1,1,106133,93867
3:3:3,0,-1,106134,93866
1:3:4,0,-1,106135,93865
6:6:6,0,-1,106136,93864
6:3:1,0,-1,106137,93863
2:6:5,1,1,106136,93864
6:2:1,1,1,106135,93865
4:4:1,0,-1,106136,93864
3:2:2,2,2,106134,93866
3:1:1,0,-1,106135,93865
2:6:4,1,1,106134,93866
1:6:4,0,-1,106135,93865
1:6:1,0,-1,106136,93864
6:4:4,0,-1,106137,93863
4:4:6,0,-1,106138,93862
4:5:3,0,-1,106139,93861
6:4:3,0,-1,106140,93860
5:3:3,0,-1,106141,93859
5:3:3,0,-1,106142,93858
3:4:6,0,-1,106143,93857
1:4:1,0,-1,106144,93856
1:3:1,0,-1,106145,93855
5:5:5,0,-1,106146,93854
3:6:4,0,-1,106147,93853
6:1:3,0,-1,106148,93852
1:6:2,1,1,106147,93853
4:3:2,1,1,106146,93854
1:1:2,1,1,106145,93855
6:5:2,1,1,106144,93856
1:3:4,0,-1,106145,93855
3:4:6,0,-1,106146,93854
5:5:3,0,-1,106147,93853
3:4:4,0,-1,106148,93852
4:3:1,0,-1,106149,93851
1:2:3,1,1,106148,93852
1:5:1,0,-1,106149,93851
4:4:3,0,-1,106150,93850
4:5:1,0,-1,106151,93849
1:5:4,0,-1,106152,93848
1:3:2,1,1,106151,93849
5:3:2,1,1,106150,93850
3:5:6,0,-1,106151,93849
2:5:3,1,1,106150,93850
3:4:2,1,1,106149,93851
4:3:5,0,-1,106150,93850
3:5:2,1,1,106149,93851
4:1:5,0,-1,106150,93850
2:1:4,1,1,106149,93851
6:4:5,0,-1,106150,93850
2:5:5,1,1,106149,93851
5:4:2,1,1,106148,93852
4:5:1,0,-1,106149,93851
2:2:5,2,2,106147,93853
4:5:5,0,-1,106148,93852
2:3:1,1,1,106147,93853
5:4:4,0,-1,106148,93852
1:6:6,0,-1,106149,93851
2:6:6,1,1,106148,93852
2:3:1,1,1,106147,93853
4:6:5,0,-1,106148,93852
1:6:1,0,-1,106149,93851
2:2:6,2,2,106147,93853
1:1:4,0,-1,106148,93852
5:6:6,0,-1,106149,93851
2:2:4,2,2,106147,93853
5:4:2,1,1,106146,93854
3:5:2,1,1,106145,93855
6:4:6,0,-1,106146,93854
5:4:6,0,-1,106147,93853
2:1:5,1,1,106146,93854
3:4:1,0,-1,106147,93853
2:3:2,2,2,106145,93855
5:4:1,0,-1,106146,93854
4:4:3,0,-1,106147,93853
3:1:2,1,1,106146,93854
3:2:6,1,1,106145,93855
6:5:5,0,-1,106146,93854
4:3:3,0,-1,106147,93853
5:3:3,0,-1,106148,93852
5:1:6,0,-1,106149,93851
4:1:5,0,-1,106150,93850
2:3:4,1,1,106149,93851
4:6:2,1,1,106148,93852
5:3:4,0,-1,106149,93851
4:5:1,0,-1,106150,93850
3:1:1,0,-1,106151,93849
3:5:2,1,1,106150,93850
6:6:4,0,-1,106151,93849
3:3:5,0,-1,106152,93848
4:1:1,0,-1,106153,93847
4:5:3,0,-1,106154,93846
6:6:3,0,-1,106155,93845
6:3:5,0,-1,106156,93844
6:1:5,0,-1,106157,93843
2:5:3,1,1,106156,93844
6:2:4,1,1,106155,93845
5:5:6,0,-1,106156,93844
3:6:5,0,-1,106157,93843
5:3:2,1,1,106156,93844
3:2:5,1,1,106155,93845
2:3:5,1,1,106154,93846
6:3:6,0,-1,106155,93845
3:1:4,0,-1,106156,93844
3:5:6,0,-1,106157,93843
1:5:3,0,-1,106158,93842
5:3:3,0,-1,106159,93841
4:6:3,0,-1,106160,93840
3:6:2,1,1,106159,93841
1:5:5,0,-1,106160,93840
3:2:1,1,1,106159,93841
2:6:5,1,1,106158,93842
6:4:6,0,-1,106159,93841
6:5:6,0,-1,106160,93840
1:6:1,0,-1,106161,93839
2:2:6,2,2,106159,93841
5:5:3,0,-1,106160,93840
1:5:5,0,-1,106161,93839
5:6:5,0,-1,106162,93838
4:3:1,0,-1,106163,93837
5:1:1,0,-1,106164,93836
3:5:4,0,-1,106165,93835
1:4:3,0,-1,106166,93834
2:4:3,1,1,106165,93835
1:4:5,0,-1,106166,93834
6:1:4,0,-1,106167,93833
1:5:4,0,-1,106168,93832
5:2:2,2,2,106166,93834
4:4:3,0,-1,106167,93833
3:2:2,2,2,106165,93835
1:3:1,0,-1,106166,93834
3:5:5,0,-1,106167,93833
5:2:5,1,1,106166,93834
3:2:3,1,1,106165,93835
1:4:6,0,-1,106166,93834
5:5:4,0,-1,106167,93833
6:5:4,0,-1,106168,93832
3:1:2,1,1,106167,93833
2:5:4,1,1,106166,93834
2:1:2,2,2,106164,93836
5:1:6,0,-1,106165,93835
1:6:1,0,-1,106166,93834
6:3:3,0,-1,106167,93833
1:1:3,0,-1,106168,93832
6:2:2,2,2,106166,93834
4:2:3,1,1,106165,93835
3:2:3,1,1,106164,93836
6:4:4,0,-1,106165,93835
1:3:5,0,-1,106166,93834
2:3:5,1,1,106165,93835
5:4:2,1,1,106164,93836
3:5:3,0,-1,106165,93835
5:6:4,0,-1,106166,93834
3:5:1,0,-1,106167,93833
3:1:1,0,-1,106168,93832
2:1:4,1,1,106167,93833
4:3:3,0,-1,106168,93832
1:6:4,0,-1,106169,93831
3:4:4,0,-1,106170,93830
3:3:2,1,1,106169,93831
6:6:5,0,-1,106170,93830
4:4:4,0,-1,106171,93829
3:6:5,0,-1,106172,93828
5:3:2,1,1,106171,93829
4:1:3,0,-1,106172,93828
1:1:2,1,1,106171,93829
6:5:4,0,-1,106172,93828
4:1:5,0,-1,106173,93827
3:1:5,0,-1,106174,93826
6:2:3,1,1,106173,93827
1:1:1,0,-1,106174,93826
6:6:5,0,-1,106175,93825
4:5:4,0,-1,106176,93824
1:5:2,1,1,106175,93825
6:1:4,0,-1,106176,93824
3:6:2,1,1,106175,93825
5:2:6,1,1,106174,93826
1:2:1,1,1,106173,93827
3:2:3,1,1,106172,93828
6:4:5,0,-1,106173,93827
3:2:4,1,1,106172,93828
5:4:6,0,-1,106173,93827
1:4:3,0,-1,106174,93826
6:4:6,0,-1,106175,93825
2:6:5,1,1,106174,93826
1:3:1,0,-1,106175,93825
3:2:5,1,1,106174,93826
6:3:4,0,-1,106175,93825
4:3:3,0,-1,106176,93824
5:6:1,0,-1,106177,93823
4:3:1,0,-1,106178,93822
1:5:6,0,-1,106179,93821
4:6:4,0,-1,106180,93820
2:6:6,1,1,106179,93821
5:2:1,1,1,106178,93822
1:2:4,1,1,106177,93823
4:4:6,0,-1,106178,93822
4:6:6,0,-1,106179,93821
2:4:5,1,1,106178,93822
6:4:5,0,-1,106179,93821
5:2:6,1,1,106178,93822
6:3:5,0,-1,106179,93821
3:1:3,0,-1,106180,93820
4:4:1,0,-1,106181,93819
1:1:2,1,1,106180,93820
1:1:5,0,-1,106181,93819
1:3:4,0,-1,106182,93818
5:4:6,0,-1,106183,93817
3:3:3,0,-1,106184,93816
4:5:1,0,-1,106185,93815
6:1:1,0,-1,106186,93814
5:2:3,1,1,106185,93815
5:3:3,0,-1,106186,93814
5:4:5,0,-1,106187,93813
2:2:1,2,2,106185,93815
1:1:5,0,-1,106186,93814
5:2:1,1,1,106185,93815
1:5:5,0,-1,106186,93814
1:4:4,0,-1,106187,93813
4:4:6,0,-1,106188,93812
1:6:1,0,-1,106189,93811
2:4:5,1,1,106188,93812
3:1:4,0,-1,106189,93811
4:4:5,0,-1,106190,93810
6:1:5,0,-1,106191,93809
6:2:3,1,1,106190,93810
5:2:3,1,1,106189,93811
6:4:2,1,1,106188,93812
1:5:4,0,-1,106189,93811
3:6:3,0,-1,106190,93810
1:4:6,0,-1,106191,93809
1:4:4,0,-1,106192,93808
4:5:6,0,-1,106193,93807
1:1:1,0,-1,106194,93806
6:4:5,0,-1,106195,93805
3:1:3,0,-1,106196,93804
5:6:5,0,-1,106197,93803
1:4:6,0,-1,106198,93802
5:6:4,0,-1,106199,93801
6:4:3,0,-1,106200,93800
1:5:1,0,-1,106201,93799
5:3:6,0,-1,106202,93798
2:1:1,1,1,106201,93799
5:3:3,0,-1,106202,93798
2:5:5,1,1,106201,93799
2:4:2,2,2,106199,93801
1:4:6,0,-1,106200,93800
4:1:6,0,-1,106201,93799
3:3:6,0,-1,106202,93798
4:3:2,1,1,106201,93799
5:3:2,1,1,106200,93800
1:3:5,0,-1,106201,93799
1:5:1,0,-1,106202,93798
1:2:2,2,2,106200,93800
4:1:6,0,-1,106201,93799
6:2:3,1,1,106200,93800
5:4:5,0,-1,106201,93799
3:5:6,0,-1,106202,93798
3:2:2,2,2,106200,93800
1:5:3,0,-1,106201,93799
5:1:6,0,-1,106202,93798
5:6:4,0,-1,106203,93797
3:3:3,0,-1,106204,93796
5:5:4,0,-1,106205,93795
1:1:6,0,-1,106206,93794
3:6:2,1,1,106205,93795
2:2:6,2,2,106203,93797
1:1:6,0,-1,106204,93796
4:1:6,0,-1,106205,93795
3:5:4,0,-1,106206,93794
6:2:6,1,1,106205,93795
6:4:1,0,-1,106206,93794
6:5:4,0,-1,106207,93793
3:1:5,0,-1,106208,93792
5:2:1,1,1,106207,93793
4:6:3,0,-1,106208,93792
5:2:2,2,2,106206,93794
2:4:2,2,2,106204,93796
6:3:6,0,-1,106205,93795
6:5:6,0,-1,106206,93794
6:4:5,0,-1,106207,93793
3:2:4,1,1,106206,93794
6:1:1,0,-1,106207,93793
6:6:4,0,-1,106208,93792
5:2:4,1,1,106207,93793
1:3:3,0,-1,106208,93792
4:2:6,1,1,106207,93793
2:5:2,2,2,106205,93795
3:6:1,0,-1,106206,93794
2:1:1,1,1,106205,93795
4:5:4,0,-1,106206,93794
6:5:5,0,-1,106207,93793
6:5:5,0,-1,106208,93792
4:6:4,0,-1,106209,93791
2:2:1,2,2,106207,93793
5:3:5,0,-1,106208,93792
5:4:3,0,-1,106209,93791
5:1:5,0,-1,106210,93790
6:2:3,1,1,106209,93791
3:4:2,1,1,106208,93792
1:3:1,0,-1,106209,93791
6:4:6,0,-1,106210,93790
5:4:2,1,1,106209,93791
3:2:5,1,1,106208,93792
1:5:3,0,-1,106209,93791
6:2:2,2,2,106207,93793
1:1:1,0,-1,106208,93792
2:3:6,1,1,106207,93793
1:6:1,0,-1,106208,93792
6:4:2,1,1,106207,93793
5:5:2,1,1,106206,93794
3:6:5,0,-1,106207,93793
1:3:2,1,1,106206,93794
4:3:3,0,-1,106207,93793
6:3:6,0,-1,106208,93792
2:2:6,2,2,106206,93794
1:3:3,0,-1,106207,93793
5:3:3,0,-1,106208,93792
3:3:3,0,-1,106209,93791
1:1:4,0,-1,106210,93790
2:4:6,1,1,106209,93791
5:5:1,0,-1,106210,93790
5:3:6,0,-1,106211,93789
3:6:4,0,-1,106212,93788
4:6:6,0,-1,106213,93787
6:4:1,0,-1,106214,93786
6:3:6,0,-1,106215,93785
4:1:6,0,-1,106216,93784
3:6:1,0,-1,106217,93783
4:4:3,0,-1,106218,93782
4:2:3,1,1,106217,93783
4:5:3,0,-1,106218,93782
3:3:2,1,1,106217,93783
4:3:6,0,-1,106218,93782
6:4:2,1,1,106217,93783
4:3:4,0,-1,106218,93782
4:3:6,0,-1,106219,93781
5:5:3,0,-1,106220,93780
3:4:6,0,-1,106221,93779
2:6:6,1,1,106220,93780
5:4:4,0,-1,106221,93779
5:1:3,0,-1,106222,93778
1:1:5,0,-1,106223,93777
1:6:1,0,-1,106224,93776
6:2:6,1,1,106223,93777
6:2:5,1,1,106222,93778
2:6:1,1,1,106221,93779
3:5:3,0,-1,106222,93778
6:2:5,1,1,106221,93779
1:5:1,0,-1,106222,93778
4:4:3,0,-1,106223,93777
2:5:6,1,1,106222,93778
1:5:3,0,-1,106223,93777
2:5:6,1,1,106222,93778
1:1:6,0,-1,106223,93777
5:6:5,0,-1,106224,93776
3:6:2,1,1,106223,93777
6:6:2,1,1,106222,93778
5:6:4,0,-1,106223,93777
6:5:1,0,-1,106224,93776
3:2:3,1,1,106223,93777
5:2:1,1,1,106222,93778
3:3:1,0,-1,106223,93777
6:1:3,0,-1,106224,93776
5:5:6,0,-1,106225,93775
4:2:3,1,1,106224,93776
6:2:5,1,1,106223,93777
4:1:6,0,-1,106224,93776
3:5:4,0,-1,106225,93775
1:1:3,0,-1,106226,93774
2:1:4,1,1,106225,93775
5:3:1,0,-1,106226,93774
5:6:3,0,-1,106227,93773
2:6:3,1,1,106226,93774
1:6:2,1,1,106225,93775
6:1:2,1,1,106224,93776
2:6:6,1,1,106223,93777
3:4:3,0,-1,106224,93776
2:6:1,1,1,106223,93777
5:1:6,0,-1,106224,93776
5:6:5,0,-1,106225,93775
5:1:4,0,-1,106226,93774
2:4:1,1,1,106225,93775
3:2:1,1,1,106224,93776
2:3:5,1,1,106223,93777
3:2:3,1,1,106222,93778
2:1:5,1,1,106221,93779
2:2:3,2,2,106219,93781
1:4:2,1,1,106218,93782
2:4:3,1,1,106217,93783
4:2:2,2,2,106215,93785
4:6:3,0,-1,106216,93784
2:5:4,1,1,106215,93785
6:5:5,0,-1,106216,93784
1:5:4,0,-1,106217,93783
6:1:5,0,-1,106218,93782
5:3:6,0,-1,106219,93781
6:4:1,0,-1,106220,93780
1:4:2,1,1,106219,93781
2:1:2,2,2,106217,93783
4:2:4,1,1,106216,93784
4:2:3,1,1,106215,93785
4:5:5,0,-1,106216,93784
5:2:3,1,1,106215,93785
5:4:3,0,-1,106216,93784
3:3:6,0,-1,106217,93783
4:5:3,0,-1,106218,93782
4:1:5,0,-1,106219,93781
4:2:6,1,1,106218,93782
1:6:1,0,-1,106219,93781
1:2:3,1,1,106218,93782
6:3:6,0,-1,106219,93781
5:5:3,0,-1,106220,93780
2:3:4,1,1,106219,93781
4:1:1,0,-1,106220,93780
6:6:2,1,1,106219,93781
5:1:3,0,-1,106220,93780
3:3:5,0,-1,106221,93779
2:2:5,2,2,106219,93781
5:2:4,1,1,106218,93782
3:4:6,0,-1,106219,93781
6:6:2,1,1,106218,93782
3:4:1,0,-1,106219,93781
2:4:1,1,1,106218,93782
1:3:5,0,-1,106219,93781
4:2:3,1,1,106218,93782
3:6:2,1,1,106217,93783
2:3:6,1,1,106216,93784
6:5:5,0,-1,106217,93783
2:6:1,1,1,106216,93784
6:2:3,1,1,106215,93785
2:1:6,1,1,106214,93786
6:6:4,0,-1,106215,93785
2:5:4,1,1,106214,93786
5:5:5,0,-1,106215,93785
1:5:4,0,-1,106216,93784
5:2:5,1,1,106215,93785
6:3:5,0,-1,106216,93784
6:5:5,0,-1,106217,93783
4:5:5,0,-1,106218,93782
3:2:4,1,1,106217,93783
5:1:2,1,1,106216,93784
4:6:4,0,-1,106217,93783
5:3:5,0,-1,106218,93782
4:4:4,0,-1,106219,93781
4:1:1,0,-1,106220,93780
1:3:5,0,-1,106221,93779
1:2:5,1,1,106220,93780
4:6:6,0,-1,106221,93779
5:2:4,1,1,106220,93780
6:5:1,0,-1,106221,93779
2:2:2,3,3,106218,93782
6:1:5,0,-1,106219,93781
1:4:4,0,-1,106220,93780
2:4:1,1,1,106219,93781
2:4:6,1,1,106218,93782
5:6:1,0,-1,106219,93781
3:2:1,1,1,106218,93782
5:5:2,1,1,106217,93783
4:6:5,0,-1,106218,93782
3:5:2,1,1,106217,93783
2:3:6,1,1,106216,93784
1:4:6,0,-1,106217,93783
5:6:4,0,-1,106218,93782
5:2:1,1,1,106217,93783
2:2:6,2,2,106215,93785
1:2:6,1,1,106214,93786
1:3:6,0,-1,106215,93785
4:5:2,1,1,106214,93786
3:3:6,0,-1,106215,93785
2:2:3,2,2,106213,93787
4:1:6,0,-1,106214,93786
6:6:3,0,-1,106215,93785
1:5:2,1,1,106214,93786
5:2:5,1,1,106213,93787
1:3:1,0,-1,106214,93786
4:6:4,0,-1,106215,93785
4:4:5,0,-1,106216,93784
6:2:3,1,1,106215,93785
2:2:6,2,2,106213,93787
5:5:3,0,-1,106214,93786
1:6:2,1,1,106213,93787
6:4:6,0,-1,106214,93786
2:2:2,3,3,106211,93789
6:2:3,1,1,106210,93790
4:2:5,1,1,106209,93791
2:2:1,2,2,106207,93793
3:2:2,2,2,106205,93795
4:4:5,0,-1,106206,93794
4:2:6,1,1,106205,93795
2:3:6,1,1,106204,93796
4:6:5,0,-1,106205,93795
3:1:5,0,-1,106206,93794
6:5:5,0,-1,106207,93793
1:6:2,1,1,106206,93794
5:1:3,0,-1,106207,93793
1:5:4,0,-1,106208,93792
3:2:5,1,1,106207,93793
6:4:4,0,-1,106208,93792
2:2:2,3,3,106205,93795
3:3:5,0,-1,106206,93794
3:2:5,1,1,106205,93795
3:6:1,0,-1,106206,93794
1:3:5,0,-1,106207,93793
2:2:5,2,2,106205,93795
3:3:5,0,-1,106206,93794
3:4:6,0,-1,106207,93793
6:1:3,0,-1,106208,93792
1:1:1,0,-1,106209,93791
6:3:5,0,-1,106210,93790
5:6:5,0,-1,106211,93789
5:3:2,1,1,106210,93790
5:6:3,0,-1,106211,93789
1:1:4,0,-1,106212,93788
2:3:3,1,1,106211,93789
2:1:1,1,1,106210,93790
2:4:2,2,2,106208,93792
3:3:1,0,-1,106209,93791
6:2:1,1,1,106208,93792
4:2:3,1,1,106207,93793
5:4:4,0,-1,106208,93792
3:2:5,1,1,106207,93793
6:6:3,0,-1,106208,93792
2:2:4,2,2,106206,93794
5:1:6,0,-1,106207,93793
6:2:3,1,1,106206,93794
2:2:6,2,2,106204,93796
1:6:2,1,1,106203,93797
1:1:2,1,1,106202,93798
4:6:5,0,-1,106203,93797
6:2:1,1,1,106202,93798
3:1:4,0,-1,106203,93797
5:3:1,0,-1,106204,93796
1:5:6,0,-1,106205,93795
4:2:2,2,2,106203,93797
2:5:3,1,1,106202,93798
3:6:6,0,-1,106203,93797
6:6:3,0,-1,106204,93796
1:5:2,1,1,106203,93797
1:5:4,0,-1,106204,93796
2:4:6,1,1,106203,93797
2:1:6,1,1,106202,93798
6:3:3,0,-1,106203,93797
5:1:2,1,1,106202,93798
6:5:4,0,-1,106203,93797
1:1:4,0,-1,106204,93796
2:6:5,1,1,106203,93797
6:5:4,0,-1,106204,93796
6:6:6,0,-1,106205,93795
1:1:4,0,-1,106206,93794
1:6:6,0,-1,106207,93793
1:4:2,1,1,106206,93794
2:5:3,1,1,106205,93795
5:6:1,0,-1,106206,93794
3:4:2,1,1,106205,93795
4:3:4,0,-1,106206,93794
3:5:1,0,-1,106207,93793
5:4:2,1,1,106206,93794
5:2:4,1,1,106205,93795
3:2:2,2,2,106203,93797
2:3:4,1,1,106202,93798
5:6:1,0,-1,106203,93797
5:1:5,0,-1,106204,93796
1:4:6,0,-1,106205,93795
3:4:6,0,-1,106206,93794
4:3:4,0,-1,106207,93793
4:4:5,0,-1,106208,93792
5:1:1,0,-1,106209,93791
5:3:2,1,1,106208,93792
4:1:4,0,-1,106209,93791
2:5:1,1,1,106208,93792
6:6:1,0,-1,106209,93791
5:5:3,0,-1,106210,93790
1:1:5,0,-1,106211,93789
3:3:3,0,-1,106212,93788
1:6:4,0,-1,106213,93787
5:1:3,0,-1,106214,93786
2:6:2,2,2,106212,93788
5:1:4,0,-1,106213,93787
5:4:6,0,-1,106214,93786
3:6:2,1,1,106213,93787
6:5:6,0,-1,106214,93786
6:3:2,1,1,106213,93787
2:1:1,1,1,106212,93788
3:4:3,0,-1,106213,93787
4:5:4,0,-1,106214,93786
6:1:1,0,-1,106215,93785
1:2:5,1,1,106214,93786
6:4:6,0,-1,106215,93785
3:6:4,0,-1,106216,93784
4:1:6,0,-1,106217,93783
5:6:5,0,-1,106218,93782
6:3:6,0,-1,106219,93781
4:1:5,0,-1,106220,93780
1:5:5,0,-1,106221,93779
6:3:5,0,-1,106222,93778
6:2:2,2,2,106220,93780
5:2:6,1,1,106219,93781
5:3:6,0,-1,106220,93780
5:2:1,1,1,106219,93781
1:6:1,0,-1,106220,93780
4:5:1,0,-1,106221,93779
2:1:1,1,1,106220,93780
5:2:2,2,2,106218,93782
6:3:2,1,1,106217,93783
3:1:2,1,1,106216,93784
5:6:2,1,1,106215,93785
2:2:6,2,2,106213,93787
6:5:2,1,1,106212,93788
6:5:3,0,-1,106213,93787
4:1:4,0,-1,106214,93786
1:2:5,1,1,106213,93787
1:3:2,1,1,106212,93788
5:1:4,0,-1,106213,93787
1:4:3,0,-1,106214,93786
1:6:6,0,-1,106215,93785
1:2:3,1,1,106214,93786
1:3:3,0,-1,106215,93785
5:5:2,1,1,106214,93786
5:6:3,0,-1,106215,93785
1:1:1,0,-1,106216,93784
3:6:3,0,-1,106217,93783
6:4:2,1,1,106216,93784
3:5:6,0,-1,106217,93783
6:3:2,1,1,106216,93784
5:2:6,1,1,106215,93785
4:6:5,0,-1,106216,93784
2:4:2,2,2,106214,93786
2:6:5,1,1,106213,93787
3:5:2,1,1,106212,93788
5:2:4,1,1,106211,93789
5:4:2,1,1,106210,93790
1:5:5,0,-1,106211,93789
4:3:4,0,-1,106212,93788
6:6:1,0,-1,106213,93787
3:6:5,0,-1,106214,93786
2:1:2,2,2,106212,93788
1:1:3,0,-1,106213,93787
6:1:5,0,-1,106214,93786
4:5:2,1,1,106213,93787
6:6:1,0,-1,106214,93786
4:5:4,0,-1,106215,93785
3:1:6,0,-1,106216,93784
5:6:3,0,-1,106217,93783
3:3:4,0,-1,106218,93782
3:1:3,0,-1,106219,93781
4:2:4,1,1,106218,93782
5:6:4,0,-1,106219,93781
2:6:6,1,1,106218,93782
2:1:5,1,1,106217,93783
6:4:3,0,-1,106218,93782
4:3:4,0,-1,106219,93781
2:6:5,1,1,106218,93782
4:4:6,0,-1,106219,93781
6:5:4,0,-1,106220,93780
1:5:5,0,-1,106221,93779
2:5:1,1,1,106220,93780
6:1:3,0,-1,106221,93779
6:3:5,0,-1,106222,93778
5:1:3,0,-1,106223,93777
2:1:2,2,2,106221,93779
1:6:3,0,-1,106222,93778
4:6:2,1,1,106221,93779
6:3:6,0,-1,106222,93778
3:1:4,0,-1,106223,93777
2:1:5,1,1,106222,93778
5:4:2,1,1,106221,93779
6:6:4,0,-1,106222,93778
4:6:1,0,-1,106223,93777
3:5:2,1,1,106222,93778
4:3:3,0,-1,106223,93777
2:2:5,2,2,106221,93779
6:2:5,1,1,106220,93780
2:3:3,1,1,106219,93781
6:2:4,1,1,106218,93782
4:4:3,0,-1,106219,93781
6:4:3,0,-1,106220,93780
1:1:5,0,-1,106221,93779
4:4:5,0,-1,106222,93778
4:6:4,0,-1,106223,93777
3:4:3,0,-1,106224,93776
1:6:4,0,-1,106225,93775
2:3:5,1,1,106224,93776
5:4:3,0,-1,106225,93775
4:1:5,0,-1,106226,93774
3:1:3,0,-1,106227,93773
4:3:2,1,1,106226,93774
3:3:5,0,-1,106227,93773
4:1:6,0,-1,106228,93772
3:5:2,1,1,106227,93773
2:4:6,1,1,106226,93774
5:6:1,0,-1,106227,93773
1:3:6,0,-1,106228,93772
2:4:5,1,1,106227,93773
6:5:2,1,1,106226,93774
3:2:3,1,1,106225,93775
5:5:2,1,1,106224,93776
1:4:2,1,1,106223,93777
4:4:4,0,-1,106224,93776
1:2:1,1,1,106223,93777
1:1:4,0,-1,106224,93776
1:4:5,0,-1,106225,93775
2:2:2,3,3,106222,93778
4:6:6,0,-1,106223,93777
2:1:6,1,1,106222,93778
5:4:1,0,-1,106223,93777
1:4:4,0,-1,106224,93776
2:4:3,1,1,106223,93777
4:3:4,0,-1,106224,93776
6:4:1,0,-1,106225,93775
5:1:3,0,-1,106226,93774
6:4:6,0,-1,106227,93773
2:5:5,1,1,106226,93774
3:6:4,0,-1,106227,93773
3:6:4,0,-1,106228,93772
4:3:3,0,-1,106229,93771
6:5:3,0,-1,106230,93770
4:5:3,0,-1,106231,93769
2:3:6,1,1,106230,93770
5:3:2,1,1,106229,93771
4:6:3,0,-1,106230,93770
4:2:3,1,1,106229,93771
5:5:4,0,-1,106230,93770
2:6:2,2,2,106228,93772
4:2:5,1,1,106227,93773
2:1:5,1,1,106226,93774
6:6:4,0,-1,106227,93773
2:3:1,1,1,106226,93774
6:4:1,0,-1,106227,93773
5:2:3,1,1,106226,93774
6:2:1,1,1,106225,93775
6:5:3,0,-1,106226,93774
2:4:2,2,2,106224,93776
3:1:5,0,-1,106225,93775
2:2:2,3,3,106222,93778
3:4:5,0,-1,106223,93777
1:4:4,0,-1,106224,93776
2:2:1,2,2,106222,93778
6:1:4,0,-1,106223,93777
6:1:6,0,-1,106224,93776
2:2:4,2,2,106222,93778
4:5:6,0,-1,106223,93777
4:4:1,0,-1,106224,93776
5:2:2,2,2,106222,93778
5:4:1,0,-1,106223,93777
3:2:3,1,1,106222,93778
3:4:1,0,-1,106223,93777
1:6:4,0,-1,106224,93776
6:5:4,0,-1,106225,93775
1:5:6,0,-1,106226,93774
2:6:6,1,1,106225,93775
3:3:4,0,-1,106226,93774
2:4:6,1,1,106225,93775
2:6:2,2,2,106223,93777
5:5:1,0,-1,106224,93776
5:4:5,0,-1,106225,93775
6:3:6,0,-1,106226,93774
5:6:1,0,-1,106227,93773
6:1:5,0,-1,106228,93772
3:6:2,1,1,106227,93773
5:6:1,0,-1,106228,93772
5:2:1,1,1,106227,93773
6:3:3,0,-1,106228,93772
3:6:4,0,-1,106229,93771
6:4:1,0,-1,106230,93770
6:6:1,0,-1,106231,93769
1:2:4,1,1,106230,93770
6:2:5,1,1,106229,93771
5:3:3,0,-1,106230,93770
1:6:6,0,-1,106231,93769
5:3:5,0,-1,106232,93768
4:2:3,1,1,106231,93769
3:1:5,0,-1,106232,93768
3:5:6,0,-1,106233,93767
6:3:5,0,-1,106234,93766
4:5:4,0,-1,106235,93765
1:2:5,1,1,106234,93766
1:6:2,1,1,106233,93767
1:1:1,0,-1,106234,93766
5:6:5,0,-1,106235,93765
5:1:4,0,-1,106236,93764
1:2:2,2,2,106234,93766
6:2:3,1,1,106233,93767
4:3:3,0,-1,106234,93766
2:2:5,2,2,106232,93768
5:1:2,1,1,106231,93769
2:1:1,1,1,106230,93770
1:5:6,0,-1,106231,93769
5:2:5,1,1,106230,93770
6:3:3,0,-1,106231,93769
6:2:2,2,2,106229,93771
5:4:5,0,-1,106230,93770
4:3:1,0,-1,106231,93769
2:2:6,2,2,106229,93771
1:4:2,1,1,106228,93772
3:6:2,1,1,106227,93773
5:3:5,0,-1,106228,93772
2:2:3,2,2,106226,93774
2:1:5,1,1,106225,93775
5:1:4,0,-1,106226,93774
2:5:4,1,1,106225,93775
3:3:1,0,-1,106226,93774
6:2:1,1,1,106225,93775
2:3:6,1,1,106224,93776
5:6:2,1,1,106223,93777
4:5:5,0,-1,106224,93776
2:5:3,1,1,106223,93777
4:1:2,1,1,106222,93778
3:5:5,0,-1,106223,93777
5:6:5,0,-1,106224,93776
5:3:1,0,-1,106225,93775
5:5:5,0,-1,106226,93774
5:4:3,0,-1,106227,93773
4:6:3,0,-1,106228,93772
3:4:4,0,-1,106229,93771
3:2:6,1,1,106228,93772
4:6:3,0,-1,106229,93771
3:5:6,0,-1,106230,93770
4:4:1,0,-1,106231,93769
2:1:4,1,1,106230,93770
3:4:2,1,1,106229,93771
5:5:4,0,-1,106230,93770
6:4:3,0,-1,106231,93769
5:2:4,1,1,106230,93770
3:4:6,0,-1,106231,93769
2:5:5,1,1,106230,93770
3:4:2,1,1,106229,93771
5:1:4,0,-1,106230,93770
1:4:1,0,-1,106231,93769
4:6:1,0,-1,106232,93768
5:1:6,0,-1,106233,93767
2:2:2,3,3,106230,93770
1:5:1,0,-1,106231,93769
5:5:6,0,-1,106232,93768
3:6:5,0,-1,106233,93767
4:3:6,0,-1,106234,93766
4:3:2,1,1,106233,93767
4:4:1,0,-1,106234,93766
2:2:6,2,2,106232,93768
1:5:5,0,-1,106233,93767
3:5:5,0,-1,106234,93766
4:2:6,1,1,106233,93767
4:5:6,0,-1,106234,93766
5:2:6,1,1,106233,93767
3:3:2,1,1,106232,93768
1:4:4,0,-1,106233,93767
6:2:6,1,1,106232,93768
5:2:4,1,1,106231,93769
5:4:2,1,1,106230,93770
6:6:5,0,-1,106231,93769
4:4:4,0,-1,106232,93768
4:4:1,0,-1,106233,93767
3:6:5,0,-1,106234,93766
6:1:5,0,-1,106235,93765
1:3:3,0,-1,106236,93764
6:3:1,0,-1,106237,93763
5:1:3,0,-1,106238,93762
5:2:1,1,1,106237,93763
1:1:5,0,-1,106238,93762
4:6:3,0,-1,106239,93761
4:4:1,0,-1,106240,93760
6:6:3,0,-1,106241,93759
2:1:1,1,1,106240,93760
2:4:1,1,1,106239,93761
4:6:4,0,-1,106240,93760
5:3:3,0,-1,106241,93759
1:2:2,2,2,106239,93761
4:6:6,0,-1,106240,93760
3:1:1,0,-1,106241,93759
2:6:1,1,1,106240,93760
2:3:2,2,2,106238,93762
4:5:6,0,-1,106239,93761
6:1:5,0,-1,106240,93760
1:3:1,0,-1,106241,93759
3:3:3,0,-1,106242,93758
1:3:2,1,1,106241,93759
4:3:2,1,1,106240,93760
1:5:3,0,-1,106241,93759
4:4:1,0,-1,106242,93758
3:4:1,0,-1,106243,93757
2:2:3,2,2,106241,93759
6:4:5,0,-1,106242,93758
5:5:3,0,-1,106243,93757
3:6:3,0,-1,106244,93756
5:6:4,0,-1,106245,93755
3:6:3,0,-1,106246,93754
2:1:4,1,1,106245,93755
5:3:5,0,-1,106246,93754
6:3:4,0,-1,106247,93753
5:4:1,0,-1,106248,93752
6:2:5,1,1,106247,93753
1:4:4,0,-1,106248,93752
3:2:6,1,1,106247,93753
5:4:2,1,1,106246,93754
1:6:5,0,-1,106247,93753
4:5:5,0,-1,106248,93752
6:6:2,1,1,106247,93753
4:6:3,0,-1,106248,93752
6:6:3,0,-1,106249,93751
6:5:2,1,1,106248,93752
2:6:6,1,1,106247,93753
5:1:2,1,1,106246,93754
1:1:5,0,-1,106247,93753
2:1:5,1,1,106246,93754
5:3:4,0,-1,106247,93753
2:1:2,2,2,106245,93755
5:2:3,1,1,106244,93756
5:5:1,0,-1,106245,93755
4:3:6,0,-1,106246,93754
2:6:5,1,1,106245,93755
6:1:2,1,1,106244,93756
3:4:2,1,1,106243,93757
6:5:6,0,-1,106244,93756
3:6:2,1,1,106243,93757
4:1:2,1,1,106242,93758
4:1:1,0,-1,106243,93757
5:2:6,1,1,106242,93758
2:6:4,1,1,106241,93759
6:4:2,1,1,106240,93760
5:4:1,0,-1,106241,93759
2:5:3,1,1,106240,93760
5:1:2,1,1,106239,93761
3:4:6,0,-1,106240,93760
2:3:2,2,2,106238,93762
5:5:3,0,-1,106239,93761
1:1:5,0,-1,106240,93760
1:5:2,1,1,106239,93761
6:2:2,2,2,106237,93763
1:2:5,1,1,106236,93764
4:5:3,0,-1,106237,93763
6:3:4,0,-1,106238,93762
5:3:3,0,-1,106239,93761
3:6:3,0,-1,106240,93760
2:2:3,2,2,106238,93762
4:3:2,1,1,106237,93763
1:2:4,1,1,106236,93764
5:2:5,1,1,106235,93765
3:6:2,1,1,106234,93766
5:4:4,0,-1,106235,93765
5:4:1,0,-1,106236,93764
2:5:6,1,1,106235,93765
6:6:3,0,-1,106236,93764
3:1:5,0,-1,106237,93763
2:5:2,2,2,106235,93765
6:6:3,0,-1,106236,93764
3:2:1,1,1,106235,93765
4:3:4,0,-1,106236,93764
3:3:2,1,1,106235,93765
6:3:2,1,1,106234,93766
3:1:6,0,-1,106235,93765
4:6:1,0,-1,106236,93764
1:4:2,1,1,106235,93765
1:1:4,0,-1,106236,93764
6:5:1,0,-1,106237,93763
3:1:3,0,-1,106238,93762
5:6:2,1,1,106237,93763
2:5:2,2,2,106235,93765
4:5:6,0,-1,106236,93764
4:1:4,0,-1,106237,93763
5:3:4,0,-1,106238,93762
6:4:1,0,-1,106239,93761
1:6:5,0,-1,106240,93760
3:5:4,0,-1,106241,93759
4:1:4,0,-1,106242,93758
2:6:2,2,2,106240,93760
4:6:3,0,-1,106241,93759
5:2:5,1,1,106240,93760
2:3:4,1,1,106239,93761
1:2:5,1,1,106238,93762
3:2:1,1,1,106237,93763
3:2:4,1,1,106236,93764
6:5:4,0,-1,106237,93763
4:4:2,1,1,106236,93764
5:1:5,0,-1,106237,93763
4:1:4,0,-1,106238,93762
5:2:3,1,1,106237,93763
1:6:1,0,-1,106238,93762
6:6:2,1,1,106237,93763
5:1:6,0,-1,106238,93762
3:5:6,0,-1,106239,93761
1:3:6,0,-1,106240,93760
3:1:6,0,-1,106241,93759
4:1:1,0,-1,106242,93758
2:5:5,1,1,106241,93759
4:1:2,1,1,106240,93760
4:6:3,0,-1,106241,93759
5:5:1,0,-1,106242,93758
3:6:6,0,-1,106243,93757
6:3:2,1,1,106242,93758
2:4:3,1,1,106241,93759
5:5:3,0,-1,106242,93758
4:5:5,0,-1,106243,93757
1:3:5,0,-1,106244,93756
6:4:4,0,-1,106245,93755
4:5:2,1,1,106244,93756
3:4:5,0,-1,106245,93755
3:3:3,0,-1,106246,93754
6:5:1,0,-1,106247,93753
2:4:6,1,1,106246,93754
4:4:4,0,-1,106247,93753
4:2:4,1,1,106246,93754
6:2:3,1,1,106245,93755
4:6:5,0,-1,106246,93754
4:6:6,0,-1,106247,93753
2:3:6,1,1,106246,93754
5:6:4,0,-1,106247,93753
2:1:6,1,1,106246,93754
4:4:3,0,-1,106247,93753
4:5:3,0,-1,106248,93752
2:3:3,1,1,106247,93753
6:5:5,0,-1,106248,93752
6:3:2,1,1,106247,93753
6:1:1,0,-1,106248,93752
6:3:1,0,-1,106249,93751
4:4:5,0,-1,106250,93750
3:1:4,0,-1,106251,93749
3:1:1,0,-1,106252,93748
3:4:2,1,1,106251,93749
3:1:6,0,-1,106252,93748
6:1:5,0,-1,106253,93747
2:5:3,1,1,106252,93748
5:2:3,1,1,106251,93749
4:2:3,1,1,106250,93750
2:5:1,1,1,106249,93751
4:6:1,0,-1,106250,93750
3:4:4,0,-1,106251,93749
3:5:5,0,-1,106252,93748
2:1:4,1,1,106251,93749
4:2:5,1,1,106250,93750
3:3:1,0,-1,106251,93749
1:4:4,0,-1,106252,93748
5:4:3,0,-1,106253,93747
5:4:2,1,1,106252,93748
4:6:4,0,-1,106253,93747
2:2:1,2,2,106251,93749
4:2:5,1,1,106250,93750
4:4:4,0,-1,106251,93749
1:2:3,1,1,106250,93750
1:2:3,1,1,106249,93751
2:2:2,3,3,106246,93754
3:6:5,0,-1,106247,93753
4:5:5,0,-1,106248,93752
1:4:1,0,-1,106249,93751
6:5:4,0,-1,106250,93750
1:1:1,0,-1,106251,93749
5:4:2,1,1,106250,93750
5:5:5,0,-1,106251,93749
2:1:4,1,1,106250,93750
1:2:3,1,1,106249,93751
5:6:2,1,1,106248,93752
1:6:2,1,1,106247,93753
2:3:4,1,1,106246,93754
4:4:3,0,-1,106247,93753
4:1:2,1,1,106246,93754
1:4:1,0,-1,106247,93753
1:5:3,0,-1,106248,93752
5:2:4,1,1,106247,93753
4:4:1,0,-1,106248,93752
4:1:1,0,-1,106249,93751
1:2:1,1,1,106248,93752
3:4:4,0,-1,106249,93751
6:6:2,1,1,106248,93752
1:6:3,0,-1,106249,93751
2:3:6,1,1,106248,93752
6:5:2,1,1,106247,93753
6:4:5,0,-1,106248,93752
6:5:5,0,-1,106249,93751
1:5:2,1,1,106248,93752
4:6:3,0,-1,106249,93751
1:4:2,1,1,106248,93752
6:5:3,0,-1,106249,93751
5:6:2,1,1,106248,93752
3:5:3,0,-1,106249,93751
2:3:5,1,1,106248,93752
6:6:4,0,-1,106249,93751
2:1:2,2,2,106247,93753
1:6:4,0,-1,106248,93752
5:6:4,0,-1,106249,93751
2:5:4,1,1,106248,93752
5:4:6,0,-1,106249,93751
2:6:3,1,1,106248,93752
1:6:4,0,-1,106249,93751
3:3:5,0,-1,106250,93750
3:3:6,0,-1,106251,93749
2:6:5,1,1,106250,93750
6:5:2,1,1,106249,93751
6:1:3,0,-1,106250,93750
1:6:2,1,1,106249,93751
4:4:5,0,-1,106250,93750
2:1:2,2,2,106248,93752
1:4:6,0,-1,106249,93751
4:1:1,0,-1,106250,93750
1:5:4,0,-1,106251,93749
1:6:5,0,-1,106252,93748
2:5:5,1,1,106251,93749
5:2:2,2,2,106249,93751
3:3:2,1,1,106248,93752
5:3:2,1,1,106247,93753
5:6:2,1,1,106246,93754
2:3:5,1,1,106245,93755
1:4:4,0,-1,106246,93754
5:5:3,0,-1,106247,93753
6:3:2,1,1,106246,93754
5:6:1,0,-1,106247,93753
3:6:1,0,-1,106248,93752
3:6:5,0,-1,106249,93751
1:1:5,0,-1,106250,93750
3:2:5,1,1,106249,93751
2:5:4,1,1,106248,93752
4:5:6,0,-1,106249,93751
3:5:4,0,-1,106250,93750
5:6:6,0,-1,106251,93749
6:5:3,0,-1,106252,93748
3:6:3,0,-1,106253,93747
4:4:6,0,-1,106254,93746
2:3:3,1,1,106253,93747
4:4:5,0,-1,106254,93746
2:6:1,1,1,106253,93747
4:2:3,1,1,106252,93748
4:6:2,1,1,106251,93749
3:4:4,0,-1,106252,93748
6:4:2,1,1,106251,93749
1:5:4,0,-1,106252,93748
2:1:3,1,1,106251,93749
1:5:6,0,-1,106252,93748
2:2:4,2,2,106250,93750
5:4:4,0,-1,106251,93749
1:4:5,0,-1,106252,93748
1:3:5,0,-1,106253,93747
3:5:6,0,-1,106254,93746
3:5:2,1,1,106253,93747
1:4:6,0,-1,106254,93746
4:3:5,0,-1,106255,93745
3:1:1,0,-1,106256,93744
4:5:4,0,-1,106257,93743
6:6:1,0,-1,106258,93742
1:1:5,0,-1,106259,93741
1:2:5,1,1,106258,93742
1:4:2,1,1,106257,93743
2:3:1,1,1,106256,93744
1:3:1,0,-1,106257,93743
4:3:5,0,-1,106258,93742
2:3:5,1,1,106257,93743
4:2:4,1,1,106256,93744
3:3:5,0,-1,106257,93743
1:4:5,0,-1,106258,93742
5:6:4,0,-1,106259,93741
3:1:4,0,-1,106260,93740
5:4:2,1,1,106259,93741
5:5:1,0,-1,106260,93740
5:1:1,0,-1,106261,93739
1:2:3,1,1,106260,93740
6:5:5,0,-1,106261,93739
5:3:3,0,-1,106262,93738
6:3:3,0,-1,106263,93737
3:4:2,1,1,106262,93738
2:2:3,2,2,106260,93740
1:1:1,0,-1,106261,93739
5:2:1,1,1,106260,93740
1:6:6,0,-1,106261,93739
2:4:4,1,1,106260,93740
6:6:5,0,-1,106261,93739
2:1:6,1,1,106260,93740
4:3:2,1,1,106259,93741
2:5:2,2,2,106257,93743
4:1:2,1,1,106256,93744
2:2:5,2,2,106254,93746
1:4:6,0,-1,106255,93745
6:5:4,0,-1,106256,93744
1:2:2,2,2,106254,93746
2:5:2,2,2,106252,93748
3:3:6,0,-1,106253,93747
5:3:5,0,-1,106254,93746
5:6:3,0,-1,106255,93745
4:1:2,1,1,106254,93746
1:6:6,0,-1,106255,93745
5:1:6,0,-1,106256,93744
3:6:6,0,-1,106257,93743
2:4:3,1,1,106256,93744
4:3:4,0,-1,106257,93743
3:1:5,0,-1,106258,93742
5:5:2,1,1,106257,93743
1:3:1,0,-1,106258,93742
2:2:6,2,2,106256,93744
6:3:3,0,-1,106257,93743
3:3:1,0,-1,106258,93742
6:6:5,0,-1,106259,93741
1:1:3,0,-1,106260,93740
1:4:4,0,-1,106261,93739
1:6:4,0,-1,106262,93738
3:4:1,0,-1,106263,93737
6:6:4,0,-1,106264,93736
2:6:5,1,1,106263,93737
4:2:4,1,1,106262,93738
2:1:4,1,1,106261,93739
6:3:6,0,-1,106262,93738
4:5:5,0,-1,106263,93737
6:4:4,0,-1,106264,93736
4:6:4,0,-1,106265,93735
6:4:5,0,-1,106266,93734
6:5:2,1,1,106265,93735
4:1:4,0,-1,106266,93734
1:5:2,1,1,106265,93735
3:5:2,1,1,106264,93736
6:4:1,0,-1,106265,93735
5:5:4,0,-1,106266,93734
1:6:5,0,-1,106267,93733
4:5:5,0,-1,106268,93732
2:5:4,1,1,106267,93733
4:6:5,0,-1,106268,93732
6:1:1,0,-1,106269,93731
1:4:6,0,-1,106270,93730
2:4:5,1,1,106269,93731
4:1:6,0,-1,106270,93730
6:3:3,0,-1,106271,93729
3:3:2,1,1,106270,93730
3:3:1,0,-1,106271,93729
2:2:1,2,2,106269,93731
5:1:6,0,-1,106270,93730
1:2:1,1,1,106269,93731
3:6:6,0,-1,106270,93730
1:5:2,1,1,106269,93731
3:6:3,0,-1,106270,93730
1:4:2,1,1,106269,93731
6:6:2,1,1,106268,93732
2:1:5,1,1,106267,93733
3:3:6,0,-1,106268,93732
6:2:2,2,2,106266,93734
1:5:1,0,-1,106267,93733
3:2:1,1,1,106266,93734
3:2:4,1,1,106265,93735
4:5:1,0,-1,106266,93734
4:6:4,0,-1,106267,93733
1:4:6,0,-1,106268,93732
2:4:3,1,1,106267,93733
5:3:1,0,-1,106268,93732
3:2:4,1,1,106267,93733
3:2:6,1,1,106266,93734
5:2:4,1,1,106265,93735
1:1:1,0,-1,106266,93734
2:1:2,2,2,106264,93736
1:1:4,0,-1,106265,93735
4:5:6,0,-1,106266,93734
4:1:2,1,1,106265,93735
6:5:5,0,-1,106266,93734
5:3:3,0,-1,106267,93733
6:4:6,0,-1,106268,93732
5:5:4,0,-1,106269,93731
1:3:6,0,-1,106270,93730
1:1:2,1,1,106269,93731
6:4:6,0,-1,106270,93730
6:5:6,0,-1,106271,93729
5:4:3,0,-1,106272,93728
2:2:5,2,2,106270,93730
5:5:5,0,-1,106271,93729
2:3:1,1,1,106270,93730
4:2:4,1,1,106269,93731
6:1:3,0,-1,106270,93730
4:6:5,0,-1,106271,93729
3:3:4,0,-1,106272,93728
3:5:5,0,-1,106273,93727
3:1:6,0,-1,106274,93726
3:3:6,0,-1,106275,93725
5:1:1,0,-1,106276,93724
3:2:4,1,1,106275,93725
5:2:5,1,1,106274,93726
2:3:5,1,1,106273,93727
6:3:5,0,-1,106274,93726
4:3:4,0,-1,106275,93725
6:2:3,1,1,106274,93726
1:2:4,1,1,106273,93727
5:3:5,0,-1,106274,93726
5:3:2,1,1,106273,93727
5:6:3,0,-1,106274,93726
4:2:1,1,1,106273,93727
4:2:4,1,1,106272,93728
5:1:1,0,-1,106273,93727
6:5:6,0,-1,106274,93726
6:5:6,0,-1,106275,93725
1:2:2,2,2,106273,93727
5:2:1,1,1,106272,93728
2:5:3,1,1,106271,93729
4:6:6,0,-1,106272,93728
4:5:1,0,-1,106273,93727
5:1:5,0,-1,106274,93726
1:4:6,0,-1,106275,93725
3:3:2,1,1,106274,93726
3:4:2,1,1,106273,93727
3:2:4,1,1,106272,93728
3:1:2,1,1,106271,93729
3:2:5,1,1,106270,93730
3:2:5,1,1,106269,93731
6:4:1,0,-1,106270,93730
3:4:6,0,-1,106271,93729
6:4:1,0,-1,106272,93728
5:2:5,1,1,106271,93729
6:4:1,0,-1,106272,93728
5:2:6,1,1,106271,93729
5:1:3,0,-1,106272,93728
5:2:1,1,1,106271,93729
1:4:6,0,-1,106272,93728
1:1:5,0,-1,106273,93727
5:2:6,1,1,106272,93728
6:5:3,0,-1,106273,93727
3:3:2,1,1,106272,93728
1:1:6,0,-1,106273,93727
4:5:2,1,1,106272,93728
6:1:5,0,-1,106273,93727
6:4:2,1,1,106272,93728
6:3:2,1,1,106271,93729
2:5:3,1,1,106270,93730
4:3:5,0,-1,106271,93729
1:4:5,0,-1,106272,93728
4:2:6,1,1,106271,93729
6:4:1,0,-1,106272,93728
3:4:6,0,-1,106273,93727
2:3:6,1,1,106272,93728
3:1:4,0,-1,106273,93727
1:2:1,1,1,106272,93728
1:5:4,0,-1,106273,93727
1:5:5,0,-1,106274,93726
3:6:2,1,1,106273,93727
2:3:3,1,1,106272,93728
6:3:3,0,-1,106273,93727
3:5:1,0,-1,106274,93726
5:3:5,0,-1,106275,93725
2:4:2,2,2,106273,93727
3:1:4,0,-1,106274,93726
5:6:4,0,-1,106275,93725
1:3:5,0,-1,106276,93724
4:3:6,0,-1,106277,93723
3:3:5,0,-1,106278,93722
5:6:5,0,-1,106279,93721
4:6:4,0,-1,106280,93720
2:1:6,1,1,106279,93721
4:3:5,0,-1,106280,93720
4:2:6,1,1,106279,93721
1:3:6,0,-1,106280,93720
2:1:4,1,1,106279,93721
1:3:6,0,-1,106280,93720
2:1:2,2,2,106278,93722
1:6:5,0,-1,106279,93721
5:6:3,0,-1,106280,93720
4:2:3,1,1,106279,93721
2:2:6,2,2,106277,93723
2:2:1,2,2,106275,93725
6:2:4,1,1,106274,93726
3:3:1,0,-1,106275,93725
4:5:6,0,-1,106276,93724
5:1:4,0,-1,106277,93723
4:1:4,0,-1,106278,93722
1:6:6,0,-1,106279,93721
4:3:4,0,-1,106280,93720
4:3:1,0,-1,106281,93719
6:4:6,0,-1,106282,93718
3:2:5,1,1,106281,93719
6:3:5,0,-1,106282,93718
2:2:6,2,2,106280,93720
6:5:6,0,-1,106281,93719
2:1:5,1,1,106280,93720
3:5:5,0,-1,106281,93719
5:1:4,0,-1,106282,93718
3:5:4,0,-1,106283,93717
5:2:5,1,1,106282,93718
2:2:2,3,3,106279,93721
6:1:2,1,1,106278,93722
1:1:4,0,-1,106279,93721
3:4:5,0,-1,106280,93720
4:3:5,0,-1,106281,93719
4:1:4,0,-1,106282,93718
3:6:6,0,-1,106283,93717
6:6:3,0,-1,106284,93716
4:3:5,0,-1,106285,93715
4:6:3,0,-1,106286,93714
3:4:5,0,-1,106287,93713
3:4:4,0,-1,106288,93712
5:2:6,1,1,106287,93713
5:5:5,0,-1,106288,93712
3:3:6,0,-1,106289,93711
5:5:3,0,-1,106290,93710
6:5:3,0,-1,106291,93709
1:2:3,1,1,106290,93710
4:2:6,1,1,106289,93711
2:1:3,1,1,106288,93712
4:5:6,0,-1,106289,93711
3:6:5,0,-1,106290,93710
1:3:6,0,-1,106291,93709
6:5:2,1,1,106290,93710
1:3:1,0,-1,106291,93709
6:4:4,0,-1,106292,93708
6:2:6,1,1,106291,93709
1:1:1,0,-1,106292,93708
3:1:6,0,-1,106293,93707
3:5:5,0,-1,106294,93706
4:4:5,0,-1,106295,93705
3:4:5,0,-1,106296,93704
5:5:6,0,-1,106297,93703
3:5:3,0,-1,106298,93702
1:4:4,0,-1,106299,93701
5:4:6,0,-1,106300,93700
6:1:5,0,-1,106301,93699
5:2:2,2,2,106299,93701
5:4:6,0,-1,106300,93700
4:5:3,0,-1,106301,93699
3:6:1,0,-1,106302,93698
2:3:6,1,1,106301,93699
3:5:1,0,-1,106302,93698
6:4:1,0,-1,106303,93697
1:6:6,0,-1,106304,93696
3:5:4,0,-1,106305,93695
6:1:1,0,-1,106306,93694
2:4:5,1,1,106305,93695
2:1:1,1,1,106304,93696
3:3:6,0,-1,106305,93695
3:2:5,1,1,106304,93696
6:4:3,0,-1,106305,93695
6:5:5,0,-1,106306,93694
3:5:5,0,-1,106307,93693
3:5:6,0,-1,106308,93692
2:6:6,1,1,106307,93693
6:3:5,0,-1,106308,93692
4:2:5,1,1,106307,93693
6:1:1,0,-1,106308,93692
4:5:1,0,-1,106309,93691
4:6:3,0,-1,106310,93690
4:2:5,1,1,106309,93691
4:1:5,0,-1,106310,93690
5:5:3,0,-1,106311,93689
3:1:3,0,-1,106312,93688
3:5:3,0,-1,106313,93687
3:1:5,0,-1,106314,93686
4:6:4,0,-1,106315,93685
2:3:6,1,1,106314,93686
3:3:6,0,-1,106315,93685
4:2:4,1,1,106314,93686
6:2:5,1,1,106313,93687
4:4:2,1,1,106312,93688
1:5:1,0,-1,106313,93687
6:6:2,1,1,106312,93688
1:3:6,0,-1,106313,93687
2:5:1,1,1,106312,93688
6:3:6,0,-1,106313,93687
4:4:5,0,-1,106314,93686
5:5:1,0,-1,106315,93685
6:4:3,0,-1,106316,93684
1:3:5,0,-1,106317,93683
1:6:6,0,-1,106318,93682
3:1:1,0,-1,106319,93681
3:6:5,0,-1,106320,93680
1:1:5,0,-1,106321,93679
2:2:1,2,2,106319,93681
5:2:2,2,2,106317,93683
1:5:4,0,-1,106318,93682
6:5:2,1,1,106317,93683
2:3:3,1,1,106316,93684
2:3:3,1,1,106315,93685
5:1:5,0,-1,106316,93684
4:5:4,0,-1,106317,93683
3:2:6,1,1,106316,93684
4:3:1,0,-1,106317,93683
2:1:6,1,1,106316,93684
6:4:2,1,1,106315,93685
3:2:6,1,1,106314,93686
1:2:5,1,1,106313,93687
5:1:3,0,-1,106314,93686
5:6:4,0,-1,106315,93685
3:4:4,0,-1,106316,93684
3:6:1,0,-1,106317,93683
6:1:1,0,-1,106318,93682
1:5:2,1,1,106317,93683
3:5:2,1,1,106316,93684
5:3:3,0,-1,106317,93683
5:4:6,0,-1,106318,93682
3:1:1,0,-1,106319,93681
1:4:1,0,-1,106320,93680
3:3:2,1,1,106319,93681
4:1:3,0,-1,106320,93680
3:2:5,1,1,106319,93681
5:4:2,1,1,106318,93682
4:6:1,0,-1,106319,93681
2:6:6,1,1,106318,93682
1:2:4,1,1,106317,93683
1:3:4,0,-1,106318,93682
5:1:5,0,-1,106319,93681
3:1:3,0,-1,106320,93680
5:3:5,0,-1,106321,93679
1:5:1,0,-1,106322,93678
4:5:6,0,-1,106323,93677
2:2:5,2,2,106321,93679
3:5:4,0,-1,106322,93678
3:4:1,0,-1,106323,93677
2:1:1,1,1,106322,93678
2:1:1,1,1,106321,93679
4:2:3,1,1,106320,93680
6:6:3,0,-1,106321,93679
4:1:3,0,-1,106322,93678
5:1:6,0,-1,106323,93677
3:3:5,0,-1,106324,93676
1:5:6,0,-1,106325,93675
1:3:2,1,1,106324,93676
4:3:1,0,-1,106325,93675
6:5:3,0,-1,106326,93674
2:4:5,1,1,106325,93675
5:3:1,0,-1,106326,93674
2:4:1,1,1,106325,93675
6:5:6,0,-1,106326,93674
2:4:1,1,1,106325,93675
3:2:2,2,2,106323,93677
3:6:4,0,-1,106324,93676
2:2:5,2,2,106322,93678
5:4:3,0,-1,106323,93677
5:3:1,0,-1,106324,93676
6:2:5,1,1,106323,93677
1:3:2,1,1,106322,93678
1:2:2,2,2,106320,93680
6:5:3,0,-1,106321,93679
1:2:5,1,1,106320,93680
4:2:2,2,2,106318,93682
6:4:4,0,-1,106319,93681
5:3:5,0,-1,106320,93680
2:4:2,2,2,106318,93682
1:1:2,1,1,106317,93683
6:3:5,0,-1,106318,93682
2:1:5,1,1,106317,93683
1:3:1,0,-1,106318,93682
5:4:6,0,-1,106319,93681
5:6:3,0,-1,106320,93680
1:2:2,2,2,106318,93682
4:1:4,0,-1,106319,93681
4:3:4,0,-1,106320,93680
5:5:2,1,1,106319,93681
1:2:3,1,1,106318,93682
1:1:2,1,1,106317,93683
1:1:5,0,-1,106318,93682
6:6:2,1,1,106317,93683
2:4:6,1,1,106316,93684
3:2:1,1,1,106315,93685
4:1:6,0,-1,106316,93684
3:6:5,0,-1,106317,93683
5:5:6,0,-1,106318,93682
4:6:4,0,-1,106319,93681
3:5:5,0,-1,106320,93680
2:5:4,1,1,106319,93681
3:3:1,0,-1,106320,93680
4:1:4,0,-1,106321,93679
1:4:4,0,-1,106322,93678
3:1:1,0,-1,106323,93677
4:2:6,1,1,106322,93678
6:6:2,1,1,106321,93679
4:5:4,0,-1,106322,93678
2:4:3,1,1,106321,93679
4:3:3,0,-1,106322,93678
3:3:1,0,-1,106323,93677
5:4:1,0,-1,106324,93676
6:4:2,1,1,106323,93677
4:2:4,1,1,106322,93678
1:5:2,1,1,106321,93679
2:6:2,2,2,106319,93681
5:5:3,0,-1,106320,93680
3:3:1,0,-1,106321,93679
5:6:5,0,-1,106322,93678
5:3:2,1,1,106321,93679
1:1:6,0,-1,106322,93678
3:2:6,1,1,106321,93679
3:1:3,0,-1,106322,93678
2:4:4,1,1,106321,93679
2:6:5,1,1,106320,93680
2:1:3,1,1,106319,93681
5:5:6,0,-1,106320,93680
2:2:5,2,2,106318,93682
4:3:1,0,-1,106319,93681
1:1:4,0,-1,106320,93680
6:6:5,0,-1,106321,93679
4:2:3,1,1,106320,93680
1:6:2,1,1,106319,93681
4:6:2,1,1,106318,93682
5:5:6,0,-1,106319,93681
6:6:6,0,-1,106320,93680
3:5:3,0,-1,106321,93679
1:1:4,0,-1,106322,93678
2:4:5,1,1,106321,93679
3:6:1,0,-1,106322,93678
1:4:6,0,-1,106323,93677
1:2:5,1,1,106322,93678
5:2:4,1,1,106321,93679
1:2:2,2,2,106319,93681
5:4:4,0,-1,106320,93680
3:6:2,1,1,106319,93681
4:5:1,0,-1,106320,93680
3:2:1,1,1,106319,93681
6:1:6,0,-1,106320,93680
6:5:5,0,-1,106321,93679
3:1:5,0,-1,106322,93678
1:6:6,0,-1,106323,93677
2:3:6,1,1,106322,93678
2:2:3,2,2,106320,93680
5:3:4,0,-1,106321,93679
3:3:1,0,-1,106322,93678
2:5:3,1,1,106321,93679
1:6:1,0,-1,106322,93678
2:6:3,1,1,106321,93679
1:2:1,1,1,106320,93680
4:5:5,0,-1,106321,93679
4:2:5,1,1,106320,93680
3:5:6,0,-1,106321,93679
1:3:3,0,-1,106322,93678
5:6:4,0,-1,106323,93677
6:6:4,0,-1,106324,93676
5:2:6,1,1,106323,93677
4:3:3,0,-1,106324,93676
3:2:5,1,1,106323,93677
6:2:3,1,1,106322,93678
6:2:4,1,1,106321,93679
4:2:5,1,1,106320,93680
5:5:1,0,-1,106321,93679
6:3:2,1,1,106320,93680
3:6:1,0,-1,106321,93679
4:6:4,0,-1,106322,93678
5:1:5,0,-1,106323,93677
4:3:2,1,1,106322,93678
1:6:5,0,-1,106323,93677
1:5:6,0,-1,106324,93676
3:3:1,0,-1,106325,93675
6:4:2,1,1,106324,93676
2:1:3,1,1,106323,93677
5:6:4,0,-1,106324,93676
1:6:2,1,1,106323,93677
6:3:5,0,-1,106324,93676
4:2:2,2,2,106322,93678
4:3:2,1,1,106321,93679
3:3:6,0,-1,106322,93678
6:4:6,0,-1,106323,93677
6:5:5,0,-1,106324,93676
6:4:1,0,-1,106325,93675
1:3:4,0,-1,106326,93674
2:5:4,1,1,106325,93675
5:5:5,0,-1,106326,93674
5:5:1,0,-1,106327,93673
3:1:5,0,-1,106328,93672
5:4:2,1,1,106327,93673
6:6:5,0,-1,106328,93672
4:2:2,2,2,106326,93674
6:5:4,0,-1,106327,93673
6:3:6,0,-1,106328,93672
5:2:5,1,1,106327,93673
2:5:5,1,1,106326,93674
6:2:3,1,1,106325,93675
2:1:6,1,1,106324,93676
2:5:1,1,1,106323,93677
2:5:4,1,1,106322,93678
3:1:1,0,-1,106323,93677
6:6:5,0,-1,106324,93676
6:3:3,0,-1,106325,93675
6:4:6,0,-1,106326,93674
2:4:4,1,1,106325,93675
4:5:3,0,-1,106326,93674
5:1:4,0,-1,106327,93673
2:3:6,1,1,106326,93674
6:6:3,0,-1,106327,93673
3:5:3,0,-1,106328,93672
4:1:4,0,-1,106329,93671
6:3:5,0,-1,106330,93670
5:6:6,0,-1,106331,93669
6:5:4,0,-1,106332,93668
1:6:4,0,-1,106333,93667
2:3:3,1,1,106332,93668
4:4:4,0,-1,106333,93667
6:3:3,0,-1,106334,93666
3:6:5,0,-1,106335,93665
4:3:5,0,-1,106336,93664
6:4:2,1,1,106335,93665
1:2:2,2,2,106333,93667
1:6:4,0,-1,106334,93666
4:6:3,0,-1,106335,93665
3:6:2,1,1,106334,93666
2:4:5,1,1,106333,93667
1:6:5,0,-1,106334,93666
4:3:6,0,-1,106335,93665
1:3:3,0,-1,106336,93664
2:5:5,1,1,106335,93665
4:4:1,0,-1,106336,93664
3:6:5,0,-1,106337,93663
1:2:4,1,1,106336,93664
6:3:2,1,1,106335,93665
6:6:5,0,-1,106336,93664
6:5:1,0,-1,106337,93663
3:2:5,1,1,106336,93664
5:5:3,0,-1,106337,93663
2:2:2,3,3,106334,93666
1:2:6,1,1,106333,93667
2:5:6,1,1,106332,93668
5:4:5,0,-1,106333,93667
4:5:4,0,-1,106334,93666
3:5:1,0,-1,106335,93665
6:5:1,0,-1,106336,93664
4:3:5,0,-1,106337,93663
1:5:3,0,-1,106338,93662
3:1:1,0,-1,106339,93661
3:5:5,0,-1,106340,93660
6:1:1,0,-1,106341,93659
3:6:1,0,-1,106342,93658
5:4:4,0,-1,106343,93657
4:5:3,0,-1,106344,93656
4:4:3,0,-1,106345,93655
2:5:2,2,2,106343,93657
6:4:6,0,-1,106344,93656
6:6:6,0,-1,106345,93655
3:5:4,0,-1,106346,93654
4:1:1,0,-1,106347,93653
3:4:1,0,-1,106348,93652
3:6:6,0,-1,106349,93651
5:3:4,0,-1,106350,93650
5:4:6,0,-1,106351,93649
3:4:3,0,-1,106352,93648
1:1:1,0,-1,106353,93647
6:1:1,0,-1,106354,93646
4:3:1,0,-1,106355,93645
6:3:4,0,-1,106356,93644
6:3:3,0,-1,106357,93643
1:3:1,0,-1,106358,93642
3:4:4,0,-1,106359,93641
2:2:4,2,2,106357,93643
4:2:1,1,1,106356,93644
5:2:4,1,1,106355,93645
4:5:5,0,-1,106356,93644
3:3:1,0,-1,106357,93643
3:4:6,0,-1,106358,93642
6:6:5,0,-1,106359,93641
6:1:3,0,-1,106360,93640
5:1:2,1,1,106359,93641
6:6:4,0,-1,106360,93640
3:1:3,0,-1,106361,93639
3:4:1,0,-1,106362,93638
3:3:2,1,1,106361,93639
2:1:4,1,1,106360,93640
1:2:6,1,1,106359,93641
5:3:4,0,-1,106360,93640
5:2:3,1,1,106359,93641
5:2:1,1,1,106358,93642
5:4:4,0,-1,106359,93641
4:5:4,0,-1,106360,93640
4:2:2,2,2,106358,93642
2:2:2,3,3,106355,93645
6:5:1,0,-1,106356,93644
2:1:2,2,2,106354,93646
3:1:6,0,-1,106355,93645
1:6:4,0,-1,106356,93644
1:1:6,0,-1,106357,93643
4:3:3,0,-1,106358,93642
1:4:6,0,-1,106359,93641
3:6:5,0,-1,106360,93640
5:5:6,0,-1,106361,93639
4:4:1,0,-1,106362,93638
3:5:2,1,1,106361,93639
4:3:2,1,1,106360,93640
6:5:2,1,1,106359,93641
5:5:4,0,-1,106360,93640
2:3:3,1,1,106359,93641
5:3:5,0,-1,106360,93640
5:1:3,0,-1,106361,93639
6:3:4,0,-1,106362,93638
3:2:2,2,2,106360,93640
4:3:6,0,-1,106361,93639
6:6:4,0,-1,106362,93638
2:1:2,2,2,106360,93640
6:2:3,1,1,106359,93641
1:2:1,1,1,106358,93642
1:6:4,0,-1,106359,93641
1:2:3,1,1,106358,93642
4:3:6,0,-1,106359,93641
6:4:1,0,-1,106360,93640
6:6:3,0,-1,106361,93639
2:4:4,1,1,106360,93640
3:5:6,0,-1,106361,93639
4:4:2,1,1,106360,93640
1:5:4,0,-1,106361,93639
4:5:3,0,-1,106362,93638
3:5:3,0,-1,106363,93637
3:4:2,1,1,106362,93638
2:2:1,2,2,106360,93640
4:5:4,0,-1,106361,93639
6:2:2,2,2,106359,93641
6:5:6,0,-1,106360,93640
5:1:3,0,-1,106361,93639
5:2:5,1,1,106360,93640
2:2:5,2,2,106358,93642
1:4:3,0,-1,106359,93641
5:2:3,1,1,106358,93642
1:1:1,0,-1,106359,93641
5:4:4,0,-1,106360,93640
4:5:3,0,-1,106361,93639
5:6:4,0,-1,106362,93638
2:6:6,1,1,106361,93639
6:1:5,0,-1,106362,93638
5:2:5,1,1,106361,93639
2:6:2,2,2,106359,93641
1:5:4,0,-1,106360,93640
4:5:4,0,-1,106361,93639
5:4:6,0,-1,106362,93638
1:4:5,0,-1,106363,93637
5:5:3,0,-1,106364,93636
4:1:6,0,-1,106365,93635
3:3:4,0,-1,106366,93634
1:3:6,0,-1,106367,93633
4:3:1,0,-1,106368,93632
6:2:5,1,1,106367,93633
1:4:2,1,1,106366,93634
4:5:5,0,-1,106367,93633
2:5:1,1,1,106366,93634
6:4:5,0,-1,106367,93633
6:3:1,0,-1,106368,93632
6:6:4,0,-1,106369,93631
2:6:6,1,1,106368,93632
4:1:3,0,-1,106369,93631
6:6:4,0,-1,106370,93630
2:5:6,1,1,106369,93631
6:6:3,0,-1,106370,93630
3:1:2,1,1,106369,93631
3:6:1,0,-1,106370,93630
1:3:1,0,-1,106371,93629
4:4:4,0,-1,106372,93628
4:4:4,0,-1,106373,93627
4:6:3,0,-1,106374,93626
4:5:2,1,1,106373,93627
6:1:3,0,-1,106374,93626
3:6:3,0,-1,106375,93625
1:6:1,0,-1,106376,93624
5:6:3,0,-1,106377,93623
2:1:5,1,1,106376,93624
5:5:2,1,1,106375,93625
1:2:4,1,1,106374,93626
4:3:4,0,-1,106375,93625
2:3:5,1,1,106374,93626
1:6:6,0,-1,106375,93625
3:1:1,0,-1,106376,93624
2:3:4,1,1,106375,93625
6:6:2,1,1,106374,93626
1:6:1,0,-1,106375,93625
6:3:1,0,-1,106376,93624
5:1:4,0,-1,106377,93623
1:1:3,0,-1,106378,93622
3:3:5,0,-1,106379,93621
6:4:6,0,-1,106380,93620
4:4:1,0,-1,106381,93619
6:3:3,0,-1,106382,93618
1:4:4,0,-1,106383,93617
4:3:4,0,-1,106384,93616
3:2:4,1,1,106383,93617
1:1:4,0,-1,106384,93616
6:6:3,0,-1,106385,93615
1:1:3,0,-1,106386,93614
3:3:6,0,-1,106387,93613
2:4:5,1,1,106386,93614
3:6:3,0,-1,106387,93613
4:1:4,0,-1,106388,93612
3:1:1,0,-1,106389,93611
2:6:4,1,1,106388,93612
6:2:5,1,1,106387,93613
1:2:6,1,1,106386,93614
2:2:6,2,2,106384,93616
4:6:4,0,-1,106385,93615
4:3:1,0,-1,106386,93614
6:3:2,1,1,106385,93615
1:5:1,0,-1,106386,93614
4:5:5,0,-1,106387,93613
5:6:1,0,-1,106388,93612
6:2:3,1,1,106387,93613
2:4:2,2,2,106385,93615
6:5:5,0,-1,106386,93614
6:2:1,1,1,106385,93615
1:1:3,0,-1,106386,93614
3:5:4,0,-1,106387,93613
2:3:4,1,1,106386,93614
5:6:6,0,-1,106387,93613
3:1:6,0,-1,106388,93612
2:1:4,1,1,106387,93613
5:4:5,0,-1,106388,93612
2:1:5,1,1,106387,93613
6:6:1,0,-1,106388,93612
2:5:1,1,1,106387,93613
4:2:4,1,1,106386,93614
3:2:1,1,1,106385,93615
3:1:2,1,1,106384,93616
5:4:3,0,-1,106385,93615
1:3:2,1,1,106384,93616
1:6:4,0,-1,106385,93615
6:4:6,0,-1,106386,93614
2:1:4,1,1,106385,93615
6:1:4,0,-1,106386,93614
1:2:1,1,1,106385,93615
2:4:3,1,1,106384,93616
1:5:6,0,-1,106385,93615
4:5:6,0,-1,106386,93614
3:5:6,0,-1,106387,93613
3:1:5,0,-1,106388,93612
4:6:3,0,-1,106389,93611
1:4:1,0,-1,106390,93610
1:2:6,1,1,106389,93611
2:1:4,1,1,106388,93612
4:5:1,0,-1,106389,93611
6:3:2,1,1,106388,93612
6:3:6,0,-1,106389,93611
5:2:5,1,1,106388,93612
4:4:1,0,-1,106389,93611
6:2:3,1,1,106388,93612
1:5:6,0,-1,106389,93611
5:3:2,1,1,106388,93612
2:3:4,1,1,106387,93613
1:6:2,1,1,106386,93614
1:2:6,1,1,106385,93615
4:6:3,0,-1,106386,93614
6:1:2,1,1,106385,93615
2:6:2,2,2,106383,93617
1:1:6,0,-1,106384,93616
3:6:1,0,-1,106385,93615
5:1:2,1,1,106384,93616
6:2:1,1,1,106383,93617
1:3:3,0,-1,106384,93616
6:2:4,1,1,106383,93617
2:3:4,1,1,106382,93618
4:4:3,0,-1,106383,93617
4:6:6,0,-1,106384,93616
1:6:2,1,1,106383,93617
6:3:2,1,1,106382,93618
3:6:2,1,1,106381,93619
2:5:3,1,1,106380,93620
2:1:6,1,1,106379,93621
2:2:1,2,2,106377,93623
2:2:6,2,2,106375,93625
3:3:4,0,-1,106376,93624
5:4:4,0,-1,106377,93623
1:5:1,0,-1,106378,93622
6:6:6,0,-1,106379,93621
1:4:6,0,-1,106380,93620
3:6:4,0,-1,106381,93619
4:5:2,1,1,106380,93620
6:6:3,0,-1,106381,93619
1:5:3,0,-1,106382,93618
4:4:3,0,-1,106383,93617
5:2:1,1,1,106382,93618
4:4:3,0,-1,106383,93617
3:6:3,0,-1,106384,93616
3:6:6,0,-1,106385,93615
4:3:4,0,-1,106386,93614
5:5:1,0,-1,106387,93613
4:6:6,0,-1,106388,93612
5:3:5,0,-1,106389,93611
4:6:1,0,-1,106390,93610
3:3:5,0,-1,106391,93609
4:3:2,1,1,106390,93610
1:3:1,0,-1,106391,93609
1:6:3,0,-1,106392,93608
5:6:2,1,1,106391,93609
1:3:3,0,-1,106392,93608
5:4:3,0,-1,106393,93607
3:1:5,0,-1,106394,93606
2:2:1,2,2,106392,93608
6:5:5,0,-1,106393,93607
2:4:2,2,2,106391,93609
5:1:3,0,-1,106392,93608
3:6:3,0,-1,106393,93607
6:5:2,1,1,106392,93608
1:2:2,2,2,106390,93610
4:5:6,0,-1,106391,93609
2:2:1,2,2,106389,93611
2:5:6,1,1,106388,93612
6:4:5,0,-1,106389,93611
2:1:1,1,1,106388,93612
5:1:6,0,-1,106389,93611
4:3:6,0,-1,106390,93610
6:3:3,0,-1,106391,93609
5:6:5,0,-1,106392,93608
1:3:2,1,1,106391,93609
6:3:3,0,-1,106392,93608
4:5:3,0,-1,106393,93607
1:4:2,1,1,106392,93608
4:2:5,1,1,106391,93609
6:5:5,0,-1,106392,93608
6:4:4,0,-1,106393,93607
3:2:6,1,1,106392,93608
2:4:2,2,2,106390,93610
3:3:4,0,-1,106391,93609
1:4:3,0,-1,106392,93608
6:3:4,0,-1,106393,93607
1:4:3,0,-1,106394,93606
6:3:5,0,-1,106395,93605
1:5:1,0,-1,106396,93604
3:2:2,2,2,106394,93606
5:2:2,2,2,106392,93608
5:4:4,0,-1,106393,93607
1:4:1,0,-1,106394,93606
4:6:2,1,1,106393,93607
1:5:5,0,-1,106394,93606
6:2:6,1,1,106393,93607
3:1:2,1,1,106392,93608
3:2:3,1,1,106391,93609
5:3:2,1,1,106390,93610
5:2:3,1,1,106389,93611
4:3:3,0,-1,106390,93610
5:1:6,0,-1,106391,93609
3:5:3,0,-1,106392,93608
4:5:3,0,-1,106393,93607
4:6:2,1,1,106392,93608
1:1:5,0,-1,106393,93607
5:4:6,0,-1,106394,93606
5:3:2,1,1,106393,93607
2:5:1,1,1,106392,93608
2:5:1,1,1,106391,93609
1:1:3,0,-1,106392,93608
2:1:1,1,1,106391,93609
6:1:6,0,-1,106392,93608
5:3:6,0,-1,106393,93607
4:1:1,0,-1,106394,93606
1:2:6,1,1,106393,93607
6:1:6,0,-1,106394,93606
6:2:3,1,1,106393,93607
3:1:2,1,1,106392,93608
4:6:1,0,-1,106393,93607
3:2:2,2,2,106391,93609
4:1:3,0,-1,106392,93608
1:1:1,0,-1,106393,93607
4:5:4,0,-1,106394,93606
1:5:3,0,-1,106395,93605
5:2:4,1,1,106394,93606
1:1:2,1,1,106393,93607
3:3:6,0,-1,106394,93606
3:2:3,1,1,106393,93607
2:1:5,1,1,106392,93608
2:4:6,1,1,106391,93609
4:5:4,0,-1,106392,93608
2:2:5,2,2,106390,93610
6:4:4,0,-1,106391,93609
2:3:4,1,1,106390,93610
6:2:2,2,2,106388,93612
4:5:2,1,1,106387,93613
3:3:4,0,-1,106388,93612
2:6:1,1,1,106387,93613
3:5:5,0,-1,106388,93612
2:6:4,1,1,106387,93613
1:6:3,0,-1,106388,93612
6:1:1,0,-1,106389,93611
3:2:2,2,2,106387,93613
3:1:6,0,-1,106388,93612
3:6:6,0,-1,106389,93611
5:3:2,1,1,106388,93612
5:2:1,1,1,106387,93613
2:5:3,1,1,106386,93614
5:1:1,0,-1,106387,93613
5:6:5,0,-1,106388,93612
2:2:4,2,2,106386,93614
6:2:1,1,1,106385,93615
4:1:6,0,-1,106386,93614
6:3:4,0,-1,106387,93613
2:3:6,1,1,106386,93614
4:1:6,0,-1,106387,93613
3:1:5,0,-1,106388,93612
3:3:3,0,-1,106389,93611
1:3:6,0,-1,106390,93610
5:4:4,0,-1,106391,93609
2:4:3,1,1,106390,93610
3:3:6,0,-1,106391,93609
1:1:4,0,-1,106392,93608
5:6:2,1,1,106391,93609
5:3:2,1,1,106390,93610
3:6:3,0,-1,106391,93609
2:3:4,1,1,106390,93610
4:1:4,0,-1,106391,93609
2:4:6,1,1,106390,93610
4:3:1,0,-1,106391,93609
2:5:5,1,1,106390,93610
5:4:2,1,1,106389,93611
6:1:3,0,-1,106390,93610
1:4:2,1,1,106389,93611
2:3:6,1,1,106388,93612
6:6:2,1,1,106387,93613
5:6:2,1,1,106386,93614
2:6:3,1,1,106385,93615
2:4:1,1,1,106384,93616
4:4:6,0,-1,106385,93615
6:3:4,0,-1,106386,93614
5:1:5,0,-1,106387,93613
2:5:1,1,1,106386,93614
3:4:1,0,-1,106387,93613
6:6:4,0,-1,106388,93612
6:4:6,0,-1,106389,93611
1:1:2,1,1,106388,93612
6:2:4,1,1,106387,93613
3:1:5,0,-1,106388,93612
4:1:2,1,1,106387,93613
2:1:3,1,1,106386,93614
1:6:4,0,-1,106387,93613
2:6:4,1,1,106386,93614
4:5:1,0,-1,106387,93613
3:3:2,1,1,106386,93614
4:2:4,1,1,106385,93615
5:6:2,1,1,106384,93616
1:4:5,0,-1,106385,93615
6:2:5,1,1,106384,93616
1:1:5,0,-1,106385,93615
5:4:3,0,-1,106386,93614
1:1:1,0,-1,106387,93613
1:6:1,0,-1,106388,93612
3:5:1,0,-1,106389,93611
3:4:4,0,-1,106390,93610
4:2:1,1,1,106389,93611
6:6:4,0,-1,106390,93610
3:2:6,1,1,106389,93611
1:4:2,1,1,106388,93612
2:3:2,2,2,106386,93614
3:4:6,0,-1,106387,93613
5:6:3,0,-1,106388,93612
5:2:5,1,1,106387,93613
6:3:5,0,-1,106388,93612
3:5:2,1,1,106387,93613
3:2:3,1,1,106386,93614
3:5:5,0,-1,106387,93613
6:3:6,0,-1,106388,93612
2:2:4,2,2,106386,93614
6:1:1,0,-1,106387,93613
2:4:6,1,1,106386,93614
5:3:1,0,-1,106387,93613
6:6:4,0,-1,106388,93612
3:1:5,0,-1,106389,93611
3:6:1,0,-1,106390,93610
6:6:6,0,-1,106391,93609
6:1:2,1,1,106390,93610
2:1:4,1,1,106389,93611
3:4:6,0,-1,106390,93610
1:4:6,0,-1,106391,93609
4:4:2,1,1,106390,93610
5:2:5,1,1,106389,93611
2:6:6,1,1,106388,93612
2:5:5,1,1,106387,93613
1:3:5,0,-1,106388,93612
5:2:4,1,1,106387,93613
6:1:6,0,-1,106388,93612
4:5:6,0,-1,106389,93611
1:5:4,0,-1,106390,93610
2:5:1,1,1,106389,93611
5:1:2,1,1,106388,93612
5:4:6,0,-1,106389,93611
4:6:2,1,1,106388,93612
1:5:1,0,-1,106389,93611
5:3:5,0,-1,106390,93610
3:1:6,0,-1,106391,93609
6:1:3,0,-1,106392,93608
1:4:6,0,-1,106393,93607
4:3:1,0,-1,106394,93606
3:4:4,0,-1,106395,93605
2:2:2,3,3,106392,93608
2:1:4,1,1,106391,93609
1:5:4,0,-1,106392,93608
6:4:4,0,-1,106393,93607
6:2:6,1,1,106392,93608
2:6:6,1,1,106391,93609
3:3:3,0,-1,106392,93608
4:4:1,0,-1,106393,93607
4:5:4,0,-1,106394,93606
5:1:4,0,-1,106395,93605
3:6:4,0,-1,106396,93604
3:5:4,0,-1,106397,93603
1:6:4,0,-1,106398,93602
1:4:3,0,-1,106399,93601
5:1:3,0,-1,106400,93600
6:3:1,0,-1,106401,93599
4:3:6,0,-1,106402,93598
2:3:5,1,1,106401,93599
6:2:6,1,1,106400,93600
6:6:3,0,-1,106401,93599
1:1:5,0,-1,106402,93598
3:4:3,0,-1,106403,93597
1:4:4,0,-1,106404,93596
2:3:6,1,1,106403,93597
4:4:4,0,-1,106404,93596
5:5:2,1,1,106403,93597
2:3:5,1,1,106402,93598
3:1:2,1,1,106401,93599
2:2:4,2,2,106399,93601
4:6:2,1,1,106398,93602
4:2:3,1,1,106397,93603
4:4:4,0,-1,106398,93602
6:4:6,0,-1,106399,93601
6:4:4,0,-1,106400,93600
2:1:1,1,1,106399,93601
5:5:5,0,-1,106400,93600
6:1:2,1,1,106399,93601
5:6:4,0,-1,106400,93600
4:2:6,1,1,106399,93601
3:6:1,0,-1,106400,93600
5:6:2,1,1,106399,93601
1:1:1,0,-1,106400,93600
4:2:3,1,1,106399,93601
5:4:5,0,-1,106400,93600
4:3:2,1,1,106399,93601
2:2:6,2,2,106397,93603
4:2:2,2,2,106395,93605
4:5:4,0,-1,106396,93604
5:4:4,0,-1,106397,93603
4:6:5,0,-1,106398,93602
3:5:1,0,-1,106399,93601
2:4:6,1,1,106398,93602
6:1:1,0,-1,106399,93601
2:5:5,1,1,106398,93602
2:1:2,2,2,106396,93604
3:6:3,0,-1,106397,93603
2:3:6,1,1,106396,93604
5:2:4,1,1,106395,93605
1:4:1,0,-1,106396,93604
5:6:3,0,-1,106397,93603
4:3:6,0,-1,106398,93602
3:5:5,0,-1,106399,93601
5:3:3,0,-1,106400,93600
2:3:1,1,1,106399,93601
4:5:1,0,-1,106400,93600
2:1:2,2,2,106398,93602
6:2:1,1,1,106397,93603
1:2:2,2,2,106395,93605
3:2:2,2,2,106393,93607
1:1:4,0,-1,106394,93606
2:6:3,1,1,106393,93607
3:1:1,0,-1,106394,93606
4:6:1,0,-1,106395,93605
2:5:6,1,1,106394,93606
1:2:5,1,1,106393,93607
1:6:3,0,-1,106394,93606
4:4:2,1,1,106393,93607
5:2:5,1,1,106392,93608
2:5:5,1,1,106391,93609
2:6:1,1,1,106390,93610
6:6:1,0,-1,106391,93609
3:4:3,0,-1,106392,93608
3:6:2,1,1,106391,93609
6:3:2,1,1,106390,93610
2:2:5,2,2,106388,93612
6:6:4,0,-1,106389,93611
1:6:5,0,-1,106390,93610
6:1:5,0,-1,106391,93609
2:5:3,1,1,106390,93610
5:5:2,1,1,106389,93611
1:6:3,0,-1,106390,93610
1:5:5,0,-1,106391,93609
5:6:2,1,1,106390,93610
2:5:4,1,1,106389,93611
3:4:1,0,-1,106390,93610
4:2:5,1,1,106389,93611
1:2:3,1,1,106388,93612
4:3:3,0,-1,106389,93611
5:3:2,1,1,106388,93612
4:3:2,1,1,106387,93613
3:5:2,1,1,106386,93614
6:6:3,0,-1,106387,93613
2:6:3,1,1,106386,93614
3:6:2,1,1,106385,93615
4:3:2,1,1,106384,93616
1:6:1,0,-1,106385,93615
3:6:4,0,-1,106386,93614
2:1:3,1,1,106385,93615
5:1:3,0,-1,106386,93614
6:6:5,0,-1,106387,93613
5:1:1,0,-1,106388,93612
4:1:3,0,-1,106389,93611
5:6:2,1,1,106388,93612
5:5:3,0,-1,106389,93611
3:1:4,0,-1,106390,93610
6:5:6,0,-1,106391,93609
4:4:3,0,-1,106392,93608
1:2:6,1,1,106391,93609
1:5:4,0,-1,106392,93608
6:6:5,0,-1,106393,93607
1:5:5,0,-1,106394,93606
2:2:1,2,2,106392,93608
5:5:4,0,-1,106393,93607
3:1:4,0,-1,106394,93606
6:5:1,0,-1,106395,93605
5:2:4,1,1,106394,93606
4:2:2,2,2,106392,93608
2:6:6,1,1,106391,93609
5:3:3,0,-1,106392,93608
5:3:2,1,1,106391,93609
1:4:6,0,-1,106392,93608
1:3:5,0,-1,106393,93607
5:3:4,0,-1,106394,93606
4:2:4,1,1,106393,93607
1:5:3,0,-1,106394,93606
4:1:4,0,-1,106395,93605
3:2:6,1,1,106394,93606
3:6:2,1,1,106393,93607
5:2:4,1,1,106392,93608
1:5:3,0,-1,106393,93607
1:5:1,0,-1,106394,93606
4:5:5,0,-1,106395,93605
6:6:3,0,-1,106396,93604
4:4:6,0,-1,106397,93603
5:4:6,0,-1,106398,93602
6:5:2,1,1,106397,93603
3:5:1,0,-1,106398,93602
5:4:4,0,-1,106399,93601
3:5:1,0,-1,106400,93600
4:2:5,1,1,106399,93601
3:4:1,0,-1,106400,93600
4:2:2,2,2,106398,93602
4:3:4,0,-1,106399,93601
1:5:2,1,1,106398,93602
4:3:3,0,-1,106399,93601
1:6:2,1,1,106398,93602
4:6:1,0,-1,106399,93601
2:3:6,1,1,106398,93602
1:2:3,1,1,106397,93603
2:4:5,1,1,106396,93604
2:3:5,1,1,106395,93605
6:3:4,0,-1,106396,93604
4:5:6,0,-1,106397,93603
3:3:6,0,-1,106398,93602
2:5:2,2,2,106396,93604
2:4:4,1,1,106395,93605
4:4:3,0,-1,106396,93604
3:2:6,1,1,106395,93605
6:3:1,0,-1,106396,93604
4:3:1,0,-1,106397,93603
1:2:6,1,1,106396,93604
5:4:6,0,-1,106397,93603
5:4:1,0,-1,106398,93602
1:6:2,1,1,106397,93603
3:6:5,0,-1,106398,93602
3:5:4,0,-1,106399,93601
3:4:4,0,-1,106400,93600
1:4:2,1,1,106399,93601
2:1:3,1,1,106398,93602
5:5:5,0,-1,106399,93601
3:2:3,1,1,106398,93602
6:4:1,0,-1,106399,93601
1:3:3,0,-1,106400,93600
5:3:5,0,-1,106401,93599
5:6:2,1,1,106400,93600
1:6:5,0,-1,106401,93599
6:3:2,1,1,106400,93600
4:6:4,0,-1,106401,93599
1:5:4,0,-1,106402,93598
4:6:3,0,-1,106403,93597
5:6:1,0,-1,106404,93596
3:5:2,1,1,106403,93597
4:5:1,0,-1,106404,93596
2:6:3,1,1,106403,93597
4:6:5,0,-1,106404,93596
5:4:5,0,-1,106405,93595
6:5:4,0,-1,106406,93594
5:2:2,2,2,106404,93596
4:1:2,1,1,106403,93597
6:3:5,0,-1,106404,93596
6:4:3,0,-1,106405,93595
1:5:3,0,-1,106406,93594
3:6:5,0,-1,106407,93593
5:2:1,1,1,106406,93594
1:4:1,0,-1,106407,93593
5:1:6,0,-1,106408,93592
3:1:4,0,-1,106409,93591
2:5:6,1,1,106408,93592
3:1:6,0,-1,106409,93591
3:3:3,0,-1,106410,93590
6:6:1,0,-1,106411,93589
5:6:3,0,-1,106412,93588
3:1:4,0,-1,106413,93587
2:3:1,1,1,106412,93588
5:2:6,1,1,106411,93589
6:4:5,0,-1,106412,93588
5:5:6,0,-1,106413,93587
5:5:6,0,-1,106414,93586
1:1:4,0,-1,106415,93585
3:5:2,1,1,106414,93586
5:5:1,0,-1,106415,93585
5:4:2,1,1,106414,93586
1:6:6,0,-1,106415,93585
2:3:4,1,1,106414,93586
6:3:2,1,1,106413,93587
4:3:4,0,-1,106414,93586
1:3:5,0,-1,106415,93585
1:6:6,0,-1,106416,93584
5:3:2,1,1,106415,93585
3:4:6,0,-1,106416,93584
1:4:6,0,-1,106417,93583
1:5:3,0,-1,106418,93582
3:5:4,0,-1,106419,93581
4:2:6,1,1,106418,93582
3:4:5,0,-1,106419,93581
3:2:3,1,1,106418,93582
2:2:2,3,3,106415,93585
4:2:2,2,2,106413,93587
4:3:2,1,1,106412,93588
1:5:1,0,-1,106413,93587
5:1:6,0,-1,106414,93586
2:1:2,2,2,106412,93588
1:3:3,0,-1,106413,93587
3:2:3,1,1,106412,93588
3:5:4,0,-1,106413,93587
6:6:5,0,-1,106414,93586
1:1:6,0,-1,106415,93585
5:6:1,0,-1,106416,93584
2:1:4,1,1,106415,93585
2:6:2,2,2,106413,93587
3:6:1,0,-1,106414,93586
2:4:4,1,1,106413,93587
1:1:2,1,1,106412,93588
4:2:6,1,1,106411,93589
5:5:6,0,-1,106412,93588
2:1:2,2,2,106410,93590
3:6:2,1,1,106409,93591
1:4:2,1,1,106408,93592
1:4:5,0,-1,106409,93591
4:4:1,0,-1,106410,93590
2:5:3,1,1,106409,93591
5:5:4,0,-1,106410,93590
2:2:3,2,2,106408,93592
4:4:6,0,-1,106409,93591
3:2:3,1,1,106408,93592
5:4:3,0,-1,106409,93591
1:3:4,0,-1,106410,93590
2:5:6,1,1,106409,93591
6:5:5,0,-1,106410,93590
3:5:2,1,1,106409,93591
3:5:4,0,-1,106410,93590
6:2:5,1,1,106409,93591
6:6:1,0,-1,106410,93590
6:4:2,1,1,106409,93591
4:1:6,0,-1,106410,93590
3:2:3,1,1,106409,93591
5:1:2,1,1,106408,93592
5:4:3,0,-1,106409,93591
2:1:5,1,1,106408,93592
5:1:6,0,-1,106409,93591
5:1:4,0,-1,106410,93590
6:2:6,1,1,106409,93591
5:4:6,0,-1,106410,93590
5:3:2,1,1,106409,93591
3:2:6,1,1,106408,93592
2:4:3,1,1,106407,93593
6:5:2,1,1,106406,93594
2:3:2,2,2,106404,93596
2:4:1,1,1,106403,93597
3:2:1,1,1,106402,93598
2:1:2,2,2,106400,93600
1:5:3,0,-1,106401,93599
6:4:6,0,-1,106402,93598
4:5:5,0,-1,106403,93597
5:3:5,0,-1,106404,93596
3:2:6,1,1,106403,93597
5:1:3,0,-1,106404,93596
2:1:6,1,1,106403,93597
2:3:6,1,1,106402,93598
2:2:2,3,3,106399,93601
5:2:5,1,1,106398,93602
4:5:2,1,1,106397,93603
3:3:5,0,-1,106398,93602
1:2:5,1,1,106397,93603
1:1:4,0,-1,106398,93602
2:6:3,1,1,106397,93603
1:5:2,1,1,106396,93604
4:6:6,0,-1,106397,93603
3:2:6,1,1,106396,93604
5:5:6,0,-1,106397,93603
2:4:2,2,2,106395,93605
4:1:4,0,-1,106396,93604
2:1:6,1,1,106395,93605
1:1:5,0,-1,106396,93604
2:2:6,2,2,106394,93606
1:3:4,0,-1,106395,93605
3:1:4,0,-1,106396,93604
3:2:3,1,1,106395,93605
6:5:3,0,-1,106396,93604
2:4:1,1,1,106395,93605
6:2:6,1,1,106394,93606
2:5:4,1,1,106393,93607
6:6:2,1,1,106392,93608
4:4:2,1,1,106391,93609
2:3:3,1,1,106390,93610
5:6:5,0,-1,106391,93609
3:5:4,0,-1,106392,93608
1:5:3,0,-1,106393,93607
5:1:2,1,1,106392,93608
5:4:6,0,-1,106393,93607
6:3:5,0,-1,106394,93606
4:3:1,0,-1,106395,93605
5:4:4,0,-1,106396,93604
5:4:3,0,-1,106397,93603
4:3:6,0,-1,106398,93602
3:5:6,0,-1,106399,93601
2:6:1,1,1,106398,93602
1:5:2,1,1,106397,93603
5:1:2,1,1,106396,93604
5:5:5,0,-1,106397,93603
6:4:5,0,-1,106398,93602
1:3:1,0,-1,106399,93601
4:6:1,0,-1,106400,93600
2:5:3,1,1,106399,93601
4:2:5,1,1,106398,93602
1:5:2,1,1,106397,93603
2:5:6,1,1,106396,93604
2:3:3,1,1,106395,93605
6:3:3,0,-1,106396,93604
2:6:2,2,2,106394,93606
4:3:5,0,-1,106395,93605
5:6:4,0,-1,106396,93604
5:2:6,1,1,106395,93605
3:5:4,0,-1,106396,93604
5:3:3,0,-1,106397,93603
3:4:2,1,1,106396,93604
2:1:2,2,2,106394,93606
2:6:2,2,2,106392,93608
6:1:1,0,-1,106393,93607
3:4:3,0,-1,106394,93606
4:5:4,0,-1,106395,93605
3:3:4,0,-1,106396,93604
3:4:6,0,-1,106397,93603
2:2:1,2,2,106395,93605
2:6:5,1,1,106394,93606
2:5:4,1,1,106393,93607
4:6:6,0,-1,106394,93606
2:1:2,2,2,106392,93608
4:4:3,0,-1,106393,93607
2:2:2,3,3,106390,93610
4:5:2,1,1,106389,93611
2:3:3,1,1,106388,93612
6:4:4,0,-1,106389,93611
1:5:6,0,-1,106390,93610
1:4:2,1,1,106389,93611
4:1:4,0,-1,106390,93610
4:6:4,0,-1,106391,93609
3:1:4,0,-1,106392,93608
3:6:4,0,-1,106393,93607
4:1:5,0,-1,106394,93606
3:5:1,0,-1,106395,93605
6:1:3,0,-1,106396,93604
3:5:6,0,-1,106397,93603
3:3:1,0,-1,106398,93602
2:2:4,2,2,106396,93604
6:4:3,0,-1,106397,93603
2:1:4,1,1,106396,93604
4:2:6,1,1,106395,93605
3:2:2,2,2,106393,93607
3:3:2,1,1,106392,93608
5:2:1,1,1,106391,93609
3:5:4,0,-1,106392,93608
5:1:1,0,-1,106393,93607
3:3:4,0,-1,106394,93606
1:4:1,0,-1,106395,93605
5:5:5,0,-1,106396,93604
6:3:3,0,-1,106397,93603
5:4:1,0,-1,106398,93602
1:2:4,1,1,106397,93603
6:5:6,0,-1,106398,93602
4:2:6,1,1,106397,93603
3:4:6,0,-1,106398,93602
4:3:1,0,-1,106399,93601
2:6:3,1,1,106398,93602
6:3:5,0,-1,106399,93601
6:2:5,1,1,106398,93602
3:5:4,0,-1,106399,93601
2:5:4,1,1,106398,93602
6:3:5,0,-1,106399,93601
2:1:6,1,1,106398,93602
3:4:2,1,1,106397,93603
6:2:5,1,1,106396,93604
2:6:2,2,2,106394,93606
6:4:5,0,-1,106395,93605
4:2:4,1,1,106394,93606
1:4:3,0,-1,106395,93605
2:1:5,1,1,106394,93606
6:3:2,1,1,106393,93607
4:1:5,0,-1,106394,93606
2:4:4,1,1,106393,93607
6:1:3,0,-1,106394,93606
5:1:5,0,-1,106395,93605
3:6:1,0,-1,106396,93604
1:3:4,0,-1,106397,93603
5:5:5,0,-1,106398,93602
4:1:1,0,-1,106399,93601
3:1:6,0,-1,106400,93600
3:3:5,0,-1,106401,93599
1:1:4,0,-1,106402,93598
6:6:4,0,-1,106403,93597
5:3:3,0,-1,106404,93596
3:5:2,1,1,106403,93597
2:3:5,1,1,106402,93598
5:4:2,1,1,106401,93599
6:6:2,1,1,106400,93600
3:2:5,1,1,106399,93601
1:2:5,1,1,106398,93602
3:5:6,0,-1,106399,93601
1:3:5,0,-1,106400,93600
1:2:5,1,1,106399,93601
1:3:5,0,-1,106400,93600
4:3:1,0,-1,106401,93599
1:5:2,1,1,106400,93600
6:5:1,0,-1,106401,93599
6:3:5,0,-1,106402,93598
3:5:3,0,-1,106403,93597
5:4:3,0,-1,106404,93596
2:2:6,2,2,106402,93598
1:5:5,0,-1,106403,93597
5:6:2,1,1,106402,93598
6:2:5,1,1,106401,93599
2:5:3,1,1,106400,93600
6:2:2,2,2,106398,93602
3:3:4,0,-1,106399,93601
2:3:6,1,1,106398,93602
1:6:6,0,-1,106399,93601
1:3:4,0,-1,106400,93600
4:2:4,1,1,106399,93601
6:3:3,0,-1,106400,93600
5:4:2,1,1,106399,93601
2:5:2,2,2,106397,93603
6:2:4,1,1,106396,93604
1:1:4,0,-1,106397,93603
2:1:6,1,1,106396,93604
6:3:4,0,-1,106397,93603
1:4:6,0,-1,106398,93602
6:5:2,1,1,106397,93603
5:2:1,1,1,106396,93604
6:5:6,0,-1,106397,93603
3:2:3,1,1,106396,93604
2:6:3,1,1,106395,93605
2:6:4,1,1,106394,93606
5:2:2,2,2,106392,93608
3:3:5,0,-1,106393,93607
5:2:4,1,1,106392,93608
5:6:3,0,-1,106393,93607
5:2:6,1,1,106392,93608
4:1:3,0,-1,106393,93607
6:3:1,0,-1,106394,93606
2:1:6,1,1,106393,93607
5:3:5,0,-1,106394,93606
5:4:5,0,-1,106395,93605
2:6:5,1,1,106394,93606
4:1:4,0,-1,106395,93605
5:2:2,2,2,106393,93607
1:6:5,0,-1,106394,93606
4:1:2,1,1,106393,93607
1:1:4,0,-1,106394,93606
5:1:5,0,-1,106395,93605
4:4:3,0,-1,106396,93604
4:1:4,0,-1,106397,93603
1:1:3,0,-1,106398,93602
1:3:3,0,-1,106399,93601
6:4:2,1,1,106398,93602
5:2:2,2,2,106396,93604
3:5:1,0,-1,106397,93603
1:6:4,0,-1,106398,93602
2:1:6,1,1,106397,93603
6:3:1,0,-1,106398,93602
6:1:1,0,-1,106399,93601
1:3:2,1,1,106398,93602
1:1:4,0,-1,106399,93601
4:6:2,1,1,106398,93602
2:4:3,1,1,106397,93603
3:5:3,0,-1,106398,93602
1:2:1,1,1,106397,93603
6:5:2,1,1,106396,93604
2:1:2,2,2,106394,93606
6:2:2,2,2,106392,93608
6:4:4,0,-1,106393,93607
6:1:1,0,-1,106394,93606
4:1:4,0,-1,106395,93605
5:1:6,0,-1,106396,93604
3:1:6,0,-1,106397,93603
3:1:1,0,-1,106398,93602
3:2:2,2,2,106396,93604
4:1:4,0,-1,106397,93603
4:3:5,0,-1,106398,93602
5:4:5,0,-1,106399,93601
1:1:5,0,-1,106400,93600
3:1:2,1,1,106399,93601
3:1:4,0,-1,106400,93600
2:6:5,1,1,106399,93601
1:5:1,0,-1,106400,93600
5:5:1,0,-1,106401,93599
4:5:3,0,-1,106402,93598
5:1:5,0,-1,106403,93597
5:5:2,1,1,106402,93598
6:5:4,0,-1,106403,93597
3:2:3,1,1,106402,93598
1:1:3,0,-1,106403,93597
3:5:4,0,-1,106404,93596
1:2:4,1,1,106403,93597
1:1:3,0,-1,106404,93596
2:1:5,1,1,106403,93597
2:4:4,1,1,106402,93598
2:2:4,2,2,106400,93600
4:3:6,0,-1,106401,93599
6:3:5,0,-1,106402,93598
5:5:1,0,-1,106403,93597
6:1:3,0,-1,106404,93596
4:6:4,0,-1,106405,93595
2:2:4,2,2,106403,93597
3:4:2,1,1,106402,93598
5:2:2,2,2,106400,93600
5:6:2,1,1,106399,93601
1:2:4,1,1,106398,93602
1:5:4,0,-1,106399,93601
2:6:3,1,1,106398,93602
3:2:2,2,2,106396,93604
6:4:3,0,-1,106397,93603
5:4:4,0,-1,106398,93602
5:1:1,0,-1,106399,93601
5:2:5,1,1,106398,93602
6:5:1,0,-1,106399,93601
6:3:6,0,-1,106400,93600
1:3:4,0,-1,106401,93599
4:1:5,0,-1,106402,93598
1:2:2,2,2,106400,93600
3:1:4,0,-1,106401,93599
3:5:1,0,-1,106402,93598
5:4:4,0,-1,106403,93597
3:1:4,0,-1,106404,93596
1:2:6,1,1,106403,93597
1:2:5,1,1,106402,93598
5:3:2,1,1,106401,93599
6:6:6,0,-1,106402,93598
6:2:1,1,1,106401,93599
6:3:1,0,-1,106402,93598
6:2:4,1,1,106401,93599
4:6:2,1,1,106400,93600
2:2:5,2,2,106398,93602
1:6:1,0,-1,106399,93601
2:5:3,1,1,106398,93602
2:5:6,1,1,106397,93603
3:2:3,1,1,106396,93604
2:4:6,1,1,106395,93605
1:2:2,2,2,106393,93607
3:1:5,0,-1,106394,93606
5:4:2,1,1,106393,93607
3:5:2,1,1,106392,93608
1:1:6,0,-1,106393,93607
6:6:6,0,-1,106394,93606
4:2:6,1,1,106393,93607
1:1:4,0,-1,106394,93606
2:6:5,1,1,106393,93607
2:3:1,1,1,106392,93608
6:4:2,1,1,106391,93609
5:3:2,1,1,106390,93610
4:5:1,0,-1,106391,93609
5:3:1,0,-1,106392,93608
5:2:4,1,1,106391,93609
5:5:3,0,-1,106392,93608
5:1:2,1,1,106391,93609
2:6:1,1,1,106390,93610
6:1:2,1,1,106389,93611
3:2:3,1,1,106388,93612
4:3:1,0,-1,106389,93611
3:4:4,0,-1,106390,93610
6:4:2,1,1,106389,93611
2:2:3,2,2,106387,93613
1:2:3,1,1,106386,93614
3:6:4,0,-1,106387,93613
6:4:1,0,-1,106388,93612
2:2:4,2,2,106386,93614
5:5:5,0,-1,106387,93613
4:3:5,0,-1,106388,93612
1:1:2,1,1,106387,93613
2:1:1,1,1,106386,93614
1:5:5,0,-1,106387,93613
1:5:6,0,-1,106388,93612
6:6:3,0,-1,106389,93611
3:2:3,1,1,106388,93612
5:4:2,1,1,106387,93613
2:4:1,1,1,106386,93614
2:1:4,1,1,106385,93615
2:5:6,1,1,106384,93616
6:4:3,0,-1,106385,93615
2:2:2,3,3,106382,93618
3:5:2,1,1,106381,93619
4:4:3,0,-1,106382,93618
2:1:6,1,1,106381,93619
5:4:5,0,-1,106382,93618
1:3:1,0,-1,106383,93617
3:4:3,0,-1,106384,93616
3:3:3,0,-1,106385,93615
3:4:2,1,1,106384,93616
3:3:3,0,-1,106385,93615
4:3:4,0,-1,106386,93614
2:2:6,2,2,106384,93616
3:4:5,0,-1,106385,93615
3:3:6,0,-1,106386,93614
1:5:5,0,-1,106387,93613
6:3:6,0,-1,106388,93612
4:2:5,1,1,106387,93613
2:6:1,1,1,106386,93614
3:1:2,1,1,106385,93615
4:4:2,1,1,106384,93616
4:5:5,0,-1,106385,93615
4:1:6,0,-1,106386,93614
2:1:3,1,1,106385,93615
4:3:4,0,-1,106386,93614
6:1:4,0,-1,106387,93613
2:3:5,1,1,106386,93614
3:6:2,1,1,106385,93615
4:3:6,0,-1,106386,93614
5:6:4,0,-1,106387,93613
6:6:1,0,-1,106388,93612
5:1:1,0,-1,106389,93611
5:6:4,0,-1,106390,93610
3:4:1,0,-1,106391,93609
1:1:1,0,-1,106392,93608
3:2:6,1,1,106391,93609
1:2:2,2,2,106389,93611
1:1:5,0,-1,106390,93610
1:6:6,0,-1,106391,93609
6:3:3,0,-1,106392,93608
1:3:3,0,-1,106393,93607
6:3:6,0,-1,106394,93606
6:5:1,0,-1,106395,93605
6:6:6,0,-1,106396,93604
5:5:4,0,-1,106397,93603
2:3:5,1,1,106396,93604
5:2:2,2,2,106394,93606
1:3:4,0,-1,106395,93605
3:1:2,1,1,106394,93606
1:6:4,0,-1,106395,93605
2:1:3,1,1,106394,93606
6:3:5,0,-1,106395,93605
2:4:1,1,1,106394,93606
3:1:3,0,-1,106395,93605
4:1:6,0,-1,106396,93604
1:1:5,0,-1,106397,93603
1:2:2,2,2,106395,93605
6:5:6,0,-1,106396,93604
1:6:2,1,1,106395,93605
2:4:4,1,1,106394,93606
3:5:4,0,-1,106395,93605
4:2:3,1,1,106394,93606
4:1:5,0,-1,106395,93605
3:1:1,0,-1,106396,93604
3:2:5,1,1,106395,93605
2:6:1,1,1,106394,93606
5:4:6,0,-1,106395,93605
6:4:2,1,1,106394,93606
2:4:5,1,1,106393,93607
4:2:1,1,1,106392,93608
6:4:1,0,-1,106393,93607
1:1:2,1,1,106392,93608
3:5:2,1,1,106391,93609
3:1:4,0,-1,106392,93608
1:5:2,1,1,106391,93609
6:1:5,0,-1,106392,93608
2:2:3,2,2,106390,93610
3:6:4,0,-1,106391,93609
1:3:3,0,-1,106392,93608
3:2:5,1,1,106391,93609
3:2:3,1,1,106390,93610
3:2:1,1,1,106389,93611
5:2:4,1,1,106388,93612
1:5:5,0,-1,106389,93611
5:5:2,1,1,106388,93612
3:1:4,0,-1,106389,93611
2:2:6,2,2,106387,93613
5:4:1,0,-1,106388,93612
6:2:1,1,1,106387,93613
4:3:6,0,-1,106388,93612
2:6:5,1,1,106387,93613
6:4:1,0,-1,106388,93612
5:5:4,0,-1,106389,93611
6:1:2,1,1,106388,93612
2:4:1,1,1,106387,93613
5:3:5,0,-1,106388,93612
4:4:4,0,-1,106389,93611
6:3:3,0,-1,106390,93610
2:6:5,1,1,106389,93611
1:1:4,0,-1,106390,93610
4:4:2,1,1,106389,93611
2:4:1,1,1,106388,93612
3:3:4,0,-1,106389,93611
3:3:5,0,-1,106390,93610
2:6:4,1,1,106389,93611
5:6:1,0,-1,106390,93610
1:4:1,0,-1,106391,93609
3:2:5,1,1,106390,93610
4:4:2,1,1,106389,93611
6:2:5,1,1,106388,93612
1:6:1,0,-1,106389,93611
6:1:3,0,-1,106390,93610
1:2:4,1,1,106389,93611
6:2:3,1,1,106388,93612
1:4:6,0,-1,106389,93611
4:3:1,0,-1,106390,93610
5:6:6,0,-1,106391,93609
1:6:2,1,1,106390,93610
3:6:2,1,1,106389,93611
1:4:4,0,-1,106390,93610
2:5:4,1,1,106389,93611
6:2:4,1,1,106388,93612
6:5:4,0,-1,106389,93611
2:1:3,1,1,106388,93612
5:2:3,1,1,106387,93613
4:6:2,1,1,106386,93614
6:6:1,0,-1,106387,93613
6:5:4,0,-1,106388,93612
5:6:5,0,-1,106389,93611
4:3:3,0,-1,106390,93610
6:6:1,0,-1,106391,93609
5:2:5,1,1,106390,93610
1:3:5,0,-1,106391,93609
5:6:6,0,-1,106392,93608
1:3:6,0,-1,106393,93607
3:2:5,1,1,106392,93608
6:6:5,0,-1,106393,93607
5:2:3,1,1,106392,93608
1:4:4,0,-1,106393,93607
3:6:1,0,-1,106394,93606
2:2:6,2,2,106392,93608
5:2:2,2,2,106390,93610
6:5:1,0,-1,106391,93609
3:2:3,1,1,106390,93610
6:1:3,0,-1,106391,93609
2:1:2,2,2,106389,93611
5:5:1,0,-1,106390,93610
5:5:3,0,-1,106391,93609
4:3:4,0,-1,106392,93608
4:4:5,0,-1,106393,93607
2:3:5,1,1,106392,93608
6:2:3,1,1,106391,93609
1:2:5,1,1,106390,93610
5:3:4,0,-1,106391,93609
2:3:3,1,1,106390,93610
2:5:4,1,1,106389,93611
3:4:3,0,-1,106390,93610
2:2:5,2,2,106388,93612
5:4:5,0,-1,106389,93611
5:4:3,0,-1,106390,93610
5:1:5,0,-1,106391,93609
4:3:5,0,-1,106392,93608
4:6:5,0,-1,106393,93607
5:1:1,0,-1,106394,93606
1:3:2,1,1,106393,93607
5:5:5,0,-1,106394,93606
5:4:5,0,-1,106395,93605
1:5:1,0,-1,106396,93604
4:4:6,0,-1,106397,93603
3:5:5,0,-1,106398,93602
2:6:2,2,2,106396,93604
3:4:4,0,-1,106397,93603
5:4:4,0,-1,106398,93602
5:3:1,0,-1,106399,93601
4:2:3,1,1,106398,93602
3:2:5,1,1,106397,93603
6:5:3,0,-1,106398,93602
3:1:2,1,1,106397,93603
3:1:4,0,-1,106398,93602
1:5:3,0,-1,106399,93601
5:5:6,0,-1,106400,93600
3:4:6,0,-1,106401,93599
5:1:4,0,-1,106402,93598
2:2:5,2,2,106400,93600
3:1:1,0,-1,106401,93599
6:6:5,0,-1,106402,93598
1:1:4,0,-1,106403,93597
1:4:1,0,-1,106404,93596
1:5:4,0,-1,106405,93595
6:1:4,0,-1,106406,93594
2:1:5,1,1,106405,93595
1:4:3,0,-1,106406,93594
5:6:5,0,-1,106407,93593
6:6:5,0,-1,106408,93592
3:3:6,0,-1,106409,93591
1:1:4,0,-1,106410,93590
4:4:3,0,-1,106411,93589
6:3:4,0,-1,106412,93588
1:3:4,0,-1,106413,93587
6:4:2,1,1,106412,93588
5:3:4,0,-1,106413,93587
5:4:6,0,-1,106414,93586
4:2:1,1,1,106413,93587
5:6:3,0,-1,106414,93586
5:6:1,0,-1,106415,93585
1:4:5,0,-1,106416,93584
4:5:1,0,-1,106417,93583
4:1:4,0,-1,106418,93582
5:5:4,0,-1,106419,93581
2:5:1,1,1,106418,93582
6:3:3,0,-1,106419,93581
5:5:1,0,-1,106420,93580
6:1:3,0,-1,106421,93579
5:6:6,0,-1,106422,93578
1:1:3,0,-1,106423,93577
6:1:2,1,1,106422,93578
6:6:2,1,1,106421,93579
5:5:2,1,1,106420,93580
2:2:6,2,2,106418,93582
4:2:2,2,2,106416,93584
6:2:6,1,1,106415,93585
2:6:5,1,1,106414,93586
1:4:5,0,-1,106415,93585
1:6:3,0,-1,106416,93584
1:3:3,0,-1,106417,93583
2:1:4,1,1,106416,93584
2:3:3,1,1,106415,93585
6:1:4,0,-1,106416,93584
1:1:4,0,-1,106417,93583
6:2:2,2,2,106415,93585
2:2:4,2,2,106413,93587
3:5:1,0,-1,106414,93586
4:5:1,0,-1,106415,93585
3:4:4,0,-1,106416,93584
2:1:5,1,1,106415,93585
2:4:4,1,1,106414,93586
6:4:6,0,-1,106415,93585
1:4:1,0,-1,106416,93584
4:4:4,0,-1,106417,93583
6:3:5,0,-1,106418,93582
5:2:3,1,1,106417,93583
1:3:4,0,-1,106418,93582
6:1:2,1,1,106417,93583
4:6:5,0,-1,106418,93582
2:2:6,2,2,106416,93584
4:3:6,0,-1,106417,93583
3:1:3,0,-1,106418,93582
5:5:6,0,-1,106419,93581
2:3:6,1,1,106418,93582
1:3:3,0,-1,106419,93581
6:6:1,0,-1,106420,93580
3:2:4,1,1,106419,93581
4:6:2,1,1,106418,93582
3:1:5,0,-1,106419,93581
2:5:2,2,2,106417,93583
2:3:5,1,1,106416,93584
6:1:6,0,-1,106417,93583
6:2:3,1,1,106416,93584
2:2:2,3,3,106413,93587
1:1:3,0,-1,106414,93586
4:5:4,0,-1,106415,93585
3:3:1,0,-1,106416,93584
3:2:4,1,1,106415,93585
1:2:4,1,1,106414,93586
5:6:2,1,1,106413,93587
5:2:6,1,1,106412,93588
3:3:2,1,1,106411,93589
1:5:6,0,-1,106412,93588
5:6:2,1,1,106411,93589
5:6:5,0,-1,106412,93588
1:2:6,1,1,106411,93589
6:1:1,0,-1,106412,93588
5:1:3,0,-1,106413,93587
2:1:6,1,1,106412,93588
4:4:4,0,-1,106413,93587
6:4:2,1,1,106412,93588
4:3:3,0,-1,106413,93587
4:3:3,0,-1,106414,93586
5:3:5,0,-1,106415,93585
4:2:5,1,1,106414,93586
1:4:3,0,-1,106415,93585
4:2:4,1,1,106414,93586
4:5:6,0,-1,106415,93585
3:6:3,0,-1,106416,93584
2:1:3,1,1,106415,93585
1:6:6,0,-1,106416,93584
2:5:3,1,1,106415,93585
5:1:5,0,-1,106416,93584
5:6:3,0,-1,106417,93583
4:4:6,0,-1,106418,93582
1:5:3,0,-1,106419,93581
6:5:4,0,-1,106420,93580
3:5:6,0,-1,106421,93579
5:1:4,0,-1,106422,93578
1:2:1,1,1,106421,93579
5:1:6,0,-1,106422,93578
3:2:5,1,1,106421,93579
5:4:2,1,1,106420,93580
3:4:1,0,-1,106421,93579
1:1:6,0,-1,106422,93578
3:1:6,0,-1,106423,93577
4:5:2,1,1,106422,93578
6:1:6,0,-1,106423,93577
3:3:1,0,-1,106424,93576
3:3:1,0,-1,106425,93575
6:2:6,1,1,106424,93576
4:1:4,0,-1,106425,93575
2:3:5,1,1,106424,93576
2:3:3,1,1,106423,93577
1:4:2,1,1,106422,93578
4:5:4,0,-1,106423,93577
5:6:5,0,-1,106424,93576
5:6:5,0,-1,106425,93575
1:2:1,1,1,106424,93576
3:3:2,1,1,106423,93577
2:6:2,2,2,106421,93579
1:6:2,1,1,106420,93580
5:6:4,0,-1,106421,93579
5:6:3,0,-1,106422,93578
1:5:4,0,-1,106423,93577
2:6:3,1,1,106422,93578
6:1:3,0,-1,106423,93577
2:1:2,2,2,106421,93579
2:1:5,1,1,106420,93580
1:5:3,0,-1,106421,93579
5:5:3,0,-1,106422,93578
3:6:4,0,-1,106423,93577
3:2:5,1,1,106422,93578
3:3:2,1,1,106421,93579
2:6:1,1,1,106420,93580
2:2:3,2,2,106418,93582
1:4:5,0,-1,106419,93581
1:4:3,0,-1,106420,93580
5:1:1,0,-1,106421,93579
6:2:5,1,1,106420,93580
1:5:5,0,-1,106421,93579
2:6:2,2,2,106419,93581
3:2:2,2,2,106417,93583
1:6:2,1,1,106416,93584
3:4:3,0,-1,106417,93583
3:5:3,0,-1,106418,93582
6:6:3,0,-1,106419,93581
4:4:2,1,1,106418,93582
2:3:5,1,1,106417,93583
2:1:1,1,1,106416,93584
3:1:3,0,-1,106417,93583
2:1:6,1,1,106416,93584
4:6:4,0,-1,106417,93583
1:6:6,0,-1,106418,93582
4:4:1,0,-1,106419,93581
5:5:2,1,1,106418,93582
3:1:1,0,-1,106419,93581
2:3:1,1,1,106418,93582
4:5:3,0,-1,106419,93581
6:6:1,0,-1,106420,93580
3:1:3,0,-1,106421,93579
2:5:4,1,1,106420,93580
2:3:5,1,1,106419,93581
6:4:6,0,-1,106420,93580
1:1:4,0,-1,106421,93579
6:6:2,1,1,106420,93580
2:2:5,2,2,106418,93582
5:4:4,0,-1,106419,93581
4:3:3,0,-1,106420,93580
4:1:2,1,1,106419,93581
4:3:2,1,1,106418,93582
1:4:1,0,-1,106419,93581
1:2:1,1,1,106418,93582
4:6:5,0,-1,106419,93581
1:1:1,0,-1,106420,93580
2:1:3,1,1,106419,93581
3:5:2,1,1,106418,93582
3:1:1,0,-1,106419,93581
1:3:2,1,1,106418,93582
6:3:2,1,1,106417,93583
6:5:5,0,-1,106418,93582
4:5:2,1,1,106417,93583
4:1:2,1,1,106416,93584
5:3:4,0,-1,106417,93583
5:4:4,0,-1,106418,93582
5:2:2,2,2,106416,93584
6:6:3,0,-1,106417,93583
4:5:6,0,-1,106418,93582
5:1:6,0,-1,106419,93581
2:1:6,1,1,106418,93582
6:1:2,1,1,106417,93583
6:4:5,0,-1,106418,93582
6:2:1,1,1,106417,93583
3:3:3,0,-1,106418,93582
1:4:4,0,-1,106419,93581
3:3:6,0,-1,106420,93580
1:4:5,0,-1,106421,93579
3:5:2,1,1,106420,93580
4:4:6,0,-1,106421,93579
1:6:4,0,-1,106422,93578
3:5:3,0,-1,106423,93577
2:3:3,1,1,106422,93578
1:2:5,1,1,106421,93579
6:2:5,1,1,106420,93580
1:1:1,0,-1,106421,93579
6:5:5,0,-1,106422,93578
3:3:2,1,1,106421,93579
3:2:5,1,1,106420,93580
2:5:1,1,1,106419,93581
4:2:5,1,1,106418,93582
1:6:1,0,-1,106419,93581
4:3:3,0,-1,106420,93580
1:3:6,0,-1,106421,93579
2:4:1,1,1,106420,93580
1:2:5,1,1,106419,93581
5:3:3,0,-1,106420,93580
2:3:5,1,1,106419,93581
3:4:1,0,-1,106420,93580
2:5:4,1,1,106419,93581
4:2:6,1,1,106418,93582
3:1:1,0,-1,106419,93581
5:6:1,0,-1,106420,93580
6:5:1,0,-1,106421,93579
5:4:3,0,-1,106422,93578
5:1:4,0,-1,106423,93577
4:5:4,0,-1,106424,93576
3:5:1,0,-1,106425,93575
6:1:2,1,1,106424,93576
1:5:4,0,-1,106425,93575
2:1:2,2,2,106423,93577
1:2:4,1,1,106422,93578
3:3:3,0,-1,106423,93577
6:5:2,1,1,106422,93578
5:4:6,0,-1,106423,93577
3:1:2,1,1,106422,93578
6:1:6,0,-1,106423,93577
4:6:6,0,-1,106424,93576
6:4:3,0,-1,106425,93575
2:2:2,3,3,106422,93578
1:4:1,0,-1,106423,93577
1:4:3,0,-1,106424,93576
6:5:2,1,1,106423,93577
5:3:2,1,1,106422,93578
5:1:2,1,1,106421,93579
2:2:4,2,2,106419,93581
1:5:3,0,-1,106420,93580
5:1:5,0,-1,106421,93579
3:5:3,0,-1,106422,93578
6:5:6,0,-1,106423,93577
6:2:1,1,1,106422,93578
6:1:2,1,1,106421,93579
3:5:4,0,-1,106422,93578
6:5:1,0,-1,106423,93577
4:3:5,0,-1,106424,93576
4:4:5,0,-1,106425,93575
6:4:3,0,-1,106426,93574
6:5:2,1,1,106425,93575
1:6:4,0,-1,106426,93574
1:2:2,2,2,106424,93576
5:5:5,0,-1,106425,93575
4:4:2,1,1,106424,93576
3:4:3,0,-1,106425,93575
6:1:4,0,-1,106426,93574
2:6:2,2,2,106424,93576
6:4:4,0,-1,106425,93575
3:2:6,1,1,106424,93576
1:5:5,0,-1,106425,93575
5:2:2,2,2,106423,93577
5:5:3,0,-1,106424,93576
3:3:4,0,-1,106425,93575
5:5:3,0,-1,106426,93574
5:5:2,1,1,106425,93575
5:2:5,1,1,106424,93576
3:2:2,2,2,106422,93578
2:5:2,2,2,106420,93580
1:5:6,0,-1,106421,93579
3:3:5,0,-1,106422,93578
5:5:3,0,-1,106423,93577
6:1:5,0,-1,106424,93576
4:6:2,1,1,106423,93577
5:4:2,1,1,106422,93578
5:5:1,0,-1,106423,93577
3:1:3,0,-1,106424,93576
4:2:3,1,1,106423,93577
3:5:5,0,-1,106424,93576
3:4:6,0,-1,106425,93575
1:2:6,1,1,106424,93576
2:2:5,2,2,106422,93578
5:2:2,2,2,106420,93580
3:3:6,0,-1,106421,93579
5:6:3,0,-1,106422,93578
4:5:5,0,-1,106423,93577
5:2:5,1,1,106422,93578
4:5:5,0,-1,106423,93577
3:5:5,0,-1,106424,93576
1:6:1,0,-1,106425,93575
1:2:2,2,2,106423,93577
4:3:6,0,-1,106424,93576
1:1:1,0,-1,106425,93575
6:1:4,0,-1,106426,93574
1:5:5,0,-1,106427,93573
2:2:5,2,2,106425,93575
3:3:3,0,-1,106426,93574
4:2:6,1,1,106425,93575
1:6:3,0,-1,106426,93574
2:5:4,1,1,106425,93575
5:6:5,0,-1,106426,93574
3:6:4,0,-1,106427,93573
4:6:1,0,-1,106428,93572
2:4:5,1,1,106427,93573
3:3:2,1,1,106426,93574
3:4:4,0,-1,106427,93573
6:2:4,1,1,106426,93574
2:1:6,1,1,106425,93575
3:5:6,0,-1,106426,93574
1:3:6,0,-1,106427,93573
2:2:4,2,2,106425,93575
4:2:4,1,1,106424,93576
3:6:1,0,-1,106425,93575
6:3:2,1,1,106424,93576
3:5:2,1,1,106423,93577
2:5:3,1,1,106422,93578
6:1:5,0,-1,106423,93577
5:2:1,1,1,106422,93578
1:1:2,1,1,106421,93579
3:6:4,0,-1,106422,93578
1:2:3,1,1,106421,93579
1:6:6,0,-1,106422,93578
5:3:1,0,-1,106423,93577
1:2:2,2,2,106421,93579
6:1:4,0,-1,106422,93578
4:4:5,0,-1,106423,93577
4:4:5,0,-1,106424,93576
4:1:6,0,-1,106425,93575
1:1:1,0,-1,106426,93574
2:3:4,1,1,106425,93575
5:6:2,1,1,106424,93576
2:4:6,1,1,106423,93577
5:3:6,0,-1,106424,93576
6:5:6,0,-1,106425,93575
1:3:5,0,-1,106426,93574
4:1:4,0,-1,106427,93573
3:5:5,0,-1,106428,93572
2:2:6,2,2,106426,93574
4:3:5,0,-1,106427,93573
4:4:5,0,-1,106428,93572
6:3:6,0,-1,106429,93571
3:3:6,0,-1,106430,93570
1:2:4,1,1,106429,93571
5:3:4,0,-1,106430,93570
3:4:1,0,-1,106431,93569
2:5:3,1,1,106430,93570
1:2:4,1,1,106429,93571
5:2:1,1,1,106428,93572
4:2:4,1,1,106427,93573
3:1:2,1,1,106426,93574
1:4:6,0,-1,106427,93573
2:3:3,1,1,106426,93574
2:1:1,1,1,106425,93575
2:5:2,2,2,106423,93577
2:4:5,1,1,106422,93578
3:5:6,0,-1,106423,93577
6:6:3,0,-1,106424,93576
6:3:4,0,-1,106425,93575
1:2:1,1,1,106424,93576
1:2:6,1,1,106423,93577
5:6:2,1,1,106422,93578
4:6:3,0,-1,106423,93577
1:2:4,1,1,106422,93578
6:3:6,0,-1,106423,93577
3:5:5,0,-1,106424,93576
1:5:6,0,-1,106425,93575
3:2:3,1,1,106424,93576
4:4:2,1,1,106423,93577
1:6:1,0,-1,106424,93576
3:1:4,0,-1,106425,93575
6:4:3,0,-1,106426,93574
2:5:4,1,1,106425,93575
5:5:6,0,-1,106426,93574
6:3:4,0,-1,106427,93573
1:4:6,0,-1,106428,93572
3:3:3,0,-1,106429,93571
1:5:3,0,-1,106430,93570
3:1:1,0,-1,106431,93569
5:2:3,1,1,106430,93570
1:6:4,0,-1,106431,93569
5:6:4,0,-1,106432,93568
6:1:4,0,-1,106433,93567
1:5:5,0,-1,106434,93566
6:6:5,0,-1,106435,93565
2:4:5,1,1,106434,93566
4:5:3,0,-1,106435,93565
6:1:5,0,-1,106436,93564
1:2:5,1,1,106435,93565
2:6:4,1,1,106434,93566
5:3:2,1,1,106433,93567
3:4:1,0,-1,106434,93566
5:2:1,1,1,106433,93567
4:5:1,0,-1,106434,93566
1:4:3,0,-1,106435,93565
4:3:3,0,-1,106436,93564
6:2:5,1,1,106435,93565
1:3:2,1,1,106434,93566
6:4:4,0,-1,106435,93565
1:3:3,0,-1,106436,93564
5:3:6,0,-1,106437,93563
6:5:5,0,-1,106438,93562
5:4:3,0,-1,106439,93561
5:2:4,1,1,106438,93562
5:4:5,0,-1,106439,93561
5:6:4,0,-1,106440,93560
1:3:5,0,-1,106441,93559
4:2:3,1,1,106440,93560
3:1:6,0,-1,106441,93559
2:2:2,3,3,106438,93562
6:4:2,1,1,106437,93563
4:6:4,0,-1,106438,93562
5:3:4,0,-1,106439,93561
6:3:6,0,-1,106440,93560
1:1:2,1,1,106439,93561
1:6:5,0,-1,106440,93560
1:5:4,0,-1,106441,93559
4:2:3,1,1,106440,93560
5:6:1,0,-1,106441,93559
6:2:3,1,1,106440,93560
2:5:6,1,1,106439,93561
4:4:1,0,-1,106440,93560
4:3:3,0,-1,106441,93559
4:1:3,0,-1,106442,93558
4:1:4,0,-1,106443,93557
5:3:6,0,-1,106444,93556
3:5:3,0,-1,106445,93555
6:3:2,1,1,106444,93556
1:4:2,1,1,106443,93557
6:6:2,1,1,106442,93558
4:6:6,0,-1,106443,93557
1:3:1,0,-1,106444,93556
4:4:2,1,1,106443,93557
1:6:1,0,-1,106444,93556
2:3:6,1,1,106443,93557
6:2:1,1,1,106442,93558
4:5:1,0,-1,106443,93557
4:5:2,1,1,106442,93558
6:1:1,0,-1,106443,93557
1:3:3,0,-1,106444,93556
5:5:3,0,-1,106445,93555
5:1:3,0,-1,106446,93554
4:1:4,0,-1,106447,93553
4:6:5,0,-1,106448,93552
6:5:3,0,-1,106449,93551
4:1:4,0,-1,106450,93550
5:1:6,0,-1,106451,93549
3:6:5,0,-1,106452,93548
3:3:1,0,-1,106453,93547
5:1:5,0,-1,106454,93546
6:5:1,0,-1,106455,93545
1:2:2,2,2,106453,93547
2:2:6,2,2,106451,93549
3:3:2,1,1,106450,93550
3:5:3,0,-1,106451,93549
6:2:5,1,1,106450,93550
2:5:1,1,1,106449,93551
2:2:4,2,2,106447,93553
2:6:2,2,2,106445,93555
4:4:2,1,1,106444,93556
6:1:6,0,-1,106445,93555
5:1:2,1,1,106444,93556
3:5:3,0,-1,106445,93555
3:2:4,1,1,106444,93556
2:1:6,1,1,106443,93557
2:4:2,2,2,106441,93559
5:1:1,0,-1,106442,93558
5:4:5,0,-1,106443,93557
6:1:5,0,-1,106444,93556
4:3:6,0,-1,106445,93555
2:2:2,3,3,106442,93558
1:6:4,0,-1,106443,93557
6:6:6,0,-1,106444,93556
6:5:6,0,-1,106445,93555
3:6:5,0,-1,106446,93554
1:2:2,2,2,106444,93556
5:2:2,2,2,106442,93558
4:3:2,1,1,106441,93559
4:2:1,1,1,106440,93560
1:2:6,1,1,106439,93561
2:2:5,2,2,106437,93563
3:3:5,0,-1,106438,93562
1:6:3,0,-1,106439,93561
3:3:6,0,-1,106440,93560
5:2:3,1,1,106439,93561
5:1:2,1,1,106438,93562
1:6:1,0,-1,106439,93561
4:2:3,1,1,106438,93562
1:6:5,0,-1,106439,93561
5:4:2,1,1,106438,93562
2:6:2,2,2,106436,93564
3:4:1,0,-1,106437,93563
1:3:5,0,-1,106438,93562
4:1:2,1,1,106437,93563
1:3:5,0,-1,106438,93562
4:1:1,0,-1,106439,93561
4:5:2,1,1,106438,93562
2:4:2,2,2,106436,93564
3:5:5,0,-1,106437,93563
3:4:1,0,-1,106438,93562
6:6:2,1,1,106437,93563
5:6:5,0,-1,106438,93562
1:1:2,1,1,106437,93563
1:1:4,0,-1,106438,93562
1:1:2,1,1,106437,93563
6:3:6,0,-1,106438,93562
6:4:2,1,1,106437,93563
6:3:4,0,-1,106438,93562
5:1:4,0,-1,106439,93561
2:4:6,1,1,106438,93562
1:4:2,1,1,106437,93563
6:4:3,0,-1,106438,93562
3:5:4,0,-1,106439,93561
5:4:4,0,-1,106440,93560
2:5:2,2,2,106438,93562
3:5:6,0,-1,106439,93561
2:4:5,1,1,106438,93562
6:4:2,1,1,106437,93563
3:3:1,0,-1,106438,93562
6:6:5,0,-1,106439,93561
1:4:4,0,-1,106440,93560
6:2:6,1,1,106439,93561
4:2:6,1,1,106438,93562
4:2:5,1,1,106437,93563
1:3:3,0,-1,106438,93562
4:4:2,1,1,106437,93563
2:3:4,1,1,106436,93564
3:6:4,0,-1,106437,93563
5:3:4,0,-1,106438,93562
1:1:5,0,-1,106439,93561
2:4:6,1,1,106438,93562
1:1:6,0,-1,106439,93561
1:4:5,0,-1,106440,93560
2:4:2,2,2,106438,93562
3:6:4,0,-1,106439,93561
5:1:5,0,-1,106440,93560
6:3:3,0,-1,106441,93559
1:5:1,0,-1,106442,93558
5:2:5,1,1,106441,93559
5:2:5,1,1,106440,93560
2:3:5,1,1,106439,93561
1:6:4,0,-1,106440,93560
6:4:3,0,-1,106441,93559
4:2:3,1,1,106440,93560
1:6:4,0,-1,106441,93559
1:1:4,0,-1,106442,93558
6:2:4,1,1,106441,93559
3:4:3,0,-1,106442,93558
4:1:5,0,-1,106443,93557
6:4:2,1,1,106442,93558
1:2:1,1,1,106441,93559
2:6:1,1,1,106440,93560
6:3:6,0,-1,106441,93559
5:2:2,2,2,106439,93561
6:1:4,0,-1,106440,93560
5:6:3,0,-1,106441,93559
2:4:6,1,1,106440,93560
3:1:1,0,-1,106441,93559
6:5:6,0,-1,106442,93558
1:3:6,0,-1,106443,93557
1:4:4,0,-1,106444,93556
3:4:5,0,-1,106445,93555
6:5:1,0,-1,106446,93554
5:5:2,1,1,106445,93555
6:5:5,0,-1,106446,93554
2:4:2,2,2,106444,93556
3:1:1,0,-1,106445,93555
5:2:1,1,1,106444,93556
1:4:4,0,-1,106445,93555
1:2:3,1,1,106444,93556
4:2:1,1,1,106443,93557
3:3:5,0,-1,106444,93556
6:6:3,0,-1,106445,93555
6:1:4,0,-1,106446,93554
2:5:2,2,2,106444,93556
6:1:2,1,1,106443,93557
3:5:2,1,1,106442,93558
1:2:3,1,1,106441,93559
1:6:1,0,-1,106442,93558
5:5:5,0,-1,106443,93557
4:4:1,0,-1,106444,93556
1:3:6,0,-1,106445,93555
6:4:3,0,-1,106446,93554
1:4:4,0,-1,106447,93553
5:5:2,1,1,106446,93554
2:1:6,1,1,106445,93555
1:4:5,0,-1,106446,93554
6:1:3,0,-1,106447,93553
3:3:4,0,-1,106448,93552
1:6:2,1,1,106447,93553
5:4:1,0,-1,106448,93552
6:1:4,0,-1,106449,93551
3:2:5,1,1,106448,93552
4:3:4,0,-1,106449,93551
4:6:5,0,-1,106450,93550
5:2:3,1,1,106449,93551
2:1:4,1,1,106448,93552
3:4:4,0,-1,106449,93551
3:3:2,1,1,106448,93552
5:4:6,0,-1,106449,93551
1:5:2,1,1,106448,93552
4:1:2,1,1,106447,93553
3:6:4,0,-1,106448,93552
2:2:5,2,2,106446,93554
1:3:3,0,-1,106447,93553
5:2:3,1,1,106446,93554
4:5:4,0,-1,106447,93553
3:5:3,0,-1,106448,93552
4:2:3,1,1,106447,93553
4:3:4,0,-1,106448,93552
2:6:1,1,1,106447,93553
5:4:6,0,-1,106448,93552
5:3:2,1,1,106447,93553
4:3:2,1,1,106446,93554
3:3:1,0,-1,106447,93553
6:3:2,1,1,106446,93554
1:2:1,1,1,106445,93555
1:4:2,1,1,106444,93556
1:6:5,0,-1,106445,93555
5:3:5,0,-1,106446,93554
2:6:1,1,1,106445,93555
4:3:3,0,-1,106446,93554
5:5:1,0,-1,106447,93553
3:1:1,0,-1,106448,93552
4:5:1,0,-1,106449,93551
4:4:3,0,-1,106450,93550
4:5:4,0,-1,106451,93549
2:3:1,1,1,106450,93550
1:6:1,0,-1,106451,93549
5:2:1,1,1,106450,93550
3:2:2,2,2,106448,93552
6:2:1,1,1,106447,93553
3:2:2,2,2,106445,93555
1:2:3,1,1,106444,93556
6:3:2,1,1,106443,93557
5:5:2,1,1,106442,93558
5:5:4,0,-1,106443,93557
5:4:2,1,1,106442,93558
5:3:3,0,-1,106443,93557
5:6:6,0,-1,106444,93556
1:3:2,1,1,106443,93557
6:6:3,0,-1,106444,93556
6:1:2,1,1,106443,93557
4:6:2,1,1,106442,93558
1:5:6,0,-1,106443,93557
3:4:4,0,-1,106444,93556
3:1:4,0,-1,106445,93555
4:6:4,0,-1,106446,93554
6:3:2,1,1,106445,93555
1:3:2,1,1,106444,93556
3:6:4,0,-1,106445,93555
2:6:3,1,1,106444,93556
1:6:1,0,-1,106445,93555
6:4:1,0,-1,106446,93554
2:2:6,2,2,106444,93556
1:1:1,0,-1,106445,93555
4:1:2,1,1,106444,93556
3:1:4,0,-1,106445,93555
4:5:6,0,-1,106446,93554
4:6:1,0,-1,106447,93553
4:6:6,0,-1,106448,93552
3:2:1,1,1,106447,93553
2:3:5,1,1,106446,93554
4:1:1,0,-1,106447,93553
5:5:3,0,-1,106448,93552
2:6:6,1,1,106447,93553
2:5:3,1,1,106446,93554
4:1:1,0,-1,106447,93553
3:2:5,1,1,106446,93554
1:2:6,1,1,106445,93555
3:2:2,2,2,106443,93557
3:3:3,0,-1,106444,93556
1:1:1,0,-1,106445,93555
3:4:2,1,1,106444,93556
3:4:4,0,-1,106445,93555
3:4:1,0,-1,106446,93554
4:6:3,0,-1,106447,93553
1:5:3,0,-1,106448,93552
6:4:2,1,1,106447,93553
2:3:4,1,1,106446,93554
2:4:2,2,2,106444,93556
5:6:4,0,-1,106445,93555
4:2:5,1,1,106444,93556
4:4:1,0,-1,106445,93555
5:6:6,0,-1,106446,93554
3:4:6,0,-1,106447,93553
6:4:5,0,-1,106448,93552
1:5:2,1,1,106447,93553
3:5:5,0,-1,106448,93552
6:5:6,0,-1,106449,93551
1:4:1,0,-1,106450,93550
6:4:6,0,-1,106451,93549
3:1:3,0,-1,106452,93548
6:1:6,0,-1,106453,93547
4:4:2,1,1,106452,93548
5:2:6,1,1,106451,93549
1:3:6,0,-1,106452,93548
5:1:6,0,-1,106453,93547
1:5:4,0,-1,106454,93546
6:6:2,1,1,106453,93547
1:2:4,1,1,106452,93548
6:5:5,0,-1,106453,93547
1:2:5,1,1,106452,93548
5:3:4,0,-1,106453,93547
2:3:1,1,1,106452,93548
1:3:1,0,-1,106453,93547
3:2:1,1,1,106452,93548
4:6:3,0,-1,106453,93547
6:5:3,0,-1,106454,93546
4:2:3,1,1,106453,93547
5:4:2,1,1,106452,93548
3:2:5,1,1,106451,93549
2:5:6,1,1,106450,93550
1:2:2,2,2,106448,93552
5:2:5,1,1,106447,93553
2:4:4,1,1,106446,93554
2:3:1,1,1,106445,93555
2:3:1,1,1,106444,93556
5:2:4,1,1,106443,93557
5:6:5,0,-1,106444,93556
2:4:3,1,1,106443,93557
3:5:1,0,-1,106444,93556
6:2:4,1,1,106443,93557
5:6:2,1,1,106442,93558
5:1:3,0,-1,106443,93557
3:4:5,0,-1,106444,93556
3:4:1,0,-1,106445,93555
5:5:2,1,1,106444,93556
1:6:2,1,1,106443,93557
5:4:3,0,-1,106444,93556
3:5:4,0,-1,106445,93555
5:6:2,1,1,106444,93556
2:1:2,2,2,106442,93558
3:6:5,0,-1,106443,93557
1:3:4,0,-1,106444,93556
4:5:4,0,-1,106445,93555
6:1:6,0,-1,106446,93554
5:2:2,2,2,106444,93556
3:2:5,1,1,106443,93557
4:5:5,0,-1,106444,93556
6:2:6,1,1,106443,93557
1:3:6,0,-1,106444,93556
3:2:5,1,1,106443,93557
1:1:1,0,-1,106444,93556
2:5:2,2,2,106442,93558
4:5:3,0,-1,106443,93557
4:5:2,1,1,106442,93558
6:5:5,0,-1,106443,93557
1:3:4,0,-1,106444,93556
3:5:4,0,-1,106445,93555
5:1:6,0,-1,106446,93554
2:6:5,1,1,106445,93555
1:5:6,0,-1,106446,93554
4:4:6,0,-1,106447,93553
1:4:2,1,1,106446,93554
1:3:1,0,-1,106447,93553
4:3:3,0,-1,106448,93552
1:3:1,0,-1,106449,93551
3:5:1,0,-1,106450,93550
5:4:4,0,-1,106451,93549
3:3:5,0,-1,106452,93548
6:4:4,0,-1,106453,93547
6:6:3,0,-1,106454,93546
3:3:2,1,1,106453,93547
6:2:5,1,1,106452,93548
2:6:4,1,1,106451,93549
2:4:2,2,2,106449,93551
6:4:3,0,-1,106450,93550
2:6:3,1,1,106449,93551
4:5:2,1,1,106448,93552
3:6:6,0,-1,106449,93551
1:1:3,0,-1,106450,93550
2:3:6,1,1,106449,93551
3:4:5,0,-1,106450,93550
1:1:1,0,-1,106451,93549
5:3:4,0,-1,106452,93548
3:3:5,0,-1,106453,93547
3:5:3,0,-1,106454,93546
4:2:1,1,1,106453,93547
3:4:4,0,-1,106454,93546
6:4:6,0,-1,106455,93545
2:2:1,2,2,106453,93547
5:5:3,0,-1,106454,93546
1:6:5,0,-1,106455,93545
4:2:5,1,1,106454,93546
5:6:1,0,-1,106455,93545
2:6:3,1,1,106454,93546
4:4:6,0,-1,106455,93545
1:5:3,0,-1,106456,93544
3:4:1,0,-1,106457,93543
3:4:2,1,1,106456,93544
4:6:1,0,-1,106457,93543
2:1:1,1,1,106456,93544
3:2:5,1,1,106455,93545
6:1:3,0,-1,106456,93544
6:4:5,0,-1,106457,93543
2:6:4,1,1,106456,93544
5:2:6,1,1,106455,93545
1:5:6,0,-1,106456,93544
2:3:4,1,1,106455,93545
4:5:4,0,-1,106456,93544
5:3:4,0,-1,106457,93543
3:1:5,0,-1,106458,93542
4:6:3,0,-1,106459,93541
3:3:5,0,-1,106460,93540
5:3:6,0,-1,106461,93539
4:6:2,1,1,106460,93540
2:2:1,2,2,106458,93542
4:4:3,0,-1,106459,93541
4:5:5,0,-1,106460,93540
3:6:6,0,-1,106461,93539
1:2:2,2,2,106459,93541
2:6:3,1,1,106458,93542
1:2:6,1,1,106457,93543
1:6:3,0,-1,106458,93542
1:6:1,0,-1,106459,93541
3:6:3,0,-1,106460,93540
6:4:5,0,-1,106461,93539
2:6:5,1,1,106460,93540
2:2:4,2,2,106458,93542
2:1:5,1,1,106457,93543
4:3:4,0,-1,106458,93542
3:4:4,0,-1,106459,93541
1:1:3,0,-1,106460,93540
6:4:5,0,-1,106461,93539
5:2:1,1,1,106460,93540
4:5:6,0,-1,106461,93539
5:2:2,2,2,106459,93541
1:6:1,0,-1,106460,93540
3:5:6,0,-1,106461,93539
2:2:3,2,2,106459,93541
2:5:2,2,2,106457,93543
3:6:1,0,-1,106458,93542
6:1:2,1,1,106457,93543
1:4:4,0,-1,106458,93542
1:2:3,1,1,106457,93543
4:4:3,0,-1,106458,93542
3:5:6,0,-1,106459,93541
4:4:5,0,-1,106460,93540
5:5:3,0,-1,106461,93539
2:5:2,2,2,106459,93541
1:5:5,0,-1,106460,93540
3:3:6,0,-1,106461,93539
5:1:4,0,-1,106462,93538
5:4:4,0,-1,106463,93537
3:2:5,1,1,106462,93538
6:4:2,1,1,106461,93539
1:1:6,0,-1,106462,93538
6:4:6,0,-1,106463,93537
5:1:1,0,-1,106464,93536
2:1:2,2,2,106462,93538
6:3:5,0,-1,106463,93537
3:1:4,0,-1,106464,93536
5:1:1,0,-1,106465,93535
2:6:1,1,1,106464,93536
1:2:1,1,1,106463,93537
3:5:3,0,-1,106464,93536
1:4:4,0,-1,106465,93535
3:6:1,0,-1,106466,93534
1:1:2,1,1,106465,93535
1:2:3,1,1,106464,93536
5:5:5,0,-1,106465,93535
4:2:1,1,1,106464,93536
2:6:5,1,1,106463,93537
2:2:1,2,2,106461,93539
6:6:3,0,-1,106462,93538
4:6:6,0,-1,106463,93537
2:3:6,1,1,106462,93538
1:4:5,0,-1,106463,93537
6:2:3,1,1,106462,93538
4:3:5,0,-1,106463,93537
3:1:5,0,-1,106464,93536
4:1:5,0,-1,106465,93535
5:5:2,1,1,106464,93536
5:6:5,0,-1,106465,93535
5:5:2,1,1,106464,93536
4:2:6,1,1,106463,93537
3:6:3,0,-1,106464,93536
3:1:3,0,-1,106465,93535
3:2:2,2,2,106463,93537
4:5:5,0,-1,106464,93536
3:2:1,1,1,106463,93537
5:6:5,0,-1,106464,93536
6:5:5,0,-1,106465,93535
6:6:2,1,1,106464,93536
4:2:2,2,2,106462,93538
2:5:1,1,1,106461,93539
3:6:2,1,1,106460,93540
1:5:3,0,-1,106461,93539
3:3:4,0,-1,106462,93538
4:3:2,1,1,106461,93539
3:6:1,0,-1,106462,93538
5:4:6,0,-1,106463,93537
1:3:2,1,1,106462,93538
2:1:2,2,2,106460,93540
4:3:3,0,-1,106461,93539
5:5:6,0,-1,106462,93538
6:4:1,0,-1,106463,93537
5:5:3,0,-1,106464,93536
1:6:6,0,-1,106465,93535
5:3:2,1,1,106464,93536
2:6:6,1,1,106463,93537
4:1:2,1,1,106462,93538
4:5:4,0,-1,106463,93537
4:3:5,0,-1,106464,93536
2:2:3,2,2,106462,93538
3:2:1,1,1,106461,93539
4:6:5,0,-1,106462,93538
6:2:2,2,2,106460,93540
3:6:2,1,1,106459,93541
1:5:2,1,1,106458,93542
2:2:5,2,2,106456,93544
5:3:4,0,-1,106457,93543
2:6:5,1,1,106456,93544
2:3:4,1,1,106455,93545
3:4:1,0,-1,106456,93544
1:5:2,1,1,106455,93545
3:1:4,0,-1,106456,93544
5:1:5,0,-1,106457,93543
4:3:2,1,1,106456,93544
2:4:5,1,1,106455,93545
6:5:6,0,-1,106456,93544
2:1:6,1,1,106455,93545
1:6:6,0,-1,106456,93544
1:4:2,1,1,106455,93545
1:5:5,0,-1,106456,93544
1:2:3,1,1,106455,93545
6:3:5,0,-1,106456,93544
3:6:3,0,-1,106457,93543
4:4:2,1,1,106456,93544
5:5:6,0,-1,106457,93543
1:3:3,0,-1,106458,93542
2:5:5,1,1,106457,93543
1:1:6,0,-1,106458,93542
6:6:6,0,-1,106459,93541
6:2:4,1,1,106458,93542
5:3:3,0,-1,106459,93541
3:6:5,0,-1,106460,93540
6:6:5,0,-1,106461,93539
2:4:1,1,1,106460,93540
3:6:5,0,-1,106461,93539
2:4:6,1,1,106460,93540
2:1:4,1,1,106459,93541
2:1:6,1,1,106458,93542
1:2:1,1,1,106457,93543
1:6:6,0,-1,106458,93542
1:1:6,0,-1,106459,93541
2:6:5,1,1,106458,93542
2:4:2,2,2,106456,93544
1:4:6,0,-1,106457,93543
4:5:3,0,-1,106458,93542
2:1:2,2,2,106456,93544
1:4:2,1,1,106455,93545
6:3:4,0,-1,106456,93544
1:2:6,1,1,106455,93545
6:2:5,1,1,106454,93546
2:2:4,2,2,106452,93548
3:3:1,0,-1,106453,93547
2:1:5,1,1,106452,93548
3:5:3,0,-1,106453,93547
1:6:3,0,-1,106454,93546
5:5:2,1,1,106453,93547
1:1:2,1,1,106452,93548
3:1:1,0,-1,106453,93547
3:6:6,0,-1,106454,93546
6:5:1,0,-1,106455,93545
4:4:2,1,1,106454,93546
6:1:5,0,-1,106455,93545
3:2:5,1,1,106454,93546
2:4:4,1,1,106453,93547
1:2:4,1,1,106452,93548
5:2:4,1,1,106451,93549
2:6:6,1,1,106450,93550
6:5:3,0,-1,106451,93549
4:4:2,1,1,106450,93550
5:3:4,0,-1,106451,93549
6:5:1,0,-1,106452,93548
4:2:4,1,1,106451,93549
4:4:4,0,-1,106452,93548
5:1:3,0,-1,106453,93547
6:6:3,0,-1,106454,93546
2:4:3,1,1,106453,93547
2:3:4,1,1,106452,93548
2:4:5,1,1,106451,93549
5:3:3,0,-1,106452,93548
5:2:1,1,1,106451,93549
3:6:1,0,-1,106452,93548
3:4:5,0,-1,106453,93547
1:1:2,1,1,106452,93548
1:1:6,0,-1,106453,93547
4:4:3,0,-1,106454,93546
6:4:2,1,1,106453,93547
1:4:5,0,-1,106454,93546
5:2:5,1,1,106453,93547
1:4:6,0,-1,106454,93546
4:6:4,0,-1,106455,93545
6:4:3,0,-1,106456,93544
1:2:6,1,1,106455,93545
2:6:3,1,1,106454,93546
3:4:2,1,1,106453,93547
4:3:2,1,1,106452,93548
2:6:2,2,2,106450,93550
3:3:1,0,-1,106451,93549
5:3:4,0,-1,106452,93548
6:1:4,0,-1,106453,93547
2:4:5,1,1,106452,93548
2:1:2,2,2,106450,93550
2:3:6,1,1,106449,93551
3:4:2,1,1,106448,93552
2:6:6,1,1,106447,93553
4:4:4,0,-1,106448,93552
6:4:1,0,-1,106449,93551
2:3:5,1,1,106448,93552
1:5:1,0,-1,106449,93551
5:2:4,1,1,106448,93552
1:1:5,0,-1,106449,93551
4:2:6,1,1,106448,93552
2:5:6,1,1,106447,93553
5:4:3,0,-1,106448,93552
3:5:5,0,-1,106449,93551
4:5:3,0,-1,106450,93550
1:4:4,0,-1,106451,93549
5:5:3,0,-1,106452,93548
5:1:5,0,-1,106453,93547
4:1:1,0,-1,106454,93546
1:1:6,0,-1,106455,93545
1:2:2,2,2,106453,93547
5:5:4,0,-1,106454,93546
3:6:4,0,-1,106455,93545
1:2:1,1,1,106454,93546
2:4:5,1,1,106453,93547
4:6:2,1,1,106452,93548
5:5:5,0,-1,106453,93547
4:3:1,0,-1,106454,93546
2:1:1,1,1,106453,93547
3:3:6,0,-1,106454,93546
3:3:2,1,1,106453,93547
4:4:3,0,-1,106454,93546
1:2:1,1,1,106453,93547
5:2:1,1,1,106452,93548
4:6:3,0,-1,106453,93547
3:1:6,0,-1,106454,93546
3:4:5,0,-1,106455,93545
6:4:5,0,-1,106456,93544
6:3:1,0,-1,106457,93543
3:1:3,0,-1,106458,93542
5:6:1,0,-1,106459,93541
3:6:5,0,-1,106460,93540
3:6:1,0,-1,106461,93539
1:3:2,1,1,106460,93540
3:6:1,0,-1,106461,93539
2:1:4,1,1,106460,93540
2:4:1,1,1,106459,93541
4:5:1,0,-1,106460,93540
5:4:5,0,-1,106461,93539
4:5:6,0,-1,106462,93538
3:4:5,0,-1,106463,93537
4:6:5,0,-1,106464,93536
4:3:2,1,1,106463,93537
6:6:1,0,-1,106464,93536
3:2:6,1,1,106463,93537
2:3:5,1,1,106462,93538
4:3:3,0,-1,106463,93537
4:5:1,0,-1,106464,93536
3:6:3,0,-1,106465,93535
2:3:6,1,1,106464,93536
4:6:6,0,-1,106465,93535
4:6:1,0,-1,106466,93534
5:6:1,0,-1,106467,93533
4:5:4,0,-1,106468,93532
2:2:5,2,2,106466,93534
1:3:5,0,-1,106467,93533
6:5:5,0,-1,106468,93532
1:5:6,0,-1,106469,93531
4:3:4,0,-1,106470,93530
4:2:6,1,1,106469,93531
3:1:4,0,-1,106470,93530
3:6:2,1,1,106469,93531
2:5:6,1,1,106468,93532
1:2:4,1,1,106467,93533
5:4:3,0,-1,106468,93532
2:1:6,1,1,106467,93533
5:6:4,0,-1,106468,93532
4:2:6,1,1,106467,93533
1:5:2,1,1,106466,93534
4:6:3,0,-1,106467,93533
3:5:1,0,-1,106468,93532
5:3:1,0,-1,106469,93531
6:4:1,0,-1,106470,93530
4:5:1,0,-1,106471,93529
3:4:5,0,-1,106472,93528
4:4:1,0,-1,106473,93527
1:4:2,1,1,106472,93528
6:4:6,0,-1,106473,93527
1:4:6,0,-1,106474,93526
2:1:2,2,2,106472,93528
1:1:1,0,-1,106473,93527
4:2:1,1,1,106472,93528
6:4:6,0,-1,106473,93527
3:6:4,0,-1,106474,93526
6:2:3,1,1,106473,93527
4:3:1,0,-1,106474,93526
2:4:3,1,1,106473,93527
3:6:4,0,-1,106474,93526
2:6:1,1,1,106473,93527
1:2:5,1,1,106472,93528
6:4:5,0,-1,106473,93527
5:5:6,0,-1,106474,93526
1:5:6,0,-1,106475,93525
6:6:4,0,-1,106476,93524
3:2:4,1,1,106475,93525
4:1:1,0,-1,106476,93524
4:4:2,1,1,106475,93525
1:5:4,0,-1,106476,93524
1:4:1,0,-1,106477,93523
4:5:5,0,-1,106478,93522
4:3:5,0,-1,106479,93521
6:5:4,0,-1,106480,93520
1:5:1,0,-1,106481,93519
1:4:1,0,-1,106482,93518
3:2:4,1,1,106481,93519
1:6:1,0,-1,106482,93518
1:6:2,1,1,106481,93519
1:2:2,2,2,106479,93521
3:2:2,2,2,106477,93523
2:2:4,2,2,106475,93525
1:3:4,0,-1,106476,93524
5:6:3,0,-1,106477,93523
2:3:6,1,1,106476,93524
2:6:3,1,1,106475,93525
3:5:3,0,-1,106476,93524
4:1:3,0,-1,106477,93523
5:2:5,1,1,106476,93524
2:1:2,2,2,106474,93526
1:2:3,1,1,106473,93527
6:3:2,1,1,106472,93528
1:6:1,0,-1,106473,93527
6:2:6,1,1,106472,93528
5:3:2,1,1,106471,93529
1:2:2,2,2,106469,93531
3:6:4,0,-1,106470,93530
3:5:5,0,-1,106471,93529
5:5:1,0,-1,106472,93528
6:3:4,0,-1,106473,93527
1:6:1,0,-1,106474,93526
6:2:3,1,1,106473,93527
1:1:1,0,-1,106474,93526
4:2:4,1,1,106473,93527
3:4:6,0,-1,106474,93526
3:1:4,0,-1,106475,93525
5:1:1,0,-1,106476,93524
6:5:6,0,-1,106477,93523
6:2:4,1,1,106476,93524
6:6:3,0,-1,106477,93523
1:6:2,1,1,106476,93524
3:6:5,0,-1,106477,93523
2:3:4,1,1,106476,93524
5:6:6,0,-1,106477,93523
4:2:1,1,1,106476,93524
1:1:2,1,1,106475,93525
3:5:2,1,1,106474,93526
3:4:1,0,-1,106475,93525
5:4:4,0,-1,106476,93524
1:5:3,0,-1,106477,93523
3:3:4,0,-1,106478,93522
1:3:5,0,-1,106479,93521
4:2:6,1,1,106478,93522
1:5:5,0,-1,106479,93521
2:2:1,2,2,106477,93523
1:6:2,1,1,106476,93524
1:1:1,0,-1,106477,93523
6:3:3,0,-1,106478,93522
2:4:2,2,2,106476,93524
4:6:4,0,-1,106477,93523
6:4:4,0,-1,106478,93522
4:6:3,0,-1,106479,93521
1:1:1,0,-1,106480,93520
4:2:4,1,1,106479,93521
4:5:3,0,-1,106480,93520
1:1:4,0,-1,106481,93519
3:3:1,0,-1,106482,93518
5:4:4,0,-1,106483,93517
1:1:5,0,-1,106484,93516
2:1:5,1,1,106483,93517
6:6:5,0,-1,106484,93516
1:4:2,1,1,106483,93517
5:3:4,0,-1,106484,93516
2:5:5,1,1,106483,93517
5:4:2,1,1,106482,93518
2:3:5,1,1,106481,93519
4:3:6,0,-1,106482,93518
5:4:3,0,-1,106483,93517
6:1:4,0,-1,106484,93516
3:4:1,0,-1,106485,93515
6:1:4,0,-1,106486,93514
6:2:5,1,1,106485,93515
5:2:6,1,1,106484,93516
1:4:5,0,-1,106485,93515
1:2:6,1,1,106484,93516
4:3:3,0,-1,106485,93515
1:4:1,0,-1,106486,93514
3:6:6,0,-1,106487,93513
1:4:4,0,-1,106488,93512
6:2:4,1,1,106487,93513
6:3:5,0,-1,106488,93512
4:1:4,0,-1,106489,93511
6:4:5,0,-1,106490,93510
6:6:1,0,-1,106491,93509
4:6:4,0,-1,106492,93508
5:5:6,0,-1,106493,93507
3:5:6,0,-1,106494,93506
6:3:5,0,-1,106495,93505
5:1:6,0,-1,106496,93504
6:2:6,1,1,106495,93505
1:1:5,0,-1,106496,93504
5:3:2,1,1,106495,93505
1:1:4,0,-1,106496,93504
4:5:5,0,-1,106497,93503
1:2:1,1,1,106496,93504
2:3:6,1,1,106495,93505
5:4:5,0,-1,106496,93504
6:4:4,0,-1,106497,93503
1:6:2,1,1,106496,93504
4:3:4,0,-1,106497,93503
5:2:4,1,1,106496,93504
5:3:3,0,-1,106497,93503
2:1:4,1,1,106496,93504
3:2:5,1,1,106495,93505
6:4:4,0,-1,106496,93504
6:2:1,1,1,106495,93505
1:1:4,0,-1,106496,93504
4:5:6,0,-1,106497,93503
4:6:4,0,-1,106498,93502
5:4:3,0,-1,106499,93501
1:2:2,2,2,106497,93503
6:4:6,0,-1,106498,93502
3:3:6,0,-1,106499,93501
5:6:4,0,-1,106500,93500
5:5:4,0,-1,106501,93499
3:3:2,1,1,106500,93500
6:3:2,1,1,106499,93501
1:5:6,0,-1,106500,93500
6:4:1,0,-1,106501,93499
6:5:3,0,-1,106502,93498
2:5:3,1,1,106501,93499
2:3:1,1,1,106500,93500
2:1:2,2,2,106498,93502
2:2:3,2,2,106496,93504
6:3:5,0,-1,106497,93503
2:6:4,1,1,106496,93504
6:1:6,0,-1,106497,93503
6:1:6,0,-1,106498,93502
1:5:2,1,1,106497,93503
3:6:4,0,-1,106498,93502
3:5:6,0,-1,106499,93501
2:5:5,1,1,106498,93502
6:3:6,0,-1,106499,93501
6:1:5,0,-1,106500,93500
2:5:5,1,1,106499,93501
2:3:4,1,1,106498,93502
1:1:6,0,-1,106499,93501
2:3:1,1,1,106498,93502
6:4:2,1,1,106497,93503
1:1:3,0,-1,106498,93502
1:4:4,0,-1,106499,93501
5:2:6,1,1,106498,93502
4:3:1,0,-1,106499,93501
6:2:3,1,1,106498,93502
6:4:2,1,1,106497,93503
4:2:6,1,1,106496,93504
4:3:6,0,-1,106497,93503
4:1:1,0,-1,106498,93502
5:5:6,0,-1,106499,93501
2:1:1,1,1,106498,93502
6:5:2,1,1,106497,93503
4:2:3,1,1,106496,93504
6:2:4,1,1,106495,93505
3:4:2,1,1,106494,93506
2:6:1,1,1,106493,93507
4:4:2,1,1,106492,93508
5:6:2,1,1,106491,93509
1:4:2,1,1,106490,93510
4:4:5,0,-1,106491,93509
2:5:5,1,1,106490,93510
1:3:2,1,1,106489,93511
5:5:6,0,-1,106490,93510
1:6:6,0,-1,106491,93509
2:5:4,1,1,106490,93510
3:6:6,0,-1,106491,93509
6:5:6,0,-1,106492,93508
4:6:2,1,1,106491,93509
3:6:1,0,-1,106492,93508
6:4:6,0,-1,106493,93507
3:2:3,1,1,106492,93508
4:1:2,1,1,106491,93509
6:4:5,0,-1,106492,93508
6:3:3,0,-1,106493,93507
1:6:2,1,1,106492,93508
1:1:5,0,-1,106493,93507
4:5:6,0,-1,106494,93506
1:5:4,0,-1,106495,93505
6:1:3,0,-1,106496,93504
4:3:2,1,1,106495,93505
4:6:1,0,-1,106496,93504
5:5:2,1,1,106495,93505
5:4:3,0,-1,106496,93504
5:4:4,0,-1,106497,93503
1:1:4,0,-1,106498,93502
6:4:4,0,-1,106499,93501
3:4:4,0,-1,106500,93500
2:4:6,1,1,106499,93501
5:3:3,0,-1,106500,93500
2:4:4,1,1,106499,93501
1:3:6,0,-1,106500,93500
6:3:2,1,1,106499,93501
1:1:1,0,-1,106500,93500
6:2:3,1,1,106499,93501
6:2:2,2,2,106497,93503
4:1:6,0,-1,106498,93502
4:1:5,0,-1,106499,93501
4:3:2,1,1,106498,93502
3:6:3,0,-1,106499,93501
2:4:5,1,1,106498,93502
2:4:3,1,1,106497,93503
4:1:3,0,-1,106498,93502
5:6:4,0,-1,106499,93501
6:6:2,1,1,106498,93502
5:6:2,1,1,106497,93503
1:3:2,1,1,106496,93504
4:6:3,0,-1,106497,93503
1:1:2,1,1,106496,93504
2:3:1,1,1,106495,93505
5:3:2,1,1,106494,93506
4:3:5,0,-1,106495,93505
3:2:2,2,2,106493,93507
1:2:2,2,2,106491,93509
4:6:1,0,-1,106492,93508
5:3:3,0,-1,106493,93507
6:3:6,0,-1,106494,93506
5:1:6,0,-1,106495,93505
4:3:1,0,-1,106496,93504
1:2:3,1,1,106495,93505
1:6:4,0,-1,106496,93504
3:6:6,0,-1,106497,93503
1:1:5,0,-1,106498,93502
6:2:1,1,1,106497,93503
4:6:6,0,-1,106498,93502
1:2:1,1,1,106497,93503
4:2:3,1,1,106496,93504
2:4:4,1,1,106495,93505
5:4:4,0,-1,106496,93504
2:5:1,1,1,106495,93505
4:5:4,0,-1,106496,93504
2:5:5,1,1,106495,93505
2:3:1,1,1,106494,93506
2:2:6,2,2,106492,93508
6:5:4,0,-1,106493,93507
3:1:6,0,-1,106494,93506
6:6:6,0,-1,106495,93505
4:2:2,2,2,106493,93507
6:6:2,1,1,106492,93508
3:6:4,0,-1,106493,93507
1:1:3,0,-1,106494,93506
6:4:2,1,1,106493,93507
2:1:5,1,1,106492,93508
1:1:6,0,-1,106493,93507
1:5:4,0,-1,106494,93506
5:4:1,0,-1,106495,93505
5:4:1,0,-1,106496,93504
6:5:5,0,-1,106497,93503
2:6:1,1,1,106496,93504
2:6:6,1,1,106495,93505
2:2:5,2,2,106493,93507
3:1:5,0,-1,106494,93506
4:6:3,0,-1,106495,93505
6:3:2,1,1,106494,93506
5:1:1,0,-1,106495,93505
4:2:6,1,1,106494,93506
1:3:1,0,-1,106495,93505
4:3:6,0,-1,106496,93504
4:4:3,0,-1,106497,93503
1:3:6,0,-1,106498,93502
5:6:3,0,-1,106499,93501
5:3:5,0,-1,106500,93500
3:1:3,0,-1,106501,93499
3:2:6,1,1,106500,93500
1:5:2,1,1,106499,93501
5:2:1,1,1,106498,93502
4:3:4,0,-1,106499,93501
5:1:6,0,-1,106500,93500
6:5:1,0,-1,106501,93499
6:3:1,0,-1,106502,93498
6:5:3,0,-1,106503,93497
5:1:2,1,1,106502,93498
5:6:5,0,-1,106503,93497
5:5:3,0,-1,106504,93496
3:4:3,0,-1,106505,93495
6:5:3,0,-1,106506,93494
1:4:1,0,-1,106507,93493
4:3:1,0,-1,106508,93492
4:2:5,1,1,106507,93493
4:2:2,2,2,106505,93495
1:6:3,0,-1,106506,93494
2:5:6,1,1,106505,93495
2:1:2,2,2,106503,93497
4:4:3,0,-1,106504,93496
5:3:3,0,-1,106505,93495
4:4:4,0,-1,106506,93494
6:5:4,0,-1,106507,93493
3:1:4,0,-1,106508,93492
1:6:4,0,-1,106509,93491
4:6:1,0,-1,106510,93490
5:1:5,0,-1,106511,93489
5:4:5,0,-1,106512,93488
6:1:1,0,-1,106513,93487
4:4:5,0,-1,106514,93486
3:3:1,0,-1,106515,93485
2:6:4,1,1,106514,93486
6:6:2,1,1,106513,93487
1:5:4,0,-1,106514,93486
6:1:2,1,1,106513,93487
2:2:6,2,2,106511,93489
1:2:2,2,2,106509,93491
6:1:2,1,1,106508,93492
1:6:5,0,-1,106509,93491
5:4:5,0,-1,106510,93490
4:1:5,0,-1,106511,93489
4:3:6,0,-1,106512,93488
6:5:4,0,-1,106513,93487
1:3:6,0,-1,106514,93486
6:2:3,1,1,106513,93487
1:3:1,0,-1,106514,93486
5:2:5,1,1,106513,93487
5:4:4,0,-1,106514,93486
6:4:1,0,-1,106515,93485
6:2:4,1,1,106514,93486
4:2:5,1,1,106513,93487
4:1:4,0,-1,106514,93486
4:4:1,0,-1,106515,93485
1:6:5,0,-1,106516,93484
5:5:5,0,-1,106517,93483
5:3:2,1,1,106516,93484
2:5:5,1,1,106515,93485
4:5:2,1,1,106514,93486
2:2:1,2,2,106512,93488
4:3:5,0,-1,106513,93487
6:5:3,0,-1,106514,93486
3:5:6,0,-1,106515,93485
3:3:1,0,-1,106516,93484
3:1:1,0,-1,106517,93483
5:2:4,1,1,106516,93484
1:5:6,0,-1,106517,93483
2:5:5,1,1,106516,93484
3:5:3,0,-1,106517,93483
2:2:3,2,2,106515,93485
2:4:3,1,1,106514,93486
4:1:5,0,-1,106515,93485
4:6:1,0,-1,106516,93484
4:4:2,1,1,106515,93485
2:2:2,3,3,106512,93488
4:6:4,0,-1,106513,93487
4:3:3,0,-1,106514,93486
5:6:2,1,1,106513,93487
1:5:1,0,-1,106514,93486
6:1:6,0,-1,106515,93485
4:4:2,1,1,106514,93486
1:1:2,1,1,106513,93487
3:1:3,0,-1,106514,93486
5:1:1,0,-1,106515,93485
5:3:2,1,1,106514,93486
5:3:6,0,-1,106515,93485
1:2:1,1,1,106514,93486
5:4:4,0,-1,106515,93485
4:1:5,0,-1,106516,93484
2:3:1,1,1,106515,93485
1:5:6,0,-1,106516,93484
5:6:3,0,-1,106517,93483
6:5:4,0,-1,106518,93482
2:6:4,1,1,106517,93483
5:4:3,0,-1,106518,93482
6:5:2,1,1,106517,93483
3:5:3,0,-1,106518,93482
1:5:6,0,-1,106519,93481
5:6:1,0,-1,106520,93480
3:4:4,0,-1,106521,93479
3:4:3,0,-1,106522,93478
6:5:5,0,-1,106523,93477
4:3:6,0,-1,106524,93476
5:4:6,0,-1,106525,93475
1:2:1,1,1,106524,93476
3:2:1,1,1,106523,93477
6:2:3,1,1,106522,93478
5:5:1,0,-1,106523,93477
3:1:1,0,-1,106524,93476
6:4:5,0,-1,106525,93475
4:6:1,0,-1,106526,93474
2:2:4,2,2,106524,93476
2:6:6,1,1,106523,93477
6:3:5,0,-1,106524,93476
4:1:4,0,-1,106525,93475
2:1:2,2,2,106523,93477
3:6:1,0,-1,106524,93476
3:2:2,2,2,106522,93478
2:2:1,2,2,106520,93480
6:4:2,1,1,106519,93481
2:6:6,1,1,106518,93482
3:4:4,0,-1,106519,93481
4:5:1,0,-1,106520,93480
6:3:6,0,-1,106521,93479
2:2:1,2,2,106519,93481
6:2:3,1,1,106518,93482
3:1:6,0,-1,106519,93481
1:2:3,1,1,106518,93482
1:2:2,2,2,106516,93484
1:2:2,2,2,106514,93486
6:3:1,0,-1,106515,93485
1:3:4,0,-1,106516,93484
4:3:6,0,-1,106517,93483
6:1:2,1,1,106516,93484
5:2:4,1,1,106515,93485
2:4:4,1,1,106514,93486
6:4:3,0,-1,106515,93485
3:1:5,0,-1,106516,93484
6:5:5,0,-1,106517,93483
2:5:2,2,2,106515,93485
5:3:3,0,-1,106516,93484
4:3:4,0,-1,106517,93483
3:2:3,1,1,106516,93484
4:5:2,1,1,106515,93485
4:1:5,0,-1,106516,93484
5:2:4,1,1,106515,93485
4:3:2,1,1,106514,93486
6:4:4,0,-1,106515,93485
4:3:2,1,1,106514,93486
1:3:4,0,-1,106515,93485
2:1:2,2,2,106513,93487
6:1:3,0,-1,106514,93486
1:4:2,1,1,106513,93487
2:6:5,1,1,106512,93488
1:3:1,0,-1,106513,93487
3:2:3,1,1,106512,93488
4:6:6,0,-1,106513,93487
6:4:5,0,-1,106514,93486
6:1:3,0,-1,106515,93485
6:1:6,0,-1,106516,93484
1:5:3,0,-1,106517,93483
3:2:3,1,1,106516,93484
6:5:6,0,-1,106517,93483
4:5:1,0,-1,106518,93482
3:2:2,2,2,106516,93484
3:2:3,1,1,106515,93485
2:6:6,1,1,106514,93486
5:5:6,0,-1,106515,93485
5:3:4,0,-1,106516,93484
3:6:1,0,-1,106517,93483
4:2:2,2,2,106515,93485
1:5:1,0,-1,106516,93484
5:6:2,1,1,106515,93485
6:5:2,1,1,106514,93486
1:4:4,0,-1,106515,93485
3:5:3,0,-1,106516,93484
5:2:6,1,1,106515,93485
3:3:2,1,1,106514,93486
1:3:5,0,-1,106515,93485
4:5:4,0,-1,106516,93484
5:6:3,0,-1,106517,93483
3:5:5,0,-1,106518,93482
5:4:2,1,1,106517,93483
6:6:6,0,-1,106518,93482
4:6:2,1,1,106517,93483
3:5:2,1,1,106516,93484
6:4:5,0,-1,106517,93483
5:1:3,0,-1,106518,93482
6:2:4,1,1,106517,93483
5:4:2,1,1,106516,93484
5:3:1,0,-1,106517,93483
6:4:5,0,-1,106518,93482
6:2:1,1,1,106517,93483
4:2:6,1,1,106516,93484
1:6:1,0,-1,106517,93483
5:6:3,0,-1,106518,93482
4:3:2,1,1,106517,93483
4:2:5,1,1,106516,93484
4:4:3,0,-1,106517,93483
4:4:5,0,-1,106518,93482
3:4:2,1,1,106517,93483
2:2:3,2,2,106515,93485
2:6:1,1,1,106514,93486
1:6:5,0,-1,106515,93485
5:3:4,0,-1,106516,93484
4:4:4,0,-1,106517,93483
3:2:3,1,1,106516,93484
6:1:4,0,-1,106517,93483
2:4:4,1,1,106516,93484
2:4:5,1,1,106515,93485
3:4:5,0,-1,106516,93484
1:4:2,1,1,106515,93485
6:4:1,0,-1,106516,93484
2:5:1,1,1,106515,93485
4:2:3,1,1,106514,93486
1:3:1,0,-1,106515,93485
4:6:4,0,-1,106516,93484
3:6:6,0,-1,106517,93483
2:6:5,1,1,106516,93484
2:2:2,3,3,106513,93487
6:3:4,0,-1,106514,93486
2:6:4,1,1,106513,93487
4:2:2,2,2,106511,93489
5:5:1,0,-1,106512,93488
4:2:4,1,1,106511,93489
1:4:2,1,1,106510,93490
4:1:4,0,-1,106511,93489
5:4:6,0,-1,106512,93488
5:6:3,0,-1,106513,93487
5:6:5,0,-1,106514,93486
4:2:5,1,1,106513,93487
4:6:6,0,-1,106514,93486
6:5:6,0,-1,106515,93485
2:4:2,2,2,106513,93487
2:1:4,1,1,106512,93488
1:3:4,0,-1,106513,93487
6:2:4,1,1,106512,93488
1:1:3,0,-1,106513,93487
1:4:1,0,-1,106514,93486
1:2:3,1,1,106513,93487
6:1:4,0,-1,106514,93486
2:4:2,2,2,106512,93488
3:2:6,1,1,106511,93489
3:1:2,1,1,106510,93490
3:5:3,0,-1,106511,93489
6:3:1,0,-1,106512,93488
4:5:2,1,1,106511,93489
4:4:5,0,-1,106512,93488
1:1:5,0,-1,106513,93487
1:2:5,1,1,106512,93488
4:4:6,0,-1,106513,93487
1:3:1,0,-1,106514,93486
5:6:2,1,1,106513,93487
6:1:6,0,-1,106514,93486
3:5:1,0,-1,106515,93485
6:3:6,0,-1,106516,93484
6:4:4,0,-1,106517,93483
1:6:6,0,-1,106518,93482
2:3:1,1,1,106517,93483
2:2:5,2,2,106515,93485
1:4:5,0,-1,106516,93484
6:1:3,0,-1,106517,93483
3:1:1,0,-1,106518,93482
5:5:6,0,-1,106519,93481
2:1:1,1,1,106518,93482
3:3:2,1,1,106517,93483
6:2:2,2,2,106515,93485
6:4:6,0,-1,106516,93484
5:2:1,1,1,106515,93485
5:6:2,1,1,106514,93486
4:4:3,0,-1,106515,93485
5:4:5,0,-1,106516,93484
1:6:4,0,-1,106517,93483
3:6:5,0,-1,106518,93482
4:1:3,0,-1,106519,93481
2:3:3,1,1,106518,93482
3:6:3,0,-1,106519,93481
6:4:4,0,-1,106520,93480
6:4:1,0,-1,106521,93479
6:5:5,0,-1,106522,93478
6:5:2,1,1,106521,93479
6:6:5,0,-1,106522,93478
2:4:1,1,1,106521,93479
3:6:2,1,1,106520,93480
2:4:6,1,1,106519,93481
6:3:3,0,-1,106520,93480
3:2:6,1,1,106519,93481
5:2:6,1,1,106518,93482
5:6:3,0,-1,106519,93481
4:1:5,0,-1,106520,93480
6:5:3,0,-1,106521,93479
1:3:1,0,-1,106522,93478
1:5:4,0,-1,106523,93477
1:3:1,0,-1,106524,93476
4:4:5,0,-1,106525,93475
5:5:1,0,-1,106526,93474
4:1:2,1,1,106525,93475
5:5:4,0,-1,106526,93474
1:3:4,0,-1,106527,93473
6:4:1,0,-1,106528,93472
3:4:1,0,-1,106529,93471
4:1:3,0,-1,106530,93470
6:2:3,1,1,106529,93471
5:2:5,1,1,106528,93472
2:5:3,1,1,106527,93473
3:6:2,1,1,106526,93474
4:2:2,2,2,106524,93476
2:2:5,2,2,106522,93478
1:3:4,0,-1,106523,93477
2:6:6,1,1,106522,93478
4:2:6,1,1,106521,93479
3:5:5,0,-1,106522,93478
5:5:1,0,-1,106523,93477
6:3:2,1,1,106522,93478
1:1:2,1,1,106521,93479
3:6:5,0,-1,106522,93478
3:6:6,0,-1,106523,93477
6:2:3,1,1,106522,93478
1:4:5,0,-1,106523,93477
4:4:3,0,-1,106524,93476
4:6:6,0,-1,106525,93475
1:3:5,0,-1,106526,93474
4:1:6,0,-1,106527,93473
4:4:4,0,-1,106528,93472
3:1:3,0,-1,106529,93471
3:4:6,0,-1,106530,93470
3:1:6,0,-1,106531,93469
1:5:4,0,-1,106532,93468
1:2:4,1,1,106531,93469
4:6:2,1,1,106530,93470
5:6:3,0,-1,106531,93469
4:1:3,0,-1,106532,93468
1:6:5,0,-1,106533,93467
3:3:3,0,-1,106534,93466
4:2:4,1,1,106533,93467
3:2:2,2,2,106531,93469
1:2:1,1,1,106530,93470
2:1:1,1,1,106529,93471
1:1:2,1,1,106528,93472
3:6:6,0,-1,106529,93471
3:3:6,0,-1,106530,93470
2:5:4,1,1,106529,93471
4:3:2,1,1,106528,93472
2:5:4,1,1,106527,93473
2:6:6,1,1,106526,93474
2:6:6,1,1,106525,93475
4:6:3,0,-1,106526,93474
4:3:2,1,1,106525,93475
3:3:4,0,-1,106526,93474
5:1:4,0,-1,106527,93473
3:6:2,1,1,106526,93474
4:6:2,1,1,106525,93475
5:5:2,1,1,106524,93476
1:1:6,0,-1,106525,93475
2:1:6,1,1,106524,93476
1:6:6,0,-1,106525,93475
1:2:5,1,1,106524,93476
1:6:3,0,-1,106525,93475
2:3:5,1,1,106524,93476
4:1:6,0,-1,106525,93475
3:1:3,0,-1,106526,93474
6:1:3,0,-1,106527,93473
5:5:2,1,1,106526,93474
1:4:2,1,1,106525,93475
1:6:6,0,-1,106526,93474
4:1:5,0,-1,106527,93473
1:3:6,0,-1,106528,93472
5:5:5,0,-1,106529,93471
5:4:1,0,-1,106530,93470
5:3:6,0,-1,106531,93469
6:4:6,0,-1,106532,93468
1:6:4,0,-1,106533,93467
1:3:1,0,-1,106534,93466
2:2:3,2,2,106532,93468
4:6:2,1,1,106531,93469
6:1:2,1,1,106530,93470
3:5:3,0,-1,106531,93469
6:5:2,1,1,106530,93470
4:4:4,0,-1,106531,93469
2:5:5,1,1,106530,93470
6:4:4,0,-1,106531,93469
5:6:4,0,-1,106532,93468
1:1:3,0,-1,106533,93467
1:5:6,0,-1,106534,93466
3:6:4,0,-1,106535,93465
1:2:5,1,1,106534,93466
5:6:2,1,1,106533,93467
6:6:6,0,-1,106534,93466
1:3:3,0,-1,106535,93465
5:3:4,0,-1,106536,93464
3:2:3,1,1,106535,93465
2:1:5,1,1,106534,93466
2:2:4,2,2,106532,93468
4:2:4,1,1,106531,93469
3:1:5,0,-1,106532,93468
5:3:6,0,-1,106533,93467
4:4:1,0,-1,106534,93466
1:6:6,0,-1,106535,93465
6:1:5,0,-1,106536,93464
4:4:2,1,1,106535,93465
4:2:4,1,1,106534,93466
3:3:3,0,-1,106535,93465
4:3:6,0,-1,106536,93464
2:3:3,1,1,106535,93465
2:3:1,1,1,106534,93466
2:2:5,2,2,106532,93468
6:2:5,1,1,106531,93469
3:6:4,0,-1,106532,93468
3:2:5,1,1,106531,93469
5:6:3,0,-1,106532,93468
1:1:2,1,1,106531,93469
4:4:1,0,-1,106532,93468
6:2:6,1,1,106531,93469
4:2:3,1,1,106530,93470
1:2:3,1,1,106529,93471
4:2:1,1,1,106528,93472
2:3:2,2,2,106526,93474
3:2:3,1,1,106525,93475
3:4:1,0,-1,106526,93474
5:6:4,0,-1,106527,93473
1:4:1,0,-1,106528,93472
1:4:5,0,-1,106529,93471
4:3:2,1,1,106528,93472
2:4:2,2,2,106526,93474
2:4:3,1,1,106525,93475
3:2:3,1,1,106524,93476
3:2:2,2,2,106522,93478
4:4:6,0,-1,106523,93477
2:3:2,2,2,106521,93479
1:3:2,1,1,106520,93480
5:1:6,0,-1,106521,93479
5:5:5,0,-1,106522,93478
1:1:6,0,-1,106523,93477
6:1:6,0,-1,106524,93476
2:6:4,1,1,106523,93477
6:3:5,0,-1,106524,93476
5:3:1,0,-1,106525,93475
2:2:3,2,2,106523,93477
1:6:3,0,-1,106524,93476
3:6:5,0,-1,106525,93475
1:2:4,1,1,106524,93476
1:3:1,0,-1,106525,93475
1:3:3,0,-1,106526,93474
4:5:4,0,-1,106527,93473
5:2:3,1,1,106526,93474
5:5:1,0,-1,106527,93473
1:3:6,0,-1,106528,93472
1:3:2,1,1,106527,93473
2:4:6,1,1,106526,93474
3:6:2,1,1,106525,93475
6:4:3,0,-1,106526,93474
3:2:3,1,1,106525,93475
2:6:5,1,1,106524,93476
2:6:6,1,1,106523,93477
4:3:1,0,-1,106524,93476
3:4:4,0,-1,106525,93475
1:5:6,0,-1,106526,93474
4:4:1,0,-1,106527,93473
3:6:6,0,-1,106528,93472
4:2:3,1,1,106527,93473
3:6:5,0,-1,106528,93472
2:1:4,1,1,106527,93473
5:5:2,1,1,106526,93474
5:5:4,0,-1,106527,93473
3:2:5,1,1,106526,93474
2:2:1,2,2,106524,93476
6:5:5,0,-1,106525,93475
2:5:3,1,1,106524,93476
3:5:2,1,1,106523,93477
1:2:6,1,1,106522,93478
1:3:2,1,1,106521,93479
5:3:5,0,-1,106522,93478
1:3:6,0,-1,106523,93477
2:3:2,2,2,106521,93479
3:4:6,0,-1,106522,93478
5:3:5,0,-1,106523,93477
4:3:6,0,-1,106524,93476
6:5:5,0,-1,106525,93475
5:1:5,0,-1,106526,93474
6:3:5,0,-1,106527,93473
1:4:4,0,-1,106528,93472
2:2:6,2,2,106526,93474
5:5:2,1,1,106525,93475
1:3:2,1,1,106524,93476
3:5:6,0,-1,106525,93475
6:4:2,1,1,106524,93476
1:4:3,0,-1,106525,93475
6:2:2,2,2,106523,93477
6:2:1,1,1,106522,93478
4:5:5,0,-1,106523,93477
3:1:4,0,-1,106524,93476
4:5:1,0,-1,106525,93475
6:2:5,1,1,106524,93476
5:4:4,0,-1,106525,93475
4:1:3,0,-1,106526,93474
5:1:5,0,-1,106527,93473
5:4:1,0,-1,106528,93472
5:6:1,0,-1,106529,93471
2:6:5,1,1,106528,93472
2:4:6,1,1,106527,93473
4:5:1,0,-1,106528,93472
1:4:2,1,1,106527,93473
6:1:3,0,-1,106528,93472
1:6:4,0,-1,106529,93471
5:1:3,0,-1,106530,93470
4:2:4,1,1,106529,93471
4:5:4,0,-1,106530,93470
4:4:2,1,1,106529,93471
6:5:2,1,1,106528,93472
3:6:6,0,-1,106529,93471
5:6:1,0,-1,106530,93470
1:6:2,1,1,106529,93471
2:5:4,1,1,106528,93472
5:3:6,0,-1,106529,93471
6:5:6,0,-1,106530,93470
3:4:3,0,-1,106531,93469
6:4:1,0,-1,106532,93468
2:3:5,1,1,106531,93469
4:6:1,0,-1,106532,93468
5:2:2,2,2,106530,93470
2:6:5,1,1,106529,93471
3:4:3,0,-1,106530,93470
3:6:4,0,-1,106531,93469
2:6:3,1,1,106530,93470
4:5:4,0,-1,106531,93469
6:6:4,0,-1,106532,93468
3:6:6,0,-1,106533,93467
6:6:1,0,-1,106534,93466
2:3:1,1,1,106533,93467
5:2:6,1,1,106532,93468
3:1:5,0,-1,106533,93467
4:3:4,0,-1,106534,93466
5:5:2,1,1,106533,93467
1:1:5,0,-1,106534,93466
4:4:3,0,-1,106535,93465
1:3:6,0,-1,106536,93464
3:3:5,0,-1,106537,93463
6:4:6,0,-1,106538,93462
5:1:6,0,-1,106539,93461
3:4:5,0,-1,106540,93460
6:6:3,0,-1,106541,93459
1:3:1,0,-1,106542,93458
6:4:6,0,-1,106543,93457
1:4:1,0,-1,106544,93456
2:3:3,1,1,106543,93457
3:2:3,1,1,106542,93458
3:3:1,0,-1,106543,93457
6:6:1,0,-1,106544,93456
3:6:3,0,-1,106545,93455
6:2:5,1,1,106544,93456
6:3:4,0,-1,106545,93455
3:5:1,0,-1,106546,93454
6:1:2,1,1,106545,93455
6:5:1,0,-1,106546,93454
2:6:1,1,1,106545,93455
1:2:1,1,1,106544,93456
1:1:3,0,-1,106545,93455
3:2:3,1,1,106544,93456
5:4:3,0,-1,106545,93455
4:6:6,0,-1,106546,93454
4:2:6,1,1,106545,93455
1:6:2,1,1,106544,93456
1:2:4,1,1,106543,93457
6:1:3,0,-1,106544,93456
4:2:3,1,1,106543,93457
1:2:6,1,1,106542,93458
6:5:6,0,-1,106543,93457
6:3:6,0,-1,106544,93456
2:2:1,2,2,106542,93458
4:1:1,0,-1,106543,93457
5:5:4,0,-1,106544,93456
2:3:5,1,1,106543,93457
5:5:3,0,-1,106544,93456
3:2:2,2,2,106542,93458
6:4:3,0,-1,106543,93457
2:3:6,1,1,106542,93458
6:3:5,0,-1,106543,93457
1:5:4,0,-1,106544,93456
5:6:2,1,1,106543,93457
2:5:5,1,1,106542,93458
6:1:2,1,1,106541,93459
4:1:6,0,-1,106542,93458
1:4:4,0,-1,106543,93457
4:4:2,1,1,106542,93458
4:1:1,0,-1,106543,93457
2:1:3,1,1,106542,93458
5:1:1,0,-1,106543,93457
4:5:4,0,-1,106544,93456
3:4:6,0,-1,106545,93455
1:5:1,0,-1,106546,93454
2:1:6,1,1,106545,93455
5:4:4,0,-1,106546,93454
6:4:1,0,-1,106547,93453
5:4:4,0,-1,106548,93452
3:4:1,0,-1,106549,93451
1:1:4,0,-1,106550,93450
6:5:5,0,-1,106551,93449
3:5:6,0,-1,106552,93448
3:2:4,1,1,106551,93449
4:4:4,0,-1,106552,93448
2:1:1,1,1,106551,93449
6:3:5,0,-1,106552,93448
3:5:6,0,-1,106553,93447
3:5:4,0,-1,106554,93446
1:5:5,0,-1,106555,93445
4:6:2,1,1,106554,93446
1:4:5,0,-1,106555,93445
5:2:6,1,1,106554,93446
4:1:2,1,1,106553,93447
3:1:4,0,-1,106554,93446
6:4:4,0,-1,106555,93445
4:3:4,0,-1,106556,93444
1:1:4,0,-1,106557,93443
3:6:1,0,-1,106558,93442
4:2:5,1,1,106557,93443
1:5:6,0,-1,106558,93442
4:2:6,1,1,106557,93443
1:5:3,0,-1,106558,93442
5:4:3,0,-1,106559,93441
6:5:4,0,-1,106560,93440
3:2:1,1,1,106559,93441
4:5:2,1,1,106558,93442
3:1:6,0,-1,106559,93441
2:6:3,1,1,106558,93442
4:6:1,0,-1,106559,93441
1:3:2,1,1,106558,93442
5:1:6,0,-1,106559,93441
1:2:5,1,1,106558,93442
4:2:4,1,1,106557,93443
1:3:3,0,-1,106558,93442
5:5:6,0,-1,106559,93441
2:5:2,2,2,106557,93443
4:1:1,0,-1,106558,93442
1:2:2,2,2,106556,93444
2:5:3,1,1,106555,93445
2:5:2,2,2,106553,93447
6:6:2,1,1,106552,93448
2:4:4,1,1,106551,93449
4:3:2,1,1,106550,93450
4:5:1,0,-1,106551,93449
4:1:1,0,-1,106552,93448
6:4:3,0,-1,106553,93447
4:1:3,0,-1,106554,93446
2:5:6,1,1,106553,93447
4:2:2,2,2,106551,93449
6:4:4,0,-1,106552,93448
4:2:3,1,1,106551,93449
3:6:2,1,1,106550,93450
4:3:1,0,-1,106551,93449
3:6:6,0,-1,106552,93448
3:2:1,1,1,106551,93449
4:1:5,0,-1,106552,93448
2:4:3,1,1,106551,93449
1:4:6,0,-1,106552,93448
4:6:5,0,-1,106553,93447
5:1:6,0,-1,106554,93446
1:2:3,1,1,106553,93447
5:6:5,0,-1,106554,93446
1:1:3,0,-1,106555,93445
2:1:4,1,1,106554,93446
4:6:6,0,-1,106555,93445
3:2:2,2,2,106553,93447
3:5:5,0,-1,106554,93446
3:6:1,0,-1,106555,93445
3:6:6,0,-1,106556,93444
1:4:5,0,-1,106557,93443
4:1:3,0,-1,106558,93442
5:5:3,0,-1,106559,93441
1:2:2,2,2,106557,93443
2:2:5,2,2,106555,93445
3:5:2,1,1,106554,93446
4:4:5,0,-1,106555,93445
1:5:4,0,-1,106556,93444
3:6:3,0,-1,106557,93443
5:6:1,0,-1,106558,93442
6:5:4,0,-1,106559,93441
6:1:5,0,-1,106560,93440
6:4:3,0,-1,106561,93439
4:4:3,0,-1,106562,93438
1:2:4,1,1,106561,93439
3:1:6,0,-1,106562,93438
3:4:4,0,-1,106563,93437
3:6:2,1,1,106562,93438
3:3:5,0,-1,106563,93437
6:2:5,1,1,106562,93438
2:2:3,2,2,106560,93440
2:1:4,1,1,106559,93441
5:2:2,2,2,106557,93443
6:6:4,0,-1,106558,93442
4:3:2,1,1,106557,93443
6:6:5,0,-1,106558,93442
4:3:6,0,-1,106559,93441
6:4:1,0,-1,106560,93440
5:3:1,0,-1,106561,93439
5:4:6,0,-1,106562,93438
4:3:2,1,1,106561,93439
3:5:6,0,-1,106562,93438
6:6:6,0,-1,106563,93437
6:1:4,0,-1,106564,93436
4:5:5,0,-1,106565,93435
6:5:4,0,-1,106566,93434
3:1:3,0,-1,106567,93433
6:3:2,1,1,106566,93434
3:3:5,0,-1,106567,93433
3:4:5,0,-1,106568,93432
3:3:1,0,-1,106569,93431
1:4:4,0,-1,106570,93430
5:4:5,0,-1,106571,93429
1:1:4,0,-1,106572,93428
5:2:4,1,1,106571,93429
1:2:4,1,1,106570,93430
2:4:4,1,1,106569,93431
6:2:2,2,2,106567,93433
3:3:3,0,-1,106568,93432
4:5:5,0,-1,106569,93431
2:4:5,1,1,106568,93432
6:4:6,0,-1,106569,93431
5:2:3,1,1,106568,93432
6:4:3,0,-1,106569,93431
5:2:4,1,1,106568,93432
2:6:3,1,1,106567,93433
4:4:5,0,-1,106568,93432
5:4:6,0,-1,106569,93431
5:2:5,1,1,106568,93432
3:1:2,1,1,106567,93433
4:6:5,0,-1,106568,93432
5:3:5,0,-1,106569,93431
4:6:2,1,1,106568,93432
1:4:5,0,-1,106569,93431
5:5:2,1,1,106568,93432
2:2:3,2,2,106566,93434
1:2:3,1,1,106565,93435
1:5:6,0,-1,106566,93434
2:6:3,1,1,106565,93435
1:3:1,0,-1,106566,93434
3:5:2,1,1,106565,93435
4:4:6,0,-1,106566,93434
1:2:4,1,1,106565,93435
4:4:5,0,-1,106566,93434
1:3:1,0,-1,106567,93433
1:5:6,0,-1,106568,93432
5:3:1,0,-1,106569,93431
4:2:6,1,1,106568,93432
6:6:5,0,-1,106569,93431
3:3:6,0,-1,106570,93430
4:5:4,0,-1,106571,93429
1:5:1,0,-1,106572,93428
3:6:1,0,-1,106573,93427
3:4:5,0,-1,106574,93426
2:2:2,3,3,106571,93429
3:5:4,0,-1,106572,93428
2:6:2,2,2,106570,93430
2:4:4,1,1,106569,93431
4:1:6,0,-1,106570,93430
4:1:6,0,-1,106571,93429
5:6:6,0,-1,106572,93428
4:5:5,0,-1,106573,93427
3:1:2,1,1,106572,93428
6:5:4,0,-1,106573,93427
5:1:2,1,1,106572,93428
2:6:1,1,1,106571,93429
6:1:5,0,-1,106572,93428
5:6:2,1,1,106571,93429
1:2:3,1,1,106570,93430
6:5:2,1,1,106569,93431
3:4:3,0,-1,106570,93430
1:6:1,0,-1,106571,93429
3:4:3,0,-1,106572,93428
5:1:2,1,1,106571,93429
6:6:4,0,-1,106572,93428
3:4:5,0,-1,106573,93427
5:1:2,1,1,106572,93428
4:5:2,1,1,106571,93429
4:6:1,0,-1,106572,93428
3:6:3,0,-1,106573,93427
2:3:1,1,1,106572,93428
1:5:1,0,-1,106573,93427
4:2:2,2,2,106571,93429
3:6:6,0,-1,106572,93428
3:3:6,0,-1,106573,93427
5:6:2,1,1,106572,93428
6:3:1,0,-1,106573,93427
4:6:5,0,-1,106574,93426
5:4:2,1,1,106573,93427
4:1:2,1,1,106572,93428
6:3:3,0,-1,106573,93427
6:3:6,0,-1,106574,93426
1:4:2,1,1,106573,93427
5:4:3,0,-1,106574,93426
5:4:1,0,-1,106575,93425
5:4:5,0,-1,106576,93424
5:1:3,0,-1,106577,93423
2:6:1,1,1,106576,93424
3:6:5,0,-1,106577,93423
3:1:3,0,-1,106578,93422
4:2:5,1,1,106577,93423
2:3:4,1,1,106576,93424
2:4:5,1,1,106575,93425
1:1:4,0,-1,106576,93424
2:1:4,1,1,106575,93425
1:2:1,1,1,106574,93426
1:5:2,1,1,106573,93427
2:5:3,1,1,106572,93428
3:1:3,0,-1,106573,93427
2:2:5,2,2,106571,93429
4:6:1,0,-1,106572,93428
1:6:5,0,-1,106573,93427
2:2:6,2,2,106571,93429
1:1:3,0,-1,106572,93428
2:1:6,1,1,106571,93429
2:2:5,2,2,106569,93431
4:3:6,0,-1,106570,93430
4:1:4,0,-1,106571,93429
1:4:2,1,1,106570,93430
3:5:4,0,-1,106571,93429
2:3:5,1,1,106570,93430
3:6:1,0,-1,106571,93429
2:2:1,2,2,106569,93431
3:5:1,0,-1,106570,93430
1:4:6,0,-1,106571,93429
6:2:6,1,1,106570,93430
4:5:6,0,-1,106571,93429
4:5:5,0,-1,106572,93428
5:4:4,0,-1,106573,93427
2:4:4,1,1,106572,93428
5:2:3,1,1,106571,93429
4:1:3,0,-1,106572,93428
4:1:2,1,1,106571,93429
2:6:4,1,1,106570,93430
6:5:4,0,-1,106571,93429
4:2:3,1,1,106570,93430
3:4:3,0,-1,106571,93429
3:2:6,1,1,106570,93430
4:3:4,0,-1,106571,93429
3:5:6,0,-1,106572,93428
3:1:3,0,-1,106573,93427
6:3:4,0,-1,106574,93426
4:4:4,0,-1,106575,93425
3:1:3,0,-1,106576,93424
5:5:6,0,-1,106577,93423
1:2:6,1,1,106576,93424
4:5:4,0,-1,106577,93423
3:1:2,1,1,106576,93424
3:6:5,0,-1,106577,93423
5:4:4,0,-1,106578,93422
3:1:3,0,-1,106579,93421
3:1:1,0,-1,106580,93420
5:6:3,0,-1,106581,93419
2:4:2,2,2,106579,93421
2:3:3,1,1,106578,93422
1:5:4,0,-1,106579,93421
1:5:6,0,-1,106580,93420
6:1:2,1,1,106579,93421
6:1:2,1,1,106578,93422
3:2:3,1,1,106577,93423
2:2:4,2,2,106575,93425
6:5:5,0,-1,106576,93424
2:3:3,1,1,106575,93425
2:6:4,1,1,106574,93426
6:2:6,1,1,106573,93427
3:3:2,1,1,106572,93428
4:6:3,0,-1,106573,93427
5:6:6,0,-1,106574,93426
1:1:6,0,-1,106575,93425
1:6:3,0,-1,106576,93424
6:5:4,0,-1,106577,93423
1:4:4,0,-1,106578,93422
2:1:1,1,1,106577,93423
3:5:5,0,-1,106578,93422
3:2:6,1,1,106577,93423
5:3:5,0,-1,106578,93422
5:1:4,0,-1,106579,93421
3:3:6,0,-1,106580,93420
1:5:1,0,-1,106581,93419
6:1:6,0,-1,106582,93418
2:1:5,1,1,106581,93419
1:3:4,0,-1,106582,93418
5:6:6,0,-1,106583,93417
4:5:4,0,-1,106584,93416
5:2:5,1,1,106583,93417
5:2:4,1,1,106582,93418
1:1:4,0,-1,106583,93417
4:3:5,0,-1,106584,93416
3:3:5,0,-1,106585,93415
3:2:4,1,1,106584,93416
1:3:5,0,-1,106585,93415
6:1:5,0,-1,106586,93414
1:5:1,0,-1,106587,93413
6:2:3,1,1,106586,93414
6:1:2,1,1,106585,93415
2:6:6,1,1,106584,93416
4:4:5,0,-1,106585,93415
5:4:6,0,-1,106586,93414
2:5:4,1,1,106585,93415
5:2:6,1,1,106584,93416
2:5:6,1,1,106583,93417
2:4:1,1,1,106582,93418
1:5:3,0,-1,106583,93417
2:2:4,2,2,106581,93419
2:4:1,1,1,106580,93420
5:1:1,0,-1,106581,93419
5:6:5,0,-1,106582,93418
4:1:4,0,-1,106583,93417
5:4:3,0,-1,106584,93416
3:5:3,0,-1,106585,93415
2:5:1,1,1,106584,93416
4:3:2,1,1,106583,93417
3:4:2,1,1,106582,93418
1:5:6,0,-1,106583,93417
5:6:2,1,1,106582,93418
3:5:5,0,-1,106583,93417
3:5:6,0,-1,106584,93416
1:2:5,1,1,106583,93417
3:2:1,1,1,106582,93418
6:5:1,0,-1,106583,93417
2:5:2,2,2,106581,93419
3:1:4,0,-1,106582,93418
3:3:5,0,-1,106583,93417
5:5:3,0,-1,106584,93416
5:5:2,1,1,106583,93417
5:2:6,1,1,106582,93418
6:1:6,0,-1,106583,93417
4:2:6,1,1,106582,93418
5:1:6,0,-1,106583,93417
4:5:5,0,-1,106584,93416
4:5:3,0,-1,106585,93415
2:4:2,2,2,106583,93417
1:4:3,0,-1,106584,93416
5:4:6,0,-1,106585,93415
5:1:4,0,-1,106586,93414
1:1:1,0,-1,106587,93413
1:3:1,0,-1,106588,93412
4:6:2,1,1,106587,93413
4:6:1,0,-1,106588,93412
5:5:2,1,1,106587,93413
5:2:4,1,1,106586,93414
4:6:3,0,-1,106587,93413
6:5:3,0,-1,106588,93412
4:6:5,0,-1,106589,93411
6:6:2,1,1,106588,93412
5:5:2,1,1,106587,93413
5:1:4,0,-1,106588,93412
1:6:6,0,-1,106589,93411
1:2:1,1,1,106588,93412
1:3:2,1,1,106587,93413
6:4:3,0,-1,106588,93412
3:3:2,1,1,106587,93413
3:5:6,0,-1,106588,93412
4:3:6,0,-1,106589,93411
2:4:3,1,1,106588,93412
1:3:5,0,-1,106589,93411
2:5:3,1,1,106588,93412
6:5:5,0,-1,106589,93411
2:5:5,1,1,106588,93412
4:5:6,0,-1,106589,93411
1:2:6,1,1,106588,93412
1:3:5,0,-1,106589,93411
2:1:2,2,2,106587,93413
5:1:2,1,1,106586,93414
1:2:4,1,1,106585,93415
3:5:2,1,1,106584,93416
6:5:4,0,-1,106585,93415
3:1:2,1,1,106584,93416
3:4:1,0,-1,106585,93415
4:1:5,0,-1,106586,93414
3:4:4,0,-1,106587,93413
3:2:4,1,1,106586,93414
2:6:2,2,2,106584,93416
2:2:6,2,2,106582,93418
3:4:3,0,-1,106583,93417
1:1:2,1,1,106582,93418
1:4:3,0,-1,106583,93417
2:6:2,2,2,106581,93419
4:2:6,1,1,106580,93420
4:1:3,0,-1,106581,93419
2:6:1,1,1,106580,93420
1:4:4,0,-1,106581,93419
4:3:6,0,-1,106582,93418
2:6:6,1,1,106581,93419
3:3:2,1,1,106580,93420
2:5:6,1,1,106579,93421
2:2:6,2,2,106577,93423
2:5:3,1,1,106576,93424
1:1:6,0,-1,106577,93423
6:6:4,0,-1,106578,93422
3:4:6,0,-1,106579,93421
6:1:3,0,-1,106580,93420
6:2:3,1,1,106579,93421
4:1:6,0,-1,106580,93420
2:2:6,2,2,106578,93422
6:2:1,1,1,106577,93423
1:6:1,0,-1,106578,93422
6:4:6,0,-1,106579,93421
5:3:1,0,-1,106580,93420
6:2:5,1,1,106579,93421
1:5:6,0,-1,106580,93420
6:1:6,0,-1,106581,93419
2:2:4,2,2,106579,93421
3:2:1,1,1,106578,93422
3:6:5,0,-1,106579,93421
3:3:3,0,-1,106580,93420
1:2:5,1,1,106579,93421
5:1:6,0,-1,106580,93420
1:2:1,1,1,106579,93421
2:1:3,1,1,106578,93422
5:1:3,0,-1,106579,93421
2:1:1,1,1,106578,93422
1:2:4,1,1,106577,93423
4:1:3,0,-1,106578,93422
3:2:4,1,1,106577,93423
4:4:1,0,-1,106578,93422
6:4:3,0,-1,106579,93421
6:2:5,1,1,106578,93422
6:6:2,1,1,106577,93423
6:3:5,0,-1,106578,93422
6:1:4,0,-1,106579,93421
4:2:4,1,1,106578,93422
6:6:1,0,-1,106579,93421
2:1:1,1,1,106578,93422
1:6:1,0,-1,106579,93421
2:5:2,2,2,106577,93423
6:2:5,1,1,106576,93424
5:2:4,1,1,106575,93425
6:4:4,0,-1,106576,93424
3:4:1,0,-1,106577,93423
1:1:1,0,-1,106578,93422
6:3:1,0,-1,106579,93421
2:5:1,1,1,106578,93422
4:5:6,0,-1,106579,93421
2:3:6,1,1,106578,93422
3:1:4,0,-1,106579,93421
5:2:2,2,2,106577,93423
1:3:3,0,-1,106578,93422
2:1:5,1,1,106577,93423
2:2:5,2,2,106575,93425
3:4:2,1,1,106574,93426
1:6:5,0,-1,106575,93425
2:2:1,2,2,106573,93427
4:2:5,1,1,106572,93428
4:2:4,1,1,106571,93429
3:3:4,0,-1,106572,93428
2:3:6,1,1,106571,93429
6:1:4,0,-1,106572,93428
3:5:6,0,-1,106573,93427
1:2:2,2,2,106571,93429
4:1:2,1,1,106570,93430
6:4:2,1,1,106569,93431
6:1:4,0,-1,106570,93430
3:4:5,0,-1,106571,93429
1:2:6,1,1,106570,93430
5:6:3,0,-1,106571,93429
1:5:4,0,-1,106572,93428
1:3:2,1,1,106571,93429
1:4:5,0,-1,106572,93428
6:5:4,0,-1,106573,93427
5:6:1,0,-1,106574,93426
2:5:2,2,2,106572,93428
5:3:4,0,-1,106573,93427
6:3:5,0,-1,106574,93426
3:5:1,0,-1,106575,93425
5:1:5,0,-1,106576,93424
1:2:3,1,1,106575,93425
6:6:4,0,-1,106576,93424
1:3:6,0,-1,106577,93423
1:4:5,0,-1,106578,93422
6:6:3,0,-1,106579,93421
2:3:6,1,1,106578,93422
5:1:2,1,1,106577,93423
1:5:3,0,-1,106578,93422
4:4:2,1,1,106577,93423
4:4:3,0,-1,106578,93422
4:6:3,0,-1,106579,93421
5:2:1,1,1,106578,93422
6:5:5,0,-1,106579,93421
5:4:6,0,-1,106580,93420
6:3:4,0,-1,106581,93419
3:1:2,1,1,106580,93420
3:5:5,0,-1,106581,93419
5:3:4,0,-1,106582,93418
3:1:5,0,-1,106583,93417
4:3:4,0,-1,106584,93416
4:1:5,0,-1,106585,93415
2:2:5,2,2,106583,93417
4:4:6,0,-1,106584,93416
3:4:3,0,-1,106585,93415
6:5:1,0,-1,106586,93414
3:2:5,1,1,106585,93415
1:1:6,0,-1,106586,93414
1:6:5,0,-1,106587,93413
1:2:1,1,1,106586,93414
6:4:5,0,-1,106587,93413
4:5:4,0,-1,106588,93412
1:2:4,1,1,106587,93413
4:2:4,1,1,106586,93414
5:6:5,0,-1,106587,93413
4:3:4,0,-1,106588,93412
3:3:3,0,-1,106589,93411
5:4:6,0,-1,106590,93410
5:2:4,1,1,106589,93411
6:2:4,1,1,106588,93412
6:3:2,1,1,106587,93413
5:3:4,0,-1,106588,93412
2:6:2,2,2,106586,93414
6:2:2,2,2,106584,93416
1:1:4,0,-1,106585,93415
6:4:6,0,-1,106586,93414
5:1:4,0,-1,106587,93413
2:1:4,1,1,106586,93414
2:5:6,1,1,106585,93415
2:4:5,1,1,106584,93416
5:1:5,0,-1,106585,93415
1:2:5,1,1,106584,93416
3:6:6,0,-1,106585,93415
1:4:4,0,-1,106586,93414
5:5:6,0,-1,106587,93413
2:2:1,2,2,106585,93415
2:2:2,3,3,106582,93418
6:5:6,0,-1,106583,93417
5:6:4,0,-1,106584,93416
4:3:4,0,-1,106585,93415
3:2:4,1,1,106584,93416
3:6:5,0,-1,106585,93415
4:1:1,0,-1,106586,93414
5:2:4,1,1,106585,93415
6:6:4,0,-1,106586,93414
6:3:6,0,-1,106587,93413
1:1:2,1,1,106586,93414
6:1:1,0,-1,106587,93413
2:1:5,1,1,106586,93414
5:2:2,2,2,106584,93416
6:4:2,1,1,106583,93417
6:3:3,0,-1,106584,93416
2:2:6,2,2,106582,93418
1:2:1,1,1,106581,93419
3:4:5,0,-1,106582,93418
5:2:1,1,1,106581,93419
2:3:4,1,1,106580,93420
4:6:5,0,-1,106581,93419
1:4:6,0,-1,106582,93418
4:1:1,0,-1,106583,93417
6:6:2,1,1,106582,93418
1:1:6,0,-1,106583,93417
6:6:1,0,-1,106584,93416
4:4:5,0,-1,106585,93415
3:3:4,0,-1,106586,93414
4:3:1,0,-1,106587,93413
2:6:6,1,1,106586,93414
6:1:6,0,-1,106587,93413
2:1:2,2,2,106585,93415
6:2:4,1,1,106584,93416
6:1:6,0,-1,106585,93415
5:5:1,0,-1,106586,93414
6:1:1,0,-1,106587,93413
6:4:4,0,-1,106588,93412
3:1:4,0,-1,106589,93411
1:2:3,1,1,106588,93412
4:4:3,0,-1,106589,93411
5:2:5,1,1,106588,93412
4:3:6,0,-1,106589,93411
6:4:2,1,1,106588,93412
4:3:3,0,-1,106589,93411
4:5:4,0,-1,106590,93410
5:2:5,1,1,106589,93411
2:1:2,2,2,106587,93413
2:2:2,3,3,106584,93416
6:4:2,1,1,106583,93417
4:6:3,0,-1,106584,93416
2:6:2,2,2,106582,93418
1:2:3,1,1,106581,93419
4:1:2,1,1,106580,93420
3:6:2,1,1,106579,93421
6:5:1,0,-1,106580,93420
4:5:5,0,-1,106581,93419
1:3:1,0,-1,106582,93418
3:1:4,0,-1,106583,93417
5:5:2,1,1,106582,93418
5:4:6,0,-1,106583,93417
3:1:4,0,-1,106584,93416
6:3:5,0,-1,106585,93415
3:2:5,1,1,106584,93416
3:3:4,0,-1,106585,93415
3:6:4,0,-1,106586,93414
5:1:2,1,1,106585,93415
1:2:1,1,1,106584,93416
1:5:4,0,-1,106585,93415
6:4:5,0,-1,106586,93414
2:1:5,1,1,106585,93415
6:2:5,1,1,106584,93416
5:5:5,0,-1,106585,93415
3:3:3,0,-1,106586,93414
6:1:6,0,-1,106587,93413
5:2:5,1,1,106586,93414
5:6:5,0,-1,106587,93413
1:2:2,2,2,106585,93415
4:4:1,0,-1,106586,93414
5:5:5,0,-1,106587,93413
3:2:3,1,1,106586,93414
3:3:4,0,-1,106587,93413
1:4:4,0,-1,106588,93412
6:5:4,0,-1,106589,93411
5:1:6,0,-1,106590,93410
2:3:3,1,1,106589,93411
4:2:3,1,1,106588,93412
5:1:6,0,-1,106589,93411
3:3:2,1,1,106588,93412
4:4:3,0,-1,106589,93411
3:5:2,1,1,106588,93412
3:5:3,0,-1,106589,93411
4:6:3,0,-1,106590,93410
5:1:1,0,-1,106591,93409
2:2:6,2,2,106589,93411
5:1:4,0,-1,106590,93410
5:1:2,1,1,106589,93411
5:3:1,0,-1,106590,93410
5:4:2,1,1,106589,93411
2:4:2,2,2,106587,93413
3:3:4,0,-1,106588,93412
5:6:5,0,-1,106589,93411
4:4:3,0,-1,106590,93410
2:6:5,1,1,106589,93411
1:1:4,0,-1,106590,93410
6:2:1,1,1,106589,93411
3:2:3,1,1,106588,93412
4:4:6,0,-1,106589,93411
5:3:6,0,-1,106590,93410
5:1:2,1,1,106589,93411
1:1:1,0,-1,106590,93410
3:4:4,0,-1,106591,93409
2:4:4,1,1,106590,93410
3:1:6,0,-1,106591,93409
1:5:5,0,-1,106592,93408
6:5:6,0,-1,106593,93407
5:2:2,2,2,106591,93409
4:6:6,0,-1,106592,93408
5:2:4,1,1,106591,93409
6:5:5,0,-1,106592,93408
6:6:6,0,-1,106593,93407
3:3:5,0,-1,106594,93406
2:4:5,1,1,106593,93407
5:1:2,1,1,106592,93408
6:4:6,0,-1,106593,93407
2:6:3,1,1,106592,93408
5:4:5,0,-1,106593,93407
6:3:1,0,-1,106594,93406
6:6:2,1,1,106593,93407
4:3:1,0,-1,106594,93406
6:1:4,0,-1,106595,93405
6:2:5,1,1,106594,93406
1:6:1,0,-1,106595,93405
6:1:2,1,1,106594,93406
6:2:1,1,1,106593,93407
1:4:6,0,-1,106594,93406
2:4:6,1,1,106593,93407
1:1:6,0,-1,106594,93406
1:3:3,0,-1,106595,93405
6:4:4,0,-1,106596,93404
4:4:2,1,1,106595,93405
4:5:4,0,-1,106596,93404
3:3:5,0,-1,106597,93403
2:5:3,1,1,106596,93404
3:1:6,0,-1,106597,93403
2:4:1,1,1,106596,93404
3:3:5,0,-1,106597,93403
6:3:3,0,-1,106598,93402
2:5:4,1,1,106597,93403
6:5:2,1,1,106596,93404
2:5:3,1,1,106595,93405
6:3:1,0,-1,106596,93404
1:5:3,0,-1,106597,93403
6:2:5,1,1,106596,93404
4:4:5,0,-1,106597,93403
1:5:2,1,1,106596,93404
3:1:2,1,1,106595,93405
1:3:6,0,-1,106596,93404
3:3:1,0,-1,106597,93403
5:1:4,0,-1,106598,93402
3:3:3,0,-1,106599,93401
4:4:1,0,-1,106600,93400
2:5:3,1,1,106599,93401
5:4:2,1,1,106598,93402
3:2:4,1,1,106597,93403
3:5:4,0,-1,106598,93402
6:1:6,0,-1,106599,93401
5:1:6,0,-1,106600,93400
2:1:2,2,2,106598,93402
5:4:1,0,-1,106599,93401
6:6:4,0,-1,106600,93400
6:2:4,1,1,106599,93401
2:6:4,1,1,106598,93402
4:1:2,1,1,106597,93403
1:3:2,1,1,106596,93404
2:6:5,1,1,106595,93405
5:3:1,0,-1,106596,93404
6:6:2,1,1,106595,93405
4:1:1,0,-1,106596,93404
3:1:1,0,-1,106597,93403
3:6:6,0,-1,106598,93402
1:4:4,0,-1,106599,93401
2:3:2,2,2,106597,93403
4:3:5,0,-1,106598,93402
2:3:3,1,1,106597,93403
4:1:3,0,-1,106598,93402
6:1:5,0,-1,106599,93401
4:6:6,0,-1,106600,93400
5:4:4,0,-1,106601,93399
2:4:5,1,1,106600,93400
3:5:6,0,-1,106601,93399
2:5:5,1,1,106600,93400
5:3:4,0,-1,106601,93399
2:5:5,1,1,106600,93400
1:5:3,0,-1,106601,93399
5:1:5,0,-1,106602,93398
5:1:1,0,-1,106603,93397
1:6:4,0,-1,106604,93396
3:1:2,1,1,106603,93397
6:2:5,1,1,106602,93398
6:1:2,1,1,106601,93399
2:3:6,1,1,106600,93400
1:1:1,0,-1,106601,93399
2:4:1,1,1,106600,93400
6:1:1,0,-1,106601,93399
5:3:2,1,1,106600,93400
2:1:3,1,1,106599,93401
3:3:4,0,-1,106600,93400
3:1:5,0,-1,106601,93399
2:2:1,2,2,106599,93401
2:6:2,2,2,106597,93403
4:5:6,0,-1,106598,93402
4:1:1,0,-1,106599,93401
1:3:3,0,-1,106600,93400
2:4:3,1,1,106599,93401
3:6:1,0,-1,106600,93400
6:1:4,0,-1,106601,93399
6:1:5,0,-1,106602,93398
3:1:3,0,-1,106603,93397
6:4:2,1,1,106602,93398
2:3:6,1,1,106601,93399
1:3:3,0,-1,106602,93398
5:2:6,1,1,106601,93399
1:6:5,0,-1,106602,93398
6:1:5,0,-1,106603,93397
2:5:4,1,1,106602,93398
1:6:2,1,1,106601,93399
1:6:5,0,-1,106602,93398
2:5:5,1,1,106601,93399
6:4:1,0,-1,106602,93398
3:2:5,1,1,106601,93399
4:6:3,0,-1,106602,93398
4:1:6,0,-1,106603,93397
5:5:5,0,-1,106604,93396
5:4:3,0,-1,106605,93395
4:2:6,1,1,106604,93396
1:4:4,0,-1,106605,93395
4:3:4,0,-1,106606,93394
6:1:6,0,-1,106607,93393
5:3:6,0,-1,106608,93392
1:6:5,0,-1,106609,93391
2:6:1,1,1,106608,93392
4:1:2,1,1,106607,93393
4:5:2,1,1,106606,93394
2:2:6,2,2,106604,93396
3:3:5,0,-1,106605,93395
5:1:1,0,-1,106606,93394
1:2:5,1,1,106605,93395
1:5:1,0,-1,106606,93394
2:4:5,1,1,106605,93395
5:3:2,1,1,106604,93396
5:1:5,0,-1,106605,93395
1:4:1,0,-1,106606,93394
1:4:6,0,-1,106607,93393
6:2:1,1,1,106606,93394
1:3:2,1,1,106605,93395
6:4:2,1,1,106604,93396
5:5:5,0,-1,106605,93395
5:6:6,0,-1,106606,93394
2:6:1,1,1,106605,93395
4:2:4,1,1,106604,93396
6:5:4,0,-1,106605,93395
6:3:4,0,-1,106606,93394
6:2:2,2,2,106604,93396
3:4:5,0,-1,106605,93395
1:6:1,0,-1,106606,93394
5:5:4,0,-1,106607,93393
2:3:1,1,1,106606,93394
4:1:6,0,-1,106607,93393
6:1:2,1,1,106606,93394
6:6:6,0,-1,106607,93393
1:3:1,0,-1,106608,93392
6:4:5,0,-1,106609,93391
5:1:5,0,-1,106610,93390
3:1:4,0,-1,106611,93389
6:2:3,1,1,106610,93390
5:6:1,0,-1,106611,93389
5:5:4,0,-1,106612,93388
1:3:5,0,-1,106613,93387
2:1:2,2,2,106611,93389
4:4:4,0,-1,106612,93388
4:4:1,0,-1,106613,93387
6:6:2,1,1,106612,93388
1:1:4,0,-1,106613,93387
1:4:5,0,-1,106614,93386
3:4:2,1,1,106613,93387
3:4:5,0,-1,106614,93386
5:6:5,0,-1,106615,93385
4:3:1,0,-1,106616,93384
6:4:1,0,-1,106617,93383
2:5:3,1,1,106616,93384
3:6:3,0,-1,106617,93383
5:1:3,0,-1,106618,93382
6:2:3,1,1,106617,93383
6:2:5,1,1,106616,93384
2:1:1,1,1,106615,93385
4:2:6,1,1,106614,93386
4:2:1,1,1,106613,93387
6:4:2,1,1,106612,93388
5:6:1,0,-1,106613,93387
1:4:4,0,-1,106614,93386
5:1:1,0,-1,106615,93385
4:1:1,0,-1,106616,93384
4:4:5,0,-1,106617,93383
3:3:1,0,-1,106618,93382
6:4:1,0,-1,106619,93381
1:3:1,0,-1,106620,93380
2:4:6,1,1,106619,93381
6:2:1,1,1,106618,93382
5:1:1,0,-1,106619,93381
4:2:1,1,1,106618,93382
6:3:4,0,-1,106619,93381
3:6:4,0,-1,106620,93380
3:2:6,1,1,106619,93381
3:3:3,0,-1,106620,93380
4:6:4,0,-1,106621,93379
1:6:6,0,-1,106622,93378
4:6:1,0,-1,106623,93377
5:1:2,1,1,106622,93378
6:3:5,0,-1,106623,93377
5:3:1,0,-1,106624,93376
6:4:4,0,-1,106625,93375
5:1:1,0,-1,106626,93374
3:2:6,1,1,106625,93375
3:6:2,1,1,106624,93376
4:2:1,1,1,106623,93377
2:4:4,1,1,106622,93378
4:6:3,0,-1,106623,93377
1:3:1,0,-1,106624,93376
1:4:3,0,-1,106625,93375
3:3:1,0,-1,106626,93374
1:4:1,0,-1,106627,93373
2:3:5,1,1,106626,93374
2:6:5,1,1,106625,93375
1:6:1,0,-1,106626,93374
3:6:3,0,-1,106627,93373
3:6:2,1,1,106626,93374
5:2:1,1,1,106625,93375
3:2:6,1,1,106624,93376
4:4:2,1,1,106623,93377
5:5:3,0,-1,106624,93376
4:6:4,0,-1,106625,93375
3:3:3,0,-1,106626,93374
1:5:4,0,-1,106627,93373
3:6:4,0,-1,106628,93372
6:3:4,0,-1,106629,93371
4:6:5,0,-1,106630,93370
3:1:1,0,-1,106631,93369
1:5:6,0,-1,106632,93368
4:5:4,0,-1,106633,93367
6:2:2,2,2,106631,93369
1:6:5,0,-1,106632,93368
2:1:1,1,1,106631,93369
4:2:5,1,1,106630,93370
2:1:4,1,1,106629,93371
3:4:1,0,-1,106630,93370
3:1:6,0,-1,106631,93369
1:2:6,1,1,106630,93370
4:1:4,0,-1,106631,93369
6:6:3,0,-1,106632,93368
6:1:1,0,-1,106633,93367
1:4:3,0,-1,106634,93366
6:6:5,0,-1,106635,93365
3:4:4,0,-1,106636,93364
5:4:4,0,-1,106637,93363
2:6:5,1,1,106636,93364
5:6:2,1,1,106635,93365
6:3:4,0,-1,106636,93364
5:3:5,0,-1,106637,93363
1:3:1,0,-1,106638,93362
6:3:1,0,-1,106639,93361
3:3:3,0,-1,106640,93360
4:3:1,0,-1,106641,93359
4:3:2,1,1,106640,93360
1:4:3,0,-1,106641,93359
5:3:2,1,1,106640,93360
5:5:2,1,1,106639,93361
3:2:4,1,1,106638,93362
4:5:3,0,-1,106639,93361
4:3:5,0,-1,106640,93360
3:1:3,0,-1,106641,93359
1:4:6,0,-1,106642,93358
4:6:4,0,-1,106643,93357
2:5:3,1,1,106642,93358
1:5:4,0,-1,106643,93357
2:1:5,1,1,106642,93358
2:1:5,1,1,106641,93359
3:1:3,0,-1,106642,93358
6:5:5,0,-1,106643,93357
5:3:3,0,-1,106644,93356
4:2:3,1,1,106643,93357
5:3:2,1,1,106642,93358
5:5:1,0,-1,106643,93357
1:4:2,1,1,106642,93358
4:5:1,0,-1,106643,93357
3:6:6,0,-1,106644,93356
4:3:1,0,-1,106645,93355
6:3:3,0,-1,106646,93354
4:3:6,0,-1,106647,93353
4:6:1,0,-1,106648,93352
4:2:2,2,2,106646,93354
4:4:6,0,-1,106647,93353
5:5:5,0,-1,106648,93352
6:1:1,0,-1,106649,93351
2:3:6,1,1,106648,93352
5:3:6,0,-1,106649,93351
5:1:3,0,-1,106650,93350
4:1:4,0,-1,106651,93349
5:5:3,0,-1,106652,93348
1:5:1,0,-1,106653,93347
6:5:1,0,-1,106654,93346
5:2:5,1,1,106653,93347
4:4:3,0,-1,106654,93346
4:3:4,0,-1,106655,93345
4:5:6,0,-1,106656,93344
6:4:3,0,-1,106657,93343
5:3:3,0,-1,106658,93342
2:4:2,2,2,106656,93344
6:1:6,0,-1,106657,93343
5:5:1,0,-1,106658,93342
3:6:2,1,1,106657,93343
2:6:3,1,1,106656,93344
4:3:5,0,-1,106657,93343
2:6:1,1,1,106656,93344
3:4:1,0,-1,106657,93343
5:4:2,1,1,106656,93344
4:6:4,0,-1,106657,93343
4:6:5,0,-1,106658,93342
3:3:4,0,-1,106659,93341
6:1:6,0,-1,106660,93340
4:3:5,0,-1,106661,93339
6:5:2,1,1,106660,93340
4:2:6,1,1,106659,93341
4:3:1,0,-1,106660,93340
3:1:5,0,-1,106661,93339
5:6:4,0,-1,106662,93338
5:6:4,0,-1,106663,93337
5:5:3,0,-1,106664,93336
3:5:5,0,-1,106665,93335
3:6:3,0,-1,106666,93334
6:2:4,1,1,106665,93335
2:2:3,2,2,106663,93337
4:5:6,0,-1,106664,93336
3:4:5,0,-1,106665,93335
5:5:1,0,-1,106666,93334
5:5:4,0,-1,106667,93333
1:5:5,0,-1,106668,93332
3:2:2,2,2,106666,93334
6:3:4,0,-1,106667,93333
4:1:3,0,-1,106668,93332
4:1:6,0,-1,106669,93331
6:2:5,1,1,106668,93332
1:2:2,2,2,106666,93334
1:1:1,0,-1,106667,93333
6:1:5,0,-1,106668,93332
4:2:5,1,1,106667,93333
1:2:5,1,1,106666,93334
6:3:2,1,1,106665,93335
3:6:1,0,-1,106666,93334
6:5:2,1,1,106665,93335
3:1:2,1,1,106664,93336
1:4:3,0,-1,106665,93335
3:4:3,0,-1,106666,93334
5:3:1,0,-1,106667,93333
3:2:5,1,1,106666,93334
1:2:3,1,1,106665,93335
6:1:6,0,-1,106666,93334
4:5:3,0,-1,106667,93333
6:4:4,0,-1,106668,93332
1:2:2,2,2,106666,93334
6:4:6,0,-1,106667,93333
2:4:6,1,1,106666,93334
6:4:1,0,-1,106667,93333
3:1:4,0,-1,106668,93332
2:1:4,1,1,106667,93333
3:4:4,0,-1,106668,93332
2:2:2,3,3,106665,93335
2:5:1,1,1,106664,93336
5:1:1,0,-1,106665,93335
1:3:5,0,-1,106666,93334
1:6:6,0,-1,106667,93333
3:6:6,0,-1,106668,93332
3:4:4,0,-1,106669,93331
6:5:4,0,-1,106670,93330
4:6:3,0,-1,106671,93329
4:1:2,1,1,106670,93330
3:4:2,1,1,106669,93331
5:5:1,0,-1,106670,93330
4:5:6,0,-1,106671,93329
3:5:4,0,-1,106672,93328
6:1:6,0,-1,106673,93327
5:5:2,1,1,106672,93328
1:4:6,0,-1,106673,93327
3:6:5,0,-1,106674,93326
4:3:4,0,-1,106675,93325
2:1:4,1,1,106674,93326
5:5:6,0,-1,106675,93325
2:2:2,3,3,106672,93328
4:6:1,0,-1,106673,93327
3:5:6,0,-1,106674,93326
4:3:4,0,-1,106675,93325
2:2:2,3,3,106672,93328
6:2:1,1,1,106671,93329
1:6:5,0,-1,106672,93328
1:6:3,0,-1,106673,93327
3:3:4,0,-1,106674,93326
1:2:2,2,2,106672,93328
3:1:3,0,-1,106673,93327
3:1:5,0,-1,106674,93326
5:4:3,0,-1,106675,93325
3:6:2,1,1,106674,93326
1:5:3,0,-1,106675,93325
3:4:2,1,1,106674,93326
5:5:4,0,-1,106675,93325
5:3:4,0,-1,106676,93324
2:5:5,1,1,106675,93325
6:4:4,0,-1,106676,93324
4:3:1,0,-1,106677,93323
4:5:3,0,-1,106678,93322
2:3:2,2,2,106676,93324
5:1:3,0,-1,106677,93323
2:5:5,1,1,106676,93324
3:2:5,1,1,106675,93325
1:6:2,1,1,106674,93326
6:5:2,1,1,106673,93327
1:1:1,0,-1,106674,93326
4:6:6,0,-1,106675,93325
1:2:2,2,2,106673,93327
6:5:3,0,-1,106674,93326
6:5:5,0,-1,106675,93325
4:3:6,0,-1,106676,93324
3:2:5,1,1,106675,93325
3:6:4,0,-1,106676,93324
5:1:2,1,1,106675,93325
3:4:4,0,-1,106676,93324
1:4:5,0,-1,106677,93323
3:5:2,1,1,106676,93324
2:1:2,2,2,106674,93326
1:1:3,0,-1,106675,93325
5:1:5,0,-1,106676,93324
4:5:5,0,-1,106677,93323
2:3:5,1,1,106676,93324
5:4:5,0,-1,106677,93323
4:4:2,1,1,106676,93324
2:4:3,1,1,106675,93325
6:2:2,2,2,106673,93327
6:1:4,0,-1,106674,93326
3:5:1,0,-1,106675,93325
3:2:5,1,1,106674,93326
3:3:5,0,-1,106675,93325
5:6:1,0,-1,106676,93324
5:4:4,0,-1,106677,93323
1:3:3,0,-1,106678,93322
5:4:6,0,-1,106679,93321
3:6:4,0,-1,106680,93320
2:2:4,2,2,106678,93322
6:1:2,1,1,106677,93323
3:3:2,1,1,106676,93324
4:2:5,1,1,106675,93325
5:6:3,0,-1,106676,93324
2:6:4,1,1,106675,93325
2:1:3,1,1,106674,93326
2:2:2,3,3,106671,93329
6:3:3,0,-1,106672,93328
5:2:4,1,1,106671,93329
4:4:6,0,-1,106672,93328
5:6:3,0,-1,106673,93327
6:1:4,0,-1,106674,93326
3:2:1,1,1,106673,93327
3:3:3,0,-1,106674,93326
4:3:3,0,-1,106675,93325
5:4:5,0,-1,106676,93324
6:4:3,0,-1,106677,93323
4:1:6,0,-1,106678,93322
2:5:6,1,1,106677,93323
6:3:2,1,1,106676,93324
5:5:3,0,-1,106677,93323
6:3:2,1,1,106676,93324
4:3:3,0,-1,106677,93323
1:1:4,0,-1,106678,93322
6:5:6,0,-1,106679,93321
3:4:4,0,-1,106680,93320
4:1:4,0,-1,106681,93319
3:3:4,0,-1,106682,93318
6:5:1,0,-1,106683,93317
1:1:3,0,-1,106684,93316
1:1:2,1,1,106683,93317
2:1:1,1,1,106682,93318
5:2:5,1,1,106681,93319
6:6:3,0,-1,106682,93318
5:3:6,0,-1,106683,93317
2:3:2,2,2,106681,93319
3:1:4,0,-1,106682,93318
3:5:5,0,-1,106683,93317
2:2:6,2,2,106681,93319
3:5:3,0,-1,106682,93318
5:3:1,0,-1,106683,93317
4:4:4,0,-1,106684,93316
3:6:1,0,-1,106685,93315
6:2:1,1,1,106684,93316
2:5:1,1,1,106683,93317
4:4:5,0,-1,106684,93316
2:4:2,2,2,106682,93318
5:6:1,0,-1,106683,93317
4:3:2,1,1,106682,93318
3:1:5,0,-1,106683,93317
2:2:5,2,2,106681,93319
4:2:5,1,1,106680,93320
5:6:2,1,1,106679,93321
5:4:6,0,-1,106680,93320
6:3:4,0,-1,106681,93319
5:5:1,0,-1,106682,93318
5:6:6,0,-1,106683,93317
5:2:1,1,1,106682,93318
2:3:3,1,1,106681,93319
3:2:5,1,1,106680,93320
3:5:2,1,1,106679,93321
1:3:3,0,-1,106680,93320
2:6:1,1,1,106679,93321
4:1:4,0,-1,106680,93320
4:4:3,0,-1,106681,93319
2:1:6,1,1,106680,93320
1:2:3,1,1,106679,93321
4:1:2,1,1,106678,93322
3:4:4,0,-1,106679,93321
1:1:6,0,-1,106680,93320
1:1:3,0,-1,106681,93319
5:6:3,0,-1,106682,93318
2:1:5,1,1,106681,93319
2:3:5,1,1,106680,93320
6:4:6,0,-1,106681,93319
6:6:1,0,-1,106682,93318
4:2:3,1,1,106681,93319
5:5:2,1,1,106680,93320
2:6:5,1,1,106679,93321
5:6:6,0,-1,106680,93320
1:4:2,1,1,106679,93321
1:6:1,0,-1,106680,93320
3:2:6,1,1,106679,93321
4:1:3,0,-1,106680,93320
4:6:6,0,-1,106681,93319
1:3:4,0,-1,106682,93318
4:5:2,1,1,106681,93319
2:6:1,1,1,106680,93320
4:3:1,0,-1,106681,93319
6:4:6,0,-1,106682,93318
2:6:5,1,1,106681,93319
2:5:6,1,1,106680,93320
5:4:6,0,-1,106681,93319
1:4:3,0,-1,106682,93318
2:3:2,2,2,106680,93320
1:6:3,0,-1,106681,93319
4:2:4,1,1,106680,93320
3:4:2,1,1,106679,93321
4:4:4,0,-1,106680,93320
3:2:4,1,1,106679,93321
4:6:6,0,-1,106680,93320
2:3:3,1,1,106679,93321
5:2:2,2,2,106677,93323
4:6:1,0,-1,106678,93322
2:5:2,2,2,106676,93324
4:1:1,0,-1,106677,93323
4:5:3,0,-1,106678,93322
6:4:4,0,-1,106679,93321
4:5:5,0,-1,106680,93320
6:4:5,0,-1,106681,93319
6:4:1,0,-1,106682,93318
1:1:3,0,-1,106683,93317
5:3:3,0,-1,106684,93316
3:4:6,0,-1,106685,93315
6:4:3,0,-1,106686,93314
4:3:3,0,-1,106687,93313
1:4:4,0,-1,106688,93312
1:3:4,0,-1,106689,93311
4:2:3,1,1,106688,93312
2:3:4,1,1,106687,93313
6:3:4,0,-1,106688,93312
5:1:4,0,-1,106689,93311
3:3:6,0,-1,106690,93310
4:6:2,1,1,106689,93311
3:1:5,0,-1,106690,93310
2:3:2,2,2,106688,93312
5:1:5,0,-1,106689,93311
6:5:1,0,-1,106690,93310
3:4:5,0,-1,106691,93309
2:5:6,1,1,106690,93310
1:3:1,0,-1,106691,93309
2:4:6,1,1,106690,93310
1:6:2,1,1,106689,93311
4:5:5,0,-1,106690,93310
6:2:1,1,1,106689,93311
4:5:4,0,-1,106690,93310
6:1:2,1,1,106689,93311
3:4:6,0,-1,106690,93310
3:2:5,1,1,106689,93311
2:1:6,1,1,106688,93312
5:6:1,0,-1,106689,93311
6:6:5,0,-1,106690,93310
5:5:6,0,-1,106691,93309
6:6:6,0,-1,106692,93308
6:4:3,0,-1,106693,93307
3:2:6,1,1,106692,93308
1:5:3,0,-1,106693,93307
1:6:4,0,-1,106694,93306
1:3:3,0,-1,106695,93305
4:1:5,0,-1,106696,93304
3:1:1,0,-1,106697,93303
5:4:2,1,1,106696,93304
1:5:2,1,1,106695,93305
4:3:5,0,-1,106696,93304
2:3:6,1,1,106695,93305
2:5:6,1,1,106694,93306
3:6:3,0,-1,106695,93305
5:4:3,0,-1,106696,93304
5:5:2,1,1,106695,93305
2:6:1,1,1,106694,93306
1:1:5,0,-1,106695,93305
4:2:4,1,1,106694,93306
6:2:2,2,2,106692,93308
3:5:6,0,-1,106693,93307
1:1:4,0,-1,106694,93306
4:3:2,1,1,106693,93307
2:1:3,1,1,106692,93308
1:2:4,1,1,106691,93309
2:6:1,1,1,106690,93310
2:1:4,1,1,106689,93311
1:3:2,1,1,106688,93312
1:5:1,0,-1,106689,93311
4:1:5,0,-1,106690,93310
4:2:5,1,1,106689,93311
4:1:5,0,-1,106690,93310
6:5:2,1,1,106689,93311
3:6:1,0,-1,106690,93310
6:2:5,1,1,106689,93311
2:1:6,1,1,106688,93312
3:1:4,0,-1,106689,93311
2:3:3,1,1,106688,93312
2:4:4,1,1,106687,93313
1:4:1,0,-1,106688,93312
2:5:1,1,1,106687,93313
2:5:4,1,1,106686,93314
1:6:5,0,-1,106687,93313
4:3:1,0,-1,106688,93312
3:6:3,0,-1,106689,93311
4:2:4,1,1,106688,93312
4:3:2,1,1,106687,93313
1:6:1,0,-1,106688,93312
2:1:5,1,1,106687,93313
3:3:2,1,1,106686,93314
6:1:5,0,-1,106687,93313
3:1:6,0,-1,106688,93312
1:5:6,0,-1,106689,93311
5:1:5,0,-1,106690,93310
4:4:3,0,-1,106691,93309
3:3:3,0,-1,106692,93308
1:1:1,0,-1,106693,93307
2:5:2,2,2,106691,93309
4:6:6,0,-1,106692,93308
2:5:2,2,2,106690,93310
2:5:2,2,2,106688,93312
4:5:2,1,1,106687,93313
5:2:6,1,1,106686,93314
4:5:6,0,-1,106687,93313
4:4:3,0,-1,106688,93312
4:5:5,0,-1,106689,93311
3:6:1,0,-1,106690,93310
3:3:2,1,1,106689,93311
4:6:4,0,-1,106690,93310
6:2:3,1,1,106689,93311
6:2:6,1,1,106688,93312
2:4:5,1,1,106687,93313
3:4:4,0,-1,106688,93312
4:5:2,1,1,106687,93313
6:6:4,0,-1,106688,93312
6:3:4,0,-1,106689,93311
2:1:6,1,1,106688,93312
2:1:4,1,1,106687,93313
2:3:1,1,1,106686,93314
1:1:3,0,-1,106687,93313
6:6:3,0,-1,106688,93312
3:4:3,0,-1,106689,93311
4:6:1,0,-1,106690,93310
5:2:2,2,2,106688,93312
4:4:1,0,-1,106689,93311
2:3:1,1,1,106688,93312
3:2:4,1,1,106687,93313
5:2:2,2,2,106685,93315
1:2:1,1,1,106684,93316
1:5:6,0,-1,106685,93315
1:1:6,0,-1,106686,93314
4:2:6,1,1,106685,93315
1:1:6,0,-1,106686,93314
1:5:2,1,1,106685,93315
2:5:1,1,1,106684,93316
3:3:1,0,-1,106685,93315
4:1:4,0,-1,106686,93314
2:4:5,1,1,106685,93315
5:5:4,0,-1,106686,93314
6:3:4,0,-1,106687,93313
5:3:4,0,-1,106688,93312
3:1:3,0,-1,106689,93311
2:1:5,1,1,106688,93312
4:1:2,1,1,106687,93313
1:6:5,0,-1,106688,93312
1:2:6,1,1,106687,93313
5:6:4,0,-1,106688,93312
5:2:5,1,1,106687,93313
3:3:6,0,-1,106688,93312
2:2:6,2,2,106686,93314
5:1:6,0,-1,106687,93313
4:5:1,0,-1,106688,93312
3:6:2,1,1,106687,93313
5:5:5,0,-1,106688,93312
1:4:3,0,-1,106689,93311
1:1:2,1,1,106688,93312
1:2:1,1,1,106687,93313
6:2:1,1,1,106686,93314
3:3:1,0,-1,106687,93313
2:1:5,1,1,106686,93314
1:2:3,1,1,106685,93315
3:2:5,1,1,106684,93316
1:6:1,0,-1,106685,93315
1:4:2,1,1,106684,93316
5:5:3,0,-1,106685,93315
1:2:2,2,2,106683,93317
5:2:2,2,2,106681,93319
6:1:1,0,-1,106682,93318
4:3:2,1,1,106681,93319
6:4:4,0,-1,106682,93318
4:5:1,0,-1,106683,93317
5:2:5,1,1,106682,93318
2:4:3,1,1,106681,93319
4:6:5,0,-1,106682,93318
4:3:6,0,-1,106683,93317
4:3:6,0,-1,106684,93316
4:4:6,0,-1,106685,93315
2:4:2,2,2,106683,93317
3:1:2,1,1,106682,93318
1:6:2,1,1,106681,93319
4:2:5,1,1,106680,93320
1:1:2,1,1,106679,93321
2:5:2,2,2,106677,93323
6:2:4,1,1,106676,93324
2:4:5,1,1,106675,93325
5:5:5,0,-1,106676,93324
2:5:3,1,1,106675,93325
3:6:2,1,1,106674,93326
3:4:6,0,-1,106675,93325
1:3:1,0,-1,106676,93324
4:3:6,0,-1,106677,93323
6:1:3,0,-1,106678,93322
6:6:4,0,-1,106679,93321
4:6:4,0,-1,106680,93320
1:3:5,0,-1,106681,93319
2:4:1,1,1,106680,93320
1:1:1,0,-1,106681,93319
5:2:5,1,1,106680,93320
2:6:3,1,1,106679,93321
5:2:6,1,1,106678,93322
2:3:1,1,1,106677,93323
4:5:5,0,-1,106678,93322
1:1:6,0,-1,106679,93321
1:2:4,1,1,106678,93322
3:6:4,0,-1,106679,93321
2:4:5,1,1,106678,93322
3:4:6,0,-1,106679,93321
5:4:2,1,1,106678,93322
3:3:1,0,-1,106679,93321
5:2:1,1,1,106678,93322
5:4:2,1,1,106677,93323
4:4:1,0,-1,106678,93322
2:6:2,2,2,106676,93324
5:2:3,1,1,106675,93325
5:3:2,1,1,106674,93326
5:5:2,1,1,106673,93327
2:1:3,1,1,106672,93328
2:1:2,2,2,106670,93330
4:5:1,0,-1,106671,93329
1:6:6,0,-1,106672,93328
4:4:4,0,-1,106673,93327
2:1:1,1,1,106672,93328
3:5:5,0,-1,106673,93327
5:5:5,0,-1,106674,93326
6:4:2,1,1,106673,93327
6:1:6,0,-1,106674,93326
1:2:6,1,1,106673,93327
1:5:3,0,-1,106674,93326
2:5:1,1,1,106673,93327
4:5:5,0,-1,106674,93326
3:4:2,1,1,106673,93327
4:2:1,1,1,106672,93328
3:3:4,0,-1,106673,93327
6:3:4,0,-1,106674,93326
4:3:1,0,-1,106675,93325
3:5:4,0,-1,106676,93324
6:6:3,0,-1,106677,93323
3:2:6,1,1,106676,93324
6:3:5,0,-1,106677,93323
4:2:5,1,1,106676,93324
5:5:1,0,-1,106677,93323
4:4:6,0,-1,106678,93322
3:4:3,0,-1,106679,93321
3:4:1,0,-1,106680,93320
3:4:2,1,1,106679,93321
4:4:6,0,-1,106680,93320
6:5:2,1,1,106679,93321
6:6:6,0,-1,106680,93320
1:6:6,0,-1,106681,93319
6:5:2,1,1,106680,93320
6:2:1,1,1,106679,93321
6:1:5,0,-1,106680,93320
5:4:2,1,1,106679,93321
3:1:3,0,-1,106680,93320
1:5:5,0,-1,106681,93319
3:3:2,1,1,106680,93320
5:4:6,0,-1,106681,93319
6:3:1,0,-1,106682,93318
4:6:4,0,-1,106683,93317
4:4:6,0,-1,106684,93316
6:5:3,0,-1,106685,93315
1:6:5,0,-1,106686,93314
2:1:1,1,1,106685,93315
4:1:5,0,-1,106686,93314
5:2:3,1,1,106685,93315
4:1:5,0,-1,106686,93314
1:1:2,1,1,106685,93315
4:1:1,0,-1,106686,93314
2:2:6,2,2,106684,93316
5:2:3,1,1,106683,93317
2:5:4,1,1,106682,93318
2:4:6,1,1,106681,93319
4:2:2,2,2,106679,93321
5:1:3,0,-1,106680,93320
1:5:5,0,-1,106681,93319
3:2:6,1,1,106680,93320
5:4:4,0,-1,106681,93319
1:6:5,0,-1,106682,93318
5:3:2,1,1,106681,93319
3:6:4,0,-1,106682,93318
2:5:5,1,1,106681,93319
4:5:2,1,1,106680,93320
1:6:5,0,-1,106681,93319
6:6:3,0,-1,106682,93318
3:6:5,0,-1,106683,93317
2:1:3,1,1,106682,93318
4:1:5,0,-1,106683,93317
3:4:5,0,-1,106684,93316
2:3:5,1,1,106683,93317
1:4:1,0,-1,106684,93316
5:2:3,1,1,106683,93317
4:6:5,0,-1,106684,93316
2:3:2,2,2,106682,93318
1:2:1,1,1,106681,93319
5:2:5,1,1,106680,93320
6:2:4,1,1,106679,93321
2:6:3,1,1,106678,93322
3:5:3,0,-1,106679,93321
3:2:1,1,1,106678,93322
6:4:5,0,-1,106679,93321
3:5:3,0,-1,106680,93320
6:6:6,0,-1,106681,93319
1:2:5,1,1,106680,93320
1:1:6,0,-1,106681,93319
6:1:1,0,-1,106682,93318
2:3:3,1,1,106681,93319
4:1:4,0,-1,106682,93318
3:4:4,0,-1,106683,93317
2:6:3,1,1,106682,93318
2:3:6,1,1,106681,93319
5:6:4,0,-1,106682,93318
5:3:6,0,-1,106683,93317
5:3:1,0,-1,106684,93316
5:5:2,1,1,106683,93317
1:4:2,1,1,106682,93318
2:3:4,1,1,106681,93319
6:5:4,0,-1,106682,93318
6:2:4,1,1,106681,93319
5:1:2,1,1,106680,93320
6:1:1,0,-1,106681,93319
4:4:2,1,1,106680,93320
2:5:4,1,1,106679,93321
2:6:6,1,1,106678,93322
1:6:4,0,-1,106679,93321
2:1:5,1,1,106678,93322
3:1:1,0,-1,106679,93321
1:2:2,2,2,106677,93323
2:4:4,1,1,106676,93324
4:6:4,0,-1,106677,93323
3:3:6,0,-1,106678,93322
2:5:2,2,2,106676,93324
6:4:6,0,-1,106677,93323
5:1:1,0,-1,106678,93322
5:6:3,0,-1,106679,93321
2:4:1,1,1,106678,93322
1:6:3,0,-1,106679,93321
1:6:1,0,-1,106680,93320
2:3:1,1,1,106679,93321
4:2:6,1,1,106678,93322
1:4:3,0,-1,106679,93321
6:3:5,0,-1,106680,93320
2:1:3,1,1,106679,93321
1:5:5,0,-1,106680,93320
1:3:4,0,-1,106681,93319
5:4:3,0,-1,106682,93318
2:5:1,1,1,106681,93319
2:5:2,2,2,106679,93321
5:5:5,0,-1,106680,93320
3:2:4,1,1,106679,93321
3:6:5,0,-1,106680,93320
4:5:2,1,1,106679,93321
1:3:1,0,-1,106680,93320
1:6:5,0,-1,106681,93319
6:1:6,0,-1,106682,93318
1:3:5,0,-1,106683,93317
5:1:6,0,-1,106684,93316
2:2:2,3,3,106681,93319
3:2:1,1,1,106680,93320
3:1:6,0,-1,106681,93319
5:3:2,1,1,106680,93320
3:6:6,0,-1,106681,93319
4:4:5,0,-1,106682,93318
5:4:3,0,-1,106683,93317
5:4:1,0,-1,106684,93316
5:5:5,0,-1,106685,93315
5:2:1,1,1,106684,93316
5:6:5,0,-1,106685,93315
5:6:4,0,-1,106686,93314
6:3:2,1,1,106685,93315
3:3:5,0,-1,106686,93314
6:6:3,0,-1,106687,93313
4:6:2,1,1,106686,93314
2:1:2,2,2,106684,93316
3:6:4,0,-1,106685,93315
1:1:3,0,-1,106686,93314
3:1:2,1,1,106685,93315
2:4:3,1,1,106684,93316
2:3:5,1,1,106683,93317
4:3:5,0,-1,106684,93316
6:6:3,0,-1,106685,93315
4:1:2,1,1,106684,93316
4:2:5,1,1,106683,93317
4:5:2,1,1,106682,93318
1:4:2,1,1,106681,93319
3:3:6,0,-1,106682,93318
5:6:5,0,-1,106683,93317
5:1:6,0,-1,106684,93316
1:6:6,0,-1,106685,93315
2:3:6,1,1,106684,93316
1:6:3,0,-1,106685,93315
5:3:4,0,-1,106686,93314
5:3:2,1,1,106685,93315
2:1:1,1,1,106684,93316
4:3:4,0,-1,106685,93315
6:6:4,0,-1,106686,93314
4:3:4,0,-1,106687,93313
3:6:2,1,1,106686,93314
6:3:1,0,-1,106687,93313
2:5:3,1,1,106686,93314
2:2:2,3,3,106683,93317
3:2:5,1,1,106682,93318
5:6:4,0,-1,106683,93317
3:1:5,0,-1,106684,93316
6:3:5,0,-1,106685,93315
6:5:4,0,-1,106686,93314
3:6:4,0,-1,106687,93313
1:2:4,1,1,106686,93314
4:2:4,1,1,106685,93315
6:2:4,1,1,106684,93316
5:4:3,0,-1,106685,93315
3:4:2,1,1,106684,93316
3:4:1,0,-1,106685,93315
3:2:1,1,1,106684,93316
1:4:6,0,-1,106685,93315
3:5:3,0,-1,106686,93314
6:1:1,0,-1,106687,93313
1:4:1,0,-1,106688,93312
5:3:6,0,-1,106689,93311
4:6:3,0,-1,106690,93310
6:2:2,2,2,106688,93312
4:2:2,2,2,106686,93314
3:4:2,1,1,106685,93315
6:3:2,1,1,106684,93316
1:3:3,0,-1,106685,93315
1:4:4,0,-1,106686,93314
3:3:3,0,-1,106687,93313
5:3:2,1,1,106686,93314
6:4:1,0,-1,106687,93313
6:4:5,0,-1,106688,93312
5:4:5,0,-1,106689,93311
5:3:1,0,-1,106690,93310
5:3:1,0,-1,106691,93309
3:5:1,0,-1,106692,93308
6:1:4,0,-1,106693,93307
5:5:5,0,-1,106694,93306
6:5:4,0,-1,106695,93305
2:5:1,1,1,106694,93306
2:6:3,1,1,106693,93307
2:2:6,2,2,106691,93309
5:3:5,0,-1,106692,93308
3:3:6,0,-1,106693,93307
6:4:2,1,1,106692,93308
2:4:4,1,1,106691,93309
6:6:5,0,-1,106692,93308
3:1:4,0,-1,106693,93307
4:3:6,0,-1,106694,93306
3:1:2,1,1,106693,93307
3:1:2,1,1,106692,93308
1:4:1,0,-1,106693,93307
3:6:6,0,-1,106694,93306
6:6:1,0,-1,106695,93305
1:3:4,0,-1,106696,93304
1:2:5,1,1,106695,93305
3:4:2,1,1,106694,93306
2:6:6,1,1,106693,93307
4:1:4,0,-1,106694,93306
6:1:1,0,-1,106695,93305
3:1:6,0,-1,106696,93304
6:4:5,0,-1,106697,93303
6:4:1,0,-1,106698,93302
3:2:3,1,1,106697,93303
2:2:2,3,3,106694,93306
1:2:3,1,1,106693,93307
5:3:4,0,-1,106694,93306
3:5:1,0,-1,106695,93305
2:2:2,3,3,106692,93308
1:1:1,0,-1,106693,93307
2:2:2,3,3,106690,93310
6:5:4,0,-1,106691,93309
6:3:3,0,-1,106692,93308
4:3:3,0,-1,106693,93307
5:2:2,2,2,106691,93309
2:6:4,1,1,106690,93310
4:1:3,0,-1,106691,93309
3:2:1,1,1,106690,93310
3:6:4,0,-1,106691,93309
2:4:2,2,2,106689,93311
3:4:1,0,-1,106690,93310
1:3:4,0,-1,106691,93309
6:2:2,2,2,106689,93311
4:2:1,1,1,106688,93312
3:3:5,0,-1,106689,93311
4:5:1,0,-1,106690,93310
4:5:5,0,-1,106691,93309
1:2:2,2,2,106689,93311
2:1:3,1,1,106688,93312
1:3:2,1,1,106687,93313
2:2:3,2,2,106685,93315
5:4:3,0,-1,106686,93314
4:1:5,0,-1,106687,93313
2:3:4,1,1,106686,93314
2:3:4,1,1,106685,93315
6:4:3,0,-1,106686,93314
5:2:1,1,1,106685,93315
5:3:2,1,1,106684,93316
1:1:5,0,-1,106685,93315
5:5:2,1,1,106684,93316
4:2:4,1,1,106683,93317
1:5:1,0,-1,106684,93316
3:1:4,0,-1,106685,93315
2:1:1,1,1,106684,93316
3:6:2,1,1,106683,93317
4:6:4,0,-1,106684,93316
5:6:1,0,-1,106685,93315
5:1:2,1,1,106684,93316
4:1:1,0,-1,106685,93315
2:3:4,1,1,106684,93316
5:4:6,0,-1,106685,93315
6:2:2,2,2,106683,93317
1:4:1,0,-1,106684,93316
2:2:6,2,2,106682,93318
2:2:2,3,3,106679,93321
2:4:6,1,1,106678,93322
3:6:2,1,1,106677,93323
1:1:1,0,-1,106678,93322
1:6:2,1,1,106677,93323
4:2:2,2,2,106675,93325
6:6:2,1,1,106674,93326
4:5:4,0,-1,106675,93325
4:6:6,0,-1,106676,93324
4:3:1,0,-1,106677,93323
1:6:3,0,-1,106678,93322
1:4:1,0,-1,106679,93321
5:3:4,0,-1,106680,93320
3:1:5,0,-1,106681,93319
2:4:5,1,1,106680,93320
5:5:2,1,1,106679,93321
2:4:1,1,1,106678,93322
2:1:1,1,1,106677,93323
4:4:5,0,-1,106678,93322
3:4:1,0,-1,106679,93321
4:2:2,2,2,106677,93323
4:2:5,1,1,106676,93324
2:1:5,1,1,106675,93325
2:6:5,1,1,106674,93326
1:5:1,0,-1,106675,93325
5:2:1,1,1,106674,93326
3:2:2,2,2,106672,93328
2:2:4,2,2,106670,93330
1:6:2,1,1,106669,93331
1:3:4,0,-1,106670,93330
1:2:5,1,1,106669,93331
5:3:1,0,-1,106670,93330
1:6:1,0,-1,106671,93329
5:1:1,0,-1,106672,93328
1:1:1,0,-1,106673,93327
3:2:3,1,1,106672,93328
6:3:6,0,-1,106673,93327
5:4:5,0,-1,106674,93326
4:6:5,0,-1,106675,93325
2:1:1,1,1,106674,93326
1:1:6,0,-1,106675,93325
4:1:2,1,1,106674,93326
6:3:4,0,-1,106675,93325
5:3:4,0,-1,106676,93324
4:6:4,0,-1,106677,93323
4:2:5,1,1,106676,93324
4:2:6,1,1,106675,93325
4:3:4,0,-1,106676,93324
1:3:3,0,-1,106677,93323
2:5:5,1,1,106676,93324
2:5:1,1,1,106675,93325
5:5:1,0,-1,106676,93324
5:2:5,1,1,106675,93325
2:2:3,2,2,106673,93327
4:6:5,0,-1,106674,93326
2:2:1,2,2,106672,93328
2:1:2,2,2,106670,93330
6:4:4,0,-1,106671,93329
6:4:2,1,1,106670,93330
3:1:3,0,-1,106671,93329
6:6:5,0,-1,106672,93328
4:5:4,0,-1,106673,93327
2:4:1,1,1,106672,93328
3:6:6,0,-1,106673,93327
5:1:4,0,-1,106674,93326
6:1:3,0,-1,106675,93325
1:3:6,0,-1,106676,93324
1:3:4,0,-1,106677,93323
1:3:4,0,-1,106678,93322
3:4:2,1,1,106677,93323
6:4:3,0,-1,106678,93322
3:4:2,1,1,106677,93323
6:4:4,0,-1,106678,93322
5:6:5,0,-1,106679,93321
5:5:4,0,-1,106680,93320
6:6:6,0,-1,106681,93319
4:3:3,0,-1,106682,93318
3:3:5,0,-1,106683,93317
3:5:2,1,1,106682,93318
3:6:3,0,-1,106683,93317
1:1:3,0,-1,106684,93316
2:3:1,1,1,106683,93317
3:6:1,0,-1,106684,93316
3:3:5,0,-1,106685,93315
4:1:2,1,1,106684,93316
2:6:3,1,1,106683,93317
5:3:5,0,-1,106684,93316
6:1:4,0,-1,106685,93315
1:5:6,0,-1,106686,93314
5:2:6,1,1,106685,93315
1:6:5,0,-1,106686,93314
1:3:2,1,1,106685,93315
3:1:4,0,-1,106686,93314
5:1:3,0,-1,106687,93313
1:2:3,1,1,106686,93314
3:1:6,0,-1,106687,93313
3:1:3,0,-1,106688,93312
2:1:1,1,1,106687,93313
4:2:2,2,2,106685,93315
6:6:3,0,-1,106686,93314
4:5:4,0,-1,106687,93313
4:5:2,1,1,106686,93314
3:2:2,2,2,106684,93316
3:2:1,1,1,106683,93317
6:4:2,1,1,106682,93318
6:6:4,0,-1,106683,93317
2:4:3,1,1,106682,93318
3:3:5,0,-1,106683,93317
5:1:4,0,-1,106684,93316
4:4:2,1,1,106683,93317
4:5:4,0,-1,106684,93316
2:4:2,2,2,106682,93318
1:3:4,0,-1,106683,93317
1:6:4,0,-1,106684,93316
5:4:5,0,-1,106685,93315
2:3:2,2,2,106683,93317
6:6:5,0,-1,106684,93316
5:1:4,0,-1,106685,93315
2:4:6,1,1,106684,93316
2:3:1,1,1,106683,93317
6:6:4,0,-1,106684,93316
3:4:2,1,1,106683,93317
1:5:4,0,-1,106684,93316
1:5:6,0,-1,106685,93315
5:6:3,0,-1,106686,93314
3:6:5,0,-1,106687,93313
4:1:6,0,-1,106688,93312
1:6:2,1,1,106687,93313
3:2:4,1,1,106686,93314
1:4:6,0,-1,106687,93313
1:2:6,1,1,106686,93314
3:5:3,0,-1,106687,93313
5:2:6,1,1,106686,93314
3:2:1,1,1,106685,93315
6:3:3,0,-1,106686,93314
1:5:6,0,-1,106687,93313
3:1:1,0,-1,106688,93312
6:1:6,0,-1,106689,93311
1:4:6,0,-1,106690,93310
1:1:6,0,-1,106691,93309
4:5:4,0,-1,106692,93308
2:1:3,1,1,106691,93309
4:4:1,0,-1,106692,93308
5:3:1,0,-1,106693,93307
2:2:1,2,2,106691,93309
2:1:1,1,1,106690,93310
4:5:4,0,-1,106691,93309
3:6:5,0,-1,106692,93308
2:2:5,2,2,106690,93310
2:1:4,1,1,106689,93311
2:6:1,1,1,106688,93312
1:1:6,0,-1,106689,93311
3:3:4,0,-1,106690,93310
4:3:2,1,1,106689,93311
1:1:2,1,1,106688,93312
3:4:4,0,-1,106689,93311
2:1:3,1,1,106688,93312
2:6:5,1,1,106687,93313
4:5:1,0,-1,106688,93312
5:2:4,1,1,106687,93313
4:4:5,0,-1,106688,93312
4:2:4,1,1,106687,93313
2:3:2,2,2,106685,93315
2:4:6,1,1,106684,93316
2:3:5,1,1,106683,93317
1:1:5,0,-1,106684,93316
4:3:3,0,-1,106685,93315
6:5:3,0,-1,106686,93314
1:5:4,0,-1,106687,93313
4:4:1,0,-1,106688,93312
2:6:2,2,2,106686,93314
1:1:5,0,-1,106687,93313
1:6:4,0,-1,106688,93312
3:4:3,0,-1,106689,93311
1:2:4,1,1,106688,93312
2:3:1,1,1,106687,93313
5:6:1,0,-1,106688,93312
1:2:3,1,1,106687,93313
5:4:2,1,1,106686,93314
1:6:4,0,-1,106687,93313
2:2:3,2,2,106685,93315
4:4:4,0,-1,106686,93314
4:2:4,1,1,106685,93315
2:6:1,1,1,106684,93316
4:4:2,1,1,106683,93317
1:1:4,0,-1,106684,93316
2:4:2,2,2,106682,93318
6:6:1,0,-1,106683,93317
1:1:3,0,-1,106684,93316
2:3:6,1,1,106683,93317
4:4:5,0,-1,106684,93316
4:4:5,0,-1,106685,93315
4:4:3,0,-1,106686,93314
6:1:5,0,-1,106687,93313
1:1:2,1,1,106686,93314
2:2:2,3,3,106683,93317
1:1:5,0,-1,106684,93316
4:4:2,1,1,106683,93317
2:5:2,2,2,106681,93319
1:5:4,0,-1,106682,93318
3:2:4,1,1,106681,93319
1:5:2,1,1,106680,93320
3:2:6,1,1,106679,93321
3:1:3,0,-1,106680,93320
2:4:6,1,1,106679,93321
6:5:6,0,-1,106680,93320
5:2:3,1,1,106679,93321
2:1:3,1,1,106678,93322
5:3:5,0,-1,106679,93321
5:2:1,1,1,106678,93322
3:5:2,1,1,106677,93323
5:3:4,0,-1,106678,93322
5:1:1,0,-1,106679,93321
6:3:2,1,1,106678,93322
6:1:1,0,-1,106679,93321
2:3:6,1,1,106678,93322
1:3:5,0,-1,106679,93321
5:5:5,0,-1,106680,93320
1:2:5,1,1,106679,93321
2:3:6,1,1,106678,93322
6:6:1,0,-1,106679,93321
4:2:2,2,2,106677,93323
3:4:4,0,-1,106678,93322
4:1:3,0,-1,106679,93321
6:3:4,0,-1,106680,93320
1:2:2,2,2,106678,93322
3:6:1,0,-1,106679,93321
4:4:5,0,-1,106680,93320
3:6:6,0,-1,106681,93319
6:3:1,0,-1,106682,93318
5:5:1,0,-1,106683,93317
2:6:2,2,2,106681,93319
2:2:5,2,2,106679,93321
4:4:3,0,-1,106680,93320
5:6:5,0,-1,106681,93319
3:3:3,0,-1,106682,93318
2:1:3,1,1,106681,93319
2:3:4,1,1,106680,93320
6:6:6,0,-1,106681,93319
4:6:5,0,-1,106682,93318
3:4:2,1,1,106681,93319
2:5:6,1,1,106680,93320
5:2:5,1,1,106679,93321
1:3:1,0,-1,106680,93320
4:4:5,0,-1,106681,93319
4:3:4,0,-1,106682,93318
3:6:4,0,-1,106683,93317
6:4:6,0,-1,106684,93316
5:2:6,1,1,106683,93317
2:6:6,1,1,106682,93318
4:1:6,0,-1,106683,93317
4:2:4,1,1,106682,93318
6:3:5,0,-1,106683,93317
3:3:6,0,-1,106684,93316
2:4:5,1,1,106683,93317
1:1:2,1,1,106682,93318
3:5:1,0,-1,106683,93317
2:3:6,1,1,106682,93318
3:1:4,0,-1,106683,93317
1:4:2,1,1,106682,93318
1:2:2,2,2,106680,93320
1:5:1,0,-1,106681,93319
3:1:1,0,-1,106682,93318
4:4:2,1,1,106681,93319
4:5:5,0,-1,106682,93318
6:6:4,0,-1,106683,93317
3:5:4,0,-1,106684,93316
2:4:5,1,1,106683,93317
3:2:2,2,2,106681,93319
5:5:5,0,-1,106682,93318
5:4:4,0,-1,106683,93317
3:1:5,0,-1,106684,93316
6:5:6,0,-1,106685,93315
3:3:5,0,-1,106686,93314
5:1:1,0,-1,106687,93313
1:2:4,1,1,106686,93314
2:4:6,1,1,106685,93315
2:5:5,1,1,106684,93316
5:3:6,0,-1,106685,93315
6:6:6,0,-1,106686,93314
1:3:3,0,-1,106687,93313
4:1:5,0,-1,106688,93312
2:4:1,1,1,106687,93313
3:5:4,0,-1,106688,93312
3:5:1,0,-1,106689,93311
2:4:1,1,1,106688,93312
5:3:1,0,-1,106689,93311
2:1:4,1,1,106688,93312
5:2:6,1,1,106687,93313
6:3:6,0,-1,106688,93312
3:2:4,1,1,106687,93313
5:2:5,1,1,106686,93314
1:5:5,0,-1,106687,93313
2:2:3,2,2,106685,93315
3:1:5,0,-1,106686,93314
3:5:4,0,-1,106687,93313
3:2:6,1,1,106686,93314
6:5:3,0,-1,106687,93313
4:1:3,0,-1,106688,93312
3:4:2,1,1,106687,93313
1:6:3,0,-1,106688,93312
6:6:2,1,1,106687,93313
4:3:3,0,-1,106688,93312
3:1:4,0,-1,106689,93311
4:6:5,0,-1,106690,93310
3:4:5,0,-1,106691,93309
4:1:5,0,-1,106692,93308
3:4:1,0,-1,106693,93307
1:5:4,0,-1,106694,93306
5:6:4,0,-1,106695,93305
6:2:5,1,1,106694,93306
5:4:6,0,-1,106695,93305
4:2:5,1,1,106694,93306
6:3:4,0,-1,106695,93305
3:2:4,1,1,106694,93306
4:2:2,2,2,106692,93308
1:3:3,0,-1,106693,93307
6:4:3,0,-1,106694,93306
4:3:2,1,1,106693,93307
1:5:2,1,1,106692,93308
5:3:3,0,-1,106693,93307
2:6:6,1,1,106692,93308
4:2:1,1,1,106691,93309
3:6:5,0,-1,106692,93308
6:2:4,1,1,106691,93309
5:3:4,0,-1,106692,93308
5:1:3,0,-1,106693,93307
3:6:1,0,-1,106694,93306
5:3:3,0,-1,106695,93305
4:6:3,0,-1,106696,93304
4:1:3,0,-1,106697,93303
5:3:6,0,-1,106698,93302
6:2:2,2,2,106696,93304
1:2:5,1,1,106695,93305
4:5:1,0,-1,106696,93304
2:3:5,1,1,106695,93305
1:2:3,1,1,106694,93306
4:3:4,0,-1,106695,93305
3:6:3,0,-1,106696,93304
5:3:3,0,-1,106697,93303
6:3:1,0,-1,106698,93302
6:1:2,1,1,106697,93303
4:1:3,0,-1,106698,93302
1:5:6,0,-1,106699,93301
2:3:6,1,1,106698,93302
2:4:5,1,1,106697,93303
6:5:3,0,-1,106698,93302
4:5:1,0,-1,106699,93301
6:6:4,0,-1,106700,93300
3:5:1,0,-1,106701,93299
4:5:2,1,1,106700,93300
1:5:2,1,1,106699,93301
3:5:5,0,-1,106700,93300
4:4:4,0,-1,106701,93299
2:4:6,1,1,106700,93300
6:6:3,0,-1,106701,93299
2:2:6,2,2,106699,93301
1:1:3,0,-1,106700,93300
5:4:6,0,-1,106701,93299
5:5:2,1,1,106700,93300
3:6:4,0,-1,106701,93299
5:1:6,0,-1,106702,93298
3:6:3,0,-1,106703,93297
2:1:2,2,2,106701,93299
3:5:2,1,1,106700,93300
3:2:5,1,1,106699,93301
4:3:2,1,1,106698,93302
6:6:3,0,-1,106699,93301
6:2:5,1,1,106698,93302
6:3:1,0,-1,106699,93301
3:4:6,0,-1,106700,93300
1:3:5,0,-1,106701,93299
2:3:4,1,1,106700,93300
5:6:1,0,-1,106701,93299
5:6:2,1,1,106700,93300
5:4:3,0,-1,106701,93299
2:5:4,1,1,106700,93300
4:2:4,1,1,106699,93301
1:4:5,0,-1,106700,93300
6:5:6,0,-1,106701,93299
2:1:4,1,1,106700,93300
6:2:6,1,1,106699,93301
2:3:5,1,1,106698,93302
2:6:1,1,1,106697,93303
6:6:2,1,1,106696,93304
5:1:5,0,-1,106697,93303
4:3:1,0,-1,106698,93302
4:4:4,0,-1,106699,93301
2:3:6,1,1,106698,93302
1:4:3,0,-1,106699,93301
2:4:1,1,1,106698,93302
3:1:1,0,-1,106699,93301
2:4:2,2,2,106697,93303
6:2:3,1,1,106696,93304
3:3:6,0,-1,106697,93303
4:3:3,0,-1,106698,93302
6:2:5,1,1,106697,93303
1:3:5,0,-1,106698,93302
1:2:5,1,1,106697,93303
6:1:1,0,-1,106698,93302
3:1:3,0,-1,106699,93301
5:3:5,0,-1,106700,93300
2:6:2,2,2,106698,93302
1:6:5,0,-1,106699,93301
3:4:2,1,1,106698,93302
5:4:5,0,-1,106699,93301
6:3:2,1,1,106698,93302
4:1:2,1,1,106697,93303
2:6:3,1,1,106696,93304
3:4:2,1,1,106695,93305
3:3:3,0,-1,106696,93304
4:1:1,0,-1,106697,93303
2:2:6,2,2,106695,93305
3:2:4,1,1,106694,93306
3:1:4,0,-1,106695,93305
2:1:6,1,1,106694,93306
2:5:4,1,1,106693,93307
5:1:2,1,1,106692,93308
6:5:2,1,1,106691,93309
2:4:2,2,2,106689,93311
3:4:1,0,-1,106690,93310
5:4:3,0,-1,106691,93309
2:2:6,2,2,106689,93311
3:2:3,1,1,106688,93312
1:3:3,0,-1,106689,93311
2:2:5,2,2,106687,93313
3:4:6,0,-1,106688,93312
6:2:2,2,2,106686,93314
5:6:2,1,1,106685,93315
2:6:3,1,1,106684,93316
5:4:4,0,-1,106685,93315
1:1:5,0,-1,106686,93314
2:3:2,2,2,106684,93316
6:3:2,1,1,106683,93317
2:3:4,1,1,106682,93318
1:2:5,1,1,106681,93319
2:6:4,1,1,106680,93320
6:1:4,0,-1,106681,93319
5:1:5,0,-1,106682,93318
4:4:3,0,-1,106683,93317
3:5:3,0,-1,106684,93316
1:2:3,1,1,106683,93317
5:3:3,0,-1,106684,93316
1:2:3,1,1,106683,93317
4:6:2,1,1,106682,93318
5:1:3,0,-1,106683,93317
6:2:5,1,1,106682,93318
2:1:2,2,2,106680,93320
4:1:3,0,-1,106681,93319
6:2:5,1,1,106680,93320
4:2:3,1,1,106679,93321
5:2:3,1,1,106678,93322
4:2:4,1,1,106677,93323
5:2:2,2,2,106675,93325
1:2:6,1,1,106674,93326
2:5:6,1,1,106673,93327
3:5:2,1,1,106672,93328
4:5:3,0,-1,106673,93327
6:3:6,0,-1,106674,93326
3:1:5,0,-1,106675,93325
1:4:5,0,-1,106676,93324
1:1:5,0,-1,106677,93323
1:3:1,0,-1,106678,93322
2:5:2,2,2,106676,93324
5:4:2,1,1,106675,93325
1:4:5,0,-1,106676,93324
6:5:4,0,-1,106677,93323
5:2:3,1,1,106676,93324
4:5:5,0,-1,106677,93323
2:4:3,1,1,106676,93324
2:2:3,2,2,106674,93326
5:6:3,0,-1,106675,93325
4:4:3,0,-1,106676,93324
1:2:4,1,1,106675,93325
1:3:5,0,-1,106676,93324
2:4:1,1,1,106675,93325
2:4:3,1,1,106674,93326
3:5:2,1,1,106673,93327
5:3:3,0,-1,106674,93326
1:2:4,1,1,106673,93327
3:1:3,0,-1,106674,93326
4:1:1,0,-1,106675,93325
5:2:2,2,2,106673,93327
4:3:1,0,-1,106674,93326
6:5:4,0,-1,106675,93325
6:6:4,0,-1,106676,93324
4:3:2,1,1,106675,93325
3:4:3,0,-1,106676,93324
2:5:1,1,1,106675,93325
2:6:2,2,2,106673,93327
3:5:5,0,-1,106674,93326
3:4:3,0,-1,106675,93325
4:1:6,0,-1,106676,93324
1:5:5,0,-1,106677,93323
6:2:6,1,1,106676,93324
5:5:1,0,-1,106677,93323
2:3:1,1,1,106676,93324
6:2:5,1,1,106675,93325
1:5:4,0,-1,106676,93324
4:3:5,0,-1,106677,93323
4:1:3,0,-1,106678,93322
6:1:2,1,1,106677,93323
5:2:3,1,1,106676,93324
3:4:2,1,1,106675,93325
4:2:6,1,1,106674,93326
3:5:3,0,-1,106675,93325
2:5:1,1,1,106674,93326
3:1:2,1,1,106673,93327
4:2:5,1,1,106672,93328
2:3:4,1,1,106671,93329
5:2:6,1,1,106670,93330
6:3:2,1,1,106669,93331
6:4:3,0,-1,106670,93330
2:2:2,3,3,106667,93333
2:3:4,1,1,106666,93334
4:3:1,0,-1,106667,93333
4:1:1,0,-1,106668,93332
6:5:4,0,-1,106669,93331
2:4:6,1,1,106668,93332
2:3:2,2,2,106666,93334
4:6:2,1,1,106665,93335
3:6:6,0,-1,106666,93334
2:3:2,2,2,106664,93336
4:3:5,0,-1,106665,93335
2:4:5,1,1,106664,93336
2:6:4,1,1,106663,93337
1:6:5,0,-1,106664,93336
4:5:1,0,-1,106665,93335
1:4:2,1,1,106664,93336
3:1:6,0,-1,106665,93335
5:5:2,1,1,106664,93336
3:4:2,1,1,106663,93337
6:1:5,0,-1,106664,93336
4:6:2,1,1,106663,93337
5:6:6,0,-1,106664,93336
6:6:5,0,-1,106665,93335
2:6:3,1,1,106664,93336
2:2:4,2,2,106662,93338
3:4:2,1,1,106661,93339
4:3:2,1,1,106660,93340
2:2:2,3,3,106657,93343
1:4:1,0,-1,106658,93342
6:2:1,1,1,106657,93343
2:4:5,1,1,106656,93344
6:3:5,0,-1,106657,93343
5:3:2,1,1,106656,93344
6:4:6,0,-1,106657,93343
6:5:5,0,-1,106658,93342
5:3:3,0,-1,106659,93341
2:5:2,2,2,106657,93343
4:6:3,0,-1,106658,93342
3:6:1,0,-1,106659,93341
3:5:1,0,-1,106660,93340
2:4:6,1,1,106659,93341
1:6:1,0,-1,106660,93340
5:3:6,0,-1,106661,93339
1:6:1,0,-1,106662,93338
1:5:2,1,1,106661,93339
3:5:2,1,1,106660,93340
2:4:5,1,1,106659,93341
6:6:2,1,1,106658,93342
5:5:4,0,-1,106659,93341
5:4:4,0,-1,106660,93340
6:2:4,1,1,106659,93341
1:1:1,0,-1,106660,93340
4:1:3,0,-1,106661,93339
1:3:3,0,-1,106662,93338
1:5:5,0,-1,106663,93337
4:2:4,1,1,106662,93338
5:1:1,0,-1,106663,93337
4:5:1,0,-1,106664,93336
3:5:5,0,-1,106665,93335
2:2:2,3,3,106662,93338
2:5:5,1,1,106661,93339
3:1:4,0,-1,106662,93338
1:2:4,1,1,106661,93339
3:5:3,0,-1,106662,93338
6:4:1,0,-1,106663,93337
2:6:4,1,1,106662,93338
5:2:5,1,1,106661,93339
5:1:1,0,-1,106662,93338
5:3:4,0,-1,106663,93337
4:2:6,1,1,106662,93338
6:2:2,2,2,106660,93340
1:5:6,0,-1,106661,93339
1:2:3,1,1,106660,93340
1:1:3,0,-1,106661,93339
5:5:6,0,-1,106662,93338
1:3:4,0,-1,106663,93337
5:1:6,0,-1,106664,93336
5:1:6,0,-1,106665,93335
4:2:2,2,2,106663,93337
1:6:3,0,-1,106664,93336
3:2:5,1,1,106663,93337
1:4:5,0,-1,106664,93336
3:6:4,0,-1,106665,93335
4:6:5,0,-1,106666,93334
5:2:2,2,2,106664,93336
3:3:6,0,-1,106665,93335
3:4:2,1,1,106664,93336
6:5:1,0,-1,106665,93335
1:3:5,0,-1,106666,93334
5:2:3,1,1,106665,93335
4:4:6,0,-1,106666,93334
4:4:3,0,-1,106667,93333
2:5:5,1,1,106666,93334
5:6:2,1,1,106665,93335
6:2:2,2,2,106663,93337
6:2:2,2,2,106661,93339
1:2:5,1,1,106660,93340
3:1:5,0,-1,106661,93339
4:2:3,1,1,106660,93340
2:3:4,1,1,106659,93341
3:6:5,0,-1,106660,93340
2:1:5,1,1,106659,93341
3:3:5,0,-1,106660,93340
4:2:4,1,1,106659,93341
1:4:5,0,-1,106660,93340
6:5:5,0,-1,106661,93339
5:5:2,1,1,106660,93340
2:6:4,1,1,106659,93341
5:2:3,1,1,106658,93342
3:2:5,1,1,106657,93343
4:6:2,1,1,106656,93344
6:5:6,0,-1,106657,93343
1:2:5,1,1,106656,93344
4:1:4,0,-1,106657,93343
1:5:5,0,-1,106658,93342
5:5:1,0,-1,106659,93341
5:2:1,1,1,106658,93342
6:1:6,0,-1,106659,93341
1:2:1,1,1,106658,93342
4:3:3,0,-1,106659,93341
6:5:4,0,-1,106660,93340
6:5:2,1,1,106659,93341
2:3:4,1,1,106658,93342
2:4:6,1,1,106657,93343
5:6:2,1,1,106656,93344
5:6:1,0,-1,106657,93343
4:5:1,0,-1,106658,93342
3:3:6,0,-1,106659,93341
6:4:5,0,-1,106660,93340
2:1:1,1,1,106659,93341
6:2:1,1,1,106658,93342
5:3:1,0,-1,106659,93341
4:2:5,1,1,106658,93342
4:3:1,0,-1,106659,93341
5:4:4,0,-1,106660,93340
2:1:6,1,1,106659,93341
4:3:3,0,-1,106660,93340
2:5:6,1,1,106659,93341
1:4:5,0,-1,106660,93340
3:3:3,0,-1,106661,93339
1:3:2,1,1,106660,93340
2:3:1,1,1,106659,93341
6:4:3,0,-1,106660,93340
1:6:6,0,-1,106661,93339
2:3:3,1,1,106660,93340
2:3:2,2,2,106658,93342
2:3:1,1,1,106657,93343
2:6:1,1,1,106656,93344
4:6:2,1,1,106655,93345
4:5:6,0,-1,106656,93344
6:5:3,0,-1,106657,93343
1:4:3,0,-1,106658,93342
6:2:4,1,1,106657,93343
5:2:5,1,1,106656,93344
6:2:5,1,1,106655,93345
2:1:1,1,1,106654,93346
6:3:1,0,-1,106655,93345
2:2:4,2,2,106653,93347
6:2:4,1,1,106652,93348
1:1:2,1,1,106651,93349
2:5:5,1,1,106650,93350
2:4:2,2,2,106648,93352
2:5:4,1,1,106647,93353
3:3:2,1,1,106646,93354
1:4:2,1,1,106645,93355
1:4:2,1,1,106644,93356
6:5:6,0,-1,106645,93355
3:2:6,1,1,106644,93356
2:5:3,1,1,106643,93357
2:5:6,1,1,106642,93358
3:2:1,1,1,106641,93359
4:2:3,1,1,106640,93360
2:1:1,1,1,106639,93361
6:6:5,0,-1,106640,93360
5:4:3,0,-1,106641,93359
6:2:6,1,1,106640,93360
4:4:1,0,-1,106641,93359
4:2:6,1,1,106640,93360
3:5:2,1,1,106639,93361
3:3:3,0,-1,106640,93360
3:6:3,0,-1,106641,93359
4:3:6,0,-1,106642,93358
1:3:5,0,-1,106643,93357
1:6:4,0,-1,106644,93356
1:6:2,1,1,106643,93357
6:6:5,0,-1,106644,93356
3:5:3,0,-1,106645,93355
6:4:2,1,1,106644,93356
4:2:6,1,1,106643,93357
3:1:5,0,-1,106644,93356
5:2:6,1,1,106643,93357
2:6:3,1,1,106642,93358
1:6:5,0,-1,106643,93357
6:5:3,0,-1,106644,93356
1:4:3,0,-1,106645,93355
4:2:3,1,1,106644,93356
2:4:2,2,2,106642,93358
6:6:4,0,-1,106643,93357
6:2:5,1,1,106642,93358
3:6:5,0,-1,106643,93357
6:2:6,1,1,106642,93358
1:1:5,0,-1,106643,93357
6:6:4,0,-1,106644,93356
3:1:1,0,-1,106645,93355
4:2:2,2,2,106643,93357
1:2:1,1,1,106642,93358
2:3:6,1,1,106641,93359
6:4:2,1,1,106640,93360
5:6:2,1,1,106639,93361
1:2:2,2,2,106637,93363
2:4:6,1,1,106636,93364
4:5:3,0,-1,106637,93363
4:6:5,0,-1,106638,93362
4:1:6,0,-1,106639,93361
6:6:3,0,-1,106640,93360
4:4:5,0,-1,106641,93359
6:5:6,0,-1,106642,93358
5:5:4,0,-1,106643,93357
2:6:6,1,1,106642,93358
4:5:1,0,-1,106643,93357
2:3:6,1,1,106642,93358
1:6:4,0,-1,106643,93357
6:2:6,1,1,106642,93358
4:4:5,0,-1,106643,93357
6:5:5,0,-1,106644,93356
3:5:3,0,-1,106645,93355
4:2:4,1,1,106644,93356
5:4:4,0,-1,106645,93355
6:5:2,1,1,106644,93356
2:6:1,1,1,106643,93357
2:5:2,2,2,106641,93359
2:3:5,1,1,106640,93360
6:5:2,1,1,106639,93361
2:4:2,2,2,106637,93363
5:1:6,0,-1,106638,93362
2:4:5,1,1,106637,93363
1:1:2,1,1,106636,93364
2:2:4,2,2,106634,93366
5:5:2,1,1,106633,93367
2:4:5,1,1,106632,93368
2:2:4,2,2,106630,93370
3:6:6,0,-1,106631,93369
4:1:2,1,1,106630,93370
6:5:1,0,-1,106631,93369
2:2:3,2,2,106629,93371
5:4:4,0,-1,106630,93370
6:3:1,0,-1,106631,93369
2:1:6,1,1,106630,93370
6:1:1,0,-1,106631,93369
4:5:4,0,-1,106632,93368
3:2:1,1,1,106631,93369
6:2:5,1,1,106630,93370
5:1:1,0,-1,106631,93369
6:3:4,0,-1,106632,93368
5:5:5,0,-1,106633,93367
3:2:6,1,1,106632,93368
1:5:6,0,-1,106633,93367
1:6:1,0,-1,106634,93366
6:1:6,0,-1,106635,93365
6:6:1,0,-1,106636,93364
3:2:4,1,1,106635,93365
4:2:6,1,1,106634,93366
1:1:4,0,-1,106635,93365
3:3:3,0,-1,106636,93364
5:2:3,1,1,106635,93365
3:6:4,0,-1,106636,93364
3:1:6,0,-1,106637,93363
4:1:5,0,-1,106638,93362
5:5:2,1,1,106637,93363
6:4:3,0,-1,106638,93362
6:5:6,0,-1,106639,93361
6:6:3,0,-1,106640,93360
2:6:2,2,2,106638,93362
3:4:5,0,-1,106639,93361
5:5:2,1,1,106638,93362
4:6:6,0,-1,106639,93361
3:1:6,0,-1,106640,93360
4:2:2,2,2,106638,93362
6:6:5,0,-1,106639,93361
4:3:3,0,-1,106640,93360
3:6:1,0,-1,106641,93359
5:1:6,0,-1,106642,93358
5:1:6,0,-1,106643,93357
2:5:2,2,2,106641,93359
5:6:2,1,1,106640,93360
4:2:6,1,1,106639,93361
4:3:2,1,1,106638,93362
1:6:3,0,-1,106639,93361
3:4:2,1,1,106638,93362
4:5:5,0,-1,106639,93361
6:3:1,0,-1,106640,93360
4:3:5,0,-1,106641,93359
2:6:4,1,1,106640,93360
6:1:5,0,-1,106641,93359
3:5:3,0,-1,106642,93358
3:3:5,0,-1,106643,93357
5:3:4,0,-1,106644,93356
4:4:2,1,1,106643,93357
5:6:2,1,1,106642,93358
4:6:5,0,-1,106643,93357
4:3:5,0,-1,106644,93356
6:3:5,0,-1,106645,93355
2:4:6,1,1,106644,93356
2:4:5,1,1,106643,93357
3:1:4,0,-1,106644,93356
3:4:3,0,-1,106645,93355
1:6:6,0,-1,106646,93354
1:2:4,1,1,106645,93355
2:4:3,1,1,106644,93356
5:2:3,1,1,106643,93357
4:2:4,1,1,106642,93358
5:5:3,0,-1,106643,93357
6:3:4,0,-1,106644,93356
2:1:6,1,1,106643,93357
1:2:5,1,1,106642,93358
6:3:3,0,-1,106643,93357
4:1:5,0,-1,106644,93356
4:1:2,1,1,106643,93357
2:3:2,2,2,106641,93359
5:1:3,0,-1,106642,93358
3:2:5,1,1,106641,93359
4:5:3,0,-1,106642,93358
3:1:5,0,-1,106643,93357
1:6:4,0,-1,106644,93356
2:3:3,1,1,106643,93357
2:5:3,1,1,106642,93358
4:1:5,0,-1,106643,93357
3:5:3,0,-1,106644,93356
5:3:6,0,-1,106645,93355
1:6:4,0,-1,106646,93354
2:5:1,1,1,106645,93355
2:3:1,1,1,106644,93356
5:5:4,0,-1,106645,93355
4:1:3,0,-1,106646,93354
6:6:3,0,-1,106647,93353
3:3:1,0,-1,106648,93352
2:2:1,2,2,106646,93354
6:5:3,0,-1,106647,93353
6:2:5,1,1,106646,93354
4:3:5,0,-1,106647,93353
4:2:4,1,1,106646,93354
2:6:5,1,1,106645,93355
4:2:6,1,1,106644,93356
2:6:4,1,1,106643,93357
6:4:4,0,-1,106644,93356
2:5:6,1,1,106643,93357
3:1:2,1,1,106642,93358
2:6:4,1,1,106641,93359
6:2:6,1,1,106640,93360
4:1:3,0,-1,106641,93359
3:2:1,1,1,106640,93360
4:2:1,1,1,106639,93361
6:2:2,2,2,106637,93363
4:5:1,0,-1,106638,93362
6:4:2,1,1,106637,93363
1:5:5,0,-1,106638,93362
1:5:3,0,-1,106639,93361
5:1:5,0,-1,106640,93360
1:4:1,0,-1,106641,93359
5:2:6,1,1,106640,93360
2:2:5,2,2,106638,93362
3:2:5,1,1,106637,93363
5:1:4,0,-1,106638,93362
5:1:3,0,-1,106639,93361
4:4:3,0,-1,106640,93360
1:5:3,0,-1,106641,93359
3:6:4,0,-1,106642,93358
5:3:6,0,-1,106643,93357
1:3:6,0,-1,106644,93356
3:4:2,1,1,106643,93357
5:1:1,0,-1,106644,93356
2:6:4,1,1,106643,93357
3:5:2,1,1,106642,93358
3:2:5,1,1,106641,93359
4:1:6,0,-1,106642,93358
3:5:5,0,-1,106643,93357
2:6:6,1,1,106642,93358
2:5:6,1,1,106641,93359
1:5:5,0,-1,106642,93358
4:3:2,1,1,106641,93359
5:5:3,0,-1,106642,93358
2:3:5,1,1,106641,93359
6:1:2,1,1,106640,93360
3:1:3,0,-1,106641,93359
4:5:5,0,-1,106642,93358
1:2:4,1,1,106641,93359
1:1:1,0,-1,106642,93358
5:1:1,0,-1,106643,93357
6:4:5,0,-1,106644,93356
1:2:3,1,1,106643,93357
6:6:1,0,-1,106644,93356
3:1:5,0,-1,106645,93355
3:6:2,1,1,106644,93356
3:6:3,0,-1,106645,93355
2:2:5,2,2,106643,93357
5:4:6,0,-1,106644,93356
4:1:2,1,1,106643,93357
5:6:1,0,-1,106644,93356
6:2:2,2,2,106642,93358
1:1:1,0,-1,106643,93357
1:1:4,0,-1,106644,93356
4:3:6,0,-1,106645,93355
3:6:5,0,-1,106646,93354
4:3:3,0,-1,106647,93353
6:3:5,0,-1,106648,93352
1:1:4,0,-1,106649,93351
6:6:6,0,-1,106650,93350
6:4:1,0,-1,106651,93349
1:4:2,1,1,106650,93350
4:3:4,0,-1,106651,93349
5:3:1,0,-1,106652,93348
6:4:2,1,1,106651,93349
4:2:4,1,1,106650,93350
5:5:6,0,-1,106651,93349
6:3:5,0,-1,106652,93348
4:3:1,0,-1,106653,93347
5:3:4,0,-1,106654,93346
6:5:4,0,-1,106655,93345
6:3:3,0,-1,106656,93344
3:2:6,1,1,106655,93345
3:5:5,0,-1,106656,93344
1:4:3,0,-1,106657,93343
4:5:1,0,-1,106658,93342
6:4:3,0,-1,106659,93341
2:4:1,1,1,106658,93342
6:5:5,0,-1,106659,93341
2:6:4,1,1,106658,93342
4:2:3,1,1,106657,93343
6:3:4,0,-1,106658,93342
4:3:2,1,1,106657,93343
3:4:5,0,-1,106658,93342
6:3:4,0,-1,106659,93341
6:5:1,0,-1,106660,93340
3:3:2,1,1,106659,93341
3:5:4,0,-1,106660,93340
5:3:3,0,-1,106661,93339
5:4:2,1,1,106660,93340
3:4:6,0,-1,106661,93339
1:3:1,0,-1,106662,93338
1:4:6,0,-1,106663,93337
6:4:3,0,-1,106664,93336
5:4:4,0,-1,106665,93335
4:5:6,0,-1,106666,93334
4:6:3,0,-1,106667,93333
3:1:5,0,-1,106668,93332
1:5:3,0,-1,106669,93331
1:6:5,0,-1,106670,93330
1:1:2,1,1,106669,93331
2:1:5,1,1,106668,93332
3:1:5,0,-1,106669,93331
4:3:1,0,-1,106670,93330
4:6:6,0,-1,106671,93329
3:2:3,1,1,106670,93330
5:4:3,0,-1,106671,93329
4:3:3,0,-1,106672,93328
5:2:5,1,1,106671,93329
4:6:5,0,-1,106672,93328
2:2:6,2,2,106670,93330
6:1:2,1,1,106669,93331
6:2:5,1,1,106668,93332
5:3:3,0,-1,106669,93331
3:2:5,1,1,106668,93332
6:4:5,0,-1,106669,93331
5:3:1,0,-1,106670,93330
1:3:5,0,-1,106671,93329
4:3:6,0,-1,106672,93328
5:2:1,1,1,106671,93329
1:5:4,0,-1,106672,93328
6:2:3,1,1,106671,93329
4:5:4,0,-1,106672,93328
3:4:3,0,-1,106673,93327
3:6:5,0,-1,106674,93326
2:5:5,1,1,106673,93327
5:6:3,0,-1,106674,93326
4:3:3,0,-1,106675,93325
6:2:3,1,1,106674,93326
1:1:2,1,1,106673,93327
1:1:1,0,-1,106674,93326
2:5:6,1,1,106673,93327
5:2:6,1,1,106672,93328
1:5:4,0,-1,106673,93327
3:1:3,0,-1,106674,93326
1:6:5,0,-1,106675,93325
6:1:4,0,-1,106676,93324
4:6:6,0,-1,106677,93323
3:5:4,0,-1,106678,93322
6:1:3,0,-1,106679,93321
6:2:3,1,1,106678,93322
3:5:6,0,-1,106679,93321
4:3:5,0,-1,106680,93320
5:5:3,0,-1,106681,93319
6:3:5,0,-1,106682,93318
5:3:5,0,-1,106683,93317
1:6:1,0,-1,106684,93316
1:5:1,0,-1,106685,93315
2:5:3,1,1,106684,93316
3:4:6,0,-1,106685,93315
6:5:6,0,-1,106686,93314
6:3:3,0,-1,106687,93313
2:5:6,1,1,106686,93314
2:2:6,2,2,106684,93316
4:6:2,1,1,106683,93317
5:6:1,0,-1,106684,93316
6:4:1,0,-1,106685,93315
4:3:4,0,-1,106686,93314
4:3:2,1,1,106685,93315
1:5:5,0,-1,106686,93314
1:6:3,0,-1,106687,93313
2:3:1,1,1,106686,93314
4:6:2,1,1,106685,93315
4:2:3,1,1,106684,93316
5:3:1,0,-1,106685,93315
2:5:1,1,1,106684,93316
2:5:3,1,1,106683,93317
5:5:2,1,1,106682,93318
1:1:6,0,-1,106683,93317
6:1:3,0,-1,106684,93316
4:2:2,2,2,106682,93318
4:6:1,0,-1,106683,93317
1:1:4,0,-1,106684,93316
1:1:6,0,-1,106685,93315
4:3:2,1,1,106684,93316
4:5:1,0,-1,106685,93315
2:1:4,1,1,106684,93316
1:3:6,0,-1,106685,93315
6:2:2,2,2,106683,93317
3:2:1,1,1,106682,93318
1:6:1,0,-1,106683,93317
2:3:6,1,1,106682,93318
3:6:5,0,-1,106683,93317
3:4:1,0,-1,106684,93316
3:2:1,1,1,106683,93317
6:6:2,1,1,106682,93318
5:3:4,0,-1,106683,93317
5:3:3,0,-1,106684,93316
1:1:2,1,1,106683,93317
5:4:2,1,1,106682,93318
4:4:1,0,-1,106683,93317
2:1:3,1,1,106682,93318
6:1:4,0,-1,106683,93317
3:4:6,0,-1,106684,93316
5:4:3,0,-1,106685,93315
3:6:1,0,-1,106686,93314
2:4:3,1,1,106685,93315
2:1:4,1,1,106684,93316
3:5:6,0,-1,106685,93315
6:3:1,0,-1,106686,93314
5:6:2,1,1,106685,93315
6:3:3,0,-1,106686,93314
1:3:3,0,-1,106687,93313
5:3:4,0,-1,106688,93312
1:5:2,1,1,106687,93313
4:5:3,0,-1,106688,93312
4:6:6,0,-1,106689,93311
1:1:1,0,-1,106690,93310
5:3:1,0,-1,106691,93309
5:2:2,2,2,106689,93311
5:2:4,1,1,106688,93312
2:3:4,1,1,106687,93313
5:1:4,0,-1,106688,93312
4:4:6,0,-1,106689,93311
6:5:5,0,-1,106690,93310
6:3:6,0,-1,106691,93309
6:4:4,0,-1,106692,93308
2:4:2,2,2,106690,93310
5:1:6,0,-1,106691,93309
3:6:3,0,-1,106692,93308
1:1:3,0,-1,106693,93307
5:6:1,0,-1,106694,93306
1:5:1,0,-1,106695,93305
5:4:1,0,-1,106696,93304
4:1:2,1,1,106695,93305
6:3:6,0,-1,106696,93304
1:3:4,0,-1,106697,93303
2:5:4,1,1,106696,93304
5:1:6,0,-1,106697,93303
5:6:2,1,1,106696,93304
5:1:3,0,-1,106697,93303
1:4:4,0,-1,106698,93302
1:1:3,0,-1,106699,93301
3:2:1,1,1,106698,93302
5:1:6,0,-1,106699,93301
5:5:5,0,-1,106700,93300
2:4:5,1,1,106699,93301
1:4:4,0,-1,106700,93300
4:5:5,0,-1,106701,93299
3:5:6,0,-1,106702,93298
6:3:3,0,-1,106703,93297
2:3:2,2,2,106701,93299
1:4:4,0,-1,106702,93298
3:4:6,0,-1,106703,93297
1:5:1,0,-1,106704,93296
6:3:1,0,-1,106705,93295
1:4:3,0,-1,106706,93294
1:1:5,0,-1,106707,93293
1:3:6,0,-1,106708,93292
4:2:1,1,1,106707,93293
2:1:3,1,1,106706,93294
6:1:3,0,-1,106707,93293
4:6:6,0,-1,106708,93292
4:2:6,1,1,106707,93293
3:6:2,1,1,106706,93294
2:5:1,1,1,106705,93295
2:1:1,1,1,106704,93296
2:1:6,1,1,106703,93297
2:1:4,1,1,106702,93298
4:6:4,0,-1,106703,93297
4:3:1,0,-1,106704,93296
5:2:5,1,1,106703,93297
1:1:2,1,1,106702,93298
5:1:1,0,-1,106703,93297
4:3:2,1,1,106702,93298
5:4:3,0,-1,106703,93297
6:1:6,0,-1,106704,93296
1:4:3,0,-1,106705,93295
1:4:3,0,-1,106706,93294
4:4:3,0,-1,106707,93293
4:2:3,1,1,106706,93294
2:6:5,1,1,106705,93295
3:2:3,1,1,106704,93296
5:1:3,0,-1,106705,93295
3:2:6,1,1,106704,93296
1:3:5,0,-1,106705,93295
5:5:5,0,-1,106706,93294
6:4:1,0,-1,106707,93293
2:3:3,1,1,106706,93294
2:6:4,1,1,106705,93295
2:6:5,1,1,106704,93296
4:3:4,0,-1,106705,93295
4:1:6,0,-1,106706,93294
5:1:3,0,-1,106707,93293
3:2:5,1,1,106706,93294
3:6:5,0,-1,106707,93293
3:6:1,0,-1,106708,93292
6:4:2,1,1,106707,93293
3:2:3,1,1,106706,93294
4:5:1,0,-1,106707,93293
1:1:6,0,-1,106708,93292
4:4:3,0,-1,106709,93291
2:4:1,1,1,106708,93292
1:3:2,1,1,106707,93293
4:1:2,1,1,106706,93294
1:1:2,1,1,106705,93295
4:4:2,1,1,106704,93296
3:5:2,1,1,106703,93297
6:2:3,1,1,106702,93298
2:2:1,2,2,106700,93300
5:6:1,0,-1,106701,93299
5:2:4,1,1,106700,93300
4:3:3,0,-1,106701,93299
5:2:3,1,1,106700,93300
2:3:2,2,2,106698,93302
1:1:5,0,-1,106699,93301
1:4:5,0,-1,106700,93300
6:4:2,1,1,106699,93301
5:2:4,1,1,106698,93302
4:2:3,1,1,106697,93303
5:5:3,0,-1,106698,93302
1:6:3,0,-1,106699,93301
5:5:5,0,-1,106700,93300
5:5:3,0,-1,106701,93299
4:5:4,0,-1,106702,93298
4:4:6,0,-1,106703,93297
6:4:5,0,-1,106704,93296
6:2:2,2,2,106702,93298
6:5:5,0,-1,106703,93297
6:5:6,0,-1,106704,93296
6:6:1,0,-1,106705,93295
3:1:1,0,-1,106706,93294
6:3:5,0,-1,106707,93293
5:5:4,0,-1,106708,93292
4:2:5,1,1,106707,93293
4:4:6,0,-1,106708,93292
6:2:6,1,1,106707,93293
5:5:1,0,-1,106708,93292
4:1:1,0,-1,106709,93291
2:2:5,2,2,106707,93293
1:3:4,0,-1,106708,93292
1:1:1,0,-1,106709,93291
6:3:1,0,-1,106710,93290
2:6:1,1,1,106709,93291
4:6:5,0,-1,106710,93290
3:2:1,1,1,106709,93291
3:1:5,0,-1,106710,93290
2:6:3,1,1,106709,93291
4:1:4,0,-1,106710,93290
3:3:6,0,-1,106711,93289
6:6:4,0,-1,106712,93288
5:1:1,0,-1,106713,93287
4:2:2,2,2,106711,93289
3:6:6,0,-1,106712,93288
2:3:6,1,1,106711,93289
3:1:1,0,-1,106712,93288
4:4:4,0,-1,106713,93287
2:2:1,2,2,106711,93289
5:5:5,0,-1,106712,93288
4:2:4,1,1,106711,93289
3:3:5,0,-1,106712,93288
1:1:1,0,-1,106713,93287
2:3:4,1,1,106712,93288
5:5:5,0,-1,106713,93287
2:6:6,1,1,106712,93288
4:5:1,0,-1,106713,93287
3:2:6,1,1,106712,93288
4:4:1,0,-1,106713,93287
6:5:1,0,-1,106714,93286
2:5:5,1,1,106713,93287
2:6:3,1,1,106712,93288
4:1:4,0,-1,106713,93287
3:2:4,1,1,106712,93288
1:2:6,1,1,106711,93289
6:1:5,0,-1,106712,93288
3:5:1,0,-1,106713,93287
4:6:2,1,1,106712,93288
3:6:4,0,-1,106713,93287
6:6:1,0,-1,106714,93286
6:6:4,0,-1,106715,93285
3:1:2,1,1,106714,93286
6:2:1,1,1,106713,93287
1:6:1,0,-1,106714,93286
4:2:4,1,1,106713,93287
3:3:6,0,-1,106714,93286
6:6:6,0,-1,106715,93285
2:1:3,1,1,106714,93286
1:6:5,0,-1,106715,93285
1:6:6,0,-1,106716,93284
6:6:6,0,-1,106717,93283
1:3:2,1,1,106716,93284
1:4:1,0,-1,106717,93283
6:1:3,0,-1,106718,93282
5:4:6,0,-1,106719,93281
2:5:5,1,1,106718,93282
4:6:1,0,-1,106719,93281
2:6:2,2,2,106717,93283
2:4:2,2,2,106715,93285
1:2:2,2,2,106713,93287
5:6:3,0,-1,106714,93286
6:3:5,0,-1,106715,93285
3:3:1,0,-1,106716,93284
1:3:1,0,-1,106717,93283
3:1:3,0,-1,106718,93282
1:2:4,1,1,106717,93283
2:6:4,1,1,106716,93284
1:1:3,0,-1,106717,93283
4:2:6,1,1,106716,93284
5:5:2,1,1,106715,93285
1:1:2,1,1,106714,93286
6:1:3,0,-1,106715,93285
1:1:4,0,-1,106716,93284
6:3:5,0,-1,106717,93283
1:2:6,1,1,106716,93284
1:2:3,1,1,106715,93285
2:5:5,1,1,106714,93286
3:6:4,0,-1,106715,93285
4:5:5,0,-1,106716,93284
1:6:4,0,-1,106717,93283
4:5:1,0,-1,106718,93282
1:5:2,1,1,106717,93283
3:5:3,0,-1,106718,93282
3:2:2,2,2,106716,93284
4:6:2,1,1,106715,93285
3:5:5,0,-1,106716,93284
2:1:1,1,1,106715,93285
4:3:2,1,1,106714,93286
2:2:6,2,2,106712,93288
1:6:3,0,-1,106713,93287
5:3:1,0,-1,106714,93286
1:5:2,1,1,106713,93287
4:2:6,1,1,106712,93288
5:4:5,0,-1,106713,93287
3:4:2,1,1,106712,93288
1:4:1,0,-1,106713,93287
3:4:2,1,1,106712,93288
3:4:6,0,-1,106713,93287
2:6:2,2,2,106711,93289
5:4:2,1,1,106710,93290
2:6:6,1,1,106709,93291
6:2:4,1,1,106708,93292
1:2:1,1,1,106707,93293
6:1:1,0,-1,106708,93292
1:5:3,0,-1,106709,93291
1:4:3,0,-1,106710,93290
1:4:1,0,-1,106711,93289
4:2:4,1,1,106710,93290
4:5:5,0,-1,106711,93289
1:3:6,0,-1,106712,93288
6:1:6,0,-1,106713,93287
6:2:6,1,1,106712,93288
1:5:6,0,-1,106713,93287
2:4:2,2,2,106711,93289
2:3:5,1,1,106710,93290
5:1:6,0,-1,106711,93289
1:1:6,0,-1,106712,93288
6:6:3,0,-1,106713,93287
4:4:3,0,-1,106714,93286
5:4:4,0,-1,106715,93285
6:5:1,0,-1,106716,93284
1:5:3,0,-1,106717,93283
6:3:4,0,-1,106718,93282
3:1:5,0,-1,106719,93281
2:2:6,2,2,106717,93283
6:5:6,0,-1,106718,93282
6:3:2,1,1,106717,93283
3:5:4,0,-1,106718,93282
2:6:6,1,1,106717,93283
2:3:1,1,1,106716,93284
4:3:4,0,-1,106717,93283
5:1:3,0,-1,106718,93282
3:4:5,0,-1,106719,93281
3:3:1,0,-1,106720,93280
1:4:3,0,-1,106721,93279
6:4:4,0,-1,106722,93278
1:4:3,0,-1,106723,93277
4:2:5,1,1,106722,93278
6:1:1,0,-1,106723,93277
5:5:4,0,-1,106724,93276
4:6:2,1,1,106723,93277
3:3:1,0,-1,106724,93276
6:1:6,0,-1,106725,93275
4:1:1,0,-1,106726,93274
1:3:3,0,-1,106727,93273
4:4:6,0,-1,106728,93272
6:5:5,0,-1,106729,93271
4:1:2,1,1,106728,93272
5:4:2,1,1,106727,93273
1:1:5,0,-1,106728,93272
4:2:5,1,1,106727,93273
6:4:5,0,-1,106728,93272
1:5:4,0,-1,106729,93271
2:4:1,1,1,106728,93272
4:1:5,0,-1,106729,93271
4:6:4,0,-1,106730,93270
1:1:4,0,-1,106731,93269
3:2:5,1,1,106730,93270
6:2:5,1,1,106729,93271
6:4:3,0,-1,106730,93270
2:3:2,2,2,106728,93272
5:3:4,0,-1,106729,93271
3:3:1,0,-1,106730,93270
4:2:6,1,1,106729,93271
1:1:6,0,-1,106730,93270
2:3:6,1,1,106729,93271
1:2:5,1,1,106728,93272
6:2:1,1,1,106727,93273
2:5:1,1,1,106726,93274
6:2:4,1,1,106725,93275
4:6:6,0,-1,106726,93274
1:3:3,0,-1,106727,93273
3:6:4,0,-1,106728,93272
3:3:4,0,-1,106729,93271
2:3:4,1,1,106728,93272
4:4:3,0,-1,106729,93271
4:4:2,1,1,106728,93272
1:1:6,0,-1,106729,93271
3:5:4,0,-1,106730,93270
1:2:6,1,1,106729,93271
2:6:6,1,1,106728,93272
6:4:5,0,-1,106729,93271
5:1:4,0,-1,106730,93270
1:5:3,0,-1,106731,93269
4:3:3,0,-1,106732,93268
5:3:4,0,-1,106733,93267
5:3:3,0,-1,106734,93266
2:3:3,1,1,106733,93267
3:3:3,0,-1,106734,93266
6:4:3,0,-1,106735,93265
5:6:1,0,-1,106736,93264
3:4:3,0,-1,106737,93263
6:1:4,0,-1,106738,93262
3:4:1,0,-1,106739,93261
4:2:1,1,1,106738,93262
2:2:4,2,2,106736,93264
2:2:3,2,2,106734,93266
1:3:2,1,1,106733,93267
6:3:4,0,-1,106734,93266
2:2:1,2,2,106732,93268
6:5:3,0,-1,106733,93267
6:1:5,0,-1,106734,93266
3:3:6,0,-1,106735,93265
6:2:4,1,1,106734,93266
4:3:2,1,1,106733,93267
2:1:3,1,1,106732,93268
5:4:2,1,1,106731,93269
3:5:3,0,-1,106732,93268
4:4:3,0,-1,106733,93267
1:4:6,0,-1,106734,93266
5:5:1,0,-1,106735,93265
6:4:3,0,-1,106736,93264
3:5:2,1,1,106735,93265
2:1:1,1,1,106734,93266
6:4:1,0,-1,106735,93265
1:5:5,0,-1,106736,93264
5:5:2,1,1,106735,93265
3:6:6,0,-1,106736,93264
6:3:5,0,-1,106737,93263
1:3:1,0,-1,106738,93262
5:6:6,0,-1,106739,93261
6:5:6,0,-1,106740,93260
2:1:4,1,1,106739,93261
4:5:1,0,-1,106740,93260
6:2:1,1,1,106739,93261
5:2:5,1,1,106738,93262
3:6:5,0,-1,106739,93261
5:3:5,0,-1,106740,93260
4:1:1,0,-1,106741,93259
5:5:4,0,-1,106742,93258
5:6:6,0,-1,106743,93257
1:3:6,0,-1,106744,93256
6:6:5,0,-1,106745,93255
1:1:2,1,1,106744,93256
3:2:5,1,1,106743,93257
3:1:6,0,-1,106744,93256
2:6:1,1,1,106743,93257
4:2:4,1,1,106742,93258
6:5:2,1,1,106741,93259
2:5:3,1,1,106740,93260
1:6:5,0,-1,106741,93259
1:2:2,2,2,106739,93261
2:2:2,3,3,106736,93264
5:5:2,1,1,106735,93265
3:4:4,0,-1,106736,93264
2:5:5,1,1,106735,93265
4:6:4,0,-1,106736,93264
2:5:3,1,1,106735,93265
2:5:4,1,1,106734,93266
5:3:5,0,-1,106735,93265
3:2:4,1,1,106734,93266
1:6:6,0,-1,106735,93265
3:6:6,0,-1,106736,93264
3:1:2,1,1,106735,93265
6:6:1,0,-1,106736,93264
5:4:1,0,-1,106737,93263
6:4:6,0,-1,106738,93262
3:6:1,0,-1,106739,93261
5:2:2,2,2,106737,93263
4:4:6,0,-1,106738,93262
2:4:3,1,1,106737,93263
5:3:1,0,-1,106738,93262
5:4:3,0,-1,106739,93261
4:2:5,1,1,106738,93262
5:6:2,1,1,106737,93263
4:1:4,0,-1,106738,93262
2:1:4,1,1,106737,93263
6:4:4,0,-1,106738,93262
4:2:3,1,1,106737,93263
2:5:1,1,1,106736,93264
1:3:3,0,-1,106737,93263
6:3:1,0,-1,106738,93262
6:5:5,0,-1,106739,93261
6:6:2,1,1,106738,93262
3:5:4,0,-1,106739,93261
2:5:6,1,1,106738,93262
6:6:3,0,-1,106739,93261
2:6:3,1,1,106738,93262
2:5:2,2,2,106736,93264
5:5:1,0,-1,106737,93263
3:2:4,1,1,106736,93264
4:6:5,0,-1,106737,93263
1:1:1,0,-1,106738,93262
5:1:3,0,-1,106739,93261
2:1:3,1,1,106738,93262
1:1:2,1,1,106737,93263
1:2:5,1,1,106736,93264
4:3:2,1,1,106735,93265
3:4:6,0,-1,106736,93264
1:4:2,1,1,106735,93265
5:2:3,1,1,106734,93266
4:1:5,0,-1,106735,93265
1:5:4,0,-1,106736,93264
4:6:4,0,-1,106737,93263
5:1:1,0,-1,106738,93262
5:2:2,2,2,106736,93264
4:2:1,1,1,106735,93265
3:4:5,0,-1,106736,93264
6:4:2,1,1,106735,93265
3:6:3,0,-1,106736,93264
6:5:6,0,-1,106737,93263
6:1:2,1,1,106736,93264
1:6:1,0,-1,106737,93263
4:5:6,0,-1,106738,93262
1:3:6,0,-1,106739,93261
3:5:3,0,-1,106740,93260
5:6:1,0,-1,106741,93259
5:1:5,0,-1,106742,93258
2:5:6,1,1,106741,93259
4:6:6,0,-1,106742,93258
5:1:5,0,-1,106743,93257
5:3:6,0,-1,106744,93256
2:5:5,1,1,106743,93257
5:2:2,2,2,106741,93259
5:4:6,0,-1,106742,93258
5:2:2,2,2,106740,93260
2:1:1,1,1,106739,93261
1:2:4,1,1,106738,93262
4:1:1,0,-1,106739,93261
6:3:1,0,-1,106740,93260
1:3:4,0,-1,106741,93259
2:1:4,1,1,106740,93260
2:5:1,1,1,106739,93261
6:3:1,0,-1,106740,93260
2:3:1,1,1,106739,93261
3:5:1,0,-1,106740,93260
6:4:3,0,-1,106741,93259
4:4:5,0,-1,106742,93258
2:3:1,1,1,106741,93259
1:4:5,0,-1,106742,93258
2:5:1,1,1,106741,93259
2:1:3,1,1,106740,93260
6:5:4,0,-1,106741,93259
4:4:5,0,-1,106742,93258
5:4:5,0,-1,106743,93257
4:2:3,1,1,106742,93258
6:4:3,0,-1,106743,93257
4:4:6,0,-1,106744,93256
5:1:3,0,-1,106745,93255
3:2:4,1,1,106744,93256
2:2:2,3,3,106741,93259
4:5:6,0,-1,106742,93258
1:5:6,0,-1,106743,93257
6:1:3,0,-1,106744,93256
4:3:4,0,-1,106745,93255
2:6:6,1,1,106744,93256
4:6:3,0,-1,106745,93255
2:3:6,1,1,106744,93256
3:5:6,0,-1,106745,93255
6:4:3,0,-1,106746,93254
4:3:5,0,-1,106747,93253
3:4:5,0,-1,106748,93252
2:1:4,1,1,106747,93253
1:1:2,1,1,106746,93254
3:3:4,0,-1,106747,93253
5:3:3,0,-1,106748,93252
3:2:5,1,1,106747,93253
5:6:3,0,-1,106748,93252
6:6:6,0,-1,106749,93251
5:5:5,0,-1,106750,93250
6:3:1,0,-1,106751,93249
2:6:4,1,1,106750,93250
2:6:1,1,1,106749,93251
1:5:6,0,-1,106750,93250
3:2:3,1,1,106749,93251
3:2:4,1,1,106748,93252
4:4:4,0,-1,106749,93251
4:6:5,0,-1,106750,93250
6:4:5,0,-1,106751,93249
4:1:5,0,-1,106752,93248
6:6:1,0,-1,106753,93247
3:4:2,1,1,106752,93248
1:4:4,0,-1,106753,93247
5:4:2,1,1,106752,93248
2:4:6,1,1,106751,93249
1:5:2,1,1,106750,93250
1:2:5,1,1,106749,93251
5:3:5,0,-1,106750,93250
2:1:4,1,1,106749,93251
5:5:6,0,-1,106750,93250
3:5:4,0,-1,106751,93249
4:4:2,1,1,106750,93250
5:2:5,1,1,106749,93251
1:3:1,0,-1,106750,93250
4:3:1,0,-1,106751,93249
2:5:3,1,1,106750,93250
4:2:6,1,1,106749,93251
4:6:6,0,-1,106750,93250
4:1:4,0,-1,106751,93249
2:6:4,1,1,106750,93250
4:6:5,0,-1,106751,93249
5:4:4,0,-1,106752,93248
1:4:3,0,-1,106753,93247
2:1:6,1,1,106752,93248
6:4:2,1,1,106751,93249
4:4:5,0,-1,106752,93248
5:2:5,1,1,106751,93249
2:2:5,2,2,106749,93251
5:5:2,1,1,106748,93252
6:3:4,0,-1,106749,93251
6:2:4,1,1,106748,93252
6:5:4,0,-1,106749,93251
4:6:6,0,-1,106750,93250
6:6:6,0,-1,106751,93249
4:3:2,1,1,106750,93250
4:3:4,0,-1,106751,93249
4:6:3,0,-1,106752,93248
6:2:3,1,1,106751,93249
6:5:3,0,-1,106752,93248
4:2:1,1,1,106751,93249
3:1:6,0,-1,106752,93248
5:1:2,1,1,106751,93249
2:4:2,2,2,106749,93251
3:4:6,0,-1,106750,93250
4:1:1,0,-1,106751,93249
1:2:2,2,2,106749,93251
3:1:4,0,-1,106750,93250
3:3:3,0,-1,106751,93249
4:4:4,0,-1,106752,93248
1:5:2,1,1,106751,93249
1:1:1,0,-1,106752,93248
2:6:4,1,1,106751,93249
3:5:4,0,-1,106752,93248
1:2:6,1,1,106751,93249
5:5:1,0,-1,106752,93248
5:5:6,0,-1,106753,93247
3:1:2,1,1,106752,93248
6:1:2,1,1,106751,93249
1:4:5,0,-1,106752,93248
4:1:1,0,-1,106753,93247
6:4:4,0,-1,106754,93246
3:5:5,0,-1,106755,93245
3:3:2,1,1,106754,93246
3:4:3,0,-1,106755,93245
2:3:6,1,1,106754,93246
5:4:5,0,-1,106755,93245
4:1:6,0,-1,106756,93244
4:6:2,1,1,106755,93245
4:2:4,1,1,106754,93246
4:5:1,0,-1,106755,93245
5:4:3,0,-1,106756,93244
6:6:2,1,1,106755,93245
1:6:3,0,-1,106756,93244
4:2:3,1,1,106755,93245
5:3:1,0,-1,106756,93244
4:6:6,0,-1,106757,93243
3:3:6,0,-1,106758,93242
6:6:5,0,-1,106759,93241
6:1:1,0,-1,106760,93240
4:6:5,0,-1,106761,93239
6:2:2,2,2,106759,93241
2:1:6,1,1,106758,93242
6:3:6,0,-1,106759,93241
3:6:5,0,-1,106760,93240
2:3:5,1,1,106759,93241
5:5:3,0,-1,106760,93240
2:6:5,1,1,106759,93241
4:3:5,0,-1,106760,93240
1:5:6,0,-1,106761,93239
5:2:4,1,1,106760,93240
4:6:2,1,1,106759,93241
5:4:1,0,-1,106760,93240
6:6:6,0,-1,106761,93239
5:5:5,0,-1,106762,93238
4:1:1,0,-1,106763,93237
6:3:1,0,-1,106764,93236
4:3:5,0,-1,106765,93235
1:2:2,2,2,106763,93237
6:5:5,0,-1,106764,93236
1:6:5,0,-1,106765,93235
5:3:6,0,-1,106766,93234
3:2:5,1,1,106765,93235
4:2:3,1,1,106764,93236
2:4:1,1,1,106763,93237
5:1:1,0,-1,106764,93236
3:5:1,0,-1,106765,93235
2:6:3,1,1,106764,93236
3:6:1,0,-1,106765,93235
6:3:3,0,-1,106766,93234
6:2:1,1,1,106765,93235
6:3:6,0,-1,106766,93234
4:4:2,1,1,106765,93235
2:2:2,3,3,106762,93238
2:2:5,2,2,106760,93240
3:6:5,0,-1,106761,93239
1:4:6,0,-1,106762,93238
3:1:2,1,1,106761,93239
2:2:4,2,2,106759,93241
5:6:1,0,-1,106760,93240
5:1:1,0,-1,106761,93239
4:2:1,1,1,106760,93240
6:4:1,0,-1,106761,93239
2:5:5,1,1,106760,93240
6:2:2,2,2,106758,93242
6:6:3,0,-1,106759,93241
1:6:3,0,-1,106760,93240
5:6:4,0,-1,106761,93239
6:2:4,1,1,106760,93240
6:5:4,0,-1,106761,93239
6:2:4,1,1,106760,93240
1:3:1,0,-1,106761,93239
1:4:6,0,-1,106762,93238
6:1:3,0,-1,106763,93237
2:6:3,1,1,106762,93238
4:6:1,0,-1,106763,93237
6:1:2,1,1,106762,93238
1:6:5,0,-1,106763,93237
2:4:2,2,2,106761,93239
3:6:5,0,-1,106762,93238
3:6:3,0,-1,106763,93237
2:6:3,1,1,106762,93238
3:3:2,1,1,106761,93239
6:5:3,0,-1,106762,93238
4:6:6,0,-1,106763,93237
4:4:5,0,-1,106764,93236
3:4:5,0,-1,106765,93235
1:5:6,0,-1,106766,93234
3:3:3,0,-1,106767,93233
1:2:2,2,2,106765,93235
1:6:2,1,1,106764,93236
4:1:6,0,-1,106765,93235
1:4:3,0,-1,106766,93234
2:6:6,1,1,106765,93235
1:6:2,1,1,106764,93236
2:4:4,1,1,106763,93237
5:4:1,0,-1,106764,93236
2:2:2,3,3,106761,93239
1:5:3,0,-1,106762,93238
4:4:6,0,-1,106763,93237
4:1:3,0,-1,106764,93236
3:4:5,0,-1,106765,93235
1:6:2,1,1,106764,93236
1:5:3,0,-1,106765,93235
6:6:2,1,1,106764,93236
3:3:3,0,-1,106765,93235
2:5:1,1,1,106764,93236
4:4:5,0,-1,106765,93235
5:4:5,0,-1,106766,93234
4:5:4,0,-1,106767,93233
6:5:6,0,-1,106768,93232
5:2:2,2,2,106766,93234
5:4:5,0,-1,106767,93233
2:5:1,1,1,106766,93234
1:3:2,1,1,106765,93235
5:5:2,1,1,106764,93236
1:3:4,0,-1,106765,93235
4:3:3,0,-1,106766,93234
4:4:2,1,1,106765,93235
1:4:5,0,-1,106766,93234
6:6:2,1,1,106765,93235
5:1:5,0,-1,106766,93234
6:2:4,1,1,106765,93235
3:5:1,0,-1,106766,93234
3:5:3,0,-1,106767,93233
2:6:6,1,1,106766,93234
2:4:4,1,1,106765,93235
1:6:1,0,-1,106766,93234
3:3:6,0,-1,106767,93233
4:2:2,2,2,106765,93235
4:4:2,1,1,106764,93236
3:2:4,1,1,106763,93237
4:1:4,0,-1,106764,93236
6:1:6,0,-1,106765,93235
2:3:6,1,1,106764,93236
1:2:1,1,1,106763,93237
2:3:5,1,1,106762,93238
5:3:2,1,1,106761,93239
4:1:3,0,-1,106762,93238
6:5:4,0,-1,106763,93237
1:1:6,0,-1,106764,93236
4:5:4,0,-1,106765,93235
6:5:3,0,-1,106766,93234
3:6:5,0,-1,106767,93233
5:4:2,1,1,106766,93234
6:3:5,0,-1,106767,93233
4:5:3,0,-1,106768,93232
4:4:1,0,-1,106769,93231
2:2:6,2,2,106767,93233
2:5:1,1,1,106766,93234
5:3:1,0,-1,106767,93233
5:2:6,1,1,106766,93234
5:6:5,0,-1,106767,93233
2:4:6,1,1,106766,93234
3:6:3,0,-1,106767,93233
2:1:4,1,1,106766,93234
3:2:3,1,1,106765,93235
2:4:4,1,1,106764,93236
6:2:4,1,1,106763,93237
3:4:5,0,-1,106764,93236
6:5:4,0,-1,106765,93235
1:4:5,0,-1,106766,93234
3:1:1,0,-1,106767,93233
1:5:5,0,-1,106768,93232
2:6:1,1,1,106767,93233
2:1:2,2,2,106765,93235
4:2:4,1,1,106764,93236
3:1:3,0,-1,106765,93235
4:4:6,0,-1,106766,93234
6:1:4,0,-1,106767,93233
3:3:1,0,-1,106768,93232
2:1:2,2,2,106766,93234
4:6:4,0,-1,106767,93233
1:1:1,0,-1,106768,93232
2:3:1,1,1,106767,93233
5:3:5,0,-1,106768,93232
1:4:5,0,-1,106769,93231
2:6:5,1,1,106768,93232
3:4:4,0,-1,106769,93231
3:2:6,1,1,106768,93232
3:6:1,0,-1,106769,93231
5:5:2,1,1,106768,93232
4:2:3,1,1,106767,93233
2:1:1,1,1,106766,93234
6:3:1,0,-1,106767,93233
1:4:6,0,-1,106768,93232
1:2:6,1,1,106767,93233
3:3:3,0,-1,106768,93232
6:4:2,1,1,106767,93233
4:3:5,0,-1,106768,93232
6:6:2,1,1,106767,93233
5:5:3,0,-1,106768,93232
5:4:1,0,-1,106769,93231
2:1:5,1,1,106768,93232
6:3:3,0,-1,106769,93231
6:2:5,1,1,106768,93232
5:3:1,0,-1,106769,93231
3:5:2,1,1,106768,93232
6:1:4,0,-1,106769,93231
4:2:6,1,1,106768,93232
2:2:2,3,3,106765,93235
6:3:4,0,-1,106766,93234
6:4:3,0,-1,106767,93233
3:5:4,0,-1,106768,93232
1:6:6,0,-1,106769,93231
2:6:4,1,1,106768,93232
6:4:1,0,-1,106769,93231
2:4:2,2,2,106767,93233
6:2:5,1,1,106766,93234
6:1:5,0,-1,106767,93233
1:5:5,0,-1,106768,93232
2:4:6,1,1,106767,93233
6:1:4,0,-1,106768,93232
2:4:2,2,2,106766,93234
1:5:6,0,-1,106767,93233
5:5:3,0,-1,106768,93232
2:4:2,2,2,106766,93234
1:5:6,0,-1,106767,93233
5:4:5,0,-1,106768,93232
1:1:5,0,-1,106769,93231
5:3:1,0,-1,106770,93230
1:6:6,0,-1,106771,93229
2:5:6,1,1,106770,93230
2:2:4,2,2,106768,93232
2:2:5,2,2,106766,93234
3:6:2,1,1,106765,93235
4:1:4,0,-1,106766,93234
1:3:3,0,-1,106767,93233
6:6:3,0,-1,106768,93232
5:3:2,1,1,106767,93233
3:1:3,0,-1,106768,93232
2:4:5,1,1,106767,93233
1:6:5,0,-1,106768,93232
4:4:4,0,-1,106769,93231
2:4:5,1,1,106768,93232
5:3:5,0,-1,106769,93231
1:2:2,2,2,106767,93233
1:2:1,1,1,106766,93234
3:6:2,1,1,106765,93235
2:4:3,1,1,106764,93236
6:5:2,1,1,106763,93237
6:3:5,0,-1,106764,93236
1:5:5,0,-1,106765,93235
5:4:3,0,-1,106766,93234
6:5:6,0,-1,106767,93233
3:5:2,1,1,106766,93234
3:6:1,0,-1,106767,93233
5:1:3,0,-1,106768,93232
4:5:1,0,-1,106769,93231
3:2:6,1,1,106768,93232
2:1:5,1,1,106767,93233
1:5:4,0,-1,106768,93232
1:3:2,1,1,106767,93233
3:6:3,0,-1,106768,93232
3:6:6,0,-1,106769,93231
4:2:1,1,1,106768,93232
2:5:6,1,1,106767,93233
5:2:3,1,1,106766,93234
5:5:6,0,-1,106767,93233
4:6:2,1,1,106766,93234
1:3:5,0,-1,106767,93233
6:1:2,1,1,106766,93234
5:5:4,0,-1,106767,93233
5:1:6,0,-1,106768,93232
6:6:5,0,-1,106769,93231
4:2:4,1,1,106768,93232
6:2:2,2,2,106766,93234
6:4:3,0,-1,106767,93233
1:1:6,0,-1,106768,93232
6:2:5,1,1,106767,93233
1:2:4,1,1,106766,93234
3:6:2,1,1,106765,93235
5:2:4,1,1,106764,93236
4:6:1,0,-1,106765,93235
3:4:3,0,-1,106766,93234
6:5:1,0,-1,106767,93233
6:2:4,1,1,106766,93234
1:3:1,0,-1,106767,93233
3:2:4,1,1,106766,93234
1:4:4,0,-1,106767,93233
5:5:3,0,-1,106768,93232
2:1:5,1,1,106767,93233
5:4:1,0,-1,106768,93232
5:1:1,0,-1,106769,93231
5:6:1,0,-1,106770,93230
1:2:6,1,1,106769,93231
3:4:6,0,-1,106770,93230
5:1:1,0,-1,106771,93229
5:5:6,0,-1,106772,93228
4:2:6,1,1,106771,93229
6:4:1,0,-1,106772,93228
2:2:3,2,2,106770,93230
6:3:1,0,-1,106771,93229
1:2:2,2,2,106769,93231
4:6:1,0,-1,106770,93230
5:6:6,0,-1,106771,93229
3:5:2,1,1,106770,93230
3:4:3,0,-1,106771,93229
5:3:6,0,-1,106772,93228
1:3:3,0,-1,106773,93227
2:1:1,1,1,106772,93228
2:2:4,2,2,106770,93230
4:2:3,1,1,106769,93231
6:3:5,0,-1,106770,93230
2:4:5,1,1,106769,93231
4:3:1,0,-1,106770,93230
6:2:4,1,1,106769,93231
4:1:5,0,-1,106770,93230
6:1:2,1,1,106769,93231
2:1:1,1,1,106768,93232
4:5:5,0,-1,106769,93231
2:5:6,1,1,106768,93232
1:2:6,1,1,106767,93233
5:3:2,1,1,106766,93234
2:3:2,2,2,106764,93236
3:1:1,0,-1,106765,93235
4:1:5,0,-1,106766,93234
1:5:1,0,-1,106767,93233
2:6:3,1,1,106766,93234
1:5:4,0,-1,106767,93233
5:4:2,1,1,106766,93234
5:2:5,1,1,106765,93235
1:1:2,1,1,106764,93236
5:5:3,0,-1,106765,93235
2:5:2,2,2,106763,93237
1:4:4,0,-1,106764,93236
1:3:2,1,1,106763,93237
2:6:1,1,1,106762,93238
5:5:5,0,-1,106763,93237
6:4:6,0,-1,106764,93236
2:1:5,1,1,106763,93237
4:6:5,0,-1,106764,93236
6:5:5,0,-1,106765,93235
5:3:6,0,-1,106766,93234
6:1:6,0,-1,106767,93233
2:6:4,1,1,106766,93234
1:1:2,1,1,106765,93235
1:3:2,1,1,106764,93236
2:6:6,1,1,106763,93237
1:1:5,0,-1,106764,93236
4:3:4,0,-1,106765,93235
5:2:3,1,1,106764,93236
2:5:2,2,2,106762,93238
1:4:6,0,-1,106763,93237
5:5:6,0,-1,106764,93236
3:6:1,0,-1,106765,93235
2:2:4,2,2,106763,93237
5:3:3,0,-1,106764,93236
1:1:3,0,-1,106765,93235
3:4:2,1,1,106764,93236
2:5:6,1,1,106763,93237
1:2:5,1,1,106762,93238
1:2:5,1,1,106761,93239
5:1:5,0,-1,106762,93238
2:6:2,2,2,106760,93240
5:4:4,0,-1,106761,93239
3:4:6,0,-1,106762,93238
2:4:1,1,1,106761,93239
3:5:6,0,-1,106762,93238
5:1:6,0,-1,106763,93237
2:6:5,1,1,106762,93238
6:6:4,0,-1,106763,93237
3:2:6,1,1,106762,93238
6:1:5,0,-1,106763,93237
6:5:2,1,1,106762,93238
5:2:4,1,1,106761,93239
2:6:5,1,1,106760,93240
6:6:3,0,-1,106761,93239
5:2:4,1,1,106760,93240
1:2:2,2,2,106758,93242
6:1:4,0,-1,106759,93241
2:1:3,1,1,106758,93242
3:6:3,0,-1,106759,93241
1:3:1,0,-1,106760,93240
5:3:6,0,-1,106761,93239
3:2:1,1,1,106760,93240
3:1:5,0,-1,106761,93239
1:1:1,0,-1,106762,93238
4:2:3,1,1,106761,93239
1:4:5,0,-1,106762,93238
4:6:2,1,1,106761,93239
2:3:5,1,1,106760,93240
5:3:2,1,1,106759,93241
3:6:4,0,-1,106760,93240
2:5:1,1,1,106759,93241
4:4:4,0,-1,106760,93240
6:6:1,0,-1,106761,93239
6:6:1,0,-1,106762,93238
1:3:2,1,1,106761,93239
5:5:1,0,-1,106762,93238
3:3:6,0,-1,106763,93237
4:3:2,1,1,106762,93238
3:2:6,1,1,106761,93239
3:5:6,0,-1,106762,93238
1:4:6,0,-1,106763,93237
6:6:6,0,-1,106764,93236
6:3:2,1,1,106763,93237
1:2:5,1,1,106762,93238
4:1:2,1,1,106761,93239
6:4:3,0,-1,106762,93238
1:2:3,1,1,106761,93239
1:6:3,0,-1,106762,93238
6:1:6,0,-1,106763,93237
1:1:3,0,-1,106764,93236
2:1:5,1,1,106763,93237
4:3:5,0,-1,106764,93236
1:1:4,0,-1,106765,93235
6:4:2,1,1,106764,93236
5:2:5,1,1,106763,93237
6:1:2,1,1,106762,93238
5:1:4,0,-1,106763,93237
6:5:4,0,-1,106764,93236
3:3:1,0,-1,106765,93235
3:2:6,1,1,106764,93236
3:1:4,0,-1,106765,93235
5:1:6,0,-1,106766,93234
3:6:5,0,-1,106767,93233
3:6:4,0,-1,106768,93232
5:1:2,1,1,106767,93233
4:5:1,0,-1,106768,93232
3:2:4,1,1,106767,93233
1:4:2,1,1,106766,93234
2:1:1,1,1,106765,93235
3:2:4,1,1,106764,93236
2:6:1,1,1,106763,93237
1:4:1,0,-1,106764,93236
3:5:5,0,-1,106765,93235
2:1:3,1,1,106764,93236
2:3:5,1,1,106763,93237
3:6:4,0,-1,106764,93236
3:5:6,0,-1,106765,93235
2:6:2,2,2,106763,93237
4:3:3,0,-1,106764,93236
2:6:4,1,1,106763,93237
1:2:3,1,1,106762,93238
5:1:1,0,-1,106763,93237
6:6:3,0,-1,106764,93236
5:3:5,0,-1,106765,93235
5:3:6,0,-1,106766,93234
5:2:2,2,2,106764,93236
2:6:5,1,1,106763,93237
5:3:3,0,-1,106764,93236
4:6:1,0,-1,106765,93235
2:1:5,1,1,106764,93236
1:2:2,2,2,106762,93238
6:4:3,0,-1,106763,93237
3:3:2,1,1,106762,93238
4:3:5,0,-1,106763,93237
3:2:5,1,1,106762,93238
4:5:3,0,-1,106763,93237
4:1:2,1,1,106762,93238
5:3:5,0,-1,106763,93237
1:3:4,0,-1,106764,93236
3:3:4,0,-1,106765,93235
4:2:3,1,1,106764,93236
3:2:4,1,1,106763,93237
2:6:6,1,1,106762,93238
4:2:1,1,1,106761,93239
3:3:2,1,1,106760,93240
2:2:1,2,2,106758,93242
1:4:6,0,-1,106759,93241
1:5:1,0,-1,106760,93240
1:5:6,0,-1,106761,93239
6:3:6,0,-1,106762,93238
2:3:4,1,1,106761,93239
3:1:5,0,-1,106762,93238
5:2:6,1,1,106761,93239
5:6:1,0,-1,106762,93238
3:6:2,1,1,106761,93239
3:6:5,0,-1,106762,93238
1:3:2,1,1,106761,93239
4:4:4,0,-1,106762,93238
1:2:1,1,1,106761,93239
3:2:2,2,2,106759,93241
3:1:1,0,-1,106760,93240
5:2:4,1,1,106759,93241
5:2:1,1,1,106758,93242
6:4:2,1,1,106757,93243
1:5:1,0,-1,106758,93242
6:5:2,1,1,106757,93243
2:5:2,2,2,106755,93245
6:6:1,0,-1,106756,93244
4:6:6,0,-1,106757,93243
1:1:3,0,-1,106758,93242
4:5:6,0,-1,106759,93241
6:1:1,0,-1,106760,93240
5:3:2,1,1,106759,93241
6:6:3,0,-1,106760,93240
4:3:3,0,-1,106761,93239
3:6:3,0,-1,106762,93238
5:2:1,1,1,106761,93239
3:3:4,0,-1,106762,93238
3:2:4,1,1,106761,93239
3:1:3,0,-1,106762,93238
6:1:2,1,1,106761,93239
4:3:5,0,-1,106762,93238
3:3:5,0,-1,106763,93237
2:1:2,2,2,106761,93239
3:6:5,0,-1,106762,93238
6:2:1,1,1,106761,93239
3:3:6,0,-1,106762,93238
3:3:1,0,-1,106763,93237
6:1:1,0,-1,106764,93236
4:4:2,1,1,106763,93237
6:1:2,1,1,106762,93238
5:6:2,1,1,106761,93239
2:6:1,1,1,106760,93240
6:2:5,1,1,106759,93241
2:5:5,1,1,106758,93242
6:3:6,0,-1,106759,93241
2:1:1,1,1,106758,93242
3:4:1,0,-1,106759,93241
1:3:6,0,-1,106760,93240
4:4:3,0,-1,106761,93239
2:6:3,1,1,106760,93240
5:2:1,1,1,106759,93241
2:4:1,1,1,106758,93242
6:4:6,0,-1,106759,93241
4:4:5,0,-1,106760,93240
1:4:5,0,-1,106761,93239
2:5:4,1,1,106760,93240
1:5:5,0,-1,106761,93239
6:3:4,0,-1,106762,93238
1:5:4,0,-1,106763,93237
4:3:3,0,-1,106764,93236
1:4:5,0,-1,106765,93235
3:2:6,1,1,106764,93236
1:6:5,0,-1,106765,93235
5:6:5,0,-1,106766,93234
4:6:2,1,1,106765,93235
4:2:2,2,2,106763,93237
4:3:1,0,-1,106764,93236
5:3:3,0,-1,106765,93235
6:1:2,1,1,106764,93236
3:3:2,1,1,106763,93237
6:6:2,1,1,106762,93238
1:5:6,0,-1,106763,93237
5:5:1,0,-1,106764,93236
4:3:3,0,-1,106765,93235
6:3:4,0,-1,106766,93234
5:1:2,1,1,106765,93235
4:6:5,0,-1,106766,93234
3:2:5,1,1,106765,93235
4:4:1,0,-1,106766,93234
1:1:3,0,-1,106767,93233
5:1:6,0,-1,106768,93232
5:4:1,0,-1,106769,93231
3:4:4,0,-1,106770,93230
3:4:6,0,-1,106771,93229
1:6:5,0,-1,106772,93228
6:5:6,0,-1,106773,93227
3:6:5,0,-1,106774,93226
6:3:2,1,1,106773,93227
4:2:6,1,1,106772,93228
3:6:5,0,-1,106773,93227
5:4:1,0,-1,106774,93226
4:4:2,1,1,106773,93227
2:1:2,2,2,106771,93229
5:4:5,0,-1,106772,93228
2:1:4,1,1,106771,93229
3:2:5,1,1,106770,93230
1:1:2,1,1,106769,93231
2:1:5,1,1,106768,93232
3:3:4,0,-1,106769,93231
3:5:3,0,-1,106770,93230
5:5:4,0,-1,106771,93229
6:6:3,0,-1,106772,93228
4:4:4,0,-1,106773,93227
4:3:6,0,-1,106774,93226
2:2:3,2,2,106772,93228
1:3:5,0,-1,106773,93227
6:2:5,1,1,106772,93228
1:5:3,0,-1,106773,93227
1:6:6,0,-1,106774,93226
5:1:6,0,-1,106775,93225
1:4:5,0,-1,106776,93224
4:5:2,1,1,106775,93225
4:5:5,0,-1,106776,93224
5:3:2,1,1,106775,93225
3:4:4,0,-1,106776,93224
6:3:6,0,-1,106777,93223
6:4:4,0,-1,106778,93222
6:5:1,0,-1,106779,93221
3:6:5,0,-1,106780,93220
3:3:5,0,-1,106781,93219
1:4:6,0,-1,106782,93218
6:6:5,0,-1,106783,93217
1:4:3,0,-1,106784,93216
6:5:6,0,-1,106785,93215
2:1:4,1,1,106784,93216
2:1:1,1,1,106783,93217
6:4:6,0,-1,106784,93216
4:5:2,1,1,106783,93217
2:1:5,1,1,106782,93218
2:5:6,1,1,106781,93219
4:4:6,0,-1,106782,93218
2:5:6,1,1,106781,93219
3:4:4,0,-1,106782,93218
1:2:2,2,2,106780,93220
1:4:3,0,-1,106781,93219
2:2:1,2,2,106779,93221
4:4:1,0,-1,106780,93220
5:2:5,1,1,106779,93221
1:4:2,1,1,106778,93222
5:5:4,0,-1,106779,93221
6:6:6,0,-1,106780,93220
1:5:3,0,-1,106781,93219
6:1:4,0,-1,106782,93218
2:1:3,1,1,106781,93219
4:2:2,2,2,106779,93221
4:1:6,0,-1,106780,93220
5:4:6,0,-1,106781,93219
2:5:1,1,1,106780,93220
2:1:6,1,1,106779,93221
1:2:4,1,1,106778,93222
3:4:6,0,-1,106779,93221
2:5:5,1,1,106778,93222
1:5:6,0,-1,106779,93221
2:3:5,1,1,106778,93222
2:4:4,1,1,106777,93223
4:3:6,0,-1,106778,93222
1:3:6,0,-1,106779,93221
6:2:6,1,1,106778,93222
5:4:5,0,-1,106779,93221
5:6:4,0,-1,106780,93220
6:1:1,0,-1,106781,93219
6:6:5,0,-1,106782,93218
2:5:4,1,1,106781,93219
4:4:3,0,-1,106782,93218
5:5:4,0,-1,106783,93217
6:2:1,1,1,106782,93218
6:4:3,0,-1,106783,93217
5:2:4,1,1,106782,93218
4:6:2,1,1,106781,93219
5:6:1,0,-1,106782,93218
3:5:1,0,-1,106783,93217
2:2:2,3,3,106780,93220
1:3:4,0,-1,106781,93219
4:1:3,0,-1,106782,93218
2:2:3,2,2,106780,93220
4:1:3,0,-1,106781,93219
5:2:3,1,1,106780,93220
6:6:3,0,-1,106781,93219
2:1:4,1,1,106780,93220
3:1:1,0,-1,106781,93219
6:2:4,1,1,106780,93220
6:3:4,0,-1,106781,93219
4:1:6,0,-1,106782,93218
2:6:6,1,1,106781,93219
4:4:3,0,-1,106782,93218
4:2:1,1,1,106781,93219
6:4:6,0,-1,106782,93218
6:5:1,0,-1,106783,93217
5:3:5,0,-1,106784,93216
3:3:3,0,-1,106785,93215
4:4:5,0,-1,106786,93214
6:5:5,0,-1,106787,93213
3:1:4,0,-1,106788,93212
2:1:3,1,1,106787,93213
3:6:2,1,1,106786,93214
4:3:5,0,-1,106787,93213
3:6:5,0,-1,106788,93212
1:2:2,2,2,106786,93214
3:3:6,0,-1,106787,93213
3:3:5,0,-1,106788,93212
2:4:2,2,2,106786,93214
3:1:4,0,-1,106787,93213
2:3:4,1,1,106786,93214
3:1:4,0,-1,106787,93213
6:1:5,0,-1,106788,93212
2:5:1,1,1,106787,93213
3:4:1,0,-1,106788,93212
2:6:2,2,2,106786,93214
5:2:6,1,1,106785,93215
6:4:5,0,-1,106786,93214
2:5:3,1,1,106785,93215
2:2:5,2,2,106783,93217
2:2:4,2,2,106781,93219
6:5:4,0,-1,106782,93218
3:3:2,1,1,106781,93219
5:5:1,0,-1,106782,93218
4:2:6,1,1,106781,93219
3:1:6,0,-1,106782,93218
6:1:5,0,-1,106783,93217
2:6:3,1,1,106782,93218
1:1:4,0,-1,106783,93217
5:6:2,1,1,106782,93218
2:3:5,1,1,106781,93219
3:3:5,0,-1,106782,93218
4:2:4,1,1,106781,93219
5:1:4,0,-1,106782,93218
3:5:6,0,-1,106783,93217
3:5:4,0,-1,106784,93216
4:3:3,0,-1,106785,93215
1:3:1,0,-1,106786,93214
2:5:6,1,1,106785,93215
2:2:2,3,3,106782,93218
1:2:1,1,1,106781,93219
5:5:3,0,-1,106782,93218
2:2:5,2,2,106780,93220
6:1:3,0,-1,106781,93219
1:1:3,0,-1,106782,93218
6:6:5,0,-1,106783,93217
3:2:1,1,1,106782,93218
6:6:4,0,-1,106783,93217
5:3:6,0,-1,106784,93216
4:3:1,0,-1,106785,93215
3:1:3,0,-1,106786,93214
3:6:2,1,1,106785,93215
6:1:1,0,-1,106786,93214
4:2:6,1,1,106785,93215
2:6:6,1,1,106784,93216
4:5:6,0,-1,106785,93215
4:1:4,0,-1,106786,93214
3:4:4,0,-1,106787,93213
4:4:4,0,-1,106788,93212
4:3:6,0,-1,106789,93211
1:1:4,0,-1,106790,93210
3:2:5,1,1,106789,93211
5:4:3,0,-1,106790,93210
3:2:1,1,1,106789,93211
5:5:3,0,-1,106790,93210
3:5:1,0,-1,106791,93209
2:2:1,2,2,106789,93211
4:3:5,0,-1,106790,93210
3:4:6,0,-1,106791,93209
1:6:2,1,1,106790,93210
3:1:2,1,1,106789,93211
1:2:2,2,2,106787,93213
3:4:1,0,-1,106788,93212
2:2:2,3,3,106785,93215
5:3:1,0,-1,106786,93214
2:4:2,2,2,106784,93216
4:3:3,0,-1,106785,93215
2:3:6,1,1,106784,93216
3:1:2,1,1,106783,93217
2:5:3,1,1,106782,93218
4:4:2,1,1,106781,93219
6:6:3,0,-1,106782,93218
6:1:3,0,-1,106783,93217
5:6:6,0,-1,106784,93216
2:3:5,1,1,106783,93217
6:1:5,0,-1,106784,93216
2:1:2,2,2,106782,93218
3:5:3,0,-1,106783,93217
4:6:6,0,-1,106784,93216
6:5:3,0,-1,106785,93215
3:3:3,0,-1,106786,93214
1:5:5,0,-1,106787,93213
6:6:5,0,-1,106788,93212
3:6:5,0,-1,106789,93211
2:5:3,1,1,106788,93212
5:5:4,0,-1,106789,93211
5:2:1,1,1,106788,93212
3:2:3,1,1,106787,93213
2:1:4,1,1,106786,93214
2:2:5,2,2,106784,93216
3:4:3,0,-1,106785,93215
6:1:4,0,-1,106786,93214
1:2:3,1,1,106785,93215
4:5:2,1,1,106784,93216
6:5:4,0,-1,106785,93215
6:2:6,1,1,106784,93216
2:4:3,1,1,106783,93217
3:4:5,0,-1,106784,93216
3:6:3,0,-1,106785,93215
4:6:1,0,-1,106786,93214
1:5:3,0,-1,106787,93213
6:2:1,1,1,106786,93214
5:6:4,0,-1,106787,93213
5:1:3,0,-1,106788,93212
3:3:2,1,1,106787,93213
3:4:2,1,1,106786,93214
5:3:4,0,-1,106787,93213
1:5:2,1,1,106786,93214
3:1:2,1,1,106785,93215
3:1:4,0,-1,106786,93214
1:2:1,1,1,106785,93215
1:3:5,0,-1,106786,93214
2:6:6,1,1,106785,93215
1:6:2,1,1,106784,93216
2:5:2,2,2,106782,93218
4:2:3,1,1,106781,93219
1:2:4,1,1,106780,93220
2:2:5,2,2,106778,93222
3:3:2,1,1,106777,93223
3:2:6,1,1,106776,93224
4:6:5,0,-1,106777,93223
4:4:3,0,-1,106778,93222
4:6:6,0,-1,106779,93221
5:6:3,0,-1,106780,93220
4:1:3,0,-1,106781,93219
1:1:4,0,-1,106782,93218
3:5:1,0,-1,106783,93217
1:2:1,1,1,106782,93218
5:3:3,0,-1,106783,93217
5:2:3,1,1,106782,93218
1:5:3,0,-1,106783,93217
2:5:5,1,1,106782,93218
1:4:6,0,-1,106783,93217
5:5:4,0,-1,106784,93216
1:3:3,0,-1,106785,93215
6:4:5,0,-1,106786,93214
4:5:4,0,-1,106787,93213
6:1:2,1,1,106786,93214
5:5:5,0,-1,106787,93213
5:6:1,0,-1,106788,93212
3:5:3,0,-1,106789,93211
5:4:4,0,-1,106790,93210
1:1:3,0,-1,106791,93209
6:4:3,0,-1,106792,93208
2:3:6,1,1,106791,93209
4:4:3,0,-1,106792,93208
5:6:5,0,-1,106793,93207
4:6:4,0,-1,106794,93206
3:1:3,0,-1,106795,93205
2:4:3,1,1,106794,93206
6:2:5,1,1,106793,93207
4:5:5,0,-1,106794,93206
3:2:4,1,1,106793,93207
5:5:4,0,-1,106794,93206
4:3:3,0,-1,106795,93205
6:5:4,0,-1,106796,93204
2:5:2,2,2,106794,93206
1:5:6,0,-1,106795,93205
4:5:5,0,-1,106796,93204
4:6:3,0,-1,106797,93203
5:6:5,0,-1,106798,93202
2:5:4,1,1,106797,93203
1:4:5,0,-1,106798,93202
5:1:4,0,-1,106799,93201
5:5:1,0,-1,106800,93200
5:1:5,0,-1,106801,93199
1:1:6,0,-1,106802,93198
2:1:4,1,1,106801,93199
3:4:4,0,-1,106802,93198
3:2:4,1,1,106801,93199
5:6:2,1,1,106800,93200
6:6:5,0,-1,106801,93199
1:3:5,0,-1,106802,93198
2:3:6,1,1,106801,93199
4:2:6,1,1,106800,93200
5:6:1,0,-1,106801,93199
6:6:6,0,-1,106802,93198
2:2:6,2,2,106800,93200
1:5:5,0,-1,106801,93199
2:5:3,1,1,106800,93200
4:4:2,1,1,106799,93201
2:3:2,2,2,106797,93203
6:6:4,0,-1,106798,93202
1:4:1,0,-1,106799,93201
5:2:4,1,1,106798,93202
4:2:3,1,1,106797,93203
4:4:3,0,-1,106798,93202
3:2:6,1,1,106797,93203
3:2:5,1,1,106796,93204
6:3:3,0,-1,106797,93203
1:4:5,0,-1,106798,93202
1:4:4,0,-1,106799,93201
1:5:4,0,-1,106800,93200
4:5:6,0,-1,106801,93199
5:6:1,0,-1,106802,93198
2:5:1,1,1,106801,93199
1:6:3,0,-1,106802,93198
3:1:3,0,-1,106803,93197
6:3:6,0,-1,106804,93196
2:5:1,1,1,106803,93197
1:3:2,1,1,106802,93198
5:1:5,0,-1,106803,93197
5:2:1,1,1,106802,93198
4:4:3,0,-1,106803,93197
4:2:3,1,1,106802,93198
5:1:2,1,1,106801,93199
6:5:3,0,-1,106802,93198
2:2:4,2,2,106800,93200
2:1:4,1,1,106799,93201
3:5:1,0,-1,106800,93200
5:5:3,0,-1,106801,93199
5:4:4,0,-1,106802,93198
2:1:3,1,1,106801,93199
6:5:5,0,-1,106802,93198
1:3:2,1,1,106801,93199
4:1:3,0,-1,106802,93198
5:4:5,0,-1,106803,93197
3:6:4,0,-1,106804,93196
1:3:1,0,-1,106805,93195
5:4:2,1,1,106804,93196
1:6:5,0,-1,106805,93195
5:1:1,0,-1,106806,93194
1:6:6,0,-1,106807,93193
5:1:2,1,1,106806,93194
5:4:5,0,-1,106807,93193
1:3:5,0,-1,106808,93192
1:1:4,0,-1,106809,93191
6:2:1,1,1,106808,93192
2:3:5,1,1,106807,93193
2:5:2,2,2,106805,93195
2:6:2,2,2,106803,93197
3:4:5,0,-1,106804,93196
5:4:4,0,-1,106805,93195
4:4:4,0,-1,106806,93194
5:4:3,0,-1,106807,93193
1:5:6,0,-1,106808,93192
2:1:6,1,1,106807,93193
4:1:6,0,-1,106808,93192
2:3:4,1,1,106807,93193
3:6:3,0,-1,106808,93192
6:3:3,0,-1,106809,93191
6:5:1,0,-1,106810,93190
3:4:6,0,-1,106811,93189
6:6:5,0,-1,106812,93188
6:1:1,0,-1,106813,93187
3:4:6,0,-1,106814,93186
4:6:4,0,-1,106815,93185
3:5:1,0,-1,106816,93184
1:2:1,1,1,106815,93185
1:6:6,0,-1,106816,93184
5:2:6,1,1,106815,93185
2:6:6,1,1,106814,93186
5:2:5,1,1,106813,93187
3:4:5,0,-1,106814,93186
2:2:6,2,2,106812,93188
6:3:6,0,-1,106813,93187
5:4:3,0,-1,106814,93186
4:2:1,1,1,106813,93187
3:2:6,1,1,106812,93188
3:1:5,0,-1,106813,93187
2:4:5,1,1,106812,93188
3:2:2,2,2,106810,93190
5:1:2,1,1,106809,93191
2:1:2,2,2,106807,93193
3:3:2,1,1,106806,93194
4:4:4,0,-1,106807,93193
3:4:1,0,-1,106808,93192
2:5:4,1,1,106807,93193
2:3:4,1,1,106806,93194
3:1:4,0,-1,106807,93193
2:5:2,2,2,106805,93195
5:1:4,0,-1,106806,93194
6:5:1,0,-1,106807,93193
1:3:2,1,1,106806,93194
2:6:5,1,1,106805,93195
5:3:2,1,1,106804,93196
3:1:3,0,-1,106805,93195
6:1:5,0,-1,106806,93194
3:6:1,0,-1,106807,93193
6:2:3,1,1,106806,93194
2:4:6,1,1,106805,93195
6:5:4,0,-1,106806,93194
5:5:1,0,-1,106807,93193
2:4:1,1,1,106806,93194
3:1:6,0,-1,106807,93193
5:2:1,1,1,106806,93194
3:6:3,0,-1,106807,93193
2:2:6,2,2,106805,93195
1:3:3,0,-1,106806,93194
1:3:5,0,-1,106807,93193
1:1:6,0,-1,106808,93192
5:6:6,0,-1,106809,93191
3:6:2,1,1,106808,93192
2:2:5,2,2,106806,93194
2:6:3,1,1,106805,93195
4:2:4,1,1,106804,93196
2:6:3,1,1,106803,93197
4:6:3,0,-1,106804,93196
6:1:2,1,1,106803,93197
4:6:3,0,-1,106804,93196
5:4:3,0,-1,106805,93195
5:5:6,0,-1,106806,93194
3:5:2,1,1,106805,93195
2:2:3,2,2,106803,93197
1:2:1,1,1,106802,93198
3:6:3,0,-1,106803,93197
6:3:5,0,-1,106804,93196
3:6:5,0,-1,106805,93195
4:3:5,0,-1,106806,93194
6:5:4,0,-1,106807,93193
5:3:4,0,-1,106808,93192
2:1:5,1,1,106807,93193
3:4:5,0,-1,106808,93192
5:4:1,0,-1,106809,93191
6:6:5,0,-1,106810,93190
2:5:5,1,1,106809,93191
3:3:2,1,1,106808,93192
1:4:4,0,-1,106809,93191
5:6:4,0,-1,106810,93190
3:3:5,0,-1,106811,93189
1:5:3,0,-1,106812,93188
5:3:2,1,1,106811,93189
6:2:3,1,1,106810,93190
1:3:4,0,-1,106811,93189
4:1:4,0,-1,106812,93188
1:6:1,0,-1,106813,93187
5:5:4,0,-1,106814,93186
5:2:1,1,1,106813,93187
3:6:2,1,1,106812,93188
4:5:3,0,-1,106813,93187
5:1:6,0,-1,106814,93186
5:3:4,0,-1,106815,93185
5:5:1,0,-1,106816,93184
4:6:5,0,-1,106817,93183
6:6:3,0,-1,106818,93182
5:5:6,0,-1,106819,93181
1:3:3,0,-1,106820,93180
3:2:3,1,1,106819,93181
1:2:5,1,1,106818,93182
3:3:2,1,1,106817,93183
5:3:1,0,-1,106818,93182
2:3:1,1,1,106817,93183
1:5:6,0,-1,106818,93182
6:2:5,1,1,106817,93183
4:5:1,0,-1,106818,93182
3:2:6,1,1,106817,93183
1:4:4,0,-1,106818,93182
4:6:3,0,-1,106819,93181
5:1:5,0,-1,106820,93180
1:3:2,1,1,106819,93181
6:4:5,0,-1,106820,93180
5:4:5,0,-1,106821,93179
3:3:4,0,-1,106822,93178
3:3:5,0,-1,106823,93177
2:1:2,2,2,106821,93179
1:2:2,2,2,106819,93181
2:4:4,1,1,106818,93182
6:1:5,0,-1,106819,93181
5:1:5,0,-1,106820,93180
2:1:6,1,1,106819,93181
1:4:6,0,-1,106820,93180
4:2:2,2,2,106818,93182
6:5:6,0,-1,106819,93181
4:2:3,1,1,106818,93182
4:5:2,1,1,106817,93183
4:1:3,0,-1,106818,93182
1:3:3,0,-1,106819,93181
4:6:2,1,1,106818,93182
2:3:5,1,1,106817,93183
5:3:4,0,-1,106818,93182
6:3:4,0,-1,106819,93181
1:4:3,0,-1,106820,93180
2:2:2,3,3,106817,93183
1:4:2,1,1,106816,93184
6:3:5,0,-1,106817,93183
2:2:6,2,2,106815,93185
3:6:6,0,-1,106816,93184
2:2:5,2,2,106814,93186
6:6:5,0,-1,106815,93185
4:3:2,1,1,106814,93186
2:6:6,1,1,106813,93187
4:4:5,0,-1,106814,93186
1:1:5,0,-1,106815,93185
3:2:1,1,1,106814,93186
1:5:6,0,-1,106815,93185
3:6:3,0,-1,106816,93184
5:1:3,0,-1,106817,93183
6:4:6,0,-1,106818,93182
1:4:2,1,1,106817,93183
4:4:3,0,-1,106818,93182
3:6:5,0,-1,106819,93181
3:4:3,0,-1,106820,93180
4:1:4,0,-1,106821,93179
4:3:5,0,-1,106822,93178
2:2:6,2,2,106820,93180
3:5:5,0,-1,106821,93179
4:3:1,0,-1,106822,93178
3:5:6,0,-1,106823,93177
4:4:3,0,-1,106824,93176
5:2:5,1,1,106823,93177
4:4:3,0,-1,106824,93176
4:4:2,1,1,106823,93177
2:1:2,2,2,106821,93179
4:1:6,0,-1,106822,93178
6:2:6,1,1,106821,93179
3:3:1,0,-1,106822,93178
4:1:3,0,-1,106823,93177
5:4:5,0,-1,106824,93176
5:5:3,0,-1,106825,93175
4:5:6,0,-1,106826,93174
5:4:1,0,-1,106827,93173
5:2:5,1,1,106826,93174
3:3:4,0,-1,106827,93173
5:5:6,0,-1,106828,93172
6:5:4,0,-1,106829,93171
4:1:5,0,-1,106830,93170
5:4:6,0,-1,106831,93169
5:5:1,0,-1,106832,93168
6:4:6,0,-1,106833,93167
3:5:5,0,-1,106834,93166
3:1:4,0,-1,106835,93165
5:2:3,1,1,106834,93166
1:1:5,0,-1,106835,93165
1:1:3,0,-1,106836,93164
4:1:3,0,-1,106837,93163
6:2:5,1,1,106836,93164
6:2:3,1,1,106835,93165
1:5:5,0,-1,106836,93164
1:5:5,0,-1,106837,93163
6:2:3,1,1,106836,93164
2:1:4,1,1,106835,93165
4:5:6,0,-1,106836,93164
6:1:3,0,-1,106837,93163
6:5:2,1,1,106836,93164
4:4:4,0,-1,106837,93163
6:5:5,0,-1,106838,93162
1:1:2,1,1,106837,93163
2:4:1,1,1,106836,93164
6:6:4,0,-1,106837,93163
2:2:2,3,3,106834,93166
1:2:5,1,1,106833,93167
2:3:3,1,1,106832,93168
6:5:6,0,-1,106833,93167
3:3:3,0,-1,106834,93166
2:5:4,1,1,106833,93167
6:2:3,1,1,106832,93168
1:3:5,0,-1,106833,93167
1:3:3,0,-1,106834,93166
3:3:3,0,-1,106835,93165
1:1:4,0,-1,106836,93164
1:2:5,1,1,106835,93165
5:2:3,1,1,106834,93166
6:6:6,0,-1,106835,93165
6:2:2,2,2,106833,93167
3:5:3,0,-1,106834,93166
3:1:4,0,-1,106835,93165
6:5:1,0,-1,106836,93164
1:5:1,0,-1,106837,93163
4:1:2,1,1,106836,93164
1:6:5,0,-1,106837,93163
2:2:1,2,2,106835,93165
1:2:2,2,2,106833,93167
5:5:3,0,-1,106834,93166
2:5:2,2,2,106832,93168
3:5:5,0,-1,106833,93167
1:2:1,1,1,106832,93168
3:4:2,1,1,106831,93169
5:3:4,0,-1,106832,93168
6:1:4,0,-1,106833,93167
2:5:2,2,2,106831,93169
1:3:4,0,-1,106832,93168
4:4:4,0,-1,106833,93167
6:3:5,0,-1,106834,93166
4:6:3,0,-1,106835,93165
4:6:4,0,-1,106836,93164
6:6:2,1,1,106835,93165
1:1:6,0,-1,106836,93164
5:1:4,0,-1,106837,93163
2:2:4,2,2,106835,93165
6:3:3,0,-1,106836,93164
5:6:5,0,-1,106837,93163
5:3:3,0,-1,106838,93162
3:1:1,0,-1,106839,93161
3:4:3,0,-1,106840,93160
1:3:6,0,-1,106841,93159
2:1:3,1,1,106840,93160
1:4:4,0,-1,106841,93159
1:6:5,0,-1,106842,93158
5:3:5,0,-1,106843,93157
1:1:1,0,-1,106844,93156
2:4:1,1,1,106843,93157
6:5:1,0,-1,106844,93156
5:4:1,0,-1,106845,93155
5:6:5,0,-1,106846,93154
5:6:5,0,-1,106847,93153
1:5:2,1,1,106846,93154
2:2:5,2,2,106844,93156
1:2:3,1,1,106843,93157
6:5:6,0,-1,106844,93156
1:2:1,1,1,106843,93157
6:1:1,0,-1,106844,93156
2:5:5,1,1,106843,93157
5:6:5,0,-1,106844,93156
4:2:2,2,2,106842,93158
6:6:3,0,-1,106843,93157
6:6:1,0,-1,106844,93156
2:6:4,1,1,106843,93157
1:5:2,1,1,106842,93158
6:1:2,1,1,106841,93159
3:4:1,0,-1,106842,93158
4:5:2,1,1,106841,93159
5:2:5,1,1,106840,93160
3:6:4,0,-1,106841,93159
3:1:1,0,-1,106842,93158
4:2:4,1,1,106841,93159
3:6:5,0,-1,106842,93158
4:3:5,0,-1,106843,93157
2:2:5,2,2,106841,93159
5:4:6,0,-1,106842,93158
4:3:5,0,-1,106843,93157
1:3:3,0,-1,106844,93156
3:1:2,1,1,106843,93157
1:1:4,0,-1,106844,93156
6:2:5,1,1,106843,93157
2:1:1,1,1,106842,93158
1:3:1,0,-1,106843,93157
2:5:2,2,2,106841,93159
2:6:2,2,2,106839,93161
2:4:3,1,1,106838,93162
4:1:3,0,-1,106839,93161
4:3:6,0,-1,106840,93160
6:4:3,0,-1,106841,93159
1:3:5,0,-1,106842,93158
5:4:4,0,-1,106843,93157
5:3:3,0,-1,106844,93156
3:6:4,0,-1,106845,93155
5:3:1,0,-1,106846,93154
5:4:5,0,-1,106847,93153
6:3:6,0,-1,106848,93152
1:3:1,0,-1,106849,93151
5:2:2,2,2,106847,93153
4:6:4,0,-1,106848,93152
2:3:4,1,1,106847,93153
5:1:2,1,1,106846,93154
5:3:2,1,1,106845,93155
4:2:2,2,2,106843,93157
1:6:6,0,-1,106844,93156
5:4:5,0,-1,106845,93155
2:4:4,1,1,106844,93156
6:4:6,0,-1,106845,93155
6:1:5,0,-1,106846,93154
3:1:5,0,-1,106847,93153
6:2:2,2,2,106845,93155
1:2:5,1,1,106844,93156
3:6:3,0,-1,106845,93155
2:4:6,1,1,106844,93156
1:2:6,1,1,106843,93157
1:6:6,0,-1,106844,93156
1:2:3,1,1,106843,93157
2:2:5,2,2,106841,93159
3:6:2,1,1,106840,93160
2:1:5,1,1,106839,93161
3:1:5,0,-1,106840,93160
4:3:6,0,-1,106841,93159
1:1:6,0,-1,106842,93158
4:1:4,0,-1,106843,93157
4:3:4,0,-1,106844,93156
1:5:1,0,-1,106845,93155
1:5:5,0,-1,106846,93154
5:5:4,0,-1,106847,93153
5:6:3,0,-1,106848,93152
2:6:2,2,2,106846,93154
6:2:6,1,1,106845,93155
1:4:6,0,-1,106846,93154
1:2:1,1,1,106845,93155
2:3:6,1,1,106844,93156
4:2:3,1,1,106843,93157
5:6:2,1,1,106842,93158
5:5:3,0,-1,106843,93157
6:1:1,0,-1,106844,93156
4:4:1,0,-1,106845,93155
2:5:6,1,1,106844,93156
5:4:6,0,-1,106845,93155
1:2:2,2,2,106843,93157
2:6:2,2,2,106841,93159
4:4:4,0,-1,106842,93158
4:1:1,0,-1,106843,93157
1:4:4,0,-1,106844,93156
1:2:3,1,1,106843,93157
5:1:6,0,-1,106844,93156
3:6:4,0,-1,106845,93155
5:3:5,0,-1,106846,93154
3:2:2,2,2,106844,93156
6:5:1,0,-1,106845,93155
4:1:6,0,-1,106846,93154
4:1:1,0,-1,106847,93153
2:3:1,1,1,106846,93154
5:1:4,0,-1,106847,93153
2:2:2,3,3,106844,93156
2:1:6,1,1,106843,93157
4:5:1,0,-1,106844,93156
6:2:4,1,1,106843,93157
2:1:2,2,2,106841,93159
1:3:6,0,-1,106842,93158
6:6:6,0,-1,106843,93157
4:4:4,0,-1,106844,93156
5:3:2,1,1,106843,93157
3:2:1,1,1,106842,93158
5:3:6,0,-1,106843,93157
4:2:4,1,1,106842,93158
3:1:4,0,-1,106843,93157
4:3:2,1,1,106842,93158
5:2:6,1,1,106841,93159
2:4:3,1,1,106840,93160
3:5:6,0,-1,106841,93159
1:6:5,0,-1,106842,93158
5:2:3,1,1,106841,93159
5:3:4,0,-1,106842,93158
4:5:2,1,1,106841,93159
2:6:6,1,1,106840,93160
5:6:2,1,1,106839,93161
4:1:3,0,-1,106840,93160
2:1:6,1,1,106839,93161
5:1:4,0,-1,106840,93160
1:4:1,0,-1,106841,93159
6:5:2,1,1,106840,93160
3:1:5,0,-1,106841,93159
3:6:2,1,1,106840,93160
1:3:4,0,-1,106841,93159
6:4:2,1,1,106840,93160
2:6:5,1,1,106839,93161
5:6:5,0,-1,106840,93160
4:1:2,1,1,106839,93161
6:5:4,0,-1,106840,93160
6:4:2,1,1,106839,93161
3:3:4,0,-1,106840,93160
3:2:3,1,1,106839,93161
2:2:4,2,2,106837,93163
6:5:4,0,-1,106838,93162
2:6:4,1,1,106837,93163
2:5:1,1,1,106836,93164
4:2:4,1,1,106835,93165
2:1:1,1,1,106834,93166
3:2:2,2,2,106832,93168
3:4:3,0,-1,106833,93167
2:5:4,1,1,106832,93168
2:4:2,2,2,106830,93170
5:4:1,0,-1,106831,93169
4:1:2,1,1,106830,93170
3:6:5,0,-1,106831,93169
6:4:2,1,1,106830,93170
6:4:3,0,-1,106831,93169
3:4:3,0,-1,106832,93168
2:3:1,1,1,106831,93169
5:3:2,1,1,106830,93170
3:5:1,0,-1,106831,93169
4:3:3,0,-1,106832,93168
5:5:3,0,-1,106833,93167
4:3:3,0,-1,106834,93166
1:5:3,0,-1,106835,93165
6:2:2,2,2,106833,93167
5:6:1,0,-1,106834,93166
6:2:2,2,2,106832,93168
1:6:2,1,1,106831,93169
4:2:6,1,1,106830,93170
5:5:5,0,-1,106831,93169
1:3:4,0,-1,106832,93168
1:1:1,0,-1,106833,93167
2:2:6,2,2,106831,93169
3:1:1,0,-1,106832,93168
6:5:6,0,-1,106833,93167
5:4:3,0,-1,106834,93166
2:2:6,2,2,106832,93168
5:2:1,1,1,106831,93169
2:2:6,2,2,106829,93171
2:5:2,2,2,106827,93173
3:5:4,0,-1,106828,93172
1:1:4,0,-1,106829,93171
3:5:2,1,1,106828,93172
4:5:3,0,-1,106829,93171
6:5:3,0,-1,106830,93170
1:1:5,0,-1,106831,93169
4:4:2,1,1,106830,93170
2:6:1,1,1,106829,93171
5:1:5,0,-1,106830,93170
4:6:5,0,-1,106831,93169
2:2:6,2,2,106829,93171
1:3:5,0,-1,106830,93170
1:6:6,0,-1,106831,93169
4:6:5,0,-1,106832,93168
1:3:3,0,-1,106833,93167
1:6:5,0,-1,106834,93166
6:5:4,0,-1,106835,93165
1:2:5,1,1,106834,93166
1:6:3,0,-1,106835,93165
4:3:4,0,-1,106836,93164
6:1:4,0,-1,106837,93163
6:5:5,0,-1,106838,93162
1:4:4,0,-1,106839,93161
2:4:6,1,1,106838,93162
3:4:6,0,-1,106839,93161
5:2:5,1,1,106838,93162
6:6:2,1,1,106837,93163
2:2:1,2,2,106835,93165
2:6:1,1,1,106834,93166
5:6:4,0,-1,106835,93165
3:5:5,0,-1,106836,93164
1:5:3,0,-1,106837,93163
4:5:1,0,-1,106838,93162
1:4:4,0,-1,106839,93161
5:3:1,0,-1,106840,93160
4:4:1,0,-1,106841,93159
6:1:4,0,-1,106842,93158
4:3:4,0,-1,106843,93157
4:3:4,0,-1,106844,93156
3:6:2,1,1,106843,93157
5:6:5,0,-1,106844,93156
4:3:3,0,-1,106845,93155
3:4:2,1,1,106844,93156
5:4:6,0,-1,106845,93155
6:5:6,0,-1,106846,93154
1:3:3,0,-1,106847,93153
1:3:5,0,-1,106848,93152
3:5:4,0,-1,106849,93151
6:5:4,0,-1,106850,93150
1:3:4,0,-1,106851,93149
5:6:1,0,-1,106852,93148
2:2:2,3,3,106849,93151
2:6:3,1,1,106848,93152
4:1:4,0,-1,106849,93151
6:6:6,0,-1,106850,93150
3:2:3,1,1,106849,93151
3:5:4,0,-1,106850,93150
6:3:6,0,-1,106851,93149
4:4:6,0,-1,106852,93148
5:3:3,0,-1,106853,93147
5:6:2,1,1,106852,93148
6:1:5,0,-1,106853,93147
3:2:2,2,2,106851,93149
1:2:6,1,1,106850,93150
5:6:2,1,1,106849,93151
4:2:4,1,1,106848,93152
3:4:4,0,-1,106849,93151
5:3:2,1,1,106848,93152
5:2:3,1,1,106847,93153
3:1:1,0,-1,106848,93152
5:6:3,0,-1,106849,93151
1:4:5,0,-1,106850,93150
6:2:5,1,1,106849,93151
2:2:5,2,2,106847,93153
1:1:5,0,-1,106848,93152
2:6:3,1,1,106847,93153
4:1:2,1,1,106846,93154
1:1:3,0,-1,106847,93153
6:4:5,0,-1,106848,93152
4:5:3,0,-1,106849,93151
6:5:1,0,-1,106850,93150
5:1:6,0,-1,106851,93149
6:3:4,0,-1,106852,93148
1:4:2,1,1,106851,93149
1:1:1,0,-1,106852,93148
4:4:2,1,1,106851,93149
5:6:5,0,-1,106852,93148
6:3:2,1,1,106851,93149
6:3:4,0,-1,106852,93148
4:4:1,0,-1,106853,93147
5:4:3,0,-1,106854,93146
2:2:4,2,2,106852,93148
4:1:3,0,-1,106853,93147
1:4:6,0,-1,106854,93146
6:4:2,1,1,106853,93147
6:1:4,0,-1,106854,93146
5:5:3,0,-1,106855,93145
5:6:6,0,-1,106856,93144
3:1:1,0,-1,106857,93143
2:3:5,1,1,106856,93144
1:6:5,0,-1,106857,93143
1:1:6,0,-1,106858,93142
3:2:5,1,1,106857,93143
1:4:3,0,-1,106858,93142
3:1:4,0,-1,106859,93141
5:1:4,0,-1,106860,93140
5:2:3,1,1,106859,93141
4:6:1,0,-1,106860,93140
6:4:1,0,-1,106861,93139
5:1:1,0,-1,106862,93138
2:6:2,2,2,106860,93140
3:5:6,0,-1,106861,93139
2:4:5,1,1,106860,93140
2:2:6,2,2,106858,93142
6:4:5,0,-1,106859,93141
3:4:6,0,-1,106860,93140
5:2:4,1,1,106859,93141
1:3:6,0,-1,106860,93140
2:6:5,1,1,106859,93141
4:2:5,1,1,106858,93142
6:4:2,1,1,106857,93143
6:4:3,0,-1,106858,93142
2:6:5,1,1,106857,93143
6:5:1,0,-1,106858,93142
2:3:2,2,2,106856,93144
6:3:4,0,-1,106857,93143
4:2:4,1,1,106856,93144
4:4:6,0,-1,106857,93143
3:4:3,0,-1,106858,93142
4:4:4,0,-1,106859,93141
5:6:2,1,1,106858,93142
1:4:3,0,-1,106859,93141
2:1:1,1,1,106858,93142
3:4:2,1,1,106857,93143
4:4:1,0,-1,106858,93142
5:3:3,0,-1,106859,93141
5:5:3,0,-1,106860,93140
5:5:2,1,1,106859,93141
5:5:1,0,-1,106860,93140
3:3:3,0,-1,106861,93139
6:3:1,0,-1,106862,93138
3:1:1,0,-1,106863,93137
6:3:4,0,-1,106864,93136
6:2:4,1,1,106863,93137
1:4:2,1,1,106862,93138
2:6:1,1,1,106861,93139
4:4:2,1,1,106860,93140
5:3:4,0,-1,106861,93139
6:3:4,0,-1,106862,93138
2:4:2,2,2,106860,93140
1:2:5,1,1,106859,93141
3:2:2,2,2,106857,93143
6:6:4,0,-1,106858,93142
3:6:6,0,-1,106859,93141
4:3:5,0,-1,106860,93140
6:2:3,1,1,106859,93141
3:6:1,0,-1,106860,93140
1:3:3,0,-1,106861,93139
5:4:1,0,-1,106862,93138
6:5:3,0,-1,106863,93137
3:3:1,0,-1,106864,93136
2:3:3,1,1,106863,93137
1:2:1,1,1,106862,93138
6:4:1,0,-1,106863,93137
6:4:6,0,-1,106864,93136
4:1:5,0,-1,106865,93135
1:5:6,0,-1,106866,93134
2:4:1,1,1,106865,93135
2:4:5,1,1,106864,93136
2:1:6,1,1,106863,93137
5:6:3,0,-1,106864,93136
1:4:5,0,-1,106865,93135
1:3:6,0,-1,106866,93134
4:3:1,0,-1,106867,93133
4:3:2,1,1,106866,93134
3:2:1,1,1,106865,93135
5:3:4,0,-1,106866,93134
5:6:3,0,-1,106867,93133
3:3:3,0,-1,106868,93132
5:3:4,0,-1,106869,93131
3:6:1,0,-1,106870,93130
2:5:6,1,1,106869,93131
5:3:2,1,1,106868,93132
4:4:4,0,-1,106869,93131
6:2:3,1,1,106868,93132
4:2:1,1,1,106867,93133
3:2:3,1,1,106866,93134
6:1:1,0,-1,106867,93133
5:1:6,0,-1,106868,93132
6:6:1,0,-1,106869,93131
1:6:3,0,-1,106870,93130
6:1:4,0,-1,106871,93129
4:5:1,0,-1,106872,93128
5:1:6,0,-1,106873,93127
5:1:3,0,-1,106874,93126
3:3:2,1,1,106873,93127
2:2:2,3,3,106870,93130
1:6:6,0,-1,106871,93129
5:5:5,0,-1,106872,93128
1:5:3,0,-1,106873,93127
5:2:2,2,2,106871,93129
4:2:2,2,2,106869,93131
5:6:2,1,1,106868,93132
3:5:4,0,-1,106869,93131
3:2:2,2,2,106867,93133
5:3:4,0,-1,106868,93132
2:1:5,1,1,106867,93133
5:4:4,0,-1,106868,93132
3:5:1,0,-1,106869,93131
2:6:6,1,1,106868,93132
3:2:3,1,1,106867,93133
5:5:1,0,-1,106868,93132
2:6:4,1,1,106867,93133
4:3:1,0,-1,106868,93132
1:3:6,0,-1,106869,93131
4:6:5,0,-1,106870,93130
2:4:5,1,1,106869,93131
3:2:4,1,1,106868,93132
4:1:5,0,-1,106869,93131
5:3:4,0,-1,106870,93130
6:3:5,0,-1,106871,93129
5:5:2,1,1,106870,93130
2:3:2,2,2,106868,93132
2:1:6,1,1,106867,93133
4:3:4,0,-1,106868,93132
2:3:2,2,2,106866,93134
5:5:6,0,-1,106867,93133
5:1:1,0,-1,106868,93132
5:2:2,2,2,106866,93134
2:1:1,1,1,106865,93135
6:6:5,0,-1,106866,93134
4:3:3,0,-1,106867,93133
4:6:5,0,-1,106868,93132
4:6:5,0,-1,106869,93131
6:4:5,0,-1,106870,93130
1:3:2,1,1,106869,93131
2:6:6,1,1,106868,93132
5:2:2,2,2,106866,93134
3:2:3,1,1,106865,93135
4:1:2,1,1,106864,93136
1:2:1,1,1,106863,93137
3:2:1,1,1,106862,93138
3:5:6,0,-1,106863,93137
1:2:2,2,2,106861,93139
6:3:3,0,-1,106862,93138
6:3:2,1,1,106861,93139
5:6:3,0,-1,106862,93138
2:2:1,2,2,106860,93140
1:6:6,0,-1,106861,93139
6:2:5,1,1,106860,93140
4:6:6,0,-1,106861,93139
2:6:2,2,2,106859,93141
5:6:6,0,-1,106860,93140
6:1:4,0,-1,106861,93139
3:3:3,0,-1,106862,93138
3:1:2,1,1,106861,93139
6:6:5,0,-1,106862,93138
2:5:5,1,1,106861,93139
3:6:4,0,-1,106862,93138
6:2:6,1,1,106861,93139
4:6:6,0,-1,106862,93138
1:1:3,0,-1,106863,93137
6:4:3,0,-1,106864,93136
2:3:2,2,2,106862,93138
3:5:4,0,-1,106863,93137
6:3:1,0,-1,106864,93136
6:1:4,0,-1,106865,93135
4:2:4,1,1,106864,93136
1:6:4,0,-1,106865,93135
3:6:4,0,-1,106866,93134
4:2:3,1,1,106865,93135
3:3:2,1,1,106864,93136
1:5:1,0,-1,106865,93135
5:2:4,1,1,106864,93136
3:5:4,0,-1,106865,93135
1:6:5,0,-1,106866,93134
6:6:2,1,1,106865,93135
4:5:6,0,-1,106866,93134
2:3:1,1,1,106865,93135
2:3:1,1,1,106864,93136
1:1:6,0,-1,106865,93135
3:5:6,0,-1,106866,93134
3:6:4,0,-1,106867,93133
6:6:5,0,-1,106868,93132
5:1:4,0,-1,106869,93131
1:5:6,0,-1,106870,93130
1:5:2,1,1,106869,93131
6:6:1,0,-1,106870,93130
3:2:6,1,1,106869,93131
4:6:2,1,1,106868,93132
2:6:1,1,1,106867,93133
4:1:6,0,-1,106868,93132
1:1:2,1,1,106867,93133
3:1:4,0,-1,106868,93132
4:4:6,0,-1,106869,93131
4:1:2,1,1,106868,93132
6:2:3,1,1,106867,93133
4:6:3,0,-1,106868,93132
4:6:3,0,-1,106869,93131
6:5:6,0,-1,106870,93130
2:1:3,1,1,106869,93131
5:5:2,1,1,106868,93132
4:6:1,0,-1,106869,93131
2:5:1,1,1,106868,93132
4:5:3,0,-1,106869,93131
1:5:5,0,-1,106870,93130
6:2:4,1,1,106869,93131
4:5:1,0,-1,106870,93130
2:2:6,2,2,106868,93132
3:3:3,0,-1,106869,93131
3:4:2,1,1,106868,93132
2:5:4,1,1,106867,93133
4:3:6,0,-1,106868,93132
4:3:1,0,-1,106869,93131
5:3:5,0,-1,106870,93130
3:3:2,1,1,106869,93131
4:6:4,0,-1,106870,93130
4:2:4,1,1,106869,93131
4:5:1,0,-1,106870,93130
5:2:2,2,2,106868,93132
4:2:4,1,1,106867,93133
6:4:4,0,-1,106868,93132
2:5:2,2,2,106866,93134
5:3:1,0,-1,106867,93133
6:6:4,0,-1,106868,93132
4:2:1,1,1,106867,93133
2:5:3,1,1,106866,93134
4:2:4,1,1,106865,93135
1:1:4,0,-1,106866,93134
4:5:2,1,1,106865,93135
6:5:6,0,-1,106866,93134
5:5:4,0,-1,106867,93133
3:6:4,0,-1,106868,93132
1:2:1,1,1,106867,93133
4:3:4,0,-1,106868,93132
6:1:3,0,-1,106869,93131
1:3:4,0,-1,106870,93130
6:2:4,1,1,106869,93131
1:6:3,0,-1,106870,93130
2:3:4,1,1,106869,93131
4:2:6,1,1,106868,93132
5:4:3,0,-1,106869,93131
4:4:4,0,-1,106870,93130
3:2:4,1,1,106869,93131
3:2:4,1,1,106868,93132
6:5:2,1,1,106867,93133
1:4:3,0,-1,106868,93132
1:5:1,0,-1,106869,93131
2:4:2,2,2,106867,93133
3:1:4,0,-1,106868,93132
3:1:4,0,-1,106869,93131
2:6:3,1,1,106868,93132
2:4:6,1,1,106867,93133
2:3:1,1,1,106866,93134
5:4:6,0,-1,106867,93133
4:2:3,1,1,106866,93134
1:3:3,0,-1,106867,93133
1:6:1,0,-1,106868,93132
1:3:4,0,-1,106869,93131
2:3:2,2,2,106867,93133
1:6:5,0,-1,106868,93132
6:6:1,0,-1,106869,93131
5:6:4,0,-1,106870,93130
4:4:6,0,-1,106871,93129
5:2:3,1,1,106870,93130
5:3:3,0,-1,106871,93129
4:4:2,1,1,106870,93130
4:4:2,1,1,106869,93131
6:3:5,0,-1,106870,93130
5:3:4,0,-1,106871,93129
5:2:5,1,1,106870,93130
3:2:4,1,1,106869,93131
3:3:5,0,-1,106870,93130
4:4:1,0,-1,106871,93129
1:3:2,1,1,106870,93130
1:1:5,0,-1,106871,93129
5:6:2,1,1,106870,93130
4:3:3,0,-1,106871,93129
5:6:4,0,-1,106872,93128
5:4:4,0,-1,106873,93127
2:5:2,2,2,106871,93129
3:6:5,0,-1,106872,93128
1:4:3,0,-1,106873,93127
4:6:3,0,-1,106874,93126
5:1:1,0,-1,106875,93125
3:3:1,0,-1,106876,93124
6:1:6,0,-1,106877,93123
5:2:5,1,1,106876,93124
5:3:3,0,-1,106877,93123
4:5:5,0,-1,106878,93122
6:2:4,1,1,106877,93123
1:2:3,1,1,106876,93124
5:4:5,0,-1,106877,93123
6:2:6,1,1,106876,93124
3:6:3,0,-1,106877,93123
4:5:5,0,-1,106878,93122
4:1:3,0,-1,106879,93121
6:6:6,0,-1,106880,93120
3:6:3,0,-1,106881,93119
2:3:4,1,1,106880,93120
6:3:4,0,-1,106881,93119
4:3:3,0,-1,106882,93118
4:2:3,1,1,106881,93119
2:3:4,1,1,106880,93120
6:2:3,1,1,106879,93121
6:4:5,0,-1,106880,93120
3:6:1,0,-1,106881,93119
4:4:3,0,-1,106882,93118
3:4:6,0,-1,106883,93117
3:2:3,1,1,106882,93118
4:6:2,1,1,106881,93119
2:2:1,2,2,106879,93121
1:6:4,0,-1,106880,93120
3:3:2,1,1,106879,93121
6:4:1,0,-1,106880,93120
5:4:4,0,-1,106881,93119
5:3:6,0,-1,106882,93118
2:3:5,1,1,106881,93119
6:5:1,0,-1,106882,93118
6:4:1,0,-1,106883,93117
1:1:6,0,-1,106884,93116
2:5:1,1,1,106883,93117
4:6:4,0,-1,106884,93116
1:6:3,0,-1,106885,93115
5:5:2,1,1,106884,93116
2:1:6,1,1,106883,93117
6:5:4,0,-1,106884,93116
5:5:1,0,-1,106885,93115
2:1:4,1,1,106884,93116
3:4:1,0,-1,106885,93115
4:5:1,0,-1,106886,93114
5:4:3,0,-1,106887,93113
6:4:4,0,-1,106888,93112
2:5:2,2,2,106886,93114
3:3:6,0,-1,106887,93113
1:3:2,1,1,106886,93114
3:4:6,0,-1,106887,93113
4:6:1,0,-1,106888,93112
6:1:1,0,-1,106889,93111
2:4:2,2,2,106887,93113
5:3:3,0,-1,106888,93112
2:1:6,1,1,106887,93113
2:3:3,1,1,106886,93114
4:4:5,0,-1,106887,93113
2:5:5,1,1,106886,93114
2:1:5,1,1,106885,93115
6:6:3,0,-1,106886,93114
2:2:6,2,2,106884,93116
1:4:4,0,-1,106885,93115
2:4:2,2,2,106883,93117
6:6:4,0,-1,106884,93116
5:1:5,0,-1,106885,93115
1:6:2,1,1,106884,93116
1:6:6,0,-1,106885,93115
1:4:5,0,-1,106886,93114
3:1:6,0,-1,106887,93113
6:2:6,1,1,106886,93114
2:4:3,1,1,106885,93115
2:1:6,1,1,106884,93116
4:6:2,1,1,106883,93117
5:6:3,0,-1,106884,93116
1:4:1,0,-1,106885,93115
4:1:4,0,-1,106886,93114
3:6:1,0,-1,106887,93113
5:6:3,0,-1,106888,93112
2:3:1,1,1,106887,93113
6:5:1,0,-1,106888,93112
3:4:3,0,-1,106889,93111
2:5:2,2,2,106887,93113
3:2:2,2,2,106885,93115
3:4:4,0,-1,106886,93114
5:2:2,2,2,106884,93116
5:6:6,0,-1,106885,93115
3:5:3,0,-1,106886,93114
2:3:3,1,1,106885,93115
1:1:6,0,-1,106886,93114
6:3:4,0,-1,106887,93113
4:4:1,0,-1,106888,93112
2:4:1,1,1,106887,93113
3:2:4,1,1,106886,93114
1:1:3,0,-1,106887,93113
1:2:5,1,1,106886,93114
6:2:3,1,1,106885,93115
6:3:1,0,-1,106886,93114
1:3:5,0,-1,106887,93113
3:2:6,1,1,106886,93114
3:6:5,0,-1,106887,93113
2:2:1,2,2,106885,93115
5:4:5,0,-1,106886,93114
2:5:5,1,1,106885,93115
1:2:4,1,1,106884,93116
5:2:1,1,1,106883,93117
5:2:6,1,1,106882,93118
5:1:3,0,-1,106883,93117
3:1:2,1,1,106882,93118
2:6:5,1,1,106881,93119
1:1:1,0,-1,106882,93118
5:4:6,0,-1,106883,93117
4:3:2,1,1,106882,93118
3:2:1,1,1,106881,93119
2:4:4,1,1,106880,93120
2:1:4,1,1,106879,93121
5:1:2,1,1,106878,93122
3:1:1,0,-1,106879,93121
5:5:5,0,-1,106880,93120
1:5:1,0,-1,106881,93119
2:6:5,1,1,106880,93120
6:3:2,1,1,106879,93121
5:3:1,0,-1,106880,93120
1:1:3,0,-1,106881,93119
6:2:5,1,1,106880,93120
3:2:3,1,1,106879,93121
3:2:4,1,1,106878,93122
2:3:3,1,1,106877,93123
5:4:3,0,-1,106878,93122
2:1:6,1,1,106877,93123
6:4:1,0,-1,106878,93122
1:4:3,0,-1,106879,93121
4:6:3,0,-1,106880,93120
6:2:1,1,1,106879,93121
3:3:3,0,-1,106880,93120
3:4:6,0,-1,106881,93119
4:1:4,0,-1,106882,93118
5:1:1,0,-1,106883,93117
1:4:1,0,-1,106884,93116
3:1:1,0,-1,106885,93115
5:3:6,0,-1,106886,93114
4:3:3,0,-1,106887,93113
1:5:6,0,-1,106888,93112
3:6:3,0,-1,106889,93111
4:5:2,1,1,106888,93112
3:2:1,1,1,106887,93113
2:2:4,2,2,106885,93115
2:3:3,1,1,106884,93116
2:1:1,1,1,106883,93117
6:4:2,1,1,106882,93118
1:6:1,0,-1,106883,93117
5:6:2,1,1,106882,93118
3:6:6,0,-1,106883,93117
1:2:3,1,1,106882,93118
2:5:3,1,1,106881,93119
1:6:2,1,1,106880,93120
4:4:1,0,-1,106881,93119
4:1:4,0,-1,106882,93118
1:6:3,0,-1,106883,93117
6:3:5,0,-1,106884,93116
5:3:6,0,-1,106885,93115
4:5:5,0,-1,106886,93114
2:4:1,1,1,106885,93115
3:3:6,0,-1,106886,93114
3:3:4,0,-1,106887,93113
4:3:1,0,-1,106888,93112
3:1:2,1,1,106887,93113
6:6:6,0,-1,106888,93112
3:4:3,0,-1,106889,93111
2:5:2,2,2,106887,93113
4:6:4,0,-1,106888,93112
1:2:1,1,1,106887,93113
4:6:5,0,-1,106888,93112
5:4:4,0,-1,106889,93111
1:1:6,0,-1,106890,93110
1:6:1,0,-1,106891,93109
1:6:3,0,-1,106892,93108
2:1:2,2,2,106890,93110
4:4:6,0,-1,106891,93109
6:2:5,1,1,106890,93110
5:5:2,1,1,106889,93111
4:4:1,0,-1,106890,93110
3:4:4,0,-1,106891,93109
3:2:6,1,1,106890,93110
1:5:5,0,-1,106891,93109
6:5:6,0,-1,106892,93108
4:1:6,0,-1,106893,93107
5:3:1,0,-1,106894,93106
3:5:4,0,-1,106895,93105
5:3:2,1,1,106894,93106
5:5:6,0,-1,106895,93105
6:3:2,1,1,106894,93106
3:2:6,1,1,106893,93107
2:6:3,1,1,106892,93108
6:2:2,2,2,106890,93110
6:6:5,0,-1,106891,93109
4:1:5,0,-1,106892,93108
1:4:4,0,-1,106893,93107
5:2:4,1,1,106892,93108
3:3:1,0,-1,106893,93107
2:2:6,2,2,106891,93109
3:1:4,0,-1,106892,93108
5:2:6,1,1,106891,93109
6:3:1,0,-1,106892,93108
3:3:4,0,-1,106893,93107
5:3:2,1,1,106892,93108
4:4:3,0,-1,106893,93107
3:1:4,0,-1,106894,93106
3:3:1,0,-1,106895,93105
5:1:1,0,-1,106896,93104
6:6:3,0,-1,106897,93103
5:1:1,0,-1,106898,93102
3:1:1,0,-1,106899,93101
5:5:1,0,-1,106900,93100
1:6:1,0,-1,106901,93099
1:2:4,1,1,106900,93100
4:2:1,1,1,106899,93101
5:3:3,0,-1,106900,93100
6:4:1,0,-1,106901,93099
5:6:4,0,-1,106902,93098
1:6:3,0,-1,106903,93097
6:5:2,1,1,106902,93098
3:5:2,1,1,106901,93099
3:1:4,0,-1,106902,93098
5:6:5,0,-1,106903,93097
1:1:4,0,-1,106904,93096
2:2:4,2,2,106902,93098
1:6:5,0,-1,106903,93097
3:3:5,0,-1,106904,93096
6:1:2,1,1,106903,93097
5:3:3,0,-1,106904,93096
6:2:4,1,1,106903,93097
6:3:6,0,-1,106904,93096
2:6:2,2,2,106902,93098
3:3:1,0,-1,106903,93097
2:6:5,1,1,106902,93098
3:5:1,0,-1,106903,93097
2:2:4,2,2,106901,93099
5:5:2,1,1,106900,93100
2:4:3,1,1,106899,93101
1:4:1,0,-1,106900,93100
6:3:1,0,-1,106901,93099
4:3:3,0,-1,106902,93098
2:5:1,1,1,106901,93099
5:1:3,0,-1,106902,93098
3:5:2,1,1,106901,93099
2:5:1,1,1,106900,93100
5:6:4,0,-1,106901,93099
1:5:1,0,-1,106902,93098
4:4:6,0,-1,106903,93097
1:5:1,0,-1,106904,93096
1:4:1,0,-1,106905,93095
2:2:1,2,2,106903,93097
4:5:6,0,-1,106904,93096
1:5:1,0,-1,106905,93095
3:3:5,0,-1,106906,93094
1:1:4,0,-1,106907,93093
2:5:5,1,1,106906,93094
5:2:4,1,1,106905,93095
1:3:3,0,-1,106906,93094
4:4:2,1,1,106905,93095
3:5:6,0,-1,106906,93094
6:4:3,0,-1,106907,93093
6:1:3,0,-1,106908,93092
4:6:1,0,-1,106909,93091
3:6:3,0,-1,106910,93090
6:4:4,0,-1,106911,93089
5:6:5,0,-1,106912,93088
1:2:1,1,1,106911,93089
3:1:6,0,-1,106912,93088
6:5:5,0,-1,106913,93087
1:6:1,0,-1,106914,93086
5:3:3,0,-1,106915,93085
2:1:4,1,1,106914,93086
4:2:5,1,1,106913,93087
3:5:6,0,-1,106914,93086
4:2:2,2,2,106912,93088
3:1:3,0,-1,106913,93087
4:6:6,0,-1,106914,93086
5:3:1,0,-1,106915,93085
6:4:3,0,-1,106916,93084
6:5:2,1,1,106915,93085
1:1:2,1,1,106914,93086
4:3:6,0,-1,106915,93085
2:6:2,2,2,106913,93087
1:2:3,1,1,106912,93088
4:3:6,0,-1,106913,93087
3:1:2,1,1,106912,93088
2:4:3,1,1,106911,93089
5:2:3,1,1,106910,93090
4:6:6,0,-1,106911,93089
5:1:1,0,-1,106912,93088
3:2:6,1,1,106911,93089
4:5:6,0,-1,106912,93088
6:5:3,0,-1,106913,93087
6:4:2,1,1,106912,93088
1:5:1,0,-1,106913,93087
5:2:2,2,2,106911,93089
3:1:5,0,-1,106912,93088
5:6:2,1,1,106911,93089
3:6:2,1,1,106910,93090
6:2:3,1,1,106909,93091
6:3:5,0,-1,106910,93090
6:1:4,0,-1,106911,93089
1:2:4,1,1,106910,93090
5:2:2,2,2,106908,93092
6:4:6,0,-1,106909,93091
5:3:2,1,1,106908,93092
4:6:1,0,-1,106909,93091
5:5:1,0,-1,106910,93090
5:3:3,0,-1,106911,93089
1:3:2,1,1,106910,93090
3:1:1,0,-1,106911,93089
3:3:3,0,-1,106912,93088
3:6:2,1,1,106911,93089
3:4:1,0,-1,106912,93088
5:1:5,0,-1,106913,93087
5:6:3,0,-1,106914,93086
4:5:6,0,-1,106915,93085
5:4:5,0,-1,106916,93084
2:4:6,1,1,106915,93085
2:1:3,1,1,106914,93086
3:3:3,0,-1,106915,93085
5:6:1,0,-1,106916,93084
3:1:1,0,-1,106917,93083
2:4:3,1,1,106916,93084
3:2:5,1,1,106915,93085
5:3:3,0,-1,106916,93084
4:5:3,0,-1,106917,93083
4:1:5,0,-1,106918,93082
2:5:4,1,1,106917,93083
3:5:4,0,-1,106918,93082
6:2:1,1,1,106917,93083
5:3:2,1,1,106916,93084
2:2:1,2,2,106914,93086
3:5:4,0,-1,106915,93085
1:1:1,0,-1,106916,93084
2:3:6,1,1,106915,93085
2:6:6,1,1,106914,93086
5:1:6,0,-1,106915,93085
2:2:1,2,2,106913,93087
2:2:1,2,2,106911,93089
5:1:5,0,-1,106912,93088
2:3:5,1,1,106911,93089
4:6:6,0,-1,106912,93088
4:3:4,0,-1,106913,93087
1:6:6,0,-1,106914,93086
6:6:6,0,-1,106915,93085
2:3:3,1,1,106914,93086
4:5:6,0,-1,106915,93085
1:6:3,0,-1,106916,93084
2:1:5,1,1,106915,93085
4:3:6,0,-1,106916,93084
4:4:1,0,-1,106917,93083
5:6:4,0,-1,106918,93082
5:4:2,1,1,106917,93083
2:5:1,1,1,106916,93084
5:1:3,0,-1,106917,93083
1:1:2,1,1,106916,93084
2:5:2,2,2,106914,93086
6:6:5,0,-1,106915,93085
3:2:4,1,1,106914,93086
2:5:3,1,1,106913,93087
4:3:3,0,-1,106914,93086
3:3:1,0,-1,106915,93085
4:6:3,0,-1,106916,93084
6:3:4,0,-1,106917,93083
2:5:4,1,1,106916,93084
4:4:1,0,-1,106917,93083
5:2:4,1,1,106916,93084
5:2:1,1,1,106915,93085
5:4:5,0,-1,106916,93084
4:1:2,1,1,106915,93085
6:5:4,0,-1,106916,93084
6:5:1,0,-1,106917,93083
1:5:5,0,-1,106918,93082
6:5:2,1,1,106917,93083
6:6:1,0,-1,106918,93082
2:2:6,2,2,106916,93084
3:1:2,1,1,106915,93085
4:1:1,0,-1,106916,93084
2:1:6,1,1,106915,93085
6:6:4,0,-1,106916,93084
1:3:6,0,-1,106917,93083
4:3:2,1,1,106916,93084
5:1:6,0,-1,106917,93083
3:2:4,1,1,106916,93084
3:2:4,1,1,106915,93085
1:3:3,0,-1,106916,93084
3:2:2,2,2,106914,93086
3:3:1,0,-1,106915,93085
6:4:5,0,-1,106916,93084
1:3:2,1,1,106915,93085
4:1:2,1,1,106914,93086
3:6:4,0,-1,106915,93085
1:4:3,0,-1,106916,93084
1:5:3,0,-1,106917,93083
1:5:1,0,-1,106918,93082
5:5:5,0,-1,106919,93081
4:3:3,0,-1,106920,93080
3:2:5,1,1,106919,93081
4:3:3,0,-1,106920,93080
4:3:4,0,-1,106921,93079
3:3:4,0,-1,106922,93078
1:1:3,0,-1,106923,93077
1:5:4,0,-1,106924,93076
6:5:3,0,-1,106925,93075
6:4:4,0,-1,106926,93074
6:2:6,1,1,106925,93075
5:4:1,0,-1,106926,93074
2:6:2,2,2,106924,93076
1:4:6,0,-1,106925,93075
3:4:1,0,-1,106926,93074
1:4:4,0,-1,106927,93073
3:3:1,0,-1,106928,93072
4:5:3,0,-1,106929,93071
3:3:1,0,-1,106930,93070
3:1:4,0,-1,106931,93069
2:6:3,1,1,106930,93070
4:6:3,0,-1,106931,93069
5:1:5,0,-1,106932,93068
4:2:1,1,1,106931,93069
5:5:6,0,-1,106932,93068
4:3:2,1,1,106931,93069
6:3:1,0,-1,106932,93068
1:6:4,0,-1,106933,93067
2:3:6,1,1,106932,93068
3:6:3,0,-1,106933,93067
3:4:3,0,-1,106934,93066
2:6:1,1,1,106933,93067
6:1:5,0,-1,106934,93066
2:4:2,2,2,106932,93068
4:4:1,0,-1,106933,93067
6:6:4,0,-1,106934,93066
5:1:3,0,-1,106935,93065
4:4:2,1,1,106934,93066
1:6:5,0,-1,106935,93065
5:1:3,0,-1,106936,93064
4:2:1,1,1,106935,93065
5:3:2,1,1,106934,93066
1:1:3,0,-1,106935,93065
6:4:3,0,-1,106936,93064
3:6:5,0,-1,106937,93063
1:6:3,0,-1,106938,93062
1:2:2,2,2,106936,93064
3:4:3,0,-1,106937,93063
4:2:5,1,1,106936,93064
3:6:3,0,-1,106937,93063
6:6:6,0,-1,106938,93062
5:1:2,1,1,106937,93063
5:2:1,1,1,106936,93064
6:4:2,1,1,106935,93065
4:4:2,1,1,106934,93066
2:1:4,1,1,106933,93067
2:1:2,2,2,106931,93069
2:1:2,2,2,106929,93071
3:5:4,0,-1,106930,93070
5:1:1,0,-1,106931,93069
2:6:4,1,1,106930,93070
2:6:3,1,1,106929,93071
2:1:4,1,1,106928,93072
2:2:2,3,3,106925,93075
3:2:2,2,2,106923,93077
1:1:3,0,-1,106924,93076
2:3:2,2,2,106922,93078
3:5:1,0,-1,106923,93077
6:4:3,0,-1,106924,93076
5:2:1,1,1,106923,93077
3:1:3,0,-1,106924,93076
5:1:6,0,-1,106925,93075
2:6:1,1,1,106924,93076
3:2:3,1,1,106923,93077
4:1:1,0,-1,106924,93076
5:6:2,1,1,106923,93077
6:2:3,1,1,106922,93078
2:3:6,1,1,106921,93079
3:1:3,0,-1,106922,93078
5:5:4,0,-1,106923,93077
2:4:6,1,1,106922,93078
6:6:5,0,-1,106923,93077
4:4:3,0,-1,106924,93076
2:2:5,2,2,106922,93078
3:6:4,0,-1,106923,93077
4:3:3,0,-1,106924,93076
3:4:3,0,-1,106925,93075
1:4:2,1,1,106924,93076
3:2:6,1,1,106923,93077
4:4:1,0,-1,106924,93076
1:1:2,1,1,106923,93077
5:3:4,0,-1,106924,93076
2:5:3,1,1,106923,93077
2:4:2,2,2,106921,93079
4:4:5,0,-1,106922,93078
4:6:4,0,-1,106923,93077
1:6:4,0,-1,106924,93076
2:4:1,1,1,106923,93077
4:5:2,1,1,106922,93078
5:5:6,0,-1,106923,93077
5:5:1,0,-1,106924,93076
5:1:3,0,-1,106925,93075
5:2:2,2,2,106923,93077
1:6:3,0,-1,106924,93076
3:5:2,1,1,106923,93077
2:3:4,1,1,106922,93078
6:4:3,0,-1,106923,93077
3:5:5,0,-1,106924,93076
1:5:3,0,-1,106925,93075
6:1:3,0,-1,106926,93074
1:6:1,0,-1,106927,93073
1:5:3,0,-1,106928,93072
1:5:1,0,-1,106929,93071
5:6:4,0,-1,106930,93070
6:1:3,0,-1,106931,93069
4:3:6,0,-1,106932,93068
1:5:6,0,-1,106933,93067
2:4:6,1,1,106932,93068
3:1:1,0,-1,106933,93067
3:6:1,0,-1,106934,93066
5:3:6,0,-1,106935,93065
1:3:5,0,-1,106936,93064
6:4:3,0,-1,106937,93063
3:4:2,1,1,106936,93064
3:2:1,1,1,106935,93065
1:5:4,0,-1,106936,93064
5:2:5,1,1,106935,93065
6:5:2,1,1,106934,93066
1:1:1,0,-1,106935,93065
6:4:1,0,-1,106936,93064
2:5:2,2,2,106934,93066
1:6:4,0,-1,106935,93065
5:2:2,2,2,106933,93067
6:6:2,1,1,106932,93068
6:1:4,0,-1,106933,93067
6:4:6,0,-1,106934,93066
5:3:4,0,-1,106935,93065
1:3:2,1,1,106934,93066
1:4:5,0,-1,106935,93065
4:5:1,0,-1,106936,93064
4:6:5,0,-1,106937,93063
4:2:1,1,1,106936,93064
6:5:2,1,1,106935,93065
2:6:3,1,1,106934,93066
3:1:4,0,-1,106935,93065
5:4:4,0,-1,106936,93064
3:5:5,0,-1,106937,93063
6:2:4,1,1,106936,93064
1:5:6,0,-1,106937,93063
4:3:5,0,-1,106938,93062
2:4:6,1,1,106937,93063
5:1:5,0,-1,106938,93062
6:3:2,1,1,106937,93063
2:4:3,1,1,106936,93064
3:5:2,1,1,106935,93065
2:2:3,2,2,106933,93067
4:2:5,1,1,106932,93068
3:4:1,0,-1,106933,93067
3:6:4,0,-1,106934,93066
4:5:3,0,-1,106935,93065
5:6:1,0,-1,106936,93064
2:4:1,1,1,106935,93065
2:2:4,2,2,106933,93067
5:5:5,0,-1,106934,93066
2:6:1,1,1,106933,93067
4:5:1,0,-1,106934,93066
1:1:1,0,-1,106935,93065
4:2:3,1,1,106934,93066
2:4:5,1,1,106933,93067
2:6:5,1,1,106932,93068
5:2:4,1,1,106931,93069
4:5:2,1,1,106930,93070
4:2:1,1,1,106929,93071
5:1:2,1,1,106928,93072
5:3:3,0,-1,106929,93071
6:6:6,0,-1,106930,93070
2:5:6,1,1,106929,93071
2:4:6,1,1,106928,93072
4:6:2,1,1,106927,93073
1:4:5,0,-1,106928,93072
3:2:5,1,1,106927,93073
2:4:4,1,1,106926,93074
3:3:3,0,-1,106927,93073
6:6:4,0,-1,106928,93072
2:2:6,2,2,106926,93074
4:4:5,0,-1,106927,93073
1:5:4,0,-1,106928,93072
1:1:6,0,-1,106929,93071
5:1:6,0,-1,106930,93070
6:1:3,0,-1,106931,93069
6:2:5,1,1,106930,93070
6:3:1,0,-1,106931,93069
2:3:6,1,1,106930,93070
5:3:6,0,-1,106931,93069
3:4:2,1,1,106930,93070
1:6:1,0,-1,106931,93069
6:2:2,2,2,106929,93071
3:4:1,0,-1,106930,93070
5:6:2,1,1,106929,93071
5:2:4,1,1,106928,93072
1:4:3,0,-1,106929,93071
5:3:4,0,-1,106930,93070
6:6:1,0,-1,106931,93069
2:2:3,2,2,106929,93071
1:3:4,0,-1,106930,93070
5:3:3,0,-1,106931,93069
4:6:3,0,-1,106932,93068
1:6:6,0,-1,106933,93067
1:3:1,0,-1,106934,93066
5:2:5,1,1,106933,93067
6:6:6,0,-1,106934,93066
1:4:2,1,1,106933,93067
4:3:1,0,-1,106934,93066
1:4:2,1,1,106933,93067
4:4:6,0,-1,106934,93066
5:1:3,0,-1,106935,93065
6:6:4,0,-1,106936,93064
5:6:1,0,-1,106937,93063
6:2:6,1,1,106936,93064
6:4:5,0,-1,106937,93063
2:4:4,1,1,106936,93064
6:2:1,1,1,106935,93065
4:4:2,1,1,106934,93066
5:3:5,0,-1,106935,93065
5:5:6,0,-1,106936,93064
6:1:6,0,-1,106937,93063
2:2:2,3,3,106934,93066
2:6:3,1,1,106933,93067
3:5:4,0,-1,106934,93066
4:1:2,1,1,106933,93067
2:4:4,1,1,106932,93068
6:3:6,0,-1,106933,93067
5:2:4,1,1,106932,93068
6:5:2,1,1,106931,93069
1:5:2,1,1,106930,93070
5:3:3,0,-1,106931,93069
2:6:3,1,1,106930,93070
3:6:4,0,-1,106931,93069
6:2:3,1,1,106930,93070
6:3:3,0,-1,106931,93069
1:2:5,1,1,106930,93070
1:3:3,0,-1,106931,93069
5:1:1,0,-1,106932,93068
3:2:3,1,1,106931,93069
1:2:4,1,1,106930,93070
6:4:5,0,-1,106931,93069
4:4:3,0,-1,106932,93068
1:4:2,1,1,106931,93069
1:2:4,1,1,106930,93070
4:5:1,0,-1,106931,93069
6:2:1,1,1,106930,93070
5:1:1,0,-1,106931,93069
3:3:2,1,1,106930,93070
3:4:2,1,1,106929,93071
5:4:1,0,-1,106930,93070
4:4:5,0,-1,106931,93069
3:1:4,0,-1,106932,93068
6:1:4,0,-1,106933,93067
4:6:1,0,-1,106934,93066
2:5:4,1,1,106933,93067
1:5:5,0,-1,106934,93066
4:6:3,0,-1,106935,93065
3:2:5,1,1,106934,93066
4:5:3,0,-1,106935,93065
4:5:2,1,1,106934,93066
5:1:1,0,-1,106935,93065
5:2:1,1,1,106934,93066
6:2:3,1,1,106933,93067
5:5:5,0,-1,106934,93066
2:5:3,1,1,106933,93067
4:3:6,0,-1,106934,93066
5:5:5,0,-1,106935,93065
2:4:5,1,1,106934,93066
2:4:3,1,1,106933,93067
3:2:2,2,2,106931,93069
3:2:3,1,1,106930,93070
2:4:4,1,1,106929,93071
4:2:6,1,1,106928,93072
1:3:2,1,1,106927,93073
3:5:2,1,1,106926,93074
5:3:6,0,-1,106927,93073
5:2:6,1,1,106926,93074
3:1:2,1,1,106925,93075
6:1:4,0,-1,106926,93074
4:4:4,0,-1,106927,93073
1:2:2,2,2,106925,93075
3:5:4,0,-1,106926,93074
6:6:2,1,1,106925,93075
6:1:5,0,-1,106926,93074
4:2:4,1,1,106925,93075
3:1:4,0,-1,106926,93074
2:6:4,1,1,106925,93075
3:2:5,1,1,106924,93076
4:4:4,0,-1,106925,93075
1:6:2,1,1,106924,93076
6:5:2,1,1,106923,93077
2:4:4,1,1,106922,93078
1:5:6,0,-1,106923,93077
3:3:4,0,-1,106924,93076
6:2:3,1,1,106923,93077
5:5:5,0,-1,106924,93076
4:5:2,1,1,106923,93077
1:2:6,1,1,106922,93078
5:4:3,0,-1,106923,93077
5:1:3,0,-1,106924,93076
2:6:5,1,1,106923,93077
1:2:6,1,1,106922,93078
4:3:5,0,-1,106923,93077
2:2:3,2,2,106921,93079
4:2:6,1,1,106920,93080
6:5:4,0,-1,106921,93079
2:3:6,1,1,106920,93080
6:1:2,1,1,106919,93081
4:6:4,0,-1,106920,93080
4:2:3,1,1,106919,93081
2:2:1,2,2,106917,93083
1:6:2,1,1,106916,93084
5:2:4,1,1,106915,93085
3:1:5,0,-1,106916,93084
4:2:3,1,1,106915,93085
3:6:6,0,-1,106916,93084
2:4:2,2,2,106914,93086
6:4:6,0,-1,106915,93085
5:6:1,0,-1,106916,93084
3:6:1,0,-1,106917,93083
5:5:6,0,-1,106918,93082
5:5:4,0,-1,106919,93081
6:3:3,0,-1,106920,93080
4:1:3,0,-1,106921,93079
6:6:6,0,-1,106922,93078
5:4:2,1,1,106921,93079
5:6:6,0,-1,106922,93078
2:3:6,1,1,106921,93079
2:3:2,2,2,106919,93081
2:1:4,1,1,106918,93082
5:3:1,0,-1,106919,93081
5:5:4,0,-1,106920,93080
6:5:6,0,-1,106921,93079
1:1:3,0,-1,106922,93078
1:1:1,0,-1,106923,93077
3:3:2,1,1,106922,93078
4:5:6,0,-1,106923,93077
2:1:5,1,1,106922,93078
6:5:5,0,-1,106923,93077
1:2:3,1,1,106922,93078
3:5:6,0,-1,106923,93077
6:6:3,0,-1,106924,93076
4:3:6,0,-1,106925,93075
1:4:4,0,-1,106926,93074
5:5:1,0,-1,106927,93073
1:3:5,0,-1,106928,93072
2:3:5,1,1,106927,93073
2:2:6,2,2,106925,93075
2:3:4,1,1,106924,93076
1:1:5,0,-1,106925,93075
1:3:3,0,-1,106926,93074
2:1:5,1,1,106925,93075
4:4:3,0,-1,106926,93074
6:3:5,0,-1,106927,93073
5:6:4,0,-1,106928,93072
6:1:5,0,-1,106929,93071
4:2:3,1,1,106928,93072
5:6:1,0,-1,106929,93071
5:3:1,0,-1,106930,93070
3:1:2,1,1,106929,93071
5:1:1,0,-1,106930,93070
5:1:4,0,-1,106931,93069
1:4:6,0,-1,106932,93068
2:2:1,2,2,106930,93070
5:4:6,0,-1,106931,93069
4:1:3,0,-1,106932,93068
3:1:2,1,1,106931,93069
2:6:5,1,1,106930,93070
3:2:5,1,1,106929,93071
3:6:5,0,-1,106930,93070
2:5:6,1,1,106929,93071
2:2:2,3,3,106926,93074
4:4:1,0,-1,106927,93073
2:6:1,1,1,106926,93074
4:6:3,0,-1,106927,93073
2:6:2,2,2,106925,93075
1:3:5,0,-1,106926,93074
4:3:6,0,-1,106927,93073
6:4:6,0,-1,106928,93072
3:6:3,0,-1,106929,93071
3:3:5,0,-1,106930,93070
3:6:6,0,-1,106931,93069
3:5:2,1,1,106930,93070
1:6:1,0,-1,106931,93069
3:3:5,0,-1,106932,93068
2:5:3,1,1,106931,93069
1:1:3,0,-1,106932,93068
5:2:2,2,2,106930,93070
1:4:2,1,1,106929,93071
4:5:3,0,-1,106930,93070
5:4:1,0,-1,106931,93069
6:3:3,0,-1,106932,93068
1:5:4,0,-1,106933,93067
3:1:3,0,-1,106934,93066
2:3:6,1,1,106933,93067
3:1:4,0,-1,106934,93066
3:4:1,0,-1,106935,93065
1:2:6,1,1,106934,93066
1:2:5,1,1,106933,93067
2:1:6,1,1,106932,93068
6:2:3,1,1,106931,93069
2:6:2,2,2,106929,93071
4:1:6,0,-1,106930,93070
2:4:2,2,2,106928,93072
4:1:6,0,-1,106929,93071
4:1:5,0,-1,106930,93070
2:4:1,1,1,106929,93071
1:1:4,0,-1,106930,93070
2:3:5,1,1,106929,93071
6:2:4,1,1,106928,93072
4:2:2,2,2,106926,93074
1:5:3,0,-1,106927,93073
2:5:5,1,1,106926,93074
3:5:1,0,-1,106927,93073
3:3:2,1,1,106926,93074
4:3:4,0,-1,106927,93073
2:6:2,2,2,106925,93075
2:4:4,1,1,106924,93076
2:4:4,1,1,106923,93077
5:5:6,0,-1,106924,93076
1:5:3,0,-1,106925,93075
4:2:1,1,1,106924,93076
6:2:2,2,2,106922,93078
2:3:2,2,2,106920,93080
6:1:1,0,-1,106921,93079
2:5:1,1,1,106920,93080
2:1:1,1,1,106919,93081
6:1:5,0,-1,106920,93080
6:4:4,0,-1,106921,93079
1:3:6,0,-1,106922,93078
6:5:1,0,-1,106923,93077
6:1:1,0,-1,106924,93076
1:2:2,2,2,106922,93078
3:4:6,0,-1,106923,93077
4:4:6,0,-1,106924,93076
4:3:2,1,1,106923,93077
1:1:4,0,-1,106924,93076
1:4:4,0,-1,106925,93075
3:5:6,0,-1,106926,93074
6:3:6,0,-1,106927,93073
1:2:2,2,2,106925,93075
2:3:3,1,1,106924,93076
3:5:1,0,-1,106925,93075
2:3:6,1,1,106924,93076
2:1:6,1,1,106923,93077
5:6:5,0,-1,106924,93076
5:5:1,0,-1,106925,93075
5:1:5,0,-1,106926,93074
5:5:5,0,-1,106927,93073
2:2:3,2,2,106925,93075
1:1:4,0,-1,106926,93074
5:5:1,0,-1,106927,93073
2:1:6,1,1,106926,93074
3:4:1,0,-1,106927,93073
4:1:2,1,1,106926,93074
6:3:5,0,-1,106927,93073
5:3:1,0,-1,106928,93072
3:3:1,0,-1,106929,93071
2:1:5,1,1,106928,93072
6:3:1,0,-1,106929,93071
3:6:3,0,-1,106930,93070
4:3:3,0,-1,106931,93069
3:4:4,0,-1,106932,93068
6:4:2,1,1,106931,93069
3:2:1,1,1,106930,93070
4:2:2,2,2,106928,93072
4:1:5,0,-1,106929,93071
5:6:1,0,-1,106930,93070
5:2:3,1,1,106929,93071
3:6:6,0,-1,106930,93070
6:1:3,0,-1,106931,93069
6:5:6,0,-1,106932,93068
2:2:6,2,2,106930,93070
2:4:2,2,2,106928,93072
1:6:4,0,-1,106929,93071
4:4:6,0,-1,106930,93070
6:3:6,0,-1,106931,93069
2:3:3,1,1,106930,93070
5:5:6,0,-1,106931,93069
5:5:4,0,-1,106932,93068
2:3:5,1,1,106931,93069
6:2:3,1,1,106930,93070
4:6:2,1,1,106929,93071
1:2:2,2,2,106927,93073
3:5:1,0,-1,106928,93072
3:6:4,0,-1,106929,93071
2:6:5,1,1,106928,93072
5:5:1,0,-1,106929,93071
2:4:4,1,1,106928,93072
6:4:6,0,-1,106929,93071
3:1:3,0,-1,106930,93070
1:3:5,0,-1,106931,93069
5:1:3,0,-1,106932,93068
4:5:2,1,1,106931,93069
6:1:4,0,-1,106932,93068
3:6:3,0,-1,106933,93067
3:5:2,1,1,106932,93068
3:2:3,1,1,106931,93069
5:2:3,1,1,106930,93070
2:1:4,1,1,106929,93071
5:4:4,0,-1,106930,93070
4:6:1,0,-1,106931,93069
1:4:3,0,-1,106932,93068
4:1:5,0,-1,106933,93067
5:2:3,1,1,106932,93068
3:4:1,0,-1,106933,93067
1:5:1,0,-1,106934,93066
4:5:5,0,-1,106935,93065
4:3:5,0,-1,106936,93064
5:3:5,0,-1,106937,93063
4:3:6,0,-1,106938,93062
6:4:3,0,-1,106939,93061
4:5:5,0,-1,106940,93060
5:1:1,0,-1,106941,93059
3:4:6,0,-1,106942,93058
1:2:6,1,1,106941,93059
6:1:6,0,-1,106942,93058
6:2:2,2,2,106940,93060
3:6:2,1,1,106939,93061
6:4:5,0,-1,106940,93060
5:2:4,1,1,106939,93061
3:6:2,1,1,106938,93062
2:4:2,2,2,106936,93064
2:5:4,1,1,106935,93065
6:2:2,2,2,106933,93067
3:5:6,0,-1,106934,93066
5:3:5,0,-1,106935,93065
5:4:5,0,-1,106936,93064
5:4:4,0,-1,106937,93063
3:4:3,0,-1,106938,93062
2:2:1,2,2,106936,93064
1:3:6,0,-1,106937,93063
1:1:6,0,-1,106938,93062
3:6:4,0,-1,106939,93061
4:4:3,0,-1,106940,93060
4:4:5,0,-1,106941,93059
5:5:2,1,1,106940,93060
1:5:1,0,-1,106941,93059
1:4:1,0,-1,106942,93058
5:2:1,1,1,106941,93059
2:2:5,2,2,106939,93061
1:5:5,0,-1,106940,93060
2:6:2,2,2,106938,93062
6:3:4,0,-1,106939,93061
3:5:3,0,-1,106940,93060
6:1:2,1,1,106939,93061
4:4:6,0,-1,106940,93060
5:3:5,0,-1,106941,93059
1:6:4,0,-1,106942,93058
6:1:4,0,-1,106943,93057
1:3:2,1,1,106942,93058
5:1:1,0,-1,106943,93057
4:2:5,1,1,106942,93058
3:1:3,0,-1,106943,93057
1:6:3,0,-1,106944,93056
2:2:5,2,2,106942,93058
2:6:1,1,1,106941,93059
1:4:4,0,-1,106942,93058
4:3:5,0,-1,106943,93057
4:2:6,1,1,106942,93058
3:3:6,0,-1,106943,93057
1:6:1,0,-1,106944,93056
2:3:5,1,1,106943,93057
5:4:3,0,-1,106944,93056
1:1:1,0,-1,106945,93055
4:1:5,0,-1,106946,93054
5:3:3,0,-1,106947,93053
4:5:1,0,-1,106948,93052
1:5:2,1,1,106947,93053
6:3:6,0,-1,106948,93052
5:1:3,0,-1,106949,93051
2:1:6,1,1,106948,93052
4:5:4,0,-1,106949,93051
4:2:5,1,1,106948,93052
6:5:6,0,-1,106949,93051
3:6:6,0,-1,106950,93050
6:5:6,0,-1,106951,93049
3:4:5,0,-1,106952,93048
2:6:6,1,1,106951,93049
6:4:6,0,-1,106952,93048
4:3:1,0,-1,106953,93047
6:6:3,0,-1,106954,93046
6:4:2,1,1,106953,93047
5:2:3,1,1,106952,93048
5:1:4,0,-1,106953,93047
6:6:4,0,-1,106954,93046
6:1:3,0,-1,106955,93045
4:1:1,0,-1,106956,93044
6:4:4,0,-1,106957,93043
3:2:6,1,1,106956,93044
4:1:6,0,-1,106957,93043
4:1:4,0,-1,106958,93042
1:5:2,1,1,106957,93043
1:1:3,0,-1,106958,93042
6:6:5,0,-1,106959,93041
2:5:4,1,1,106958,93042
5:5:4,0,-1,106959,93041
4:2:4,1,1,106958,93042
5:3:2,1,1,106957,93043
1:4:1,0,-1,106958,93042
6:2:4,1,1,106957,93043
4:4:6,0,-1,106958,93042
4:6:6,0,-1,106959,93041
2:5:6,1,1,106958,93042
5:3:3,0,-1,106959,93041
6:3:5,0,-1,106960,93040
5:4:5,0,-1,106961,93039
6:2:2,2,2,106959,93041
5:6:3,0,-1,106960,93040
5:4:1,0,-1,106961,93039
5:1:6,0,-1,106962,93038
6:3:3,0,-1,106963,93037
3:6:5,0,-1,106964,93036
3:4:1,0,-1,106965,93035
4:2:3,1,1,106964,93036
3:2:2,2,2,106962,93038
1:1:6,0,-1,106963,93037
2:3:1,1,1,106962,93038
5:2:6,1,1,106961,93039
2:6:5,1,1,106960,93040
4:6:3,0,-1,106961,93039
4:5:4,0,-1,106962,93038
6:4:5,0,-1,106963,93037
3:2:1,1,1,106962,93038
1:3:5,0,-1,106963,93037
5:5:5,0,-1,106964,93036
5:1:2,1,1,106963,93037
3:1:5,0,-1,106964,93036
3:2:2,2,2,106962,93038
2:1:5,1,1,106961,93039
2:1:6,1,1,106960,93040
3:4:6,0,-1,106961,93039
5:6:2,1,1,106960,93040
5:4:3,0,-1,106961,93039
2:4:1,1,1,106960,93040
2:1:5,1,1,106959,93041
2:1:6,1,1,106958,93042
4:5:1,0,-1,106959,93041
2:2:6,2,2,106957,93043
2:5:6,1,1,106956,93044
3:3:1,0,-1,106957,93043
3:5:4,0,-1,106958,93042
1:6:4,0,-1,106959,93041
6:3:2,1,1,106958,93042
5:5:5,0,-1,106959,93041
4:6:5,0,-1,106960,93040
4:6:4,0,-1,106961,93039
3:4:2,1,1,106960,93040
1:5:6,0,-1,106961,93039
3:5:6,0,-1,106962,93038
6:5:5,0,-1,106963,93037
6:4:2,1,1,106962,93038
3:5:4,0,-1,106963,93037
4:5:5,0,-1,106964,93036
6:4:4,0,-1,106965,93035
2:6:4,1,1,106964,93036
6:6:4,0,-1,106965,93035
2:5:6,1,1,106964,93036
6:4:2,1,1,106963,93037
1:3:6,0,-1,106964,93036
2:3:2,2,2,106962,93038
3:2:4,1,1,106961,93039
2:4:2,2,2,106959,93041
2:6:1,1,1,106958,93042
1:6:4,0,-1,106959,93041
3:3:1,0,-1,106960,93040
3:2:1,1,1,106959,93041
2:5:4,1,1,106958,93042
5:1:6,0,-1,106959,93041
2:4:6,1,1,106958,93042
6:5:5,0,-1,106959,93041
4:1:6,0,-1,106960,93040
3:1:5,0,-1,106961,93039
1:4:6,0,-1,106962,93038
6:4:4,0,-1,106963,93037
6:3:2,1,1,106962,93038
3:3:6,0,-1,106963,93037
3:3:6,0,-1,106964,93036
5:3:5,0,-1,106965,93035
5:4:2,1,1,106964,93036
6:3:2,1,1,106963,93037
5:3:4,0,-1,106964,93036
5:6:1,0,-1,106965,93035
4:2:5,1,1,106964,93036
4:1:1,0,-1,106965,93035
6:5:2,1,1,106964,93036
2:1:3,1,1,106963,93037
6:4:1,0,-1,106964,93036
3:3:1,0,-1,106965,93035
4:1:4,0,-1,106966,93034
2:5:1,1,1,106965,93035
2:6:1,1,1,106964,93036
2:6:4,1,1,106963,93037
1:1:2,1,1,106962,93038
2:2:6,2,2,106960,93040
3:6:3,0,-1,106961,93039
6:2:4,1,1,106960,93040
6:2:5,1,1,106959,93041
1:3:4,0,-1,106960,93040
4:4:1,0,-1,106961,93039
2:1:6,1,1,106960,93040
1:4:3,0,-1,106961,93039
6:5:2,1,1,106960,93040
6:4:2,1,1,106959,93041
6:5:1,0,-1,106960,93040
5:4:3,0,-1,106961,93039
6:4:2,1,1,106960,93040
6:1:4,0,-1,106961,93039
1:3:1,0,-1,106962,93038
1:5:5,0,-1,106963,93037
1:5:3,0,-1,106964,93036
2:1:5,1,1,106963,93037
2:5:6,1,1,106962,93038
1:3:6,0,-1,106963,93037
2:2:5,2,2,106961,93039
3:4:2,1,1,106960,93040
3:6:6,0,-1,106961,93039
6:3:4,0,-1,106962,93038
3:6:2,1,1,106961,93039
4:5:4,0,-1,106962,93038
5:3:1,0,-1,106963,93037
5:3:2,1,1,106962,93038
1:3:3,0,-1,106963,93037
2:6:4,1,1,106962,93038
4:2:4,1,1,106961,93039
5:4:4,0,-1,106962,93038
2:3:3,1,1,106961,93039
6:4:5,0,-1,106962,93038
6:6:2,1,1,106961,93039
6:5:2,1,1,106960,93040
3:3:3,0,-1,106961,93039
3:5:5,0,-1,106962,93038
2:4:1,1,1,106961,93039
5:6:5,0,-1,106962,93038
6:1:2,1,1,106961,93039
6:6:6,0,-1,106962,93038
5:1:2,1,1,106961,93039
2:3:4,1,1,106960,93040
5:2:5,1,1,106959,93041
4:5:6,0,-1,106960,93040
1:1:3,0,-1,106961,93039
4:4:6,0,-1,106962,93038
3:2:5,1,1,106961,93039
5:6:2,1,1,106960,93040
2:2:1,2,2,106958,93042
6:1:6,0,-1,106959,93041
2:3:6,1,1,106958,93042
1:3:2,1,1,106957,93043
4:4:6,0,-1,106958,93042
1:4:3,0,-1,106959,93041
5:1:4,0,-1,106960,93040
6:3:6,0,-1,106961,93039
4:3:5,0,-1,106962,93038
1:3:2,1,1,106961,93039
3:3:5,0,-1,106962,93038
6:2:2,2,2,106960,93040
3:1:2,1,1,106959,93041
1:6:2,1,1,106958,93042
1:4:5,0,-1,106959,93041
1:6:5,0,-1,106960,93040
1:6:3,0,-1,106961,93039
4:6:4,0,-1,106962,93038
3:1:4,0,-1,106963,93037
3:1:6,0,-1,106964,93036
6:3:2,1,1,106963,93037
5:6:2,1,1,106962,93038
5:5:6,0,-1,106963,93037
2:6:5,1,1,106962,93038
6:5:2,1,1,106961,93039
3:6:6,0,-1,106962,93038
1:1:6,0,-1,106963,93037
5:1:2,1,1,106962,93038
2:6:2,2,2,106960,93040
6:4:3,0,-1,106961,93039
1:4:2,1,1,106960,93040
4:1:3,0,-1,106961,93039
3:6:5,0,-1,106962,93038
2:4:4,1,1,106961,93039
5:1:2,1,1,106960,93040
4:1:4,0,-1,106961,93039
4:3:4,0,-1,106962,93038
6:3:3,0,-1,106963,93037
5:6:2,1,1,106962,93038
3:5:6,0,-1,106963,93037
1:6:3,0,-1,106964,93036
4:3:6,0,-1,106965,93035
4:2:1,1,1,106964,93036
5:2:4,1,1,106963,93037
2:3:2,2,2,106961,93039
4:1:6,0,-1,106962,93038
4:1:2,1,1,106961,93039
5:6:2,1,1,106960,93040
5:3:4,0,-1,106961,93039
4:6:6,0,-1,106962,93038
1:5:6,0,-1,106963,93037
6:6:3,0,-1,106964,93036
6:1:3,0,-1,106965,93035
1:3:3,0,-1,106966,93034
5:3:5,0,-1,106967,93033
6:1:5,0,-1,106968,93032
6:1:5,0,-1,106969,93031
5:3:3,0,-1,106970,93030
2:3:6,1,1,106969,93031
5:2:2,2,2,106967,93033
4:2:6,1,1,106966,93034
2:2:1,2,2,106964,93036
4:3:5,0,-1,106965,93035
1:3:3,0,-1,106966,93034
3:3:2,1,1,106965,93035
3:4:5,0,-1,106966,93034
6:6:1,0,-1,106967,93033
5:2:5,1,1,106966,93034
4:2:3,1,1,106965,93035
6:2:5,1,1,106964,93036
6:6:1,0,-1,106965,93035
4:6:4,0,-1,106966,93034
3:4:5,0,-1,106967,93033
5:1:3,0,-1,106968,93032
3:3:1,0,-1,106969,93031
2:4:3,1,1,106968,93032
5:5:5,0,-1,106969,93031
2:2:4,2,2,106967,93033
2:5:1,1,1,106966,93034
2:4:6,1,1,106965,93035
2:6:4,1,1,106964,93036
5:6:5,0,-1,106965,93035
4:5:4,0,-1,106966,93034
5:2:5,1,1,106965,93035
6:3:6,0,-1,106966,93034
5:6:1,0,-1,106967,93033
6:3:4,0,-1,106968,93032
5:3:3,0,-1,106969,93031
6:4:6,0,-1,106970,93030
6:3:1,0,-1,106971,93029
4:6:5,0,-1,106972,93028
6:5:1,0,-1,106973,93027
1:3:1,0,-1,106974,93026
1:2:1,1,1,106973,93027
5:6:1,0,-1,106974,93026
6:1:6,0,-1,106975,93025
5:6:4,0,-1,106976,93024
6:6:1,0,-1,106977,93023
5:1:5,0,-1,106978,93022
1:4:1,0,-1,106979,93021
4:3:1,0,-1,106980,93020
1:6:4,0,-1,106981,93019
4:4:5,0,-1,106982,93018
6:3:5,0,-1,106983,93017
2:3:2,2,2,106981,93019
5:2:5,1,1,106980,93020
6:2:4,1,1,106979,93021
2:3:3,1,1,106978,93022
6:3:2,1,1,106977,93023
5:3:2,1,1,106976,93024
3:4:4,0,-1,106977,93023
5:4:5,0,-1,106978,93022
3:5:2,1,1,106977,93023
5:1:2,1,1,106976,93024
1:4:2,1,1,106975,93025
3:4:3,0,-1,106976,93024
2:3:4,1,1,106975,93025
4:2:2,2,2,106973,93027
3:4:4,0,-1,106974,93026
3:4:5,0,-1,106975,93025
2:5:1,1,1,106974,93026
4:3:1,0,-1,106975,93025
2:1:5,1,1,106974,93026
3:5:6,0,-1,106975,93025
2:5:2,2,2,106973,93027
6:1:5,0,-1,106974,93026
5:1:3,0,-1,106975,93025
1:1:4,0,-1,106976,93024
1:2:1,1,1,106975,93025
4:6:6,0,-1,106976,93024
4:3:3,0,-1,106977,93023
5:1:3,0,-1,106978,93022
4:4:4,0,-1,106979,93021
6:2:2,2,2,106977,93023
2:4:5,1,1,106976,93024
3:6:6,0,-1,106977,93023
2:1:3,1,1,106976,93024
6:2:6,1,1,106975,93025
5:1:6,0,-1,106976,93024
2:2:1,2,2,106974,93026
4:6:6,0,-1,106975,93025
3:6:1,0,-1,106976,93024
5:3:2,1,1,106975,93025
2:5:6,1,1,106974,93026
1:5:3,0,-1,106975,93025
3:5:5,0,-1,106976,93024
6:4:4,0,-1,106977,93023
2:4:2,2,2,106975,93025
2:4:3,1,1,106974,93026
2:6:6,1,1,106973,93027
4:4:1,0,-1,106974,93026
3:5:3,0,-1,106975,93025
5:3:6,0,-1,106976,93024
5:3:6,0,-1,106977,93023
6:4:5,0,-1,106978,93022
3:1:2,1,1,106977,93023
1:5:6,0,-1,106978,93022
2:6:1,1,1,106977,93023
1:5:6,0,-1,106978,93022
2:6:3,1,1,106977,93023
4:4:3,0,-1,106978,93022
6:4:6,0,-1,106979,93021
6:5:3,0,-1,106980,93020
1:4:6,0,-1,106981,93019
2:6:1,1,1,106980,93020
1:2:4,1,1,106979,93021
1:5:5,0,-1,106980,93020
4:4:4,0,-1,106981,93019
4:5:4,0,-1,106982,93018
2:4:3,1,1,106981,93019
2:6:2,2,2,106979,93021
1:6:1,0,-1,106980,93020
5:1:2,1,1,106979,93021
2:5:5,1,1,106978,93022
6:3:4,0,-1,106979,93021
4:2:1,1,1,106978,93022
4:5:3,0,-1,106979,93021
4:2:1,1,1,106978,93022
3:1:2,1,1,106977,93023
3:3:1,0,-1,106978,93022
5:5:4,0,-1,106979,93021
6:1:1,0,-1,106980,93020
4:2:2,2,2,106978,93022
2:5:1,1,1,106977,93023
6:6:5,0,-1,106978,93022
2:5:5,1,1,106977,93023
2:6:2,2,2,106975,93025
1:1:2,1,1,106974,93026
3:1:2,1,1,106973,93027
3:2:6,1,1,106972,93028
2:6:3,1,1,106971,93029
6:2:2,2,2,106969,93031
6:6:1,0,-1,106970,93030
3:3:4,0,-1,106971,93029
2:5:1,1,1,106970,93030
6:5:5,0,-1,106971,93029
6:3:5,0,-1,106972,93028
3:6:2,1,1,106971,93029
2:1:4,1,1,106970,93030
5:2:4,1,1,106969,93031
6:2:1,1,1,106968,93032
1:4:3,0,-1,106969,93031
6:2:5,1,1,106968,93032
6:4:1,0,-1,106969,93031
6:2:6,1,1,106968,93032
6:4:4,0,-1,106969,93031
5:5:5,0,-1,106970,93030
5:3:5,0,-1,106971,93029
4:3:5,0,-1,106972,93028
3:5:1,0,-1,106973,93027
3:1:1,0,-1,106974,93026
5:6:4,0,-1,106975,93025
4:4:4,0,-1,106976,93024
6:5:1,0,-1,106977,93023
2:3:1,1,1,106976,93024
3:1:4,0,-1,106977,93023
4:6:3,0,-1,106978,93022
6:5:3,0,-1,106979,93021
1:5:4,0,-1,106980,93020
1:6:5,0,-1,106981,93019
6:5:5,0,-1,106982,93018
4:5:4,0,-1,106983,93017
3:6:4,0,-1,106984,93016
3:4:2,1,1,106983,93017
6:6:4,0,-1,106984,93016
2:3:6,1,1,106983,93017
2:3:2,2,2,106981,93019
2:1:4,1,1,106980,93020
5:5:3,0,-1,106981,93019
4:5:5,0,-1,106982,93018
4:4:1,0,-1,106983,93017
5:3:5,0,-1,106984,93016
3:6:4,0,-1,106985,93015
4:4:5,0,-1,106986,93014
1:1:2,1,1,106985,93015
1:6:1,0,-1,106986,93014
1:1:6,0,-1,106987,93013
3:6:3,0,-1,106988,93012
1:4:2,1,1,106987,93013
4:3:1,0,-1,106988,93012
1:2:1,1,1,106987,93013
4:5:1,0,-1,106988,93012
3:5:5,0,-1,106989,93011
4:3:1,0,-1,106990,93010
5:6:3,0,-1,106991,93009
4:3:3,0,-1,106992,93008
4:3:5,0,-1,106993,93007
4:3:5,0,-1,106994,93006
2:6:1,1,1,106993,93007
1:5:4,0,-1,106994,93006
1:2:1,1,1,106993,93007
2:1:5,1,1,106992,93008
5:3:4,0,-1,106993,93007
3:4:1,0,-1,106994,93006
5:5:4,0,-1,106995,93005
1:3:5,0,-1,106996,93004
3:6:1,0,-1,106997,93003
6:3:3,0,-1,106998,93002
5:1:2,1,1,106997,93003
2:5:5,1,1,106996,93004
3:5:2,1,1,106995,93005
1:4:3,0,-1,106996,93004
6:4:1,0,-1,106997,93003
6:2:1,1,1,106996,93004
6:2:6,1,1,106995,93005
3:3:4,0,-1,106996,93004
4:1:1,0,-1,106997,93003
2:5:4,1,1,106996,93004
2:3:5,1,1,106995,93005
4:5:2,1,1,106994,93006
1:5:3,0,-1,106995,93005
6:1:4,0,-1,106996,93004
1:4:4,0,-1,106997,93003
6:2:4,1,1,106996,93004
2:6:2,2,2,106994,93006
5:2:3,1,1,106993,93007
6:2:4,1,1,106992,93008
6:3:4,0,-1,106993,93007
3:3:5,0,-1,106994,93006
6:2:1,1,1,106993,93007
4:2:2,2,2,106991,93009
5:1:4,0,-1,106992,93008
5:1:5,0,-1,106993,93007
3:6:4,0,-1,106994,93006
5:3:4,0,-1,106995,93005
6:6:6,0,-1,106996,93004
2:5:2,2,2,106994,93006
3:5:5,0,-1,106995,93005
2:6:1,1,1,106994,93006
1:2:2,2,2,106992,93008
2:5:5,1,1,106991,93009
4:5:4,0,-1,106992,93008
2:1:1,1,1,106991,93009
1:5:4,0,-1,106992,93008
2:1:4,1,1,106991,93009
2:3:2,2,2,106989,93011
6:5:1,0,-1,106990,93010
2:5:1,1,1,106989,93011
2:4:2,2,2,106987,93013
5:4:3,0,-1,106988,93012
6:5:6,0,-1,106989,93011
4:2:2,2,2,106987,93013
4:2:2,2,2,106985,93015
4:3:6,0,-1,106986,93014
4:6:3,0,-1,106987,93013
1:6:6,0,-1,106988,93012
2:2:6,2,2,106986,93014
1:5:4,0,-1,106987,93013
6:5:4,0,-1,106988,93012
2:2:2,3,3,106985,93015
4:2:3,1,1,106984,93016
6:3:6,0,-1,106985,93015
3:4:6,0,-1,106986,93014
1:6:5,0,-1,106987,93013
6:5:2,1,1,106986,93014
1:2:5,1,1,106985,93015
2:4:1,1,1,106984,93016
6:4:3,0,-1,106985,93015
4:5:4,0,-1,106986,93014
4:5:5,0,-1,106987,93013
5:5:4,0,-1,106988,93012
5:1:1,0,-1,106989,93011
1:6:4,0,-1,106990,93010
5:4:3,0,-1,106991,93009
6:3:4,0,-1,106992,93008
1:3:5,0,-1,106993,93007
1:2:2,2,2,106991,93009
5:1:5,0,-1,106992,93008
1:6:5,0,-1,106993,93007
2:6:1,1,1,106992,93008
6:1:6,0,-1,106993,93007
3:2:2,2,2,106991,93009
3:2:1,1,1,106990,93010
6:4:6,0,-1,106991,93009
3:5:4,0,-1,106992,93008
3:6:5,0,-1,106993,93007
5:1:2,1,1,106992,93008
1:2:5,1,1,106991,93009
4:2:5,1,1,106990,93010
6:1:1,0,-1,106991,93009
4:3:4,0,-1,106992,93008
6:1:6,0,-1,106993,93007
5:5:6,0,-1,106994,93006
1:2:2,2,2,106992,93008
4:2:6,1,1,106991,93009
5:1:4,0,-1,106992,93008
6:4:3,0,-1,106993,93007
3:4:3,0,-1,106994,93006
4:3:3,0,-1,106995,93005
2:4:5,1,1,106994,93006
1:4:5,0,-1,106995,93005
2:3:3,1,1,106994,93006
1:2:1,1,1,106993,93007
1:2:4,1,1,106992,93008
2:4:3,1,1,106991,93009
2:4:4,1,1,106990,93010
5:3:4,0,-1,106991,93009
3:5:5,0,-1,106992,93008
4:3:3,0,-1,106993,93007
2:4:4,1,1,106992,93008
3:4:6,0,-1,106993,93007
1:1:1,0,-1,106994,93006
2:4:3,1,1,106993,93007
2:3:5,1,1,106992,93008
2:1:2,2,2,106990,93010
5:2:5,1,1,106989,93011
3:5:2,1,1,106988,93012
1:2:6,1,1,106987,93013
6:5:3,0,-1,106988,93012
4:3:4,0,-1,106989,93011
2:4:5,1,1,106988,93012
6:3:1,0,-1,106989,93011
6:6:6,0,-1,106990,93010
1:4:6,0,-1,106991,93009
3:4:2,1,1,106990,93010
6:2:1,1,1,106989,93011
3:6:1,0,-1,106990,93010
4:3:3,0,-1,106991,93009
5:5:6,0,-1,106992,93008
2:3:6,1,1,106991,93009
5:3:6,0,-1,106992,93008
6:1:2,1,1,106991,93009
4:2:1,1,1,106990,93010
4:5:4,0,-1,106991,93009
2:2:3,2,2,106989,93011
1:4:4,0,-1,106990,93010
1:5:1,0,-1,106991,93009
3:1:3,0,-1,106992,93008
1:5:5,0,-1,106993,93007
2:2:3,2,2,106991,93009
5:4:6,0,-1,106992,93008
2:2:1,2,2,106990,93010
5:4:3,0,-1,106991,93009
2:5:3,1,1,106990,93010
3:6:6,0,-1,106991,93009
6:4:6,0,-1,106992,93008
2:4:1,1,1,106991,93009
4:3:5,0,-1,106992,93008
2:3:5,1,1,106991,93009
3:5:1,0,-1,106992,93008
1:3:3,0,-1,106993,93007
4:3:2,1,1,106992,93008
5:4:4,0,-1,106993,93007
4:6:5,0,-1,106994,93006
2:6:4,1,1,106993,93007
4:5:5,0,-1,106994,93006
5:3:5,0,-1,106995,93005
2:1:5,1,1,106994,93006
5:5:1,0,-1,106995,93005
4:1:6,0,-1,106996,93004
4:5:5,0,-1,106997,93003
5:5:2,1,1,106996,93004
3:5:5,0,-1,106997,93003
3:6:4,0,-1,106998,93002
4:3:6,0,-1,106999,93001
2:2:2,3,3,106996,93004
1:2:3,1,1,106995,93005
4:2:3,1,1,106994,93006
5:5:5,0,-1,106995,93005
3:4:3,0,-1,106996,93004
1:4:4,0,-1,106997,93003
4:6:6,0,-1,106998,93002
5:3:6,0,-1,106999,93001
3:5:5,0,-1,107000,93000
6:5:4,0,-1,107001,92999
2:6:5,1,1,107000,93000
5:1:6,0,-1,107001,92999
2:6:6,1,1,107000,93000
2:2:4,2,2,106998,93002
3:4:3,0,-1,106999,93001
2:5:3,1,1,106998,93002
5:5:3,0,-1,106999,93001
3:5:2,1,1,106998,93002
1:2:1,1,1,106997,93003
6:6:6,0,-1,106998,93002
3:1:3,0,-1,106999,93001
4:4:3,0,-1,107000,93000
4:6:1,0,-1,107001,92999
1:5:3,0,-1,107002,92998
5:2:1,1,1,107001,92999
5:2:2,2,2,106999,93001
3:2:1,1,1,106998,93002
1:6:4,0,-1,106999,93001
1:1:4,0,-1,107000,93000
2:4:6,1,1,106999,93001
1:3:4,0,-1,107000,93000
6:2:1,1,1,106999,93001
5:5:6,0,-1,107000,93000
6:3:2,1,1,106999,93001
5:5:1,0,-1,107000,93000
3:4:3,0,-1,107001,92999
1:2:5,1,1,107000,93000
1:3:3,0,-1,107001,92999
5:4:4,0,-1,107002,92998
1:6:2,1,1,107001,92999
2:1:4,1,1,107000,93000
4:5:5,0,-1,107001,92999
5:5:6,0,-1,107002,92998
3:2:1,1,1,107001,92999
6:3:4,0,-1,107002,92998
4:6:3,0,-1,107003,92997
4:5:1,0,-1,107004,92996
6:6:3,0,-1,107005,92995
3:2:1,1,1,107004,92996
3:6:4,0,-1,107005,92995
1:4:2,1,1,107004,92996
2:6:3,1,1,107003,92997
5:5:5,0,-1,107004,92996
3:2:4,1,1,107003,92997
6:3:1,0,-1,107004,92996
5:3:6,0,-1,107005,92995
2:3:6,1,1,107004,92996
2:1:2,2,2,107002,92998
5:4:4,0,-1,107003,92997
1:1:1,0,-1,107004,92996
1:2:1,1,1,107003,92997
3:1:2,1,1,107002,92998
6:3:5,0,-1,107003,92997
6:6:4,0,-1,107004,92996
3:1:3,0,-1,107005,92995
6:6:2,1,1,107004,92996
3:2:3,1,1,107003,92997
6:6:5,0,-1,107004,92996
1:5:3,0,-1,107005,92995
6:2:6,1,1,107004,92996
2:4:3,1,1,107003,92997
6:1:1,0,-1,107004,92996
2:5:5,1,1,107003,92997
1:1:4,0,-1,107004,92996
6:3:2,1,1,107003,92997
4:3:3,0,-1,107004,92996
3:4:1,0,-1,107005,92995
2:6:1,1,1,107004,92996
5:1:2,1,1,107003,92997
6:1:1,0,-1,107004,92996
6:5:4,0,-1,107005,92995
1:2:1,1,1,107004,92996
5:6:3,0,-1,107005,92995
4:4:4,0,-1,107006,92994
1:3:1,0,-1,107007,92993
1:5:2,1,1,107006,92994
5:3:5,0,-1,107007,92993
5:4:3,0,-1,107008,92992
2:6:6,1,1,107007,92993
4:1:4,0,-1,107008,92992
3:5:2,1,1,107007,92993
5:2:1,1,1,107006,92994
3:3:5,0,-1,107007,92993
3:3:4,0,-1,107008,92992
6:5:2,1,1,107007,92993
4:3:6,0,-1,107008,92992
3:6:6,0,-1,107009,92991
5:5:5,0,-1,107010,92990
2:2:5,2,2,107008,92992
4:4:2,1,1,107007,92993
2:2:6,2,2,107005,92995
6:1:6,0,-1,107006,92994
3:3:4,0,-1,107007,92993
2:6:6,1,1,107006,92994
5:2:4,1,1,107005,92995
5:1:6,0,-1,107006,92994
2:1:2,2,2,107004,92996
1:3:2,1,1,107003,92997
4:2:6,1,1,107002,92998
3:1:6,0,-1,107003,92997
5:6:5,0,-1,107004,92996
5:5:3,0,-1,107005,92995
1:1:1,0,-1,107006,92994
6:1:3,0,-1,107007,92993
4:1:3,0,-1,107008,92992
5:3:1,0,-1,107009,92991
1:2:5,1,1,107008,92992
2:4:2,2,2,107006,92994
1:5:1,0,-1,107007,92993
5:3:1,0,-1,107008,92992
3:2:2,2,2,107006,92994
6:5:4,0,-1,107007,92993
4:6:6,0,-1,107008,92992
6:6:4,0,-1,107009,92991
6:3:6,0,-1,107010,92990
4:3:2,1,1,107009,92991
4:5:5,0,-1,107010,92990
5:4:2,1,1,107009,92991
3:2:5,1,1,107008,92992
4:1:3,0,-1,107009,92991
1:3:6,0,-1,107010,92990
4:2:3,1,1,107009,92991
3:5:3,0,-1,107010,92990
5:4:3,0,-1,107011,92989
5:6:6,0,-1,107012,92988
6:4:5,0,-1,107013,92987
6:3:5,0,-1,107014,92986
2:2:5,2,2,107012,92988
1:1:3,0,-1,107013,92987
5:1:1,0,-1,107014,92986
6:2:5,1,1,107013,92987
4:6:1,0,-1,107014,92986
1:3:2,1,1,107013,92987
4:5:6,0,-1,107014,92986
4:6:5,0,-1,107015,92985
3:6:5,0,-1,107016,92984
5:2:6,1,1,107015,92985
3:3:6,0,-1,107016,92984
1:2:6,1,1,107015,92985
2:4:4,1,1,107014,92986
3:6:4,0,-1,107015,92985
3:1:6,0,-1,107016,92984
1:6:4,0,-1,107017,92983
1:1:5,0,-1,107018,92982
3:4:2,1,1,107017,92983
5:3:5,0,-1,107018,92982
5:2:4,1,1,107017,92983
2:6:3,1,1,107016,92984
2:6:2,2,2,107014,92986
2:5:4,1,1,107013,92987
5:4:3,0,-1,107014,92986
3:4:2,1,1,107013,92987
6:1:5,0,-1,107014,92986
3:4:2,1,1,107013,92987
6:2:4,1,1,107012,92988
2:2:2,3,3,107009,92991
5:3:3,0,-1,107010,92990
5:2:5,1,1,107009,92991
1:1:1,0,-1,107010,92990
1:4:3,0,-1,107011,92989
1:5:4,0,-1,107012,92988
4:5:4,0,-1,107013,92987
5:5:4,0,-1,107014,92986
3:3:3,0,-1,107015,92985
5:4:5,0,-1,107016,92984
5:3:4,0,-1,107017,92983
6:6:3,0,-1,107018,92982
1:5:1,0,-1,107019,92981
1:2:6,1,1,107018,92982
4:5:4,0,-1,107019,92981
3:6:1,0,-1,107020,92980
5:4:5,0,-1,107021,92979
6:6:2,1,1,107020,92980
6:6:3,0,-1,107021,92979
4:1:1,0,-1,107022,92978
1:6:5,0,-1,107023,92977
5:5:1,0,-1,107024,92976
2:5:2,2,2,107022,92978
5:3:6,0,-1,107023,92977
2:3:2,2,2,107021,92979
1:1:2,1,1,107020,92980
2:1:2,2,2,107018,92982
4:1:4,0,-1,107019,92981
4:5:3,0,-1,107020,92980
2:6:3,1,1,107019,92981
1:1:4,0,-1,107020,92980
1:1:2,1,1,107019,92981
1:1:4,0,-1,107020,92980
3:3:6,0,-1,107021,92979
2:2:1,2,2,107019,92981
2:4:5,1,1,107018,92982
1:1:6,0,-1,107019,92981
6:6:5,0,-1,107020,92980
5:1:5,0,-1,107021,92979
2:3:3,1,1,107020,92980
3:6:6,0,-1,107021,92979
4:6:6,0,-1,107022,92978
3:1:1,0,-1,107023,92977
4:2:2,2,2,107021,92979
3:5:4,0,-1,107022,92978
2:2:1,2,2,107020,92980
3:1:5,0,-1,107021,92979
4:1:4,0,-1,107022,92978
4:3:1,0,-1,107023,92977
5:3:3,0,-1,107024,92976
4:6:3,0,-1,107025,92975
3:2:3,1,1,107024,92976
2:6:5,1,1,107023,92977
6:5:2,1,1,107022,92978
4:6:6,0,-1,107023,92977
4:6:4,0,-1,107024,92976
3:6:6,0,-1,107025,92975
5:1:5,0,-1,107026,92974
5:3:1,0,-1,107027,92973
1:2:4,1,1,107026,92974
1:5:6,0,-1,107027,92973
2:2:1,2,2,107025,92975
3:4:1,0,-1,107026,92974
1:2:6,1,1,107025,92975
2:4:3,1,1,107024,92976
1:6:4,0,-1,107025,92975
6:3:2,1,1,107024,92976
6:6:5,0,-1,107025,92975
5:4:3,0,-1,107026,92974
5:1:3,0,-1,107027,92973
3:4:6,0,-1,107028,92972
1:2:3,1,1,107027,92973
3:5:3,0,-1,107028,92972
1:1:6,0,-1,107029,92971
2:4:4,1,1,107028,92972
6:5:3,0,-1,107029,92971
3:6:1,0,-1,107030,92970
2:6:4,1,1,107029,92971
2:4:4,1,1,107028,92972
3:2:3,1,1,107027,92973
2:4:3,1,1,107026,92974
1:4:5,0,-1,107027,92973
3:4:2,1,1,107026,92974
4:4:4,0,-1,107027,92973
2:5:3,1,1,107026,92974
5:2:4,1,1,107025,92975
5:2:6,1,1,107024,92976
2:4:3,1,1,107023,92977
2:3:2,2,2,107021,92979
2:1:3,1,1,107020,92980
2:3:6,1,1,107019,92981
5:1:1,0,-1,107020,92980
3:2:1,1,1,107019,92981
5:4:5,0,-1,107020,92980
5:3:1,0,-1,107021,92979
6:5:4,0,-1,107022,92978
6:3:2,1,1,107021,92979
5:6:6,0,-1,107022,92978
6:4:4,0,-1,107023,92977
3:6:2,1,1,107022,92978
6:1:5,0,-1,107023,92977
4:1:1,0,-1,107024,92976
4:3:3,0,-1,107025,92975
3:2:4,1,1,107024,92976
6:6:4,0,-1,107025,92975
2:5:2,2,2,107023,92977
5:3:3,0,-1,107024,92976
1:2:4,1,1,107023,92977
5:2:5,1,1,107022,92978
5:5:1,0,-1,107023,92977
3:3:4,0,-1,107024,92976
3:5:2,1,1,107023,92977
6:4:3,0,-1,107024,92976
4:5:3,0,-1,107025,92975
5:5:4,0,-1,107026,92974
1:5:5,0,-1,107027,92973
4:4:4,0,-1,107028,92972
6:5:5,0,-1,107029,92971
5:5:2,1,1,107028,92972
6:2:3,1,1,107027,92973
3:6:4,0,-1,107028,92972
2:1:3,1,1,107027,92973
6:5:5,0,-1,107028,92972
4:2:6,1,1,107027,92973
5:4:5,0,-1,107028,92972
4:6:3,0,-1,107029,92971
6:5:2,1,1,107028,92972
3:6:3,0,-1,107029,92971
3:1:3,0,-1,107030,92970
1:3:5,0,-1,107031,92969
3:2:1,1,1,107030,92970
6:5:4,0,-1,107031,92969
1:4:3,0,-1,107032,92968
4:2:1,1,1,107031,92969
2:2:2,3,3,107028,92972
1:6:1,0,-1,107029,92971
5:6:6,0,-1,107030,92970
6:2:5,1,1,107029,92971
2:5:1,1,1,107028,92972
6:1:1,0,-1,107029,92971
3:2:3,1,1,107028,92972
6:3:5,0,-1,107029,92971
5:1:3,0,-1,107030,92970
2:3:1,1,1,107029,92971
3:1:4,0,-1,107030,92970
4:6:5,0,-1,107031,92969
2:2:5,2,2,107029,92971
4:3:2,1,1,107028,92972
3:1:3,0,-1,107029,92971
5:5:6,0,-1,107030,92970
1:5:4,0,-1,107031,92969
2:1:1,1,1,107030,92970
2:4:2,2,2,107028,92972
6:4:2,1,1,107027,92973
3:4:1,0,-1,107028,92972
3:6:2,1,1,107027,92973
3:5:2,1,1,107026,92974
6:1:2,1,1,107025,92975
2:3:2,2,2,107023,92977
4:1:1,0,-1,107024,92976
1:4:3,0,-1,107025,92975
5:4:2,1,1,107024,92976
6:6:2,1,1,107023,92977
6:5:3,0,-1,107024,92976
4:3:4,0,-1,107025,92975
1:2:4,1,1,107024,92976
3:3:1,0,-1,107025,92975
5:3:1,0,-1,107026,92974
4:2:3,1,1,107025,92975
4:2:1,1,1,107024,92976
2:2:3,2,2,107022,92978
6:4:4,0,-1,107023,92977
3:3:4,0,-1,107024,92976
3:6:5,0,-1,107025,92975
6:4:4,0,-1,107026,92974
4:3:5,0,-1,107027,92973
4:1:6,0,-1,107028,92972
6:4:5,0,-1,107029,92971
5:3:3,0,-1,107030,92970
5:6:4,0,-1,107031,92969
2:6:5,1,1,107030,92970
2:6:3,1,1,107029,92971
6:4:1,0,-1,107030,92970
4:1:5,0,-1,107031,92969
3:2:3,1,1,107030,92970
6:2:5,1,1,107029,92971
1:2:6,1,1,107028,92972
4:5:1,0,-1,107029,92971
6:4:6,0,-1,107030,92970
1:4:5,0,-1,107031,92969
4:1:2,1,1,107030,92970
2:5:6,1,1,107029,92971
3:6:3,0,-1,107030,92970
6:6:5,0,-1,107031,92969
4:4:1,0,-1,107032,92968
2:5:5,1,1,107031,92969
1:3:5,0,-1,107032,92968
6:6:6,0,-1,107033,92967
3:5:4,0,-1,107034,92966
6:6:3,0,-1,107035,92965
3:2:4,1,1,107034,92966
5:4:4,0,-1,107035,92965
4:4:1,0,-1,107036,92964
3:5:1,0,-1,107037,92963
2:3:4,1,1,107036,92964
5:1:6,0,-1,107037,92963
1:1:4,0,-1,107038,92962
6:2:3,1,1,107037,92963
2:5:6,1,1,107036,92964
5:3:4,0,-1,107037,92963
5:1:3,0,-1,107038,92962
3:4:3,0,-1,107039,92961
4:4:5,0,-1,107040,92960
6:4:2,1,1,107039,92961
1:4:6,0,-1,107040,92960
1:6:1,0,-1,107041,92959
1:2:5,1,1,107040,92960
3:2:4,1,1,107039,92961
1:2:6,1,1,107038,92962
6:1:1,0,-1,107039,92961
3:1:2,1,1,107038,92962
2:4:5,1,1,107037,92963
4:1:1,0,-1,107038,92962
5:4:2,1,1,107037,92963
3:4:3,0,-1,107038,92962
3:6:6,0,-1,107039,92961
4:3:2,1,1,107038,92962
6:4:5,0,-1,107039,92961
1:3:4,0,-1,107040,92960
6:2:5,1,1,107039,92961
3:4:3,0,-1,107040,92960
4:4:4,0,-1,107041,92959
3:3:4,0,-1,107042,92958
2:3:4,1,1,107041,92959
1:1:2,1,1,107040,92960
2:6:3,1,1,107039,92961
5:5:3,0,-1,107040,92960
5:2:6,1,1,107039,92961
4:3:5,0,-1,107040,92960
4:2:4,1,1,107039,92961
3:3:2,1,1,107038,92962
1:6:3,0,-1,107039,92961
2:6:1,1,1,107038,92962
6:4:1,0,-1,107039,92961
5:4:1,0,-1,107040,92960
6:4:5,0,-1,107041,92959
6:1:1,0,-1,107042,92958
3:6:4,0,-1,107043,92957
2:5:4,1,1,107042,92958
6:6:2,1,1,107041,92959
4:2:5,1,1,107040,92960
1:2:6,1,1,107039,92961
2:4:4,1,1,107038,92962
5:4:4,0,-1,107039,92961
4:6:5,0,-1,107040,92960
2:5:4,1,1,107039,92961
6:4:1,0,-1,107040,92960
4:3:5,0,-1,107041,92959
2:1:5,1,1,107040,92960
6:6:5,0,-1,107041,92959
6:6:4,0,-1,107042,92958
4:4:1,0,-1,107043,92957
5:6:1,0,-1,107044,92956
2:4:6,1,1,107043,92957
3:2:5,1,1,107042,92958
1:6:1,0,-1,107043,92957
3:3:2,1,1,107042,92958
4:1:3,0,-1,107043,92957
5:2:5,1,1,107042,92958
1:1:1,0,-1,107043,92957
3:1:1,0,-1,107044,92956
1:1:6,0,-1,107045,92955
3:3:6,0,-1,107046,92954
4:6:6,0,-1,107047,92953
3:6:3,0,-1,107048,92952
1:4:4,0,-1,107049,92951
4:6:2,1,1,107048,92952
2:6:3,1,1,107047,92953
1:5:3,0,-1,107048,92952
2:4:1,1,1,107047,92953
3:6:3,0,-1,107048,92952
4:2:1,1,1,107047,92953
2:6:3,1,1,107046,92954
2:6:3,1,1,107045,92955
2:1:4,1,1,107044,92956
4:4:2,1,1,107043,92957
2:6:2,2,2,107041,92959
5:5:2,1,1,107040,92960
2:5:1,1,1,107039,92961
1:3:5,0,-1,107040,92960
5:4:1,0,-1,107041,92959
2:6:5,1,1,107040,92960
4:5:1,0,-1,107041,92959
6:5:5,0,-1,107042,92958
1:2:3,1,1,107041,92959
4:4:2,1,1,107040,92960
2:3:1,1,1,107039,92961
2:6:4,1,1,107038,92962
2:4:4,1,1,107037,92963
1:3:6,0,-1,107038,92962
5:2:6,1,1,107037,92963
4:1:3,0,-1,107038,92962
3:6:6,0,-1,107039,92961
4:5:5,0,-1,107040,92960
3:3:4,0,-1,107041,92959
2:2:3,2,2,107039,92961
5:4:6,0,-1,107040,92960
4:1:1,0,-1,107041,92959
2:2:1,2,2,107039,92961
3:3:4,0,-1,107040,92960
2:4:5,1,1,107039,92961
5:3:2,1,1,107038,92962
2:2:3,2,2,107036,92964
1:3:4,0,-1,107037,92963
3:1:3,0,-1,107038,92962
5:2:5,1,1,107037,92963
2:6:3,1,1,107036,92964
5:3:2,1,1,107035,92965
4:4:5,0,-1,107036,92964
1:3:6,0,-1,107037,92963
4:5:2,1,1,107036,92964
1:1:3,0,-1,107037,92963
3:4:1,0,-1,107038,92962
5:2:6,1,1,107037,92963
5:2:3,1,1,107036,92964
5:5:4,0,-1,107037,92963
4:4:1,0,-1,107038,92962
4:3:4,0,-1,107039,92961
1:1:5,0,-1,107040,92960
4:1:2,1,1,107039,92961
2:6:1,1,1,107038,92962
2:6:1,1,1,107037,92963
5:3:5,0,-1,107038,92962
6:6:2,1,1,107037,92963
6:4:5,0,-1,107038,92962
3:2:1,1,1,107037,92963
4:1:6,0,-1,107038,92962
1:5:5,0,-1,107039,92961
4:4:2,1,1,107038,92962
1:6:4,0,-1,107039,92961
2:6:2,2,2,107037,92963
1:5:2,1,1,107036,92964
4:2:1,1,1,107035,92965
2:4:2,2,2,107033,92967
2:3:2,2,2,107031,92969
1:2:6,1,1,107030,92970
1:2:3,1,1,107029,92971
5:1:5,0,-1,107030,92970
4:5:3,0,-1,107031,92969
4:2:1,1,1,107030,92970
4:3:2,1,1,107029,92971
4:3:1,0,-1,107030,92970
6:4:5,0,-1,107031,92969
1:1:2,1,1,107030,92970
6:4:2,1,1,107029,92971
4:3:5,0,-1,107030,92970
5:2:1,1,1,107029,92971
2:5:6,1,1,107028,92972
5:3:3,0,-1,107029,92971
1:1:5,0,-1,107030,92970
2:5:4,1,1,107029,92971
1:2:3,1,1,107028,92972
1:5:6,0,-1,107029,92971
3:5:3,0,-1,107030,92970
5:3:5,0,-1,107031,92969
4:6:6,0,-1,107032,92968
4:6:6,0,-1,107033,92967
1:3:3,0,-1,107034,92966
2:1:5,1,1,107033,92967
2:2:4,2,2,107031,92969
2:2:1,2,2,107029,92971
4:6:5,0,-1,107030,92970
5:4:3,0,-1,107031,92969
2:6:4,1,1,107030,92970
1:4:3,0,-1,107031,92969
1:5:6,0,-1,107032,92968
5:2:4,1,1,107031,92969
4:1:2,1,1,107030,92970
1:6:5,0,-1,107031,92969
1:3:2,1,1,107030,92970
4:1:1,0,-1,107031,92969
4:4:4,0,-1,107032,92968
1:1:2,1,1,107031,92969
6:1:1,0,-1,107032,92968
6:6:1,0,-1,107033,92967
4:3:4,0,-1,107034,92966
4:4:6,0,-1,107035,92965
3:4:4,0,-1,107036,92964
1:4:3,0,-1,107037,92963
5:3:2,1,1,107036,92964
5:4:5,0,-1,107037,92963
6:1:4,0,-1,107038,92962
2:1:5,1,1,107037,92963
5:2:3,1,1,107036,92964
4:1:1,0,-1,107037,92963
5:3:4,0,-1,107038,92962
3:5:6,0,-1,107039,92961
3:2:1,1,1,107038,92962
2:4:5,1,1,107037,92963
2:2:3,2,2,107035,92965
3:1:3,0,-1,107036,92964
6:2:1,1,1,107035,92965
2:2:4,2,2,107033,92967
2:6:1,1,1,107032,92968
4:6:1,0,-1,107033,92967
3:3:3,0,-1,107034,92966
1:1:5,0,-1,107035,92965
4:5:4,0,-1,107036,92964
1:6:3,0,-1,107037,92963
2:6:5,1,1,107036,92964
2:5:5,1,1,107035,92965
2:6:4,1,1,107034,92966
2:1:5,1,1,107033,92967
1:1:4,0,-1,107034,92966
3:4:5,0,-1,107035,92965
6:1:3,0,-1,107036,92964
4:2:6,1,1,107035,92965
3:5:4,0,-1,107036,92964
5:3:2,1,1,107035,92965
1:1:1,0,-1,107036,92964
5:3:6,0,-1,107037,92963
3:5:6,0,-1,107038,92962
3:6:5,0,-1,107039,92961
3:4:4,0,-1,107040,92960
2:3:3,1,1,107039,92961
5:3:1,0,-1,107040,92960
1:6:4,0,-1,107041,92959
4:4:6,0,-1,107042,92958
3:4:1,0,-1,107043,92957
6:4:4,0,-1,107044,92956
5:1:5,0,-1,107045,92955
3:3:1,0,-1,107046,92954
3:1:3,0,-1,107047,92953
6:6:3,0,-1,107048,92952
5:4:5,0,-1,107049,92951
2:5:3,1,1,107048,92952
2:4:2,2,2,107046,92954
5:5:5,0,-1,107047,92953
2:4:1,1,1,107046,92954
4:6:6,0,-1,107047,92953
6:3:2,1,1,107046,92954
5:5:6,0,-1,107047,92953
1:3:3,0,-1,107048,92952
1:3:2,1,1,107047,92953
6:2:1,1,1,107046,92954
4:2:1,1,1,107045,92955
5:1:1,0,-1,107046,92954
6:3:3,0,-1,107047,92953
2:2:2,3,3,107044,92956
4:3:5,0,-1,107045,92955
2:3:4,1,1,107044,92956
3:4:3,0,-1,107045,92955
5:6:4,0,-1,107046,92954
2:4:6,1,1,107045,92955
1:6:3,0,-1,107046,92954
2:4:3,1,1,107045,92955
5:4:5,0,-1,107046,92954
2:2:5,2,2,107044,92956
5:2:4,1,1,107043,92957
5:4:2,1,1,107042,92958
1:6:1,0,-1,107043,92957
3:4:2,1,1,107042,92958
3:4:4,0,-1,107043,92957
1:5:2,1,1,107042,92958
6:4:2,1,1,107041,92959
2:5:3,1,1,107040,92960
4:4:6,0,-1,107041,92959
2:3:6,1,1,107040,92960
2:3:3,1,1,107039,92961
3:2:4,1,1,107038,92962
4:3:1,0,-1,107039,92961
1:5:4,0,-1,107040,92960
2:4:2,2,2,107038,92962
4:5:4,0,-1,107039,92961
3:3:5,0,-1,107040,92960
5:4:3,0,-1,107041,92959
1:4:1,0,-1,107042,92958
1:2:1,1,1,107041,92959
6:2:3,1,1,107040,92960
5:3:5,0,-1,107041,92959
3:6:5,0,-1,107042,92958
6:4:1,0,-1,107043,92957
4:3:1,0,-1,107044,92956
2:6:6,1,1,107043,92957
5:1:4,0,-1,107044,92956
1:5:4,0,-1,107045,92955
5:4:6,0,-1,107046,92954
4:3:5,0,-1,107047,92953
3:4:1,0,-1,107048,92952
1:3:6,0,-1,107049,92951
6:5:2,1,1,107048,92952
1:4:2,1,1,107047,92953
2:4:2,2,2,107045,92955
6:6:4,0,-1,107046,92954
4:2:5,1,1,107045,92955
5:5:1,0,-1,107046,92954
1:1:5,0,-1,107047,92953
6:3:6,0,-1,107048,92952
3:3:1,0,-1,107049,92951
6:3:2,1,1,107048,92952
2:3:2,2,2,107046,92954
3:5:1,0,-1,107047,92953
1:4:1,0,-1,107048,92952
1:4:6,0,-1,107049,92951
3:3:6,0,-1,107050,92950
2:6:3,1,1,107049,92951
1:5:2,1,1,107048,92952
5:1:1,0,-1,107049,92951
4:1:2,1,1,107048,92952
4:4:3,0,-1,107049,92951
6:4:4,0,-1,107050,92950
1:3:4,0,-1,107051,92949
4:4:1,0,-1,107052,92948
4:2:3,1,1,107051,92949
4:5:5,0,-1,107052,92948
2:2:5,2,2,107050,92950
4:1:6,0,-1,107051,92949
4:5:1,0,-1,107052,92948
3:4:4,0,-1,107053,92947
4:4:1,0,-1,107054,92946
2:2:6,2,2,107052,92948
2:2:4,2,2,107050,92950
4:3:5,0,-1,107051,92949
3:2:2,2,2,107049,92951
2:2:5,2,2,107047,92953
6:3:4,0,-1,107048,92952
5:1:5,0,-1,107049,92951
1:4:3,0,-1,107050,92950
2:3:2,2,2,107048,92952
5:2:1,1,1,107047,92953
4:3:1,0,-1,107048,92952
2:2:3,2,2,107046,92954
1:3:6,0,-1,107047,92953
2:1:2,2,2,107045,92955
5:3:3,0,-1,107046,92954
1:3:1,0,-1,107047,92953
3:5:6,0,-1,107048,92952
1:5:5,0,-1,107049,92951
1:5:3,0,-1,107050,92950
2:6:3,1,1,107049,92951
6:1:4,0,-1,107050,92950
5:6:3,0,-1,107051,92949
5:1:6,0,-1,107052,92948
1:6:5,0,-1,107053,92947
5:1:2,1,1,107052,92948
1:3:1,0,-1,107053,92947
4:6:3,0,-1,107054,92946
5:4:1,0,-1,107055,92945
2:6:4,1,1,107054,92946
4:1:2,1,1,107053,92947
6:3:5,0,-1,107054,92946
6:3:2,1,1,107053,92947
6:3:5,0,-1,107054,92946
2:1:6,1,1,107053,92947
5:3:1,0,-1,107054,92946
6:3:3,0,-1,107055,92945
3:5:5,0,-1,107056,92944
1:6:1,0,-1,107057,92943
1:3:6,0,-1,107058,92942
4:1:2,1,1,107057,92943
1:5:6,0,-1,107058,92942
6:4:3,0,-1,107059,92941
2:2:1,2,2,107057,92943
2:6:3,1,1,107056,92944
1:1:1,0,-1,107057,92943
3:2:2,2,2,107055,92945
4:3:1,0,-1,107056,92944
3:3:3,0,-1,107057,92943
6:6:3,0,-1,107058,92942
3:1:4,0,-1,107059,92941
6:2:2,2,2,107057,92943
2:1:5,1,1,107056,92944
4:1:4,0,-1,107057,92943
1:2:5,1,1,107056,92944
4:5:2,1,1,107055,92945
6:5:4,0,-1,107056,92944
2:3:1,1,1,107055,92945
1:2:2,2,2,107053,92947
2:4:2,2,2,107051,92949
4:3:6,0,-1,107052,92948
4:2:4,1,1,107051,92949
4:4:5,0,-1,107052,92948
2:5:1,1,1,107051,92949
2:2:5,2,2,107049,92951
3:2:1,1,1,107048,92952
2:4:4,1,1,107047,92953
5:3:3,0,-1,107048,92952
3:4:1,0,-1,107049,92951
2:2:2,3,3,107046,92954
2:2:1,2,2,107044,92956
1:5:2,1,1,107043,92957
6:6:1,0,-1,107044,92956
5:6:1,0,-1,107045,92955
6:5:5,0,-1,107046,92954
4:4:1,0,-1,107047,92953
3:4:4,0,-1,107048,92952
2:5:1,1,1,107047,92953
3:5:5,0,-1,107048,92952
2:6:2,2,2,107046,92954
2:2:2,3,3,107043,92957
4:2:4,1,1,107042,92958
4:6:2,1,1,107041,92959
1:4:1,0,-1,107042,92958
5:5:5,0,-1,107043,92957
1:4:6,0,-1,107044,92956
4:3:3,0,-1,107045,92955
6:2:2,2,2,107043,92957
1:5:3,0,-1,107044,92956
3:4:6,0,-1,107045,92955
4:4:3,0,-1,107046,92954
5:5:4,0,-1,107047,92953
5:4:2,1,1,107046,92954
2:1:5,1,1,107045,92955
5:4:1,0,-1,107046,92954
5:5:6,0,-1,107047,92953
6:1:6,0,-1,107048,92952
5:1:1,0,-1,107049,92951
5:2:4,1,1,107048,92952
1:5:5,0,-1,107049,92951
2:5:1,1,1,107048,92952
1:4:3,0,-1,107049,92951
6:2:1,1,1,107048,92952
2:1:6,1,1,107047,92953
2:6:4,1,1,107046,92954
3:2:5,1,1,107045,92955
4:5:4,0,-1,107046,92954
2:6:2,2,2,107044,92956
6:3:6,0,-1,107045,92955
3:3:2,1,1,107044,92956
6:4:4,0,-1,107045,92955
4:2:3,1,1,107044,92956
1:1:6,0,-1,107045,92955
1:4:1,0,-1,107046,92954
3:4:3,0,-1,107047,92953
3:5:5,0,-1,107048,92952
4:6:2,1,1,107047,92953
5:4:6,0,-1,107048,92952
2:1:3,1,1,107047,92953
1:4:6,0,-1,107048,92952
1:2:1,1,1,107047,92953
2:5:6,1,1,107046,92954
2:5:6,1,1,107045,92955
3:5:5,0,-1,107046,92954
1:6:4,0,-1,107047,92953
5:5:6,0,-1,107048,92952
1:5:6,0,-1,107049,92951
4:1:4,0,-1,107050,92950
2:6:4,1,1,107049,92951
5:4:1,0,-1,107050,92950
1:6:1,0,-1,107051,92949
6:3:5,0,-1,107052,92948
4:6:1,0,-1,107053,92947
6:4:5,0,-1,107054,92946
3:1:4,0,-1,107055,92945
6:3:3,0,-1,107056,92944
2:1:1,1,1,107055,92945
2:6:6,1,1,107054,92946
6:4:5,0,-1,107055,92945
2:1:6,1,1,107054,92946
1:6:3,0,-1,107055,92945
2:3:1,1,1,107054,92946
5:3:2,1,1,107053,92947
1:1:4,0,-1,107054,92946
5:1:5,0,-1,107055,92945
6:1:1,0,-1,107056,92944
4:2:4,1,1,107055,92945
3:4:1,0,-1,107056,92944
5:1:3,0,-1,107057,92943
5:2:5,1,1,107056,92944
2:2:1,2,2,107054,92946
3:2:6,1,1,107053,92947
5:6:5,0,-1,107054,92946
5:1:3,0,-1,107055,92945
1:6:6,0,-1,107056,92944
1:6:2,1,1,107055,92945
2:2:6,2,2,107053,92947
6:2:3,1,1,107052,92948
2:6:6,1,1,107051,92949
2:6:2,2,2,107049,92951
5:3:4,0,-1,107050,92950
3:4:1,0,-1,107051,92949
4:4:4,0,-1,107052,92948
2:2:3,2,2,107050,92950
6:5:5,0,-1,107051,92949
2:1:6,1,1,107050,92950
1:2:4,1,1,107049,92951
2:6:6,1,1,107048,92952
4:6:5,0,-1,107049,92951
6:3:1,0,-1,107050,92950
2:3:4,1,1,107049,92951
1:3:3,0,-1,107050,92950
5:5:6,0,-1,107051,92949
5:6:6,0,-1,107052,92948
6:4:4,0,-1,107053,92947
5:6:5,0,-1,107054,92946
3:6:1,0,-1,107055,92945
5:4:3,0,-1,107056,92944
6:2:3,1,1,107055,92945
3:6:2,1,1,107054,92946
1:3:6,0,-1,107055,92945
6:6:2,1,1,107054,92946
3:4:4,0,-1,107055,92945
6:4:4,0,-1,107056,92944
6:6:4,0,-1,107057,92943
1:3:3,0,-1,107058,92942
6:3:5,0,-1,107059,92941
1:5:5,0,-1,107060,92940
6:1:6,0,-1,107061,92939
2:3:6,1,1,107060,92940
6:1:4,0,-1,107061,92939
3:6:3,0,-1,107062,92938
1:4:2,1,1,107061,92939
2:2:4,2,2,107059,92941
5:1:2,1,1,107058,92942
5:2:6,1,1,107057,92943
6:6:1,0,-1,107058,92942
3:4:6,0,-1,107059,92941
6:6:6,0,-1,107060,92940
3:1:1,0,-1,107061,92939
1:1:2,1,1,107060,92940
4:4:1,0,-1,107061,92939
3:6:3,0,-1,107062,92938
3:6:6,0,-1,107063,92937
5:6:2,1,1,107062,92938
4:5:5,0,-1,107063,92937
4:6:2,1,1,107062,92938
3:2:1,1,1,107061,92939
5:5:4,0,-1,107062,92938
3:5:6,0,-1,107063,92937
4:4:6,0,-1,107064,92936
2:1:6,1,1,107063,92937
6:4:2,1,1,107062,92938
6:1:3,0,-1,107063,92937
4:1:3,0,-1,107064,92936
5:2:4,1,1,107063,92937
3:3:2,1,1,107062,92938
3:1:4,0,-1,107063,92937
5:1:5,0,-1,107064,92936
3:5:2,1,1,107063,92937
1:2:4,1,1,107062,92938
3:5:4,0,-1,107063,92937
4:1:4,0,-1,107064,92936
2:2:1,2,2,107062,92938
4:5:6,0,-1,107063,92937
4:5:2,1,1,107062,92938
2:3:5,1,1,107061,92939
6:2:2,2,2,107059,92941
2:5:1,1,1,107058,92942
2:4:3,1,1,107057,92943
4:5:3,0,-1,107058,92942
2:3:5,1,1,107057,92943
3:6:4,0,-1,107058,92942
2:3:2,2,2,107056,92944
1:6:5,0,-1,107057,92943
1:5:6,0,-1,107058,92942
3:5:6,0,-1,107059,92941
6:6:5,0,-1,107060,92940
3:4:2,1,1,107059,92941
2:1:6,1,1,107058,92942
1:1:1,0,-1,107059,92941
2:1:5,1,1,107058,92942
4:4:3,0,-1,107059,92941
1:1:3,0,-1,107060,92940
3:1:3,0,-1,107061,92939
3:5:1,0,-1,107062,92938
4:4:5,0,-1,107063,92937
3:5:4,0,-1,107064,92936
1:3:2,1,1,107063,92937
4:1:6,0,-1,107064,92936
6:3:3,0,-1,107065,92935
4:1:2,1,1,107064,92936
4:3:2,1,1,107063,92937
1:2:1,1,1,107062,92938
3:1:1,0,-1,107063,92937
5:6:5,0,-1,107064,92936
3:5:2,1,1,107063,92937
6:1:5,0,-1,107064,92936
4:5:3,0,-1,107065,92935
4:1:2,1,1,107064,92936
4:6:1,0,-1,107065,92935
2:2:2,3,3,107062,92938
4:5:1,0,-1,107063,92937
1:5:5,0,-1,107064,92936
6:5:1,0,-1,107065,92935
5:1:4,0,-1,107066,92934
6:2:3,1,1,107065,92935
1:1:6,0,-1,107066,92934
4:4:5,0,-1,107067,92933
5:3:5,0,-1,107068,92932
5:4:1,0,-1,107069,92931
5:6:1,0,-1,107070,92930
1:2:5,1,1,107069,92931
4:3:1,0,-1,107070,92930
2:5:6,1,1,107069,92931
1:4:2,1,1,107068,92932
6:6:1,0,-1,107069,92931
2:5:6,1,1,107068,92932
2:1:2,2,2,107066,92934
3:4:4,0,-1,107067,92933
5:3:2,1,1,107066,92934
6:2:4,1,1,107065,92935
6:3:4,0,-1,107066,92934
5:4:6,0,-1,107067,92933
3:4:2,1,1,107066,92934
5:1:6,0,-1,107067,92933
6:3:1,0,-1,107068,92932
3:6:5,0,-1,107069,92931
1:2:3,1,1,107068,92932
5:5:6,0,-1,107069,92931
1:4:5,0,-1,107070,92930
2:2:3,2,2,107068,92932
2:6:1,1,1,107067,92933
5:5:1,0,-1,107068,92932
3:4:5,0,-1,107069,92931
3:4:2,1,1,107068,92932
4:4:2,1,1,107067,92933
6:3:6,0,-1,107068,92932
4:1:2,1,1,107067,92933
1:4:4,0,-1,107068,92932
6:4:1,0,-1,107069,92931
6:2:4,1,1,107068,92932
3:3:5,0,-1,107069,92931
2:5:2,2,2,107067,92933
6:6:3,0,-1,107068,92932
1:3:3,0,-1,107069,92931
1:3:2,1,1,107068,92932
1:4:6,0,-1,107069,92931
3:4:6,0,-1,107070,92930
5:6:5,0,-1,107071,92929
2:1:3,1,1,107070,92930
2:1:4,1,1,107069,92931
6:2:2,2,2,107067,92933
5:6:1,0,-1,107068,92932
3:6:2,1,1,107067,92933
6:1:3,0,-1,107068,92932
3:4:3,0,-1,107069,92931
1:3:5,0,-1,107070,92930
3:3:1,0,-1,107071,92929
6:4:5,0,-1,107072,92928
6:2:3,1,1,107071,92929
5:1:4,0,-1,107072,92928
1:3:6,0,-1,107073,92927
1:2:3,1,1,107072,92928
5:3:1,0,-1,107073,92927
6:1:3,0,-1,107074,92926
6:3:6,0,-1,107075,92925
1:6:1,0,-1,107076,92924
5:2:6,1,1,107075,92925
6:3:4,0,-1,107076,92924
5:3:5,0,-1,107077,92923
6:5:2,1,1,107076,92924
4:6:5,0,-1,107077,92923
6:5:4,0,-1,107078,92922
1:4:3,0,-1,107079,92921
1:3:3,0,-1,107080,92920
5:3:4,0,-1,107081,92919
2:6:6,1,1,107080,92920
5:3:1,0,-1,107081,92919
5:2:6,1,1,107080,92920
1:1:4,0,-1,107081,92919
6:1:5,0,-1,107082,92918
5:3:3,0,-1,107083,92917
4:4:4,0,-1,107084,92916
3:5:5,0,-1,107085,92915
2:5:1,1,1,107084,92916
5:5:1,0,-1,107085,92915
3:2:2,2,2,107083,92917
3:1:2,1,1,107082,92918
4:3:5,0,-1,107083,92917
6:3:5,0,-1,107084,92916
6:2:2,2,2,107082,92918
5:2:4,1,1,107081,92919
4:6:3,0,-1,107082,92918
4:2:2,2,2,107080,92920
5:4:4,0,-1,107081,92919
4:2:5,1,1,107080,92920
1:1:5,0,-1,107081,92919
6:5:4,0,-1,107082,92918
3:6:2,1,1,107081,92919
1:1:1,0,-1,107082,92918
2:1:4,1,1,107081,92919
6:1:6,0,-1,107082,92918
2:6:4,1,1,107081,92919
5:3:5,0,-1,107082,92918
2:5:4,1,1,107081,92919
5:4:2,1,1,107080,92920
1:2:4,1,1,107079,92921
5:1:4,0,-1,107080,92920
2:6:4,1,1,107079,92921
4:2:6,1,1,107078,92922
6:3:5,0,-1,107079,92921
1:1:2,1,1,107078,92922
2:2:6,2,2,107076,92924
5:2:2,2,2,107074,92926
3:1:2,1,1,107073,92927
6:3:5,0,-1,107074,92926
1:4:4,0,-1,107075,92925
3:1:1,0,-1,107076,92924
2:1:3,1,1,107075,92925
6:5:4,0,-1,107076,92924
4:2:2,2,2,107074,92926
6:3:6,0,-1,107075,92925
1:5:6,0,-1,107076,92924
2:1:6,1,1,107075,92925
3:3:1,0,-1,107076,92924
5:6:3,0,-1,107077,92923
2:4:5,1,1,107076,92924
4:5:3,0,-1,107077,92923
5:3:6,0,-1,107078,92922
4:6:1,0,-1,107079,92921
5:1:6,0,-1,107080,92920
2:5:6,1,1,107079,92921
2:1:4,1,1,107078,92922
1:5:4,0,-1,107079,92921
3:1:5,0,-1,107080,92920
6:5:4,0,-1,107081,92919
5:3:6,0,-1,107082,92918
5:1:4,0,-1,107083,92917
5:3:4,0,-1,107084,92916
6:6:5,0,-1,107085,92915
5:4:2,1,1,107084,92916
6:6:2,1,1,107083,92917
6:1:4,0,-1,107084,92916
3:3:3,0,-1,107085,92915
6:5:2,1,1,107084,92916
5:4:5,0,-1,107085,92915
1:5:5,0,-1,107086,92914
4:5:3,0,-1,107087,92913
4:2:1,1,1,107086,92914
5:5:5,0,-1,107087,92913
6:6:5,0,-1,107088,92912
5:4:5,0,-1,107089,92911
4:3:3,0,-1,107090,92910
1:5:4,0,-1,107091,92909
5:4:1,0,-1,107092,92908
4:1:6,0,-1,107093,92907
4:5:2,1,1,107092,92908
3:2:5,1,1,107091,92909
1:2:4,1,1,107090,92910
1:4:3,0,-1,107091,92909
1:1:2,1,1,107090,92910
2:1:4,1,1,107089,92911
2:5:6,1,1,107088,92912
5:5:6,0,-1,107089,92911
6:3:4,0,-1,107090,92910
3:1:1,0,-1,107091,92909
2:3:2,2,2,107089,92911
1:5:6,0,-1,107090,92910
6:6:4,0,-1,107091,92909
6:3:5,0,-1,107092,92908
2:4:4,1,1,107091,92909
2:6:3,1,1,107090,92910
5:1:5,0,-1,107091,92909
6:6:6,0,-1,107092,92908
2:4:2,2,2,107090,92910
5:5:3,0,-1,107091,92909
4:6:2,1,1,107090,92910
4:1:6,0,-1,107091,92909
5:5:5,0,-1,107092,92908
4:6:6,0,-1,107093,92907
6:5:5,0,-1,107094,92906
4:3:4,0,-1,107095,92905
1:5:4,0,-1,107096,92904
6:3:1,0,-1,107097,92903
5:6:4,0,-1,107098,92902
5:2:4,1,1,107097,92903
4:1:2,1,1,107096,92904
5:4:2,1,1,107095,92905
4:3:1,0,-1,107096,92904
5:2:3,1,1,107095,92905
3:3:4,0,-1,107096,92904
2:5:2,2,2,107094,92906
5:2:1,1,1,107093,92907
2:4:2,2,2,107091,92909
1:6:3,0,-1,107092,92908
4:2:1,1,1,107091,92909
6:4:4,0,-1,107092,92908
6:1:1,0,-1,107093,92907
4:1:3,0,-1,107094,92906
2:1:6,1,1,107093,92907
4:1:2,1,1,107092,92908
6:5:5,0,-1,107093,92907
3:4:2,1,1,107092,92908
5:2:6,1,1,107091,92909
1:2:2,2,2,107089,92911
2:2:2,3,3,107086,92914
3:5:5,0,-1,107087,92913
2:2:5,2,2,107085,92915
3:3:1,0,-1,107086,92914
1:4:3,0,-1,107087,92913
3:2:1,1,1,107086,92914
3:5:3,0,-1,107087,92913
3:2:1,1,1,107086,92914
2:6:1,1,1,107085,92915
1:6:6,0,-1,107086,92914
4:5:1,0,-1,107087,92913
5:1:6,0,-1,107088,92912
4:3:2,1,1,107087,92913
6:4:2,1,1,107086,92914
1:5:4,0,-1,107087,92913
6:3:4,0,-1,107088,92912
6:4:5,0,-1,107089,92911
5:2:6,1,1,107088,92912
3:1:4,0,-1,107089,92911
6:5:2,1,1,107088,92912
2:2:3,2,2,107086,92914
1:4:2,1,1,107085,92915
4:1:2,1,1,107084,92916
2:2:3,2,2,107082,92918
1:2:1,1,1,107081,92919
4:6:4,0,-1,107082,92918
2:1:5,1,1,107081,92919
3:5:4,0,-1,107082,92918
1:6:6,0,-1,107083,92917
6:4:1,0,-1,107084,92916
3:1:3,0,-1,107085,92915
1:1:4,0,-1,107086,92914
2:3:2,2,2,107084,92916
2:5:3,1,1,107083,92917
6:1:1,0,-1,107084,92916
6:3:3,0,-1,107085,92915
6:6:6,0,-1,107086,92914
1:5:1,0,-1,107087,92913
5:2:5,1,1,107086,92914
2:1:4,1,1,107085,92915
3:2:5,1,1,107084,92916
2:1:2,2,2,107082,92918
1:4:4,0,-1,107083,92917
2:1:1,1,1,107082,92918
2:2:6,2,2,107080,92920
3:5:6,0,-1,107081,92919
3:4:1,0,-1,107082,92918
1:4:6,0,-1,107083,92917
6:6:2,1,1,107082,92918
5:3:3,0,-1,107083,92917
1:2:3,1,1,107082,92918
1:4:2,1,1,107081,92919
2:6:2,2,2,107079,92921
1:5:1,0,-1,107080,92920
2:1:5,1,1,107079,92921
6:4:2,1,1,107078,92922
2:4:4,1,1,107077,92923
5:3:1,0,-1,107078,92922
1:1:3,0,-1,107079,92921
3:6:4,0,-1,107080,92920
3:6:6,0,-1,107081,92919
1:1:3,0,-1,107082,92918
3:1:6,0,-1,107083,92917
6:2:1,1,1,107082,92918
6:2:6,1,1,107081,92919
1:3:6,0,-1,107082,92918
3:4:2,1,1,107081,92919
4:4:6,0,-1,107082,92918
2:1:6,1,1,107081,92919
2:3:1,1,1,107080,92920
6:4:1,0,-1,107081,92919
1:6:4,0,-1,107082,92918
6:4:4,0,-1,107083,92917
2:4:3,1,1,107082,92918
2:3:5,1,1,107081,92919
3:5:4,0,-1,107082,92918
4:5:3,0,-1,107083,92917
3:1:1,0,-1,107084,92916
1:5:1,0,-1,107085,92915
4:4:2,1,1,107084,92916
4:5:3,0,-1,107085,92915
3:5:2,1,1,107084,92916
3:2:4,1,1,107083,92917
5:1:1,0,-1,107084,92916
4:3:5,0,-1,107085,92915
5:6:6,0,-1,107086,92914
4:6:2,1,1,107085,92915
6:5:3,0,-1,107086,92914
1:3:3,0,-1,107087,92913
1:4:4,0,-1,107088,92912
4:4:3,0,-1,107089,92911
6:3:3,0,-1,107090,92910
6:6:2,1,1,107089,92911
2:1:1,1,1,107088,92912
3:1:2,1,1,107087,92913
6:2:3,1,1,107086,92914
2:3:3,1,1,107085,92915
3:5:2,1,1,107084,92916
1:4:4,0,-1,107085,92915
5:3:6,0,-1,107086,92914
5:6:1,0,-1,107087,92913
3:5:2,1,1,107086,92914
6:2:4,1,1,107085,92915
1:1:6,0,-1,107086,92914
3:6:6,0,-1,107087,92913
1:6:4,0,-1,107088,92912
6:6:3,0,-1,107089,92911
5:1:5,0,-1,107090,92910
3:4:5,0,-1,107091,92909
2:2:2,3,3,107088,92912
2:2:1,2,2,107086,92914
5:6:3,0,-1,107087,92913
2:4:2,2,2,107085,92915
1:2:6,1,1,107084,92916
3:6:5,0,-1,107085,92915
1:2:2,2,2,107083,92917
5:1:3,0,-1,107084,92916
2:3:5,1,1,107083,92917
2:1:2,2,2,107081,92919
1:1:3,0,-1,107082,92918
3:1:6,0,-1,107083,92917
1:5:1,0,-1,107084,92916
1:2:2,2,2,107082,92918
3:3:6,0,-1,107083,92917
1:6:3,0,-1,107084,92916
5:2:3,1,1,107083,92917
2:3:5,1,1,107082,92918
3:5:4,0,-1,107083,92917
6:3:2,1,1,107082,92918
1:2:2,2,2,107080,92920
5:6:2,1,1,107079,92921
5:6:1,0,-1,107080,92920
3:1:6,0,-1,107081,92919
4:2:4,1,1,107080,92920
2:6:4,1,1,107079,92921
1:4:3,0,-1,107080,92920
6:4:5,0,-1,107081,92919
2:1:3,1,1,107080,92920
2:3:1,1,1,107079,92921
4:5:4,0,-1,107080,92920
5:6:4,0,-1,107081,92919
3:4:1,0,-1,107082,92918
6:3:5,0,-1,107083,92917
3:2:1,1,1,107082,92918
4:5:3,0,-1,107083,92917
4:6:1,0,-1,107084,92916
2:2:2,3,3,107081,92919
5:5:6,0,-1,107082,92918
6:3:2,1,1,107081,92919
3:1:3,0,-1,107082,92918
4:6:5,0,-1,107083,92917
3:5:3,0,-1,107084,92916
3:4:1,0,-1,107085,92915
3:1:1,0,-1,107086,92914
6:2:6,1,1,107085,92915
6:1:4,0,-1,107086,92914
1:4:6,0,-1,107087,92913
5:3:6,0,-1,107088,92912
6:4:1,0,-1,107089,92911
4:1:6,0,-1,107090,92910
4:6:4,0,-1,107091,92909
6:6:4,0,-1,107092,92908
1:4:2,1,1,107091,92909
4:3:3,0,-1,107092,92908
3:6:6,0,-1,107093,92907
2:6:3,1,1,107092,92908
3:2:3,1,1,107091,92909
1:4:4,0,-1,107092,92908
2:1:3,1,1,107091,92909
5:6:6,0,-1,107092,92908
1:4:1,0,-1,107093,92907
2:5:5,1,1,107092,92908
3:5:3,0,-1,107093,92907
1:5:5,0,-1,107094,92906
5:6:2,1,1,107093,92907
3:5:3,0,-1,107094,92906
2:4:2,2,2,107092,92908
1:4:1,0,-1,107093,92907
2:6:2,2,2,107091,92909
5:6:4,0,-1,107092,92908
4:3:1,0,-1,107093,92907
1:5:1,0,-1,107094,92906
2:4:1,1,1,107093,92907
3:5:3,0,-1,107094,92906
3:3:3,0,-1,107095,92905
1:5:4,0,-1,107096,92904
4:2:3,1,1,107095,92905
1:6:4,0,-1,107096,92904
5:2:3,1,1,107095,92905
6:1:6,0,-1,107096,92904
4:3:6,0,-1,107097,92903
6:6:6,0,-1,107098,92902
2:3:6,1,1,107097,92903
2:5:3,1,1,107096,92904
4:5:1,0,-1,107097,92903
2:5:3,1,1,107096,92904
2:2:4,2,2,107094,92906
4:6:5,0,-1,107095,92905
4:4:5,0,-1,107096,92904
6:2:5,1,1,107095,92905
6:6:1,0,-1,107096,92904
5:4:4,0,-1,107097,92903
2:5:1,1,1,107096,92904
3:6:5,0,-1,107097,92903
1:6:3,0,-1,107098,92902
6:5:4,0,-1,107099,92901
1:2:2,2,2,107097,92903
4:2:5,1,1,107096,92904
5:6:5,0,-1,107097,92903
4:2:2,2,2,107095,92905
4:6:1,0,-1,107096,92904
4:6:3,0,-1,107097,92903
5:1:2,1,1,107096,92904
3:2:3,1,1,107095,92905
1:6:6,0,-1,107096,92904
6:3:1,0,-1,107097,92903
6:1:3,0,-1,107098,92902
1:5:1,0,-1,107099,92901
1:5:5,0,-1,107100,92900
1:1:1,0,-1,107101,92899
1:1:6,0,-1,107102,92898
1:2:3,1,1,107101,92899
2:6:6,1,1,107100,92900
6:4:1,0,-1,107101,92899
5:6:5,0,-1,107102,92898
2:3:4,1,1,107101,92899
6:4:1,0,-1,107102,92898
5:6:6,0,-1,107103,92897
5:6:1,0,-1,107104,92896
1:4:3,0,-1,107105,92895
4:3:6,0,-1,107106,92894
1:1:1,0,-1,107107,92893
6:5:4,0,-1,107108,92892
6:4:2,1,1,107107,92893
2:3:5,1,1,107106,92894
4:5:5,0,-1,107107,92893
4:1:2,1,1,107106,92894
4:2:1,1,1,107105,92895
5:5:1,0,-1,107106,92894
3:6:6,0,-1,107107,92893
2:3:5,1,1,107106,92894
2:2:5,2,2,107104,92896
6:2:2,2,2,107102,92898
6:6:5,0,-1,107103,92897
1:1:1,0,-1,107104,92896
5:3:3,0,-1,107105,92895
1:4:4,0,-1,107106,92894
4:6:6,0,-1,107107,92893
5:5:6,0,-1,107108,92892
5:2:4,1,1,107107,92893
1:3:6,0,-1,107108,92892
6:4:4,0,-1,107109,92891
1:6:2,1,1,107108,92892
3:1:6,0,-1,107109,92891
2:3:5,1,1,107108,92892
2:4:5,1,1,107107,92893
4:4:1,0,-1,107108,92892
6:4:5,0,-1,107109,92891
3:2:6,1,1,107108,92892
5:4:1,0,-1,107109,92891
4:5:6,0,-1,107110,92890
5:6:6,0,-1,107111,92889
4:2:5,1,1,107110,92890
2:5:4,1,1,107109,92891
2:1:1,1,1,107108,92892
5:6:5,0,-1,107109,92891
1:1:5,0,-1,107110,92890
4:5:5,0,-1,107111,92889
6:3:4,0,-1,107112,92888
4:3:6,0,-1,107113,92887
4:1:6,0,-1,107114,92886
4:5:3,0,-1,107115,92885
3:2:5,1,1,107114,92886
2:1:1,1,1,107113,92887
6:3:6,0,-1,107114,92886
6:6:4,0,-1,107115,92885
6:1:1,0,-1,107116,92884
1:2:5,1,1,107115,92885
3:5:5,0,-1,107116,92884
6:4:1,0,-1,107117,92883
4:1:4,0,-1,107118,92882
1:4:6,0,-1,107119,92881
1:5:4,0,-1,107120,92880
4:5:2,1,1,107119,92881
5:4:1,0,-1,107120,92880
2:6:2,2,2,107118,92882
5:5:2,1,1,107117,92883
4:4:3,0,-1,107118,92882
1:4:2,1,1,107117,92883
6:4:5,0,-1,107118,92882
4:6:1,0,-1,107119,92881
2:3:3,1,1,107118,92882
1:6:2,1,1,107117,92883
3:6:4,0,-1,107118,92882
2:1:2,2,2,107116,92884
2:5:6,1,1,107115,92885
4:4:3,0,-1,107116,92884
2:5:5,1,1,107115,92885
3:2:4,1,1,107114,92886
1:6:4,0,-1,107115,92885
3:5:4,0,-1,107116,92884
5:3:6,0,-1,107117,92883
5:4:1,0,-1,107118,92882
2:4:4,1,1,107117,92883
4:4:1,0,-1,107118,92882
5:3:2,1,1,107117,92883
6:1:1,0,-1,107118,92882
4:6:1,0,-1,107119,92881
3:3:3,0,-1,107120,92880
5:6:2,1,1,107119,92881
6:4:2,1,1,107118,92882
6:6:4,0,-1,107119,92881
6:1:1,0,-1,107120,92880
4:3:2,1,1,107119,92881
1:4:2,1,1,107118,92882
1:2:5,1,1,107117,92883
1:4:4,0,-1,107118,92882
5:1:2,1,1,107117,92883
2:5:5,1,1,107116,92884
3:3:6,0,-1,107117,92883
5:4:2,1,1,107116,92884
5:6:3,0,-1,107117,92883
4:1:3,0,-1,107118,92882
3:4:3,0,-1,107119,92881
5:5:2,1,1,107118,92882
3:2:5,1,1,107117,92883
4:5:2,1,1,107116,92884
2:1:3,1,1,107115,92885
1:3:1,0,-1,107116,92884
5:3:6,0,-1,107117,92883
2:1:5,1,1,107116,92884
1:2:1,1,1,107115,92885
1:4:3,0,-1,107116,92884
2:5:6,1,1,107115,92885
5:3:1,0,-1,107116,92884
2:6:6,1,1,107115,92885
4:3:3,0,-1,107116,92884
1:3:6,0,-1,107117,92883
1:5:3,0,-1,107118,92882
4:1:6,0,-1,107119,92881
2:3:3,1,1,107118,92882
6:5:6,0,-1,107119,92881
2:2:3,2,2,107117,92883
1:6:1,0,-1,107118,92882
1:4:1,0,-1,107119,92881
6:3:1,0,-1,107120,92880
2:5:4,1,1,107119,92881
1:4:4,0,-1,107120,92880
6:3:2,1,1,107119,92881
1:4:3,0,-1,107120,92880
5:1:4,0,-1,107121,92879
6:3:1,0,-1,107122,92878
1:1:5,0,-1,107123,92877
6:3:4,0,-1,107124,92876
2:1:1,1,1,107123,92877
2:5:5,1,1,107122,92878
4:3:4,0,-1,107123,92877
5:5:5,0,-1,107124,92876
3:3:1,0,-1,107125,92875
3:5:1,0,-1,107126,92874
3:5:2,1,1,107125,92875
2:5:2,2,2,107123,92877
4:6:3,0,-1,107124,92876
1:2:1,1,1,107123,92877
3:2:5,1,1,107122,92878
6:5:2,1,1,107121,92879
4:6:6,0,-1,107122,92878
2:2:2,3,3,107119,92881
4:2:6,1,1,107118,92882
1:6:1,0,-1,107119,92881
1:6:3,0,-1,107120,92880
6:2:5,1,1,107119,92881
2:5:6,1,1,107118,92882
1:6:1,0,-1,107119,92881
2:1:3,1,1,107118,92882
3:2:5,1,1,107117,92883
5:5:5,0,-1,107118,92882
6:6:6,0,-1,107119,92881
6:1:1,0,-1,107120,92880
5:4:6,0,-1,107121,92879
2:6:5,1,1,107120,92880
4:5:4,0,-1,107121,92879
4:3:5,0,-1,107122,92878
6:4:2,1,1,107121,92879
3:1:6,0,-1,107122,92878
2:5:2,2,2,107120,92880
3:2:5,1,1,107119,92881
4:6:6,0,-1,107120,92880
3:2:5,1,1,107119,92881
5:2:4,1,1,107118,92882
2:6:3,1,1,107117,92883
4:6:3,0,-1,107118,92882
6:2:3,1,1,107117,92883
6:3:4,0,-1,107118,92882
1:5:5,0,-1,107119,92881
5:6:1,0,-1,107120,92880
3:2:6,1,1,107119,92881
1:6:4,0,-1,107120,92880
2:5:3,1,1,107119,92881
3:6:2,1,1,107118,92882
3:4:6,0,-1,107119,92881
4:1:2,1,1,107118,92882
5:6:2,1,1,107117,92883
3:1:6,0,-1,107118,92882
3:2:2,2,2,107116,92884
6:5:5,0,-1,107117,92883
2:6:3,1,1,107116,92884
5:5:4,0,-1,107117,92883
1:4:1,0,-1,107118,92882
2:1:5,1,1,107117,92883
5:2:5,1,1,107116,92884
2:3:4,1,1,107115,92885
5:3:3,0,-1,107116,92884
6:5:1,0,-1,107117,92883
3:6:4,0,-1,107118,92882
3:5:2,1,1,107117,92883
5:1:2,1,1,107116,92884
5:2:5,1,1,107115,92885
6:3:1,0,-1,107116,92884
3:1:2,1,1,107115,92885
2:6:6,1,1,107114,92886
2:5:2,2,2,107112,92888
2:1:3,1,1,107111,92889
5:3:3,0,-1,107112,92888
3:6:2,1,1,107111,92889
2:1:6,1,1,107110,92890
3:6:5,0,-1,107111,92889
4:6:6,0,-1,107112,92888
3:4:5,0,-1,107113,92887
6:4:3,0,-1,107114,92886
5:2:3,1,1,107113,92887
1:4:6,0,-1,107114,92886
1:6:5,0,-1,107115,92885
3:4:4,0,-1,107116,92884
5:4:2,1,1,107115,92885
1:5:4,0,-1,107116,92884
3:6:6,0,-1,107117,92883
5:4:5,0,-1,107118,92882
6:3:2,1,1,107117,92883
4:5:1,0,-1,107118,92882
6:5:3,0,-1,107119,92881
5:2:4,1,1,107118,92882
5:3:4,0,-1,107119,92881
2:4:3,1,1,107118,92882
3:6:5,0,-1,107119,92881
1:2:6,1,1,107118,92882
6:2:6,1,1,107117,92883
5:3:4,0,-1,107118,92882
1:1:2,1,1,107117,92883
2:6:3,1,1,107116,92884
4:5:5,0,-1,107117,92883
4:1:3,0,-1,107118,92882
5:1:1,0,-1,107119,92881
6:2:4,1,1,107118,92882
4:5:4,0,-1,107119,92881
4:6:5,0,-1,107120,92880
6:1:2,1,1,107119,92881
6:6:4,0,-1,107120,92880
1:6:5,0,-1,107121,92879
4:6:1,0,-1,107122,92878
2:3:2,2,2,107120,92880
2:1:6,1,1,107119,92881
5:5:4,0,-1,107120,92880
3:6:2,1,1,107119,92881
5:4:6,0,-1,107120,92880
1:2:6,1,1,107119,92881
4:3:2,1,1,107118,92882
5:5:6,0,-1,107119,92881
3:6:3,0,-1,107120,92880
6:1:5,0,-1,107121,92879
4:5:1,0,-1,107122,92878
1:5:1,0,-1,107123,92877
5:6:4,0,-1,107124,92876
6:2:5,1,1,107123,92877
3:3:3,0,-1,107124,92876
6:4:6,0,-1,107125,92875
4:5:3,0,-1,107126,92874
6:1:6,0,-1,107127,92873
3:3:1,0,-1,107128,92872
1:3:6,0,-1,107129,92871
3:5:3,0,-1,107130,92870
1:2:2,2,2,107128,92872
4:4:5,0,-1,107129,92871
4:6:1,0,-1,107130,92870
1:2:5,1,1,107129,92871
2:2:5,2,2,107127,92873
4:6:4,0,-1,107128,92872
5:1:4,0,-1,107129,92871
3:3:1,0,-1,107130,92870
3:6:3,0,-1,107131,92869
4:2:4,1,1,107130,92870
4:5:6,0,-1,107131,92869
3:4:2,1,1,107130,92870
6:5:3,0,-1,107131,92869
4:1:6,0,-1,107132,92868
4:2:5,1,1,107131,92869
1:5:5,0,-1,107132,92868
6:4:6,0,-1,107133,92867
1:2:5,1,1,107132,92868
3:2:6,1,1,107131,92869
6:2:2,2,2,107129,92871
6:6:4,0,-1,107130,92870
2:2:5,2,2,107128,92872
4:3:4,0,-1,107129,92871
4:4:3,0,-1,107130,92870
2:3:5,1,1,107129,92871
2:5:3,1,1,107128,92872
6:2:2,2,2,107126,92874
3:6:1,0,-1,107127,92873
1:6:6,0,-1,107128,92872
4:3:3,0,-1,107129,92871
6:4:4,0,-1,107130,92870
3:6:3,0,-1,107131,92869
5:4:5,0,-1,107132,92868
6:5:6,0,-1,107133,92867
2:1:6,1,1,107132,92868
1:1:3,0,-1,107133,92867
2:6:6,1,1,107132,92868
5:3:5,0,-1,107133,92867
3:3:6,0,-1,107134,92866
6:6:4,0,-1,107135,92865
6:5:1,0,-1,107136,92864
1:3:4,0,-1,107137,92863
3:5:1,0,-1,107138,92862
4:5:4,0,-1,107139,92861
4:2:2,2,2,107137,92863
2:6:5,1,1,107136,92864
2:2:3,2,2,107134,92866
3:1:5,0,-1,107135,92865
3:3:5,0,-1,107136,92864
4:1:5,0,-1,107137,92863
4:1:6,0,-1,107138,92862
6:2:4,1,1,107137,92863
3:6:3,0,-1,107138,92862
1:2:4,1,1,107137,92863
4:3:4,0,-1,107138,92862
2:1:3,1,1,107137,92863
1:1:6,0,-1,107138,92862
3:4:5,0,-1,107139,92861
2:1:3,1,1,107138,92862
5:2:4,1,1,107137,92863
3:3:1,0,-1,107138,92862
2:5:1,1,1,107137,92863
6:2:6,1,1,107136,92864
2:3:6,1,1,107135,92865
6:1:3,0,-1,107136,92864
1:5:3,0,-1,107137,92863
5:3:2,1,1,107136,92864
3:5:5,0,-1,107137,92863
1:3:3,0,-1,107138,92862
5:3:3,0,-1,107139,92861
4:6:1,0,-1,107140,92860
6:3:2,1,1,107139,92861
6:4:5,0,-1,107140,92860
2:6:5,1,1,107139,92861
5:2:5,1,1,107138,92862
3:4:2,1,1,107137,92863
2:1:4,1,1,107136,92864
3:4:4,0,-1,107137,92863
4:5:1,0,-1,107138,92862
2:3:3,1,1,107137,92863
5:5:2,1,1,107136,92864
1:3:5,0,-1,107137,92863
1:1:6,0,-1,107138,92862
2:1:2,2,2,107136,92864
1:6:5,0,-1,107137,92863
2:1:2,2,2,107135,92865
4:1:5,0,-1,107136,92864
5:5:5,0,-1,107137,92863
5:4:4,0,-1,107138,92862
6:3:2,1,1,107137,92863
5:4:2,1,1,107136,92864
2:3:5,1,1,107135,92865
5:2:4,1,1,107134,92866
5:3:5,0,-1,107135,92865
3:6:4,0,-1,107136,92864
4:1:1,0,-1,107137,92863
2:3:3,1,1,107136,92864
1:1:1,0,-1,107137,92863
2:3:6,1,1,107136,92864
2:6:2,2,2,107134,92866
6:2:4,1,1,107133,92867
3:3:3,0,-1,107134,92866
3:6:3,0,-1,107135,92865
5:6:1,0,-1,107136,92864
5:4:6,0,-1,107137,92863
5:6:1,0,-1,107138,92862
3:6:6,0,-1,107139,92861
4:2:6,1,1,107138,92862
4:3:2,1,1,107137,92863
3:4:5,0,-1,107138,92862
4:2:5,1,1,107137,92863
4:3:4,0,-1,107138,92862
5:1:5,0,-1,107139,92861
6:1:2,1,1,107138,92862
6:3:5,0,-1,107139,92861
2:2:4,2,2,107137,92863
5:3:6,0,-1,107138,92862
6:2:3,1,1,107137,92863
4:4:5,0,-1,107138,92862
6:1:3,0,-1,107139,92861
4:3:1,0,-1,107140,92860
1:4:6,0,-1,107141,92859
3:2:5,1,1,107140,92860
1:2:3,1,1,107139,92861
6:6:5,0,-1,107140,92860
3:2:6,1,1,107139,92861
1:1:2,1,1,107138,92862
2:2:3,2,2,107136,92864
5:2:3,1,1,107135,92865
2:4:4,1,1,107134,92866
5:4:4,0,-1,107135,92865
3:5:5,0,-1,107136,92864
6:3:4,0,-1,107137,92863
2:3:5,1,1,107136,92864
3:4:1,0,-1,107137,92863
3:5:3,0,-1,107138,92862
6:4:3,0,-1,107139,92861
3:2:1,1,1,107138,92862
5:2:6,1,1,107137,92863
2:3:2,2,2,107135,92865
4:5:4,0,-1,107136,92864
1:6:1,0,-1,107137,92863
6:3:5,0,-1,107138,92862
5:4:2,1,1,107137,92863
4:3:5,0,-1,107138,92862
4:5:4,0,-1,107139,92861
2:1:1,1,1,107138,92862
5:4:2,1,1,107137,92863
5:3:2,1,1,107136,92864
3:5:2,1,1,107135,92865
6:3:1,0,-1,107136,92864
6:2:5,1,1,107135,92865
2:2:4,2,2,107133,92867
4:4:5,0,-1,107134,92866
4:1:1,0,-1,107135,92865
6:2:4,1,1,107134,92866
3:3:6,0,-1,107135,92865
4:1:1,0,-1,107136,92864
3:2:3,1,1,107135,92865
2:2:2,3,3,107132,92868
6:4:2,1,1,107131,92869
1:4:6,0,-1,107132,92868
2:2:1,2,2,107130,92870
4:4:6,0,-1,107131,92869
2:4:3,1,1,107130,92870
2:1:1,1,1,107129,92871
2:5:2,2,2,107127,92873
2:4:2,2,2,107125,92875
6:1:4,0,-1,107126,92874
2:5:1,1,1,107125,92875
2:5:4,1,1,107124,92876
1:6:5,0,-1,107125,92875
6:2:2,2,2,107123,92877
5:6:5,0,-1,107124,92876
1:1:1,0,-1,107125,92875
5:2:5,1,1,107124,92876
4:5:3,0,-1,107125,92875
2:3:3,1,1,107124,92876
5:1:4,0,-1,107125,92875
2:1:5,1,1,107124,92876
5:5:6,0,-1,107125,92875
1:4:2,1,1,107124,92876
5:1:2,1,1,107123,92877
4:4:6,0,-1,107124,92876
5:2:3,1,1,107123,92877
1:6:1,0,-1,107124,92876
5:5:4,0,-1,107125,92875
5:1:4,0,-1,107126,92874
6:6:1,0,-1,107127,92873
3:1:1,0,-1,107128,92872
2:1:4,1,1,107127,92873
4:6:5,0,-1,107128,92872
3:2:5,1,1,107127,92873
4:2:5,1,1,107126,92874
4:3:6,0,-1,107127,92873
4:2:1,1,1,107126,92874
1:6:3,0,-1,107127,92873
2:6:3,1,1,107126,92874
4:3:4,0,-1,107127,92873
2:3:6,1,1,107126,92874
1:3:5,0,-1,107127,92873
2:3:6,1,1,107126,92874
3:2:5,1,1,107125,92875
3:6:3,0,-1,107126,92874
4:2:6,1,1,107125,92875
3:3:5,0,-1,107126,92874
1:6:5,0,-1,107127,92873
6:5:4,0,-1,107128,92872
6:4:2,1,1,107127,92873
1:5:3,0,-1,107128,92872
5:2:6,1,1,107127,92873
2:4:1,1,1,107126,92874
4:2:2,2,2,107124,92876
1:4:2,1,1,107123,92877
6:5:2,1,1,107122,92878
6:3:3,0,-1,107123,92877
4:2:4,1,1,107122,92878
1:1:5,0,-1,107123,92877
2:6:4,1,1,107122,92878
1:2:4,1,1,107121,92879
2:2:1,2,2,107119,92881
4:1:2,1,1,107118,92882
3:4:5,0,-1,107119,92881
4:6:6,0,-1,107120,92880
3:6:4,0,-1,107121,92879
5:6:6,0,-1,107122,92878
2:4:4,1,1,107121,92879
4:4:1,0,-1,107122,92878
4:6:4,0,-1,107123,92877
1:5:1,0,-1,107124,92876
1:2:4,1,1,107123,92877
2:2:5,2,2,107121,92879
4:2:6,1,1,107120,92880
3:5:1,0,-1,107121,92879
4:6:6,0,-1,107122,92878
3:2:2,2,2,107120,92880
1:4:3,0,-1,107121,92879
4:3:6,0,-1,107122,92878
6:1:1,0,-1,107123,92877
6:4:5,0,-1,107124,92876
5:5:1,0,-1,107125,92875
1:4:2,1,1,107124,92876
3:1:3,0,-1,107125,92875
5:5:1,0,-1,107126,92874
4:6:3,0,-1,107127,92873
2:6:1,1,1,107126,92874
2:6:3,1,1,107125,92875
4:6:1,0,-1,107126,92874
4:1:6,0,-1,107127,92873
3:5:5,0,-1,107128,92872
5:6:2,1,1,107127,92873
3:3:6,0,-1,107128,92872
4:5:1,0,-1,107129,92871
1:6:1,0,-1,107130,92870
1:6:4,0,-1,107131,92869
6:1:2,1,1,107130,92870
4:4:4,0,-1,107131,92869
1:6:6,0,-1,107132,92868
2:1:5,1,1,107131,92869
2:2:5,2,2,107129,92871
4:5:2,1,1,107128,92872
6:3:1,0,-1,107129,92871
3:5:1,0,-1,107130,92870
6:5:2,1,1,107129,92871
6:5:1,0,-1,107130,92870
3:3:2,1,1,107129,92871
2:6:4,1,1,107128,92872
5:1:4,0,-1,107129,92871
5:2:5,1,1,107128,92872
3:6:3,0,-1,107129,92871
5:3:3,0,-1,107130,92870
6:1:2,1,1,107129,92871
2:3:4,1,1,107128,92872
4:1:4,0,-1,107129,92871
2:3:4,1,1,107128,92872
1:6:3,0,-1,107129,92871
6:5:2,1,1,107128,92872
6:6:5,0,-1,107129,92871
4:1:2,1,1,107128,92872
6:5:3,0,-1,107129,92871
3:3:1,0,-1,107130,92870
5:3:2,1,1,107129,92871
4:6:6,0,-1,107130,92870
3:6:1,0,-1,107131,92869
6:3:3,0,-1,107132,92868
3:3:4,0,-1,107133,92867
6:6:3,0,-1,107134,92866
4:5:2,1,1,107133,92867
3:6:6,0,-1,107134,92866
2:3:2,2,2,107132,92868
4:4:4,0,-1,107133,92867
4:5:2,1,1,107132,92868
5:1:1,0,-1,107133,92867
3:3:4,0,-1,107134,92866
5:1:2,1,1,107133,92867
2:4:4,1,1,107132,92868
1:1:5,0,-1,107133,92867
4:1:2,1,1,107132,92868
4:3:4,0,-1,107133,92867
1:5:5,0,-1,107134,92866
5:3:2,1,1,107133,92867
6:3:4,0,-1,107134,92866
1:5:1,0,-1,107135,92865
4:2:3,1,1,107134,92866
1:6:3,0,-1,107135,92865
6:3:2,1,1,107134,92866
4:3:4,0,-1,107135,92865
4:2:6,1,1,107134,92866
2:5:5,1,1,107133,92867
3:1:1,0,-1,107134,92866
5:4:3,0,-1,107135,92865
5:4:1,0,-1,107136,92864
3:3:5,0,-1,107137,92863
2:6:4,1,1,107136,92864
4:5:3,0,-1,107137,92863
2:2:5,2,2,107135,92865
2:2:2,3,3,107132,92868
1:6:2,1,1,107131,92869
5:2:4,1,1,107130,92870
6:2:4,1,1,107129,92871
1:3:6,0,-1,107130,92870
6:1:1,0,-1,107131,92869
2:3:1,1,1,107130,92870
1:3:2,1,1,107129,92871
6:1:6,0,-1,107130,92870
6:6:1,0,-1,107131,92869
5:5:6,0,-1,107132,92868
1:5:4,0,-1,107133,92867
1:3:1,0,-1,107134,92866
5:1:4,0,-1,107135,92865
4:4:5,0,-1,107136,92864
3:5:4,0,-1,107137,92863
1:1:3,0,-1,107138,92862
2:6:6,1,1,107137,92863
2:2:4,2,2,107135,92865
4:3:3,0,-1,107136,92864
3:2:4,1,1,107135,92865
3:4:2,1,1,107134,92866
6:6:3,0,-1,107135,92865
4:6:1,0,-1,107136,92864
3:5:5,0,-1,107137,92863
1:1:4,0,-1,107138,92862
6:5:6,0,-1,107139,92861
5:5:4,0,-1,107140,92860
6:2:4,1,1,107139,92861
6:4:3,0,-1,107140,92860
3:5:1,0,-1,107141,92859
3:1:1,0,-1,107142,92858
3:6:1,0,-1,107143,92857
4:3:1,0,-1,107144,92856
3:1:1,0,-1,107145,92855
5:4:6,0,-1,107146,92854
5:5:6,0,-1,107147,92853
5:6:2,1,1,107146,92854
4:3:2,1,1,107145,92855
3:5:5,0,-1,107146,92854
2:3:4,1,1,107145,92855
3:3:4,0,-1,107146,92854
3:3:5,0,-1,107147,92853
4:3:2,1,1,107146,92854
1:1:4,0,-1,107147,92853
5:5:2,1,1,107146,92854
5:6:2,1,1,107145,92855
5:2:3,1,1,107144,92856
1:3:3,0,-1,107145,92855
6:5:2,1,1,107144,92856
3:2:5,1,1,107143,92857
6:6:4,0,-1,107144,92856
1:5:1,0,-1,107145,92855
3:2:3,1,1,107144,92856
6:6:6,0,-1,107145,92855
1:1:3,0,-1,107146,92854
5:1:6,0,-1,107147,92853
3:1:3,0,-1,107148,92852
2:3:6,1,1,107147,92853
3:3:4,0,-1,107148,92852
3:2:2,2,2,107146,92854
6:5:6,0,-1,107147,92853
2:5:4,1,1,107146,92854
4:4:6,0,-1,107147,92853
4:2:5,1,1,107146,92854
3:3:3,0,-1,107147,92853
4:6:6,0,-1,107148,92852
4:2:1,1,1,107147,92853
6:4:5,0,-1,107148,92852
6:2:2,2,2,107146,92854
5:4:2,1,1,107145,92855
5:1:1,0,-1,107146,92854
5:1:2,1,1,107145,92855
6:6:2,1,1,107144,92856
2:6:2,2,2,107142,92858
3:4:1,0,-1,107143,92857
5:1:6,0,-1,107144,92856
4:1:3,0,-1,107145,92855
5:4:1,0,-1,107146,92854
6:2:3,1,1,107145,92855
6:3:3,0,-1,107146,92854
6:3:2,1,1,107145,92855
2:4:6,1,1,107144,92856
2:6:6,1,1,107143,92857
3:4:2,1,1,107142,92858
1:5:5,0,-1,107143,92857
1:5:3,0,-1,107144,92856
5:2:2,2,2,107142,92858
3:2:5,1,1,107141,92859
5:1:1,0,-1,107142,92858
4:4:5,0,-1,107143,92857
4:1:3,0,-1,107144,92856
3:4:4,0,-1,107145,92855
1:4:6,0,-1,107146,92854
3:6:6,0,-1,107147,92853
1:6:3,0,-1,107148,92852
2:4:4,1,1,107147,92853
5:2:2,2,2,107145,92855
4:6:1,0,-1,107146,92854
5:4:5,0,-1,107147,92853
4:6:5,0,-1,107148,92852
5:5:3,0,-1,107149,92851
3:3:6,0,-1,107150,92850
2:3:4,1,1,107149,92851
3:4:5,0,-1,107150,92850
2:3:2,2,2,107148,92852
2:3:4,1,1,107147,92853
4:6:6,0,-1,107148,92852
3:2:4,1,1,107147,92853
1:5:5,0,-1,107148,92852
5:4:6,0,-1,107149,92851
2:2:5,2,2,107147,92853
3:4:3,0,-1,107148,92852
3:6:3,0,-1,107149,92851
5:4:6,0,-1,107150,92850
1:2:5,1,1,107149,92851
1:4:4,0,-1,107150,92850
2:4:6,1,1,107149,92851
6:3:2,1,1,107148,92852
1:6:3,0,-1,107149,92851
1:6:2,1,1,107148,92852
1:3:3,0,-1,107149,92851
4:5:4,0,-1,107150,92850
1:3:6,0,-1,107151,92849
1:1:5,0,-1,107152,92848
1:5:5,0,-1,107153,92847
3:5:5,0,-1,107154,92846
6:2:1,1,1,107153,92847
1:4:2,1,1,107152,92848
3:5:1,0,-1,107153,92847
5:1:3,0,-1,107154,92846
1:1:5,0,-1,107155,92845
6:6:6,0,-1,107156,92844
1:6:1,0,-1,107157,92843
5:5:4,0,-1,107158,92842
5:6:1,0,-1,107159,92841
3:2:1,1,1,107158,92842
2:6:6,1,1,107157,92843
2:1:5,1,1,107156,92844
6:4:6,0,-1,107157,92843
2:5:4,1,1,107156,92844
3:1:5,0,-1,107157,92843
1:4:4,0,-1,107158,92842
3:6:1,0,-1,107159,92841
4:4:1,0,-1,107160,92840
5:6:6,0,-1,107161,92839
4:2:4,1,1,107160,92840
4:6:3,0,-1,107161,92839
5:6:6,0,-1,107162,92838
1:3:3,0,-1,107163,92837
2:5:1,1,1,107162,92838
2:2:6,2,2,107160,92840
5:2:4,1,1,107159,92841
6:5:2,1,1,107158,92842
3:1:3,0,-1,107159,92841
3:6:1,0,-1,107160,92840
3:5:1,0,-1,107161,92839
3:1:5,0,-1,107162,92838
6:6:2,1,1,107161,92839
6:1:2,1,1,107160,92840
4:2:1,1,1,107159,92841
5:2:3,1,1,107158,92842
1:3:4,0,-1,107159,92841
3:2:6,1,1,107158,92842
2:5:5,1,1,107157,92843
4:2:3,1,1,107156,92844
5:4:1,0,-1,107157,92843
2:1:1,1,1,107156,92844
4:6:1,0,-1,107157,92843
4:5:3,0,-1,107158,92842
5:1:6,0,-1,107159,92841
2:5:4,1,1,107158,92842
1:2:6,1,1,107157,92843
1:4:4,0,-1,107158,92842
1:4:1,0,-1,107159,92841
3:6:6,0,-1,107160,92840
1:4:2,1,1,107159,92841
6:2:2,2,2,107157,92843
2:5:3,1,1,107156,92844
6:5:6,0,-1,107157,92843
5:2:3,1,1,107156,92844
5:5:4,0,-1,107157,92843
1:1:4,0,-1,107158,92842
2:1:6,1,1,107157,92843
3:4:2,1,1,107156,92844
3:5:1,0,-1,107157,92843
1:5:5,0,-1,107158,92842
2:5:4,1,1,107157,92843
1:5:3,0,-1,107158,92842
3:5:4,0,-1,107159,92841
2:4:2,2,2,107157,92843
4:3:4,0,-1,107158,92842
5:6:1,0,-1,107159,92841
5:5:3,0,-1,107160,92840
3:3:3,0,-1,107161,92839
2:3:2,2,2,107159,92841
4:3:5,0,-1,107160,92840
2:5:5,1,1,107159,92841
1:1:2,1,1,107158,92842
6:4:6,0,-1,107159,92841
1:6:4,0,-1,107160,92840
4:3:1,0,-1,107161,92839
3:2:4,1,1,107160,92840
5:1:1,0,-1,107161,92839
2:4:4,1,1,107160,92840
4:6:5,0,-1,107161,92839
1:3:1,0,-1,107162,92838
6:5:5,0,-1,107163,92837
6:5:4,0,-1,107164,92836
1:3:5,0,-1,107165,92835
5:6:1,0,-1,107166,92834
2:1:5,1,1,107165,92835
5:2:5,1,1,107164,92836
1:3:2,1,1,107163,92837
2:4:5,1,1,107162,92838
6:3:1,0,-1,107163,92837
3:2:6,1,1,107162,92838
5:1:4,0,-1,107163,92837
3:2:1,1,1,107162,92838
4:1:2,1,1,107161,92839
5:1:4,0,-1,107162,92838
5:4:4,0,-1,107163,92837
4:4:4,0,-1,107164,92836
5:6:4,0,-1,107165,92835
2:4:1,1,1,107164,92836
2:6:2,2,2,107162,92838
1:2:4,1,1,107161,92839
2:3:6,1,1,107160,92840
6:6:6,0,-1,107161,92839
3:1:1,0,-1,107162,92838
4:3:5,0,-1,107163,92837
5:6:5,0,-1,107164,92836
1:6:1,0,-1,107165,92835
4:4:2,1,1,107164,92836
5:4:1,0,-1,107165,92835
4:4:6,0,-1,107166,92834
5:1:1,0,-1,107167,92833
5:3:2,1,1,107166,92834
1:1:2,1,1,107165,92835
4:3:3,0,-1,107166,92834
2:5:6,1,1,107165,92835
1:2:6,1,1,107164,92836
5:5:6,0,-1,107165,92835
3:5:1,0,-1,107166,92834
4:4:2,1,1,107165,92835
6:5:5,0,-1,107166,92834
3:2:1,1,1,107165,92835
4:2:6,1,1,107164,92836
4:1:6,0,-1,107165,92835
4:6:3,0,-1,107166,92834
4:6:5,0,-1,107167,92833
6:2:2,2,2,107165,92835
5:3:6,0,-1,107166,92834
5:6:4,0,-1,107167,92833
3:3:6,0,-1,107168,92832
4:2:4,1,1,107167,92833
4:5:2,1,1,107166,92834
1:5:2,1,1,107165,92835
1:4:4,0,-1,107166,92834
5:5:6,0,-1,107167,92833
1:3:1,0,-1,107168,92832
3:4:3,0,-1,107169,92831
2:2:4,2,2,107167,92833
4:6:2,1,1,107166,92834
4:2:1,1,1,107165,92835
1:2:5,1,1,107164,92836
5:6:5,0,-1,107165,92835
5:6:2,1,1,107164,92836
6:4:5,0,-1,107165,92835
6:3:1,0,-1,107166,92834
5:5:6,0,-1,107167,92833
3:3:3,0,-1,107168,92832
2:5:3,1,1,107167,92833
6:2:2,2,2,107165,92835
6:3:2,1,1,107164,92836
5:1:4,0,-1,107165,92835
5:4:4,0,-1,107166,92834
5:6:3,0,-1,107167,92833
4:6:4,0,-1,107168,92832
1:5:6,0,-1,107169,92831
5:4:2,1,1,107168,92832
2:4:5,1,1,107167,92833
6:4:6,0,-1,107168,92832
4:4:4,0,-1,107169,92831
3:5:4,0,-1,107170,92830
2:5:2,2,2,107168,92832
3:4:3,0,-1,107169,92831
3:3:4,0,-1,107170,92830
1:2:6,1,1,107169,92831
4:6:1,0,-1,107170,92830
4:4:4,0,-1,107171,92829
3:4:4,0,-1,107172,92828
4:3:4,0,-1,107173,92827
5:4:2,1,1,107172,92828
4:4:1,0,-1,107173,92827
1:1:1,0,-1,107174,92826
3:4:4,0,-1,107175,92825
6:5:4,0,-1,107176,92824
3:5:6,0,-1,107177,92823
3:3:6,0,-1,107178,92822
2:3:2,2,2,107176,92824
6:5:3,0,-1,107177,92823
6:6:2,1,1,107176,92824
4:4:2,1,1,107175,92825
5:1:3,0,-1,107176,92824
3:3:3,0,-1,107177,92823
3:4:1,0,-1,107178,92822
4:6:6,0,-1,107179,92821
6:5:5,0,-1,107180,92820
4:5:6,0,-1,107181,92819
5:4:2,1,1,107180,92820
4:2:6,1,1,107179,92821
6:3:1,0,-1,107180,92820
5:5:6,0,-1,107181,92819
4:1:2,1,1,107180,92820
1:2:2,2,2,107178,92822
4:5:5,0,-1,107179,92821
5:4:4,0,-1,107180,92820
3:3:6,0,-1,107181,92819
3:4:4,0,-1,107182,92818
1:6:6,0,-1,107183,92817
2:6:6,1,1,107182,92818
1:1:1,0,-1,107183,92817
1:5:4,0,-1,107184,92816
1:1:2,1,1,107183,92817
2:2:6,2,2,107181,92819
5:2:5,1,1,107180,92820
1:6:4,0,-1,107181,92819
6:6:4,0,-1,107182,92818
4:3:5,0,-1,107183,92817
2:6:4,1,1,107182,92818
5:6:3,0,-1,107183,92817
6:6:5,0,-1,107184,92816
5:1:4,0,-1,107185,92815
6:5:1,0,-1,107186,92814
5:6:6,0,-1,107187,92813
2:2:6,2,2,107185,92815
3:5:1,0,-1,107186,92814
1:1:4,0,-1,107187,92813
1:2:1,1,1,107186,92814
2:4:6,1,1,107185,92815
6:5:2,1,1,107184,92816
2:5:4,1,1,107183,92817
5:1:5,0,-1,107184,92816
3:1:3,0,-1,107185,92815
5:2:1,1,1,107184,92816
5:3:4,0,-1,107185,92815
6:3:4,0,-1,107186,92814
6:1:4,0,-1,107187,92813
5:1:2,1,1,107186,92814
6:4:6,0,-1,107187,92813
4:1:3,0,-1,107188,92812
1:3:4,0,-1,107189,92811
1:3:4,0,-1,107190,92810
4:4:5,0,-1,107191,92809
5:5:1,0,-1,107192,92808
5:6:6,0,-1,107193,92807
6:2:3,1,1,107192,92808
3:5:5,0,-1,107193,92807
2:5:5,1,1,107192,92808
5:5:3,0,-1,107193,92807
5:4:6,0,-1,107194,92806
2:4:2,2,2,107192,92808
2:3:3,1,1,107191,92809
2:5:6,1,1,107190,92810
2:1:3,1,1,107189,92811
3:3:5,0,-1,107190,92810
6:5:6,0,-1,107191,92809
4:4:6,0,-1,107192,92808
4:6:6,0,-1,107193,92807
6:5:6,0,-1,107194,92806
4:5:5,0,-1,107195,92805
2:1:2,2,2,107193,92807
5:6:5,0,-1,107194,92806
4:1:2,1,1,107193,92807
3:6:6,0,-1,107194,92806
2:6:3,1,1,107193,92807
2:3:4,1,1,107192,92808
4:3:1,0,-1,107193,92807
1:4:4,0,-1,107194,92806
6:4:1,0,-1,107195,92805
1:3:3,0,-1,107196,92804
4:6:1,0,-1,107197,92803
4:4:2,1,1,107196,92804
1:6:6,0,-1,107197,92803
1:6:1,0,-1,107198,92802
6:6:6,0,-1,107199,92801
1:2:1,1,1,107198,92802
2:3:1,1,1,107197,92803
6:4:3,0,-1,107198,92802
6:3:4,0,-1,107199,92801
2:6:5,1,1,107198,92802
1:1:6,0,-1,107199,92801
5:6:1,0,-1,107200,92800
5:1:3,0,-1,107201,92799
2:6:5,1,1,107200,92800
3:5:5,0,-1,107201,92799
3:3:5,0,-1,107202,92798
2:2:2,3,3,107199,92801
5:6:3,0,-1,107200,92800
5:5:1,0,-1,107201,92799
3:3:5,0,-1,107202,92798
4:4:5,0,-1,107203,92797
1:1:2,1,1,107202,92798
2:5:5,1,1,107201,92799
5:2:6,1,1,107200,92800
4:1:2,1,1,107199,92801
2:5:6,1,1,107198,92802
3:1:3,0,-1,107199,92801
6:1:3,0,-1,107200,92800
4:3:4,0,-1,107201,92799
5:3:2,1,1,107200,92800
3:2:1,1,1,107199,92801
6:3:3,0,-1,107200,92800
3:1:1,0,-1,107201,92799
2:6:5,1,1,107200,92800
6:5:1,0,-1,107201,92799
2:3:4,1,1,107200,92800
4:5:3,0,-1,107201,92799
6:6:4,0,-1,107202,92798
2:5:1,1,1,107201,92799
4:2:1,1,1,107200,92800
3:6:2,1,1,107199,92801
3:5:5,0,-1,107200,92800
2:6:4,1,1,107199,92801
4:6:6,0,-1,107200,92800
5:1:5,0,-1,107201,92799
2:1:3,1,1,107200,92800
2:2:3,2,2,107198,92802
1:4:2,1,1,107197,92803
2:3:3,1,1,107196,92804
6:6:5,0,-1,107197,92803
3:1:4,0,-1,107198,92802
2:3:5,1,1,107197,92803
3:5:5,0,-1,107198,92802
3:6:5,0,-1,107199,92801
3:6:6,0,-1,107200,92800
5:1:4,0,-1,107201,92799
4:6:4,0,-1,107202,92798
6:1:1,0,-1,107203,92797
3:4:2,1,1,107202,92798
2:2:4,2,2,107200,92800
2:6:6,1,1,107199,92801
3:4:1,0,-1,107200,92800
3:4:2,1,1,107199,92801
2:1:4,1,1,107198,92802
2:5:2,2,2,107196,92804
4:1:1,0,-1,107197,92803
5:5:3,0,-1,107198,92802
4:1:1,0,-1,107199,92801
4:6:1,0,-1,107200,92800
4:2:2,2,2,107198,92802
2:6:6,1,1,107197,92803
5:2:6,1,1,107196,92804
2:5:5,1,1,107195,92805
2:4:1,1,1,107194,92806
3:5:1,0,-1,107195,92805
1:3:1,0,-1,107196,92804
2:1:2,2,2,107194,92806
2:2:6,2,2,107192,92808
1:5:5,0,-1,107193,92807
3:1:1,0,-1,107194,92806
6:5:4,0,-1,107195,92805
5:6:4,0,-1,107196,92804
1:1:1,0,-1,107197,92803
1:3:3,0,-1,107198,92802
5:2:5,1,1,107197,92803
5:1:1,0,-1,107198,92802
3:3:2,1,1,107197,92803
2:6:3,1,1,107196,92804
5:1:1,0,-1,107197,92803
1:5:2,1,1,107196,92804
1:6:5,0,-1,107197,92803
1:2:2,2,2,107195,92805
2:5:3,1,1,107194,92806
2:3:6,1,1,107193,92807
5:5:2,1,1,107192,92808
5:6:4,0,-1,107193,92807
1:1:4,0,-1,107194,92806
5:4:4,0,-1,107195,92805
3:5:1,0,-1,107196,92804
5:5:3,0,-1,107197,92803
1:3:5,0,-1,107198,92802
3:6:6,0,-1,107199,92801
4:2:1,1,1,107198,92802
3:2:2,2,2,107196,92804
1:5:6,0,-1,107197,92803
5:5:6,0,-1,107198,92802
1:5:1,0,-1,107199,92801
1:4:3,0,-1,107200,92800
4:3:5,0,-1,107201,92799
1:4:4,0,-1,107202,92798
3:4:1,0,-1,107203,92797
5:2:4,1,1,107202,92798
5:3:5,0,-1,107203,92797
1:1:5,0,-1,107204,92796
2:5:2,2,2,107202,92798
4:4:6,0,-1,107203,92797
4:3:6,0,-1,107204,92796
1:4:3,0,-1,107205,92795
6:3:5,0,-1,107206,92794
5:1:5,0,-1,107207,92793
1:2:3,1,1,107206,92794
5:1:4,0,-1,107207,92793
1:2:6,1,1,107206,92794
6:6:5,0,-1,107207,92793
5:1:3,0,-1,107208,92792
6:2:2,2,2,107206,92794
2:6:1,1,1,107205,92795
4:3:2,1,1,107204,92796
4:2:6,1,1,107203,92797
5:6:5,0,-1,107204,92796
2:5:5,1,1,107203,92797
1:3:6,0,-1,107204,92796
1:5:2,1,1,107203,92797
3:1:4,0,-1,107204,92796
5:4:4,0,-1,107205,92795
5:4:6,0,-1,107206,92794
2:3:6,1,1,107205,92795
3:4:5,0,-1,107206,92794
1:4:4,0,-1,107207,92793
1:5:3,0,-1,107208,92792
6:2:4,1,1,107207,92793
4:6:4,0,-1,107208,92792
6:3:5,0,-1,107209,92791
3:1:2,1,1,107208,92792
1:1:5,0,-1,107209,92791
4:4:3,0,-1,107210,92790
5:4:1,0,-1,107211,92789
4:2:3,1,1,107210,92790
3:4:3,0,-1,107211,92789
4:3:3,0,-1,107212,92788
6:6:5,0,-1,107213,92787
3:5:3,0,-1,107214,92786
2:5:1,1,1,107213,92787
6:2:3,1,1,107212,92788
2:1:4,1,1,107211,92789
1:6:5,0,-1,107212,92788
5:2:2,2,2,107210,92790
3:1:2,1,1,107209,92791
2:5:5,1,1,107208,92792
5:1:4,0,-1,107209,92791
2:4:1,1,1,107208,92792
4:5:2,1,1,107207,92793
2:4:4,1,1,107206,92794
1:2:2,2,2,107204,92796
5:5:2,1,1,107203,92797
2:5:5,1,1,107202,92798
3:2:6,1,1,107201,92799
6:4:4,0,-1,107202,92798
4:6:6,0,-1,107203,92797
6:1:6,0,-1,107204,92796
3:1:1,0,-1,107205,92795
1:6:2,1,1,107204,92796
5:2:3,1,1,107203,92797
5:5:2,1,1,107202,92798
4:6:2,1,1,107201,92799
2:2:6,2,2,107199,92801
1:3:6,0,-1,107200,92800
3:1:5,0,-1,107201,92799
5:1:5,0,-1,107202,92798
4:4:5,0,-1,107203,92797
4:3:5,0,-1,107204,92796
5:4:6,0,-1,107205,92795
1:5:6,0,-1,107206,92794
2:3:1,1,1,107205,92795
1:1:2,1,1,107204,92796
1:1:5,0,-1,107205,92795
1:1:2,1,1,107204,92796
6:6:3,0,-1,107205,92795
2:3:2,2,2,107203,92797
2:6:3,1,1,107202,92798
5:5:5,0,-1,107203,92797
1:1:1,0,-1,107204,92796
4:3:2,1,1,107203,92797
6:2:5,1,1,107202,92798
4:3:2,1,1,107201,92799
4:2:6,1,1,107200,92800
4:4:3,0,-1,107201,92799
5:3:2,1,1,107200,92800
6:5:5,0,-1,107201,92799
1:6:4,0,-1,107202,92798
6:6:4,0,-1,107203,92797
2:6:4,1,1,107202,92798
2:2:6,2,2,107200,92800
1:1:3,0,-1,107201,92799
3:5:5,0,-1,107202,92798
1:6:2,1,1,107201,92799
4:6:6,0,-1,107202,92798
1:4:3,0,-1,107203,92797
3:3:4,0,-1,107204,92796
3:6:3,0,-1,107205,92795
6:3:5,0,-1,107206,92794
6:6:3,0,-1,107207,92793
5:2:3,1,1,107206,92794
2:6:2,2,2,107204,92796
3:3:3,0,-1,107205,92795
3:1:1,0,-1,107206,92794
1:6:2,1,1,107205,92795
4:4:2,1,1,107204,92796
1:6:1,0,-1,107205,92795
2:5:5,1,1,107204,92796
1:6:3,0,-1,107205,92795
1:5:6,0,-1,107206,92794
2:3:3,1,1,107205,92795
2:5:5,1,1,107204,92796
1:3:1,0,-1,107205,92795
6:2:4,1,1,107204,92796
6:6:4,0,-1,107205,92795
4:1:5,0,-1,107206,92794
3:1:4,0,-1,107207,92793
2:1:4,1,1,107206,92794
1:4:2,1,1,107205,92795
1:1:6,0,-1,107206,92794
5:4:6,0,-1,107207,92793
6:2:1,1,1,107206,92794
4:3:3,0,-1,107207,92793
1:1:4,0,-1,107208,92792
4:2:5,1,1,107207,92793
3:4:1,0,-1,107208,92792
5:2:2,2,2,107206,92794
4:1:3,0,-1,107207,92793
3:1:6,0,-1,107208,92792
1:6:1,0,-1,107209,92791
4:6:6,0,-1,107210,92790
5:2:2,2,2,107208,92792
4:3:3,0,-1,107209,92791
1:5:1,0,-1,107210,92790
1:4:4,0,-1,107211,92789
5:6:3,0,-1,107212,92788
6:3:2,1,1,107211,92789
5:6:2,1,1,107210,92790
5:6:2,1,1,107209,92791
6:3:1,0,-1,107210,92790
3:1:4,0,-1,107211,92789
6:2:3,1,1,107210,92790
6:1:3,0,-1,107211,92789
1:2:2,2,2,107209,92791
1:3:6,0,-1,107210,92790
1:3:6,0,-1,107211,92789
2:1:5,1,1,107210,92790
5:3:3,0,-1,107211,92789
3:2:4,1,1,107210,92790
4:2:5,1,1,107209,92791
5:1:3,0,-1,107210,92790
6:1:2,1,1,107209,92791
2:5:2,2,2,107207,92793
4:1:3,0,-1,107208,92792
2:2:3,2,2,107206,92794
5:6:4,0,-1,107207,92793
3:6:3,0,-1,107208,92792
1:1:3,0,-1,107209,92791
1:2:4,1,1,107208,92792
5:1:6,0,-1,107209,92791
5:2:5,1,1,107208,92792
2:6:2,2,2,107206,92794
4:1:2,1,1,107205,92795
5:2:4,1,1,107204,92796
2:4:1,1,1,107203,92797
3:5:1,0,-1,107204,92796
4:1:1,0,-1,107205,92795
2:3:4,1,1,107204,92796
1:4:4,0,-1,107205,92795
3:2:5,1,1,107204,92796
2:4:1,1,1,107203,92797
5:1:2,1,1,107202,92798
1:2:3,1,1,107201,92799
3:4:2,1,1,107200,92800
2:4:3,1,1,107199,92801
4:6:2,1,1,107198,92802
6:2:6,1,1,107197,92803
6:2:6,1,1,107196,92804
6:1:5,0,-1,107197,92803
4:5:3,0,-1,107198,92802
3:1:1,0,-1,107199,92801
6:4:5,0,-1,107200,92800
5:2:2,2,2,107198,92802
1:6:5,0,-1,107199,92801
5:1:5,0,-1,107200,92800
2:3:3,1,1,107199,92801
1:6:6,0,-1,107200,92800
4:5:1,0,-1,107201,92799
4:3:6,0,-1,107202,92798
5:5:6,0,-1,107203,92797
6:4:6,0,-1,107204,92796
1:2:6,1,1,107203,92797
2:2:1,2,2,107201,92799
3:4:1,0,-1,107202,92798
1:4:6,0,-1,107203,92797
5:3:1,0,-1,107204,92796
5:1:6,0,-1,107205,92795
1:4:2,1,1,107204,92796
2:3:4,1,1,107203,92797
5:6:2,1,1,107202,92798
5:6:3,0,-1,107203,92797
2:3:6,1,1,107202,92798
3:6:4,0,-1,107203,92797
6:4:6,0,-1,107204,92796
4:4:6,0,-1,107205,92795
3:1:1,0,-1,107206,92794
1:5:5,0,-1,107207,92793
3:1:6,0,-1,107208,92792
5:6:5,0,-1,107209,92791
5:4:2,1,1,107208,92792
5:6:3,0,-1,107209,92791
6:2:5,1,1,107208,92792
6:1:4,0,-1,107209,92791
6:4:1,0,-1,107210,92790
1:3:5,0,-1,107211,92789
5:5:4,0,-1,107212,92788
2:5:3,1,1,107211,92789
2:5:2,2,2,107209,92791
6:4:5,0,-1,107210,92790
6:4:1,0,-1,107211,92789
6:1:1,0,-1,107212,92788
4:3:4,0,-1,107213,92787
1:1:1,0,-1,107214,92786
3:6:2,1,1,107213,92787
3:1:1,0,-1,107214,92786
4:1:2,1,1,107213,92787
5:2:3,1,1,107212,92788
4:3:3,0,-1,107213,92787
5:5:6,0,-1,107214,92786
4:2:6,1,1,107213,92787
6:2:6,1,1,107212,92788
3:3:2,1,1,107211,92789
4:5:2,1,1,107210,92790
6:4:6,0,-1,107211,92789
4:4:2,1,1,107210,92790
3:6:1,0,-1,107211,92789
5:5:5,0,-1,107212,92788
6:2:6,1,1,107211,92789
4:6:3,0,-1,107212,92788
2:4:3,1,1,107211,92789
3:4:6,0,-1,107212,92788
5:6:2,1,1,107211,92789
6:6:5,0,-1,107212,92788
2:6:2,2,2,107210,92790
1:3:4,0,-1,107211,92789
4:1:3,0,-1,107212,92788
2:5:3,1,1,107211,92789
2:1:2,2,2,107209,92791
2:3:5,1,1,107208,92792
6:5:6,0,-1,107209,92791
1:5:3,0,-1,107210,92790
6:5:3,0,-1,107211,92789
4:2:6,1,1,107210,92790
5:1:3,0,-1,107211,92789
2:4:1,1,1,107210,92790
1:2:1,1,1,107209,92791
2:6:2,2,2,107207,92793
6:6:1,0,-1,107208,92792
4:2:3,1,1,107207,92793
1:5:6,0,-1,107208,92792
3:6:1,0,-1,107209,92791
6:6:5,0,-1,107210,92790
3:3:5,0,-1,107211,92789
3:1:3,0,-1,107212,92788
4:5:5,0,-1,107213,92787
3:4:2,1,1,107212,92788
6:3:1,0,-1,107213,92787
2:6:6,1,1,107212,92788
5:3:2,1,1,107211,92789
2:2:1,2,2,107209,92791
5:6:4,0,-1,107210,92790
5:3:5,0,-1,107211,92789
5:5:2,1,1,107210,92790
3:5:4,0,-1,107211,92789
4:3:4,0,-1,107212,92788
5:2:3,1,1,107211,92789
1:6:6,0,-1,107212,92788
3:5:1,0,-1,107213,92787
4:6:3,0,-1,107214,92786
5:4:3,0,-1,107215,92785
4:3:6,0,-1,107216,92784
4:1:6,0,-1,107217,92783
1:6:1,0,-1,107218,92782
5:1:5,0,-1,107219,92781
3:3:5,0,-1,107220,92780
4:3:3,0,-1,107221,92779
6:5:2,1,1,107220,92780
5:1:2,1,1,107219,92781
3:2:5,1,1,107218,92782
5:2:2,2,2,107216,92784
6:2:3,1,1,107215,92785
2:2:3,2,2,107213,92787
6:6:2,1,1,107212,92788
6:1:3,0,-1,107213,92787
2:6:2,2,2,107211,92789
1:6:6,0,-1,107212,92788
6:5:6,0,-1,107213,92787
3:6:3,0,-1,107214,92786
2:4:5,1,1,107213,92787
6:2:1,1,1,107212,92788
5:4:1,0,-1,107213,92787
2:5:3,1,1,107212,92788
3:5:2,1,1,107211,92789
3:5:3,0,-1,107212,92788
5:3:5,0,-1,107213,92787
3:4:1,0,-1,107214,92786
3:3:2,1,1,107213,92787
5:6:3,0,-1,107214,92786
1:4:6,0,-1,107215,92785
2:4:3,1,1,107214,92786
4:1:6,0,-1,107215,92785
4:2:3,1,1,107214,92786
5:6:2,1,1,107213,92787
1:4:3,0,-1,107214,92786
6:5:4,0,-1,107215,92785
1:1:6,0,-1,107216,92784
3:6:3,0,-1,107217,92783
5:1:5,0,-1,107218,92782
2:6:4,1,1,107217,92783
6:4:2,1,1,107216,92784
2:6:2,2,2,107214,92786
1:2:5,1,1,107213,92787
4:3:3,0,-1,107214,92786
4:6:5,0,-1,107215,92785
2:2:6,2,2,107213,92787
2:3:5,1,1,107212,92788
2:1:6,1,1,107211,92789
1:3:6,0,-1,107212,92788
2:5:6,1,1,107211,92789
1:3:2,1,1,107210,92790
3:2:4,1,1,107209,92791
4:4:4,0,-1,107210,92790
5:2:2,2,2,107208,92792
4:5:5,0,-1,107209,92791
3:1:1,0,-1,107210,92790
6:3:4,0,-1,107211,92789
3:3:3,0,-1,107212,92788
6:5:2,1,1,107211,92789
2:6:1,1,1,107210,92790
2:3:6,1,1,107209,92791
6:6:1,0,-1,107210,92790
4:4:3,0,-1,107211,92789
1:4:5,0,-1,107212,92788
2:5:2,2,2,107210,92790
5:4:1,0,-1,107211,92789
3:5:6,0,-1,107212,92788
2:6:5,1,1,107211,92789
6:5:3,0,-1,107212,92788
5:4:2,1,1,107211,92789
4:3:4,0,-1,107212,92788
5:6:3,0,-1,107213,92787
4:3:6,0,-1,107214,92786
5:4:6,0,-1,107215,92785
1:4:1,0,-1,107216,92784
6:1:4,0,-1,107217,92783
3:6:5,0,-1,107218,92782
5:5:4,0,-1,107219,92781
5:2:6,1,1,107218,92782
6:4:4,0,-1,107219,92781
2:2:1,2,2,107217,92783
5:6:3,0,-1,107218,92782
3:3:2,1,1,107217,92783
1:6:2,1,1,107216,92784
6:4:2,1,1,107215,92785
4:4:4,0,-1,107216,92784
6:3:2,1,1,107215,92785
6:3:6,0,-1,107216,92784
4:2:5,1,1,107215,92785
2:5:3,1,1,107214,92786
4:2:5,1,1,107213,92787
4:2:6,1,1,107212,92788
2:2:2,3,3,107209,92791
5:2:6,1,1,107208,92792
3:2:4,1,1,107207,92793
1:2:3,1,1,107206,92794
5:5:4,0,-1,107207,92793
6:4:3,0,-1,107208,92792
6:1:3,0,-1,107209,92791
4:6:5,0,-1,107210,92790
6:1:3,0,-1,107211,92789
5:5:6,0,-1,107212,92788
3:2:5,1,1,107211,92789
5:5:4,0,-1,107212,92788
5:4:3,0,-1,107213,92787
5:6:6,0,-1,107214,92786
2:6:4,1,1,107213,92787
3:6:1,0,-1,107214,92786
6:1:4,0,-1,107215,92785
2:5:4,1,1,107214,92786
1:3:6,0,-1,107215,92785
3:2:1,1,1,107214,92786
6:5:3,0,-1,107215,92785
1:4:2,1,1,107214,92786
4:5:1,0,-1,107215,92785
4:5:6,0,-1,107216,92784
4:2:4,1,1,107215,92785
3:2:3,1,1,107214,92786
3:4:4,0,-1,107215,92785
3:5:4,0,-1,107216,92784
3:2:3,1,1,107215,92785
2:1:3,1,1,107214,92786
5:1:4,0,-1,107215,92785
6:5:4,0,-1,107216,92784
3:6:1,0,-1,107217,92783
1:6:3,0,-1,107218,92782
1:1:2,1,1,107217,92783
4:5:3,0,-1,107218,92782
3:2:1,1,1,107217,92783
1:5:4,0,-1,107218,92782
4:5:3,0,-1,107219,92781
2:1:5,1,1,107218,92782
2:1:5,1,1,107217,92783
1:3:3,0,-1,107218,92782
2:4:1,1,1,107217,92783
1:5:3,0,-1,107218,92782
1:2:3,1,1,107217,92783
6:1:3,0,-1,107218,92782
2:5:3,1,1,107217,92783
1:6:5,0,-1,107218,92782
6:3:2,1,1,107217,92783
4:2:2,2,2,107215,92785
1:4:3,0,-1,107216,92784
1:1:6,0,-1,107217,92783
1:1:3,0,-1,107218,92782
1:5:4,0,-1,107219,92781
4:3:5,0,-1,107220,92780
4:6:2,1,1,107219,92781
3:5:1,0,-1,107220,92780
3:1:1,0,-1,107221,92779
5:5:4,0,-1,107222,92778
3:5:4,0,-1,107223,92777
5:1:5,0,-1,107224,92776
6:2:4,1,1,107223,92777
2:5:1,1,1,107222,92778
6:3:5,0,-1,107223,92777
4:2:4,1,1,107222,92778
1:4:1,0,-1,107223,92777
5:2:3,1,1,107222,92778
1:6:2,1,1,107221,92779
5:1:5,0,-1,107222,92778
4:6:6,0,-1,107223,92777
3:6:3,0,-1,107224,92776
6:2:3,1,1,107223,92777
4:5:1,0,-1,107224,92776
6:4:1,0,-1,107225,92775
3:1:3,0,-1,107226,92774
3:2:2,2,2,107224,92776
5:5:4,0,-1,107225,92775
1:3:3,0,-1,107226,92774
4:2:6,1,1,107225,92775
1:2:3,1,1,107224,92776
2:6:4,1,1,107223,92777
6:3:1,0,-1,107224,92776
6:5:1,0,-1,107225,92775
6:5:1,0,-1,107226,92774
6:6:6,0,-1,107227,92773
4:4:4,0,-1,107228,92772
4:3:2,1,1,107227,92773
3:5:5,0,-1,107228,92772
2:4:3,1,1,107227,92773
1:2:3,1,1,107226,92774
3:3:2,1,1,107225,92775
4:4:4,0,-1,107226,92774
3:4:2,1,1,107225,92775
6:2:2,2,2,107223,92777
2:5:6,1,1,107222,92778
1:6:6,0,-1,107223,92777
5:5:1,0,-1,107224,92776
3:5:3,0,-1,107225,92775
1:1:5,0,-1,107226,92774
4:3:4,0,-1,107227,92773
2:6:2,2,2,107225,92775
5:5:5,0,-1,107226,92774
1:1:2,1,1,107225,92775
4:2:2,2,2,107223,92777
6:1:3,0,-1,107224,92776
1:2:3,1,1,107223,92777
6:3:4,0,-1,107224,92776
4:3:6,0,-1,107225,92775
2:2:3,2,2,107223,92777
2:1:2,2,2,107221,92779
6:1:3,0,-1,107222,92778
5:5:2,1,1,107221,92779
5:1:6,0,-1,107222,92778
6:2:4,1,1,107221,92779
1:1:3,0,-1,107222,92778
1:2:6,1,1,107221,92779
5:5:2,1,1,107220,92780
1:6:5,0,-1,107221,92779
4:2:1,1,1,107220,92780
2:6:3,1,1,107219,92781
4:3:6,0,-1,107220,92780
4:4:1,0,-1,107221,92779
2:5:1,1,1,107220,92780
1:6:3,0,-1,107221,92779
4:6:2,1,1,107220,92780
4:6:5,0,-1,107221,92779
1:3:4,0,-1,107222,92778
5:6:2,1,1,107221,92779
6:2:2,2,2,107219,92781
2:1:1,1,1,107218,92782
5:1:2,1,1,107217,92783
2:4:1,1,1,107216,92784
6:1:2,1,1,107215,92785
5:2:1,1,1,107214,92786
4:1:5,0,-1,107215,92785
1:6:2,1,1,107214,92786
2:1:4,1,1,107213,92787
6:5:1,0,-1,107214,92786
3:6:6,0,-1,107215,92785
4:3:4,0,-1,107216,92784
4:4:1,0,-1,107217,92783
3:2:4,1,1,107216,92784
3:4:4,0,-1,107217,92783
1:6:3,0,-1,107218,92782
5:3:6,0,-1,107219,92781
1:2:1,1,1,107218,92782
1:2:4,1,1,107217,92783
5:2:3,1,1,107216,92784
6:6:4,0,-1,107217,92783
1:2:3,1,1,107216,92784
2:6:1,1,1,107215,92785
6:5:1,0,-1,107216,92784
4:1:4,0,-1,107217,92783
1:3:5,0,-1,107218,92782
1:2:4,1,1,107217,92783
6:5:2,1,1,107216,92784
2:2:2,3,3,107213,92787
1:4:6,0,-1,107214,92786
5:5:3,0,-1,107215,92785
1:6:1,0,-1,107216,92784
1:5:5,0,-1,107217,92783
5:3:3,0,-1,107218,92782
3:3:3,0,-1,107219,92781
1:2:4,1,1,107218,92782
6:3:1,0,-1,107219,92781
4:1:4,0,-1,107220,92780
5:3:5,0,-1,107221,92779
6:4:5,0,-1,107222,92778
1:3:5,0,-1,107223,92777
4:6:1,0,-1,107224,92776
3:4:2,1,1,107223,92777
3:4:1,0,-1,107224,92776
4:3:5,0,-1,107225,92775
5:6:6,0,-1,107226,92774
6:6:4,0,-1,107227,92773
6:5:3,0,-1,107228,92772
1:5:6,0,-1,107229,92771
1:2:5,1,1,107228,92772
6:3:1,0,-1,107229,92771
1:1:3,0,-1,107230,92770
5:3:4,0,-1,107231,92769
5:3:4,0,-1,107232,92768
1:2:3,1,1,107231,92769
3:3:6,0,-1,107232,92768
3:6:4,0,-1,107233,92767
5:2:2,2,2,107231,92769
4:2:5,1,1,107230,92770
6:2:6,1,1,107229,92771
3:5:2,1,1,107228,92772
2:5:5,1,1,107227,92773
4:6:5,0,-1,107228,92772
5:3:6,0,-1,107229,92771
4:2:5,1,1,107228,92772
3:3:6,0,-1,107229,92771
2:6:1,1,1,107228,92772
1:1:1,0,-1,107229,92771
2:3:3,1,1,107228,92772
2:6:5,1,1,107227,92773
5:6:1,0,-1,107228,92772
2:2:3,2,2,107226,92774
2:5:3,1,1,107225,92775
1:5:1,0,-1,107226,92774
5:1:2,1,1,107225,92775
2:4:3,1,1,107224,92776
1:3:4,0,-1,107225,92775
6:1:1,0,-1,107226,92774
4:3:1,0,-1,107227,92773
5:6:2,1,1,107226,92774
5:2:4,1,1,107225,92775
4:5:4,0,-1,107226,92774
5:5:6,0,-1,107227,92773
6:4:1,0,-1,107228,92772
3:4:6,0,-1,107229,92771
1:2:5,1,1,107228,92772
1:6:1,0,-1,107229,92771
6:4:3,0,-1,107230,92770
1:1:5,0,-1,107231,92769
1:5:4,0,-1,107232,92768
5:1:5,0,-1,107233,92767
4:5:6,0,-1,107234,92766
1:2:1,1,1,107233,92767
2:2:6,2,2,107231,92769
6:4:6,0,-1,107232,92768
5:6:4,0,-1,107233,92767
4:2:2,2,2,107231,92769
6:1:6,0,-1,107232,92768
3:2:6,1,1,107231,92769
1:2:4,1,1,107230,92770
1:6:4,0,-1,107231,92769
3:2:5,1,1,107230,92770
5:1:5,0,-1,107231,92769
4:1:6,0,-1,107232,92768
5:3:4,0,-1,107233,92767
1:1:6,0,-1,107234,92766
6:6:5,0,-1,107235,92765
5:5:2,1,1,107234,92766
4:3:4,0,-1,107235,92765
4:1:4,0,-1,107236,92764
4:4:5,0,-1,107237,92763
6:3:6,0,-1,107238,92762
6:2:3,1,1,107237,92763
6:4:6,0,-1,107238,92762
6:1:6,0,-1,107239,92761
2:1:2,2,2,107237,92763
4:2:4,1,1,107236,92764
2:4:4,1,1,107235,92765
3:1:2,1,1,107234,92766
3:3:6,0,-1,107235,92765
2:2:5,2,2,107233,92767
6:5:2,1,1,107232,92768
6:5:1,0,-1,107233,92767
1:6:5,0,-1,107234,92766
5:2:4,1,1,107233,92767
1:6:5,0,-1,107234,92766
1:6:1,0,-1,107235,92765
4:6:6,0,-1,107236,92764
5:6:4,0,-1,107237,92763
2:1:3,1,1,107236,92764
4:2:4,1,1,107235,92765
1:2:6,1,1,107234,92766
2:6:6,1,1,107233,92767
1:4:3,0,-1,107234,92766
5:3:5,0,-1,107235,92765
6:1:5,0,-1,107236,92764
6:5:2,1,1,107235,92765
1:6:2,1,1,107234,92766
5:1:3,0,-1,107235,92765
6:3:2,1,1,107234,92766
2:5:2,2,2,107232,92768
5:3:5,0,-1,107233,92767
5:2:3,1,1,107232,92768
1:1:2,1,1,107231,92769
5:1:5,0,-1,107232,92768
2:2:4,2,2,107230,92770
3:4:1,0,-1,107231,92769
1:1:6,0,-1,107232,92768
3:6:6,0,-1,107233,92767
6:6:6,0,-1,107234,92766
3:3:1,0,-1,107235,92765
4:4:6,0,-1,107236,92764
3:6:6,0,-1,107237,92763
4:4:6,0,-1,107238,92762
1:4:1,0,-1,107239,92761
4:4:6,0,-1,107240,92760
3:1:5,0,-1,107241,92759
4:6:5,0,-1,107242,92758
2:4:2,2,2,107240,92760
5:4:1,0,-1,107241,92759
2:2:4,2,2,107239,92761
2:4:3,1,1,107238,92762
4:1:2,1,1,107237,92763
5:5:1,0,-1,107238,92762
3:3:1,0,-1,107239,92761
1:3:1,0,-1,107240,92760
6:2:2,2,2,107238,92762
3:5:6,0,-1,107239,92761
4:5:3,0,-1,107240,92760
2:6:5,1,1,107239,92761
4:3:4,0,-1,107240,92760
4:5:1,0,-1,107241,92759
6:6:5,0,-1,107242,92758
1:1:1,0,-1,107243,92757
6:2:5,1,1,107242,92758
1:3:1,0,-1,107243,92757
5:6:4,0,-1,107244,92756
3:3:5,0,-1,107245,92755
1:4:5,0,-1,107246,92754
1:5:1,0,-1,107247,92753
3:4:3,0,-1,107248,92752
1:6:3,0,-1,107249,92751
6:1:5,0,-1,107250,92750
1:2:6,1,1,107249,92751
3:5:1,0,-1,107250,92750
1:3:2,1,1,107249,92751
1:6:6,0,-1,107250,92750
5:3:5,0,-1,107251,92749
2:3:6,1,1,107250,92750
2:2:3,2,2,107248,92752
5:1:2,1,1,107247,92753
3:1:1,0,-1,107248,92752
6:3:3,0,-1,107249,92751
4:5:1,0,-1,107250,92750
1:1:4,0,-1,107251,92749
5:1:1,0,-1,107252,92748
5:4:2,1,1,107251,92749
4:2:1,1,1,107250,92750
5:2:4,1,1,107249,92751
2:4:6,1,1,107248,92752
5:6:6,0,-1,107249,92751
6:1:3,0,-1,107250,92750
1:1:1,0,-1,107251,92749
2:1:4,1,1,107250,92750
4:6:3,0,-1,107251,92749
4:1:6,0,-1,107252,92748
1:3:1,0,-1,107253,92747
3:4:4,0,-1,107254,92746
2:6:6,1,1,107253,92747
2:5:3,1,1,107252,92748
3:2:2,2,2,107250,92750
2:2:6,2,2,107248,92752
1:3:2,1,1,107247,92753
6:1:3,0,-1,107248,92752
4:1:6,0,-1,107249,92751
5:4:6,0,-1,107250,92750
6:4:4,0,-1,107251,92749
4:5:4,0,-1,107252,92748
2:4:1,1,1,107251,92749
5:3:6,0,-1,107252,92748
1:1:2,1,1,107251,92749
2:4:3,1,1,107250,92750
2:4:3,1,1,107249,92751
2:1:1,1,1,107248,92752
3:6:2,1,1,107247,92753
1:3:3,0,-1,107248,92752
2:4:1,1,1,107247,92753
3:6:3,0,-1,107248,92752
1:2:6,1,1,107247,92753
1:2:1,1,1,107246,92754
5:3:2,1,1,107245,92755
1:3:4,0,-1,107246,92754
2:1:3,1,1,107245,92755
5:1:3,0,-1,107246,92754
3:3:2,1,1,107245,92755
6:4:3,0,-1,107246,92754
3:1:5,0,-1,107247,92753
4:1:1,0,-1,107248,92752
6:5:3,0,-1,107249,92751
2:6:3,1,1,107248,92752
1:5:5,0,-1,107249,92751
2:4:5,1,1,107248,92752
6:6:6,0,-1,107249,92751
6:2:5,1,1,107248,92752
4:6:3,0,-1,107249,92751
5:4:1,0,-1,107250,92750
3:2:1,1,1,107249,92751
2:4:4,1,1,107248,92752
2:2:5,2,2,107246,92754
5:3:1,0,-1,107247,92753
2:4:1,1,1,107246,92754
4:4:4,0,-1,107247,92753
1:1:5,0,-1,107248,92752
4:5:5,0,-1,107249,92751
4:6:5,0,-1,107250,92750
1:3:4,0,-1,107251,92749
1:5:3,0,-1,107252,92748
4:4:3,0,-1,107253,92747
6:6:2,1,1,107252,92748
4:1:4,0,-1,107253,92747
3:4:2,1,1,107252,92748
1:6:6,0,-1,107253,92747
1:3:3,0,-1,107254,92746
1:5:3,0,-1,107255,92745
4:5:5,0,-1,107256,92744
4:1:3,0,-1,107257,92743
5:5:6,0,-1,107258,92742
4:1:3,0,-1,107259,92741
4:3:2,1,1,107258,92742
4:5:5,0,-1,107259,92741
5:5:5,0,-1,107260,92740
5:4:3,0,-1,107261,92739
3:6:6,0,-1,107262,92738
2:5:2,2,2,107260,92740
3:3:1,0,-1,107261,92739
2:3:4,1,1,107260,92740
4:2:3,1,1,107259,92741
5:6:6,0,-1,107260,92740
1:2:1,1,1,107259,92741
3:3:4,0,-1,107260,92740
3:6:3,0,-1,107261,92739
1:5:4,0,-1,107262,92738
6:1:4,0,-1,107263,92737
5:2:2,2,2,107261,92739
5:6:4,0,-1,107262,92738
2:3:5,1,1,107261,92739
2:1:2,2,2,107259,92741
5:3:6,0,-1,107260,92740
2:6:6,1,1,107259,92741
4:3:3,0,-1,107260,92740
4:5:4,0,-1,107261,92739
2:3:2,2,2,107259,92741
5:4:6,0,-1,107260,92740
5:3:1,0,-1,107261,92739
2:5:4,1,1,107260,92740
2:6:4,1,1,107259,92741
4:4:2,1,1,107258,92742
5:3:4,0,-1,107259,92741
2:5:4,1,1,107258,92742
5:6:5,0,-1,107259,92741
2:3:6,1,1,107258,92742
2:5:6,1,1,107257,92743
1:4:1,0,-1,107258,92742
5:6:1,0,-1,107259,92741
4:2:5,1,1,107258,92742
1:3:1,0,-1,107259,92741
3:1:6,0,-1,107260,92740
1:5:2,1,1,107259,92741
3:3:5,0,-1,107260,92740
3:3:2,1,1,107259,92741
2:5:2,2,2,107257,92743
3:4:4,0,-1,107258,92742
4:1:2,1,1,107257,92743
4:1:1,0,-1,107258,92742
1:6:3,0,-1,107259,92741
6:1:5,0,-1,107260,92740
2:3:2,2,2,107258,92742
3:3:4,0,-1,107259,92741
6:1:4,0,-1,107260,92740
4:3:3,0,-1,107261,92739
3:6:6,0,-1,107262,92738
4:4:4,0,-1,107263,92737
5:6:3,0,-1,107264,92736
4:4:1,0,-1,107265,92735
1:1:3,0,-1,107266,92734
3:1:1,0,-1,107267,92733
5:6:6,0,-1,107268,92732
1:2:2,2,2,107266,92734
5:2:5,1,1,107265,92735
4:2:2,2,2,107263,92737
3:3:2,1,1,107262,92738
4:4:6,0,-1,107263,92737
4:4:3,0,-1,107264,92736
3:1:5,0,-1,107265,92735
1:2:2,2,2,107263,92737
3:4:1,0,-1,107264,92736
3:2:1,1,1,107263,92737
6:6:6,0,-1,107264,92736
6:4:1,0,-1,107265,92735
4:1:3,0,-1,107266,92734
3:5:3,0,-1,107267,92733
6:2:5,1,1,107266,92734
4:5:1,0,-1,107267,92733
2:4:5,1,1,107266,92734
4:5:2,1,1,107265,92735
3:1:1,0,-1,107266,92734
3:6:3,0,-1,107267,92733
2:5:6,1,1,107266,92734
5:5:3,0,-1,107267,92733
2:5:6,1,1,107266,92734
3:2:4,1,1,107265,92735
3:4:2,1,1,107264,92736
5:5:6,0,-1,107265,92735
6:2:6,1,1,107264,92736
6:6:4,0,-1,107265,92735
4:6:2,1,1,107264,92736
6:4:3,0,-1,107265,92735
3:2:2,2,2,107263,92737
1:6:1,0,-1,107264,92736
3:2:3,1,1,107263,92737
3:2:2,2,2,107261,92739
6:4:2,1,1,107260,92740
3:2:4,1,1,107259,92741
3:6:3,0,-1,107260,92740
4:1:4,0,-1,107261,92739
4:2:3,1,1,107260,92740
6:5:6,0,-1,107261,92739
2:4:4,1,1,107260,92740
4:4:6,0,-1,107261,92739
1:5:6,0,-1,107262,92738
2:6:6,1,1,107261,92739
3:4:5,0,-1,107262,92738
3:4:2,1,1,107261,92739
5:4:2,1,1,107260,92740
1:4:5,0,-1,107261,92739
4:2:2,2,2,107259,92741
5:4:6,0,-1,107260,92740
3:1:5,0,-1,107261,92739
1:2:4,1,1,107260,92740
5:2:3,1,1,107259,92741
5:4:3,0,-1,107260,92740
6:2:1,1,1,107259,92741
3:2:1,1,1,107258,92742
3:1:3,0,-1,107259,92741
3:3:3,0,-1,107260,92740
3:6:6,0,-1,107261,92739
2:1:3,1,1,107260,92740
4:3:1,0,-1,107261,92739
5:2:2,2,2,107259,92741
5:1:2,1,1,107258,92742
4:3:5,0,-1,107259,92741
4:5:6,0,-1,107260,92740
5:1:2,1,1,107259,92741
2:1:3,1,1,107258,92742
5:6:4,0,-1,107259,92741
2:1:6,1,1,107258,92742
5:6:1,0,-1,107259,92741
4:3:1,0,-1,107260,92740
2:3:2,2,2,107258,92742
1:3:6,0,-1,107259,92741
4:2:5,1,1,107258,92742
4:2:2,2,2,107256,92744
4:2:4,1,1,107255,92745
6:6:2,1,1,107254,92746
5:2:3,1,1,107253,92747
5:3:3,0,-1,107254,92746
3:3:4,0,-1,107255,92745
6:5:2,1,1,107254,92746
5:5:1,0,-1,107255,92745
2:5:1,1,1,107254,92746
3:2:4,1,1,107253,92747
5:6:1,0,-1,107254,92746
4:6:6,0,-1,107255,92745
1:6:2,1,1,107254,92746
5:4:3,0,-1,107255,92745
4:1:6,0,-1,107256,92744
5:6:3,0,-1,107257,92743
4:4:6,0,-1,107258,92742
5:3:3,0,-1,107259,92741
5:3:3,0,-1,107260,92740
6:5:3,0,-1,107261,92739
1:5:5,0,-1,107262,92738
1:1:2,1,1,107261,92739
6:5:6,0,-1,107262,92738
1:4:1,0,-1,107263,92737
1:5:2,1,1,107262,92738
4:4:6,0,-1,107263,92737
6:1:2,1,1,107262,92738
2:2:5,2,2,107260,92740
3:4:3,0,-1,107261,92739
1:4:4,0,-1,107262,92738
1:5:6,0,-1,107263,92737
3:4:1,0,-1,107264,92736
6:5:4,0,-1,107265,92735
2:1:3,1,1,107264,92736
2:4:2,2,2,107262,92738
4:6:1,0,-1,107263,92737
4:2:3,1,1,107262,92738
4:4:5,0,-1,107263,92737
3:1:4,0,-1,107264,92736
3:1:6,0,-1,107265,92735
6:6:4,0,-1,107266,92734
1:3:3,0,-1,107267,92733
6:3:4,0,-1,107268,92732
4:6:4,0,-1,107269,92731
3:1:4,0,-1,107270,92730
1:1:4,0,-1,107271,92729
2:1:4,1,1,107270,92730
3:5:5,0,-1,107271,92729
5:3:5,0,-1,107272,92728
1:6:5,0,-1,107273,92727
3:1:2,1,1,107272,92728
3:3:3,0,-1,107273,92727
6:1:6,0,-1,107274,92726
1:1:2,1,1,107273,92727
6:3:1,0,-1,107274,92726
1:3:4,0,-1,107275,92725
5:3:5,0,-1,107276,92724
3:2:2,2,2,107274,92726
6:2:5,1,1,107273,92727
1:2:5,1,1,107272,92728
4:1:5,0,-1,107273,92727
3:5:1,0,-1,107274,92726
6:5:2,1,1,107273,92727
6:2:2,2,2,107271,92729
1:5:2,1,1,107270,92730
6:4:4,0,-1,107271,92729
1:5:5,0,-1,107272,92728
3:1:2,1,1,107271,92729
1:6:1,0,-1,107272,92728
5:6:6,0,-1,107273,92727
6:6:6,0,-1,107274,92726
3:3:2,1,1,107273,92727
6:1:2,1,1,107272,92728
4:2:1,1,1,107271,92729
2:3:2,2,2,107269,92731
1:3:4,0,-1,107270,92730
2:3:5,1,1,107269,92731
2:4:6,1,1,107268,92732
3:4:3,0,-1,107269,92731
2:2:5,2,2,107267,92733
5:2:1,1,1,107266,92734
6:6:6,0,-1,107267,92733
2:1:4,1,1,107266,92734
5:6:6,0,-1,107267,92733
2:1:4,1,1,107266,92734
6:5:6,0,-1,107267,92733
1:4:5,0,-1,107268,92732
2:6:3,1,1,107267,92733
1:4:4,0,-1,107268,92732
4:4:6,0,-1,107269,92731
6:5:5,0,-1,107270,92730
6:1:2,1,1,107269,92731
3:6:1,0,-1,107270,92730
3:2:5,1,1,107269,92731
3:6:4,0,-1,107270,92730
2:1:3,1,1,107269,92731
3:1:5,0,-1,107270,92730
5:6:5,0,-1,107271,92729
5:6:2,1,1,107270,92730
1:2:5,1,1,107269,92731
6:2:4,1,1,107268,92732
4:3:6,0,-1,107269,92731
1:4:2,1,1,107268,92732
6:4:3,0,-1,107269,92731
3:6:3,0,-1,107270,92730
2:5:4,1,1,107269,92731
2:1:6,1,1,107268,92732
3:4:2,1,1,107267,92733
5:2:5,1,1,107266,92734
6:6:2,1,1,107265,92735
4:1:3,0,-1,107266,92734
6:5:3,0,-1,107267,92733
4:6:1,0,-1,107268,92732
2:6:6,1,1,107267,92733
4:5:5,0,-1,107268,92732
4:6:3,0,-1,107269,92731
5:5:3,0,-1,107270,92730
1:6:5,0,-1,107271,92729
2:6:6,1,1,107270,92730
3:2:5,1,1,107269,92731
1:4:3,0,-1,107270,92730
4:5:1,0,-1,107271,92729
6:1:3,0,-1,107272,92728
3:6:6,0,-1,107273,92727
5:4:6,0,-1,107274,92726
6:5:4,0,-1,107275,92725
4:6:2,1,1,107274,92726
4:5:5,0,-1,107275,92725
6:6:6,0,-1,107276,92724
5:3:2,1,1,107275,92725
5:5:3,0,-1,107276,92724
1:5:4,0,-1,107277,92723
2:6:4,1,1,107276,92724
6:3:6,0,-1,107277,92723
4:6:1,0,-1,107278,92722
6:4:5,0,-1,107279,92721
2:5:5,1,1,107278,92722
1:4:4,0,-1,107279,92721
6:4:4,0,-1,107280,92720
6:4:5,0,-1,107281,92719
4:2:1,1,1,107280,92720
5:2:3,1,1,107279,92721
2:2:6,2,2,107277,92723
2:3:3,1,1,107276,92724
2:4:6,1,1,107275,92725
1:1:2,1,1,107274,92726
4:6:3,0,-1,107275,92725
3:6:6,0,-1,107276,92724
6:5:6,0,-1,107277,92723
1:2:1,1,1,107276,92724
4:2:3,1,1,107275,92725
5:3:1,0,-1,107276,92724
4:3:4,0,-1,107277,92723
3:1:2,1,1,107276,92724
6:5:4,0,-1,107277,92723
1:1:2,1,1,107276,92724
4:2:1,1,1,107275,92725
5:4:1,0,-1,107276,92724
5:5:6,0,-1,107277,92723
5:5:3,0,-1,107278,92722
3:5:5,0,-1,107279,92721
6:6:5,0,-1,107280,92720
4:5:4,0,-1,107281,92719
1:4:1,0,-1,107282,92718
4:1:3,0,-1,107283,92717
1:3:2,1,1,107282,92718
2:3:2,2,2,107280,92720
1:1:1,0,-1,107281,92719
1:4:2,1,1,107280,92720
2:6:3,1,1,107279,92721
3:1:4,0,-1,107280,92720
3:6:6,0,-1,107281,92719
3:6:1,0,-1,107282,92718
1:5:6,0,-1,107283,92717
2:6:5,1,1,107282,92718
6:1:3,0,-1,107283,92717
6:3:3,0,-1,107284,92716
4:5:2,1,1,107283,92717
2:2:5,2,2,107281,92719
6:5:3,0,-1,107282,92718
1:1:6,0,-1,107283,92717
2:5:4,1,1,107282,92718
5:1:6,0,-1,107283,92717
6:6:1,0,-1,107284,92716
1:1:2,1,1,107283,92717
4:2:2,2,2,107281,92719
6:3:2,1,1,107280,92720
5:4:2,1,1,107279,92721
5:6:2,1,1,107278,92722
2:4:3,1,1,107277,92723
2:5:3,1,1,107276,92724
2:3:5,1,1,107275,92725
2:2:3,2,2,107273,92727
4:6:4,0,-1,107274,92726
5:2:4,1,1,107273,92727
2:6:3,1,1,107272,92728
2:3:6,1,1,107271,92729
2:1:3,1,1,107270,92730
4:3:1,0,-1,107271,92729
6:4:1,0,-1,107272,92728
2:2:2,3,3,107269,92731
1:5:5,0,-1,107270,92730
4:6:6,0,-1,107271,92729
6:5:3,0,-1,107272,92728
6:5:5,0,-1,107273,92727
4:2:5,1,1,107272,92728
5:6:5,0,-1,107273,92727
6:1:1,0,-1,107274,92726
6:5:1,0,-1,107275,92725
6:2:3,1,1,107274,92726
1:6:5,0,-1,107275,92725
4:6:2,1,1,107274,92726
5:6:5,0,-1,107275,92725
6:1:6,0,-1,107276,92724
3:1:4,0,-1,107277,92723
4:6:3,0,-1,107278,92722
1:3:2,1,1,107277,92723
3:2:5,1,1,107276,92724
4:6:5,0,-1,107277,92723
2:2:5,2,2,107275,92725
3:4:6,0,-1,107276,92724
6:4:2,1,1,107275,92725
2:3:4,1,1,107274,92726
2:6:3,1,1,107273,92727
4:4:6,0,-1,107274,92726
4:5:1,0,-1,107275,92725
6:2:5,1,1,107274,92726
1:2:4,1,1,107273,92727
4:1:6,0,-1,107274,92726
2:5:4,1,1,107273,92727
6:6:4,0,-1,107274,92726
2:2:1,2,2,107272,92728
5:5:2,1,1,107271,92729
5:5:3,0,-1,107272,92728
5:3:4,0,-1,107273,92727
4:2:5,1,1,107272,92728
6:4:3,0,-1,107273,92727
3:5:1,0,-1,107274,92726
4:1:4,0,-1,107275,92725
3:1:5,0,-1,107276,92724
5:4:6,0,-1,107277,92723
3:4:4,0,-1,107278,92722
5:1:3,0,-1,107279,92721
3:2:4,1,1,107278,92722
6:1:5,0,-1,107279,92721
4:2:1,1,1,107278,92722
3:5:3,0,-1,107279,92721
2:1:3,1,1,107278,92722
1:2:2,2,2,107276,92724
6:6:4,0,-1,107277,92723
2:5:3,1,1,107276,92724
6:1:4,0,-1,107277,92723
4:2:5,1,1,107276,92724
4:5:4,0,-1,107277,92723
5:6:6,0,-1,107278,92722
6:3:1,0,-1,107279,92721
5:3:6,0,-1,107280,92720
3:4:1,0,-1,107281,92719
2:2:2,3,3,107278,92722
1:6:1,0,-1,107279,92721
3:4:2,1,1,107278,92722
6:1:1,0,-1,107279,92721
1:4:6,0,-1,107280,92720
2:5:3,1,1,107279,92721
3:4:4,0,-1,107280,92720
1:1:5,0,-1,107281,92719
4:6:6,0,-1,107282,92718
3:1:2,1,1,107281,92719
5:3:4,0,-1,107282,92718
2:4:4,1,1,107281,92719
2:6:1,1,1,107280,92720
1:5:2,1,1,107279,92721
6:1:4,0,-1,107280,92720
3:1:1,0,-1,107281,92719
3:2:1,1,1,107280,92720
4:3:2,1,1,107279,92721
5:2:2,2,2,107277,92723
5:6:2,1,1,107276,92724
6:4:3,0,-1,107277,92723
1:6:4,0,-1,107278,92722
5:6:1,0,-1,107279,92721
6:2:4,1,1,107278,92722
2:1:3,1,1,107277,92723
3:5:6,0,-1,107278,92722
3:5:5,0,-1,107279,92721
2:6:5,1,1,107278,92722
4:4:5,0,-1,107279,92721
1:2:3,1,1,107278,92722
2:4:5,1,1,107277,92723
2:6:3,1,1,107276,92724
6:1:4,0,-1,107277,92723
6:1:5,0,-1,107278,92722
4:2:2,2,2,107276,92724
1:5:2,1,1,107275,92725
4:2:4,1,1,107274,92726
1:5:5,0,-1,107275,92725
5:1:3,0,-1,107276,92724
1:4:4,0,-1,107277,92723
2:3:3,1,1,107276,92724
3:1:1,0,-1,107277,92723
4:4:2,1,1,107276,92724
3:2:4,1,1,107275,92725
2:6:6,1,1,107274,92726
4:6:2,1,1,107273,92727
1:6:2,1,1,107272,92728
5:5:5,0,-1,107273,92727
2:3:5,1,1,107272,92728
3:2:1,1,1,107271,92729
2:4:4,1,1,107270,92730
1:5:4,0,-1,107271,92729
6:1:2,1,1,107270,92730
4:2:3,1,1,107269,92731
1:2:3,1,1,107268,92732
1:2:3,1,1,107267,92733
1:4:4,0,-1,107268,92732
6:5:1,0,-1,107269,92731
5:1:2,1,1,107268,92732
2:4:5,1,1,107267,92733
3:1:5,0,-1,107268,92732
2:6:1,1,1,107267,92733
1:3:6,0,-1,107268,92732
2:4:2,2,2,107266,92734
5:1:2,1,1,107265,92735
3:5:6,0,-1,107266,92734
1:4:6,0,-1,107267,92733
6:1:6,0,-1,107268,92732
6:2:2,2,2,107266,92734
4:4:2,1,1,107265,92735
6:2:2,2,2,107263,92737
3:2:3,1,1,107262,92738
5:3:5,0,-1,107263,92737
4:1:2,1,1,107262,92738
5:5:4,0,-1,107263,92737
4:4:3,0,-1,107264,92736
3:5:6,0,-1,107265,92735
3:1:4,0,-1,107266,92734
4:6:1,0,-1,107267,92733
2:1:6,1,1,107266,92734
6:4:2,1,1,107265,92735
6:6:6,0,-1,107266,92734
5:3:1,0,-1,107267,92733
6:3:5,0,-1,107268,92732
4:6:3,0,-1,107269,92731
3:4:5,0,-1,107270,92730
5:1:6,0,-1,107271,92729
3:2:4,1,1,107270,92730
4:1:1,0,-1,107271,92729
3:4:3,0,-1,107272,92728
2:1:5,1,1,107271,92729
6:3:1,0,-1,107272,92728
4:3:5,0,-1,107273,92727
5:6:3,0,-1,107274,92726
5:3:5,0,-1,107275,92725
5:2:2,2,2,107273,92727
5:4:6,0,-1,107274,92726
1:5:4,0,-1,107275,92725
4:5:6,0,-1,107276,92724
5:6:2,1,1,107275,92725
4:1:1,0,-1,107276,92724
1:5:6,0,-1,107277,92723
6:4:2,1,1,107276,92724
4:3:2,1,1,107275,92725
2:2:4,2,2,107273,92727
4:2:2,2,2,107271,92729
4:3:2,1,1,107270,92730
3:5:4,0,-1,107271,92729
2:1:3,1,1,107270,92730
1:6:2,1,1,107269,92731
2:2:1,2,2,107267,92733
4:4:1,0,-1,107268,92732
1:1:1,0,-1,107269,92731
2:5:1,1,1,107268,92732
3:2:6,1,1,107267,92733
3:6:3,0,-1,107268,92732
1:5:3,0,-1,107269,92731
1:3:3,0,-1,107270,92730
1:6:4,0,-1,107271,92729
4:1:2,1,1,107270,92730
1:1:2,1,1,107269,92731
5:3:5,0,-1,107270,92730
6:3:4,0,-1,107271,92729
4:4:3,0,-1,107272,92728
5:5:3,0,-1,107273,92727
4:4:5,0,-1,107274,92726
5:4:3,0,-1,107275,92725
4:6:1,0,-1,107276,92724
6:3:5,0,-1,107277,92723
2:5:2,2,2,107275,92725
5:5:2,1,1,107274,92726
2:5:3,1,1,107273,92727
3:1:3,0,-1,107274,92726
5:6:6,0,-1,107275,92725
3:1:1,0,-1,107276,92724
4:3:4,0,-1,107277,92723
5:6:4,0,-1,107278,92722
1:5:6,0,-1,107279,92721
2:6:3,1,1,107278,92722
1:2:2,2,2,107276,92724
5:5:5,0,-1,107277,92723
4:4:1,0,-1,107278,92722
4:4:4,0,-1,107279,92721
2:2:4,2,2,107277,92723
4:4:2,1,1,107276,92724
1:5:1,0,-1,107277,92723
6:6:3,0,-1,107278,92722
1:2:1,1,1,107277,92723
3:4:4,0,-1,107278,92722
6:2:5,1,1,107277,92723
5:1:1,0,-1,107278,92722
1:2:1,1,1,107277,92723
4:1:5,0,-1,107278,92722
2:4:6,1,1,107277,92723
3:5:4,0,-1,107278,92722
6:3:2,1,1,107277,92723
4:2:3,1,1,107276,92724
5:6:4,0,-1,107277,92723
2:2:6,2,2,107275,92725
4:3:6,0,-1,107276,92724
3:1:5,0,-1,107277,92723
6:2:1,1,1,107276,92724
6:6:6,0,-1,107277,92723
2:6:5,1,1,107276,92724
5:3:4,0,-1,107277,92723
3:4:1,0,-1,107278,92722
2:3:3,1,1,107277,92723
2:2:3,2,2,107275,92725
4:5:3,0,-1,107276,92724
1:1:5,0,-1,107277,92723
3:6:1,0,-1,107278,92722
5:6:5,0,-1,107279,92721
6:4:6,0,-1,107280,92720
2:1:5,1,1,107279,92721
5:6:3,0,-1,107280,92720
4:3:2,1,1,107279,92721
4:2:3,1,1,107278,92722
4:4:4,0,-1,107279,92721
6:3:4,0,-1,107280,92720
3:1:2,1,1,107279,92721
2:4:3,1,1,107278,92722
4:6:3,0,-1,107279,92721
1:6:5,0,-1,107280,92720
5:3:4,0,-1,107281,92719
5:2:1,1,1,107280,92720
6:4:6,0,-1,107281,92719
6:4:5,0,-1,107282,92718
3:1:3,0,-1,107283,92717
3:5:5,0,-1,107284,92716
6:4:2,1,1,107283,92717
4:4:4,0,-1,107284,92716
2:3:2,2,2,107282,92718
1:3:3,0,-1,107283,92717
5:2:6,1,1,107282,92718
1:5:5,0,-1,107283,92717
2:1:1,1,1,107282,92718
1:1:3,0,-1,107283,92717
4:2:2,2,2,107281,92719
4:4:2,1,1,107280,92720
1:2:5,1,1,107279,92721
5:2:5,1,1,107278,92722
4:2:5,1,1,107277,92723
6:5:3,0,-1,107278,92722
5:4:1,0,-1,107279,92721
1:4:4,0,-1,107280,92720
1:4:1,0,-1,107281,92719
2:2:3,2,2,107279,92721
5:5:6,0,-1,107280,92720
2:2:4,2,2,107278,92722
1:6:6,0,-1,107279,92721
1:5:5,0,-1,107280,92720
4:4:3,0,-1,107281,92719
1:4:4,0,-1,107282,92718
2:5:4,1,1,107281,92719
2:4:5,1,1,107280,92720
4:3:1,0,-1,107281,92719
6:1:3,0,-1,107282,92718
1:1:4,0,-1,107283,92717
4:5:6,0,-1,107284,92716
2:3:5,1,1,107283,92717
1:4:5,0,-1,107284,92716
3:6:1,0,-1,107285,92715
5:4:6,0,-1,107286,92714
2:3:5,1,1,107285,92715
2:4:2,2,2,107283,92717
4:1:4,0,-1,107284,92716
2:4:6,1,1,107283,92717
4:6:4,0,-1,107284,92716
1:6:5,0,-1,107285,92715
5:6:3,0,-1,107286,92714
2:2:1,2,2,107284,92716
5:5:1,0,-1,107285,92715
4:2:6,1,1,107284,92716
5:5:2,1,1,107283,92717
5:6:1,0,-1,107284,92716
5:6:5,0,-1,107285,92715
4:5:6,0,-1,107286,92714
3:4:4,0,-1,107287,92713
4:6:3,0,-1,107288,92712
4:6:1,0,-1,107289,92711
3:4:1,0,-1,107290,92710
2:3:4,1,1,107289,92711
6:2:2,2,2,107287,92713
4:1:2,1,1,107286,92714
2:5:4,1,1,107285,92715
3:6:6,0,-1,107286,92714
5:5:2,1,1,107285,92715
3:4:4,0,-1,107286,92714
6:1:4,0,-1,107287,92713
5:3:3,0,-1,107288,92712
5:3:5,0,-1,107289,92711
2:3:3,1,1,107288,92712
4:4:1,0,-1,107289,92711
3:1:4,0,-1,107290,92710
5:1:2,1,1,107289,92711
2:6:3,1,1,107288,92712
2:6:4,1,1,107287,92713
5:4:4,0,-1,107288,92712
3:4:2,1,1,107287,92713
1:5:4,0,-1,107288,92712
6:1:6,0,-1,107289,92711
5:3:4,0,-1,107290,92710
4:3:2,1,1,107289,92711
3:2:1,1,1,107288,92712
5:3:6,0,-1,107289,92711
2:1:2,2,2,107287,92713
6:4:6,0,-1,107288,92712
3:5:6,0,-1,107289,92711
2:4:5,1,1,107288,92712
6:4:5,0,-1,107289,92711
1:3:6,0,-1,107290,92710
6:2:1,1,1,107289,92711
4:6:3,0,-1,107290,92710
3:6:3,0,-1,107291,92709
2:6:4,1,1,107290,92710
2:2:3,2,2,107288,92712
2:5:4,1,1,107287,92713
4:1:1,0,-1,107288,92712
6:6:1,0,-1,107289,92711
3:2:3,1,1,107288,92712
3:2:5,1,1,107287,92713
3:2:2,2,2,107285,92715
6:3:6,0,-1,107286,92714
5:1:6,0,-1,107287,92713
6:1:3,0,-1,107288,92712
2:5:5,1,1,107287,92713
6:3:4,0,-1,107288,92712
3:1:1,0,-1,107289,92711
1:2:6,1,1,107288,92712
5:2:6,1,1,107287,92713
4:2:4,1,1,107286,92714
3:3:2,1,1,107285,92715
2:2:3,2,2,107283,92717
1:2:2,2,2,107281,92719
5:4:5,0,-1,107282,92718
6:5:1,0,-1,107283,92717
5:4:3,0,-1,107284,92716
4:5:2,1,1,107283,92717
3:5:4,0,-1,107284,92716
6:5:5,0,-1,107285,92715
5:4:2,1,1,107284,92716
3:6:1,0,-1,107285,92715
5:3:5,0,-1,107286,92714
5:5:4,0,-1,107287,92713
2:1:1,1,1,107286,92714
3:1:5,0,-1,107287,92713
5:1:1,0,-1,107288,92712
6:5:6,0,-1,107289,92711
2:3:4,1,1,107288,92712
1:3:2,1,1,107287,92713
3:4:6,0,-1,107288,92712
6:5:6,0,-1,107289,92711
3:6:3,0,-1,107290,92710
4:3:6,0,-1,107291,92709
3:1:1,0,-1,107292,92708
5:5:4,0,-1,107293,92707
5:2:4,1,1,107292,92708
1:3:3,0,-1,107293,92707
4:5:3,0,-1,107294,92706
2:2:3,2,2,107292,92708
2:6:2,2,2,107290,92710
4:4:4,0,-1,107291,92709
2:1:2,2,2,107289,92711
3:3:1,0,-1,107290,92710
6:5:1,0,-1,107291,92709
1:3:3,0,-1,107292,92708
5:2:4,1,1,107291,92709
4:6:3,0,-1,107292,92708
6:3:6,0,-1,107293,92707
4:3:2,1,1,107292,92708
1:4:2,1,1,107291,92709
1:4:6,0,-1,107292,92708
2:4:1,1,1,107291,92709
4:3:6,0,-1,107292,92708
5:1:6,0,-1,107293,92707
1:3:4,0,-1,107294,92706
1:1:4,0,-1,107295,92705
1:3:4,0,-1,107296,92704
6:4:2,1,1,107295,92705
6:3:6,0,-1,107296,92704
4:3:2,1,1,107295,92705
6:5:2,1,1,107294,92706
4:4:5,0,-1,107295,92705
4:1:3,0,-1,107296,92704
1:5:6,0,-1,107297,92703
5:4:5,0,-1,107298,92702
2:3:3,1,1,107297,92703
5:4:4,0,-1,107298,92702
4:6:5,0,-1,107299,92701
1:4:2,1,1,107298,92702
4:2:1,1,1,107297,92703
3:1:4,0,-1,107298,92702
2:3:1,1,1,107297,92703
1:4:6,0,-1,107298,92702
3:2:5,1,1,107297,92703
3:6:2,1,1,107296,92704
5:3:3,0,-1,107297,92703
1:3:2,1,1,107296,92704
1:5:1,0,-1,107297,92703
4:4:2,1,1,107296,92704
1:1:5,0,-1,107297,92703
5:3:6,0,-1,107298,92702
3:4:4,0,-1,107299,92701
1:1:4,0,-1,107300,92700
2:1:5,1,1,107299,92701
2:6:2,2,2,107297,92703
4:2:1,1,1,107296,92704
6:6:5,0,-1,107297,92703
4:4:1,0,-1,107298,92702
3:1:4,0,-1,107299,92701
1:2:6,1,1,107298,92702
5:3:1,0,-1,107299,92701
2:6:1,1,1,107298,92702
4:6:5,0,-1,107299,92701
1:3:3,0,-1,107300,92700
1:3:4,0,-1,107301,92699
6:3:2,1,1,107300,92700
6:6:1,0,-1,107301,92699
2:4:3,1,1,107300,92700
5:3:5,0,-1,107301,92699
5:6:2,1,1,107300,92700
1:6:6,0,-1,107301,92699
4:2:3,1,1,107300,92700
2:4:4,1,1,107299,92701
6:5:3,0,-1,107300,92700
3:6:4,0,-1,107301,92699
3:5:4,0,-1,107302,92698
1:4:1,0,-1,107303,92697
3:1:2,1,1,107302,92698
5:3:5,0,-1,107303,92697
3:6:1,0,-1,107304,92696
1:2:3,1,1,107303,92697
5:3:2,1,1,107302,92698
3:3:4,0,-1,107303,92697
1:1:1,0,-1,107304,92696
3:2:4,1,1,107303,92697
5:1:2,1,1,107302,92698
3:5:2,1,1,107301,92699
6:4:5,0,-1,107302,92698
4:2:1,1,1,107301,92699
6:1:3,0,-1,107302,92698
6:3:1,0,-1,107303,92697
4:5:3,0,-1,107304,92696
2:1:6,1,1,107303,92697
3:1:6,0,-1,107304,92696
1:6:5,0,-1,107305,92695
4:3:5,0,-1,107306,92694
5:2:3,1,1,107305,92695
3:2:5,1,1,107304,92696
5:3:5,0,-1,107305,92695
2:1:6,1,1,107304,92696
4:2:6,1,1,107303,92697
1:4:2,1,1,107302,92698
6:6:6,0,-1,107303,92697
3:5:1,0,-1,107304,92696
3:5:3,0,-1,107305,92695
5:4:4,0,-1,107306,92694
6:4:6,0,-1,107307,92693
4:6:2,1,1,107306,92694
4:1:4,0,-1,107307,92693
5:1:1,0,-1,107308,92692
4:3:3,0,-1,107309,92691
2:2:2,3,3,107306,92694
3:4:1,0,-1,107307,92693
1:2:2,2,2,107305,92695
6:5:2,1,1,107304,92696
3:5:5,0,-1,107305,92695
4:3:3,0,-1,107306,92694
6:2:6,1,1,107305,92695
4:1:1,0,-1,107306,92694
3:2:2,2,2,107304,92696
4:6:4,0,-1,107305,92695
3:6:1,0,-1,107306,92694
6:2:2,2,2,107304,92696
5:5:1,0,-1,107305,92695
4:2:3,1,1,107304,92696
2:6:3,1,1,107303,92697
3:5:6,0,-1,107304,92696
4:6:2,1,1,107303,92697
1:5:4,0,-1,107304,92696
4:2:4,1,1,107303,92697
5:2:4,1,1,107302,92698
6:5:6,0,-1,107303,92697
2:5:3,1,1,107302,92698
2:1:5,1,1,107301,92699
5:6:4,0,-1,107302,92698
1:6:3,0,-1,107303,92697
4:4:4,0,-1,107304,92696
6:2:1,1,1,107303,92697
6:6:2,1,1,107302,92698
2:3:3,1,1,107301,92699
6:2:1,1,1,107300,92700
2:6:1,1,1,107299,92701
6:3:1,0,-1,107300,92700
5:6:1,0,-1,107301,92699
2:4:5,1,1,107300,92700
2:5:3,1,1,107299,92701
4:6:6,0,-1,107300,92700
4:2:3,1,1,107299,92701
4:3:2,1,1,107298,92702
4:3:3,0,-1,107299,92701
2:1:3,1,1,107298,92702
6:4:4,0,-1,107299,92701
3:5:2,1,1,107298,92702
1:5:1,0,-1,107299,92701
1:1:2,1,1,107298,92702
3:5:6,0,-1,107299,92701
3:1:4,0,-1,107300,92700
5:5:2,1,1,107299,92701
1:1:6,0,-1,107300,92700
3:5:2,1,1,107299,92701
1:6:2,1,1,107298,92702
3:5:6,0,-1,107299,92701
5:3:3,0,-1,107300,92700
5:4:5,0,-1,107301,92699
5:3:3,0,-1,107302,92698
1:6:5,0,-1,107303,92697
2:1:2,2,2,107301,92699
2:3:5,1,1,107300,92700
4:1:4,0,-1,107301,92699
2:1:6,1,1,107300,92700
1:2:1,1,1,107299,92701
6:4:1,0,-1,107300,92700
3:5:4,0,-1,107301,92699
4:5:4,0,-1,107302,92698
4:1:5,0,-1,107303,92697
4:5:5,0,-1,107304,92696
3:2:1,1,1,107303,92697
6:5:3,0,-1,107304,92696
3:1:4,0,-1,107305,92695
6:6:6,0,-1,107306,92694
6:4:6,0,-1,107307,92693
4:3:3,0,-1,107308,92692
4:4:5,0,-1,107309,92691
5:2:4,1,1,107308,92692
1:3:1,0,-1,107309,92691
4:4:1,0,-1,107310,92690
2:4:3,1,1,107309,92691
6:2:1,1,1,107308,92692
1:3:1,0,-1,107309,92691
6:4:2,1,1,107308,92692
6:5:4,0,-1,107309,92691
1:6:4,0,-1,107310,92690
2:6:6,1,1,107309,92691
3:6:3,0,-1,107310,92690
5:2:3,1,1,107309,92691
3:1:3,0,-1,107310,92690
6:6:3,0,-1,107311,92689
2:4:5,1,1,107310,92690
1:4:6,0,-1,107311,92689
4:4:5,0,-1,107312,92688
2:5:5,1,1,107311,92689
1:6:3,0,-1,107312,92688
5:5:6,0,-1,107313,92687
4:6:1,0,-1,107314,92686
1:5:6,0,-1,107315,92685
4:4:1,0,-1,107316,92684
2:3:3,1,1,107315,92685
3:2:2,2,2,107313,92687
5:5:5,0,-1,107314,92686
5:6:4,0,-1,107315,92685
3:6:2,1,1,107314,92686
6:4:4,0,-1,107315,92685
5:6:2,1,1,107314,92686
6:4:2,1,1,107313,92687
4:4:1,0,-1,107314,92686
6:3:1,0,-1,107315,92685
3:6:3,0,-1,107316,92684
3:3:6,0,-1,107317,92683
4:4:3,0,-1,107318,92682
1:6:6,0,-1,107319,92681
3:4:6,0,-1,107320,92680
2:3:4,1,1,107319,92681
5:5:2,1,1,107318,92682
4:4:1,0,-1,107319,92681
1:2:4,1,1,107318,92682
6:1:2,1,1,107317,92683
3:6:5,0,-1,107318,92682
4:2:4,1,1,107317,92683
3:5:1,0,-1,107318,92682
4:5:2,1,1,107317,92683
6:6:5,0,-1,107318,92682
1:5:4,0,-1,107319,92681
2:1:3,1,1,107318,92682
5:4:3,0,-1,107319,92681
6:1:6,0,-1,107320,92680
3:3:2,1,1,107319,92681
4:1:2,1,1,107318,92682
5:6:4,0,-1,107319,92681
6:1:5,0,-1,107320,92680
5:4:4,0,-1,107321,92679
5:4:6,0,-1,107322,92678
1:1:1,0,-1,107323,92677
6:6:5,0,-1,107324,92676
1:2:5,1,1,107323,92677
3:5:5,0,-1,107324,92676
3:6:4,0,-1,107325,92675
5:6:5,0,-1,107326,92674
6:1:1,0,-1,107327,92673
4:6:4,0,-1,107328,92672
5:5:5,0,-1,107329,92671
3:1:2,1,1,107328,92672
4:6:6,0,-1,107329,92671
6:6:3,0,-1,107330,92670
4:3:2,1,1,107329,92671
4:6:2,1,1,107328,92672
2:2:4,2,2,107326,92674
5:4:5,0,-1,107327,92673
1:4:6,0,-1,107328,92672
3:5:1,0,-1,107329,92671
6:1:4,0,-1,107330,92670
6:6:3,0,-1,107331,92669
2:6:1,1,1,107330,92670
6:2:5,1,1,107329,92671
5:2:2,2,2,107327,92673
2:6:6,1,1,107326,92674
2:3:5,1,1,107325,92675
2:3:1,1,1,107324,92676
4:2:1,1,1,107323,92677
6:4:4,0,-1,107324,92676
2:2:2,3,3,107321,92679
6:2:1,1,1,107320,92680
6:4:5,0,-1,107321,92679
3:4:4,0,-1,107322,92678
3:3:1,0,-1,107323,92677
2:5:6,1,1,107322,92678
3:3:4,0,-1,107323,92677
3:5:3,0,-1,107324,92676
1:2:6,1,1,107323,92677
6:4:5,0,-1,107324,92676
6:4:3,0,-1,107325,92675
5:1:4,0,-1,107326,92674
5:3:5,0,-1,107327,92673
3:2:1,1,1,107326,92674
6:2:6,1,1,107325,92675
1:2:6,1,1,107324,92676
6:1:6,0,-1,107325,92675
6:6:5,0,-1,107326,92674
1:5:3,0,-1,107327,92673
2:3:2,2,2,107325,92675
4:3:1,0,-1,107326,92674
2:4:6,1,1,107325,92675
3:2:5,1,1,107324,92676
5:3:2,1,1,107323,92677
1:4:4,0,-1,107324,92676
3:5:3,0,-1,107325,92675
5:5:4,0,-1,107326,92674
2:4:4,1,1,107325,92675
4:2:5,1,1,107324,92676
4:6:3,0,-1,107325,92675
3:1:5,0,-1,107326,92674
2:4:3,1,1,107325,92675
5:6:4,0,-1,107326,92674
4:4:5,0,-1,107327,92673
4:5:4,0,-1,107328,92672
6:1:3,0,-1,107329,92671
3:4:3,0,-1,107330,92670
4:1:4,0,-1,107331,92669
4:3:6,0,-1,107332,92668
2:1:2,2,2,107330,92670
3:4:5,0,-1,107331,92669
1:2:4,1,1,107330,92670
3:2:3,1,1,107329,92671
4:3:4,0,-1,107330,92670
6:2:1,1,1,107329,92671
1:4:4,0,-1,107330,92670
3:2:4,1,1,107329,92671
3:6:5,0,-1,107330,92670
1:3:6,0,-1,107331,92669
2:4:6,1,1,107330,92670
2:1:6,1,1,107329,92671
4:3:2,1,1,107328,92672
4:4:4,0,-1,107329,92671
6:6:2,1,1,107328,92672
4:3:2,1,1,107327,92673
6:5:2,1,1,107326,92674
2:5:6,1,1,107325,92675
5:6:4,0,-1,107326,92674
1:1:6,0,-1,107327,92673
4:6:2,1,1,107326,92674
6:4:6,0,-1,107327,92673
4:6:1,0,-1,107328,92672
3:6:6,0,-1,107329,92671
4:5:1,0,-1,107330,92670
2:6:3,1,1,107329,92671
6:1:2,1,1,107328,92672
4:6:3,0,-1,107329,92671
1:1:2,1,1,107328,92672
1:5:4,0,-1,107329,92671
5:2:1,1,1,107328,92672
6:3:6,0,-1,107329,92671
5:1:1,0,-1,107330,92670
5:3:6,0,-1,107331,92669
6:2:6,1,1,107330,92670
4:5:4,0,-1,107331,92669
5:4:3,0,-1,107332,92668
1:4:5,0,-1,107333,92667
2:4:3,1,1,107332,92668
4:3:1,0,-1,107333,92667
6:2:2,2,2,107331,92669
1:6:2,1,1,107330,92670
6:5:1,0,-1,107331,92669
3:4:2,1,1,107330,92670
1:1:5,0,-1,107331,92669
6:3:3,0,-1,107332,92668
4:1:6,0,-1,107333,92667
6:2:2,2,2,107331,92669
2:1:2,2,2,107329,92671
5:6:3,0,-1,107330,92670
6:4:5,0,-1,107331,92669
3:1:1,0,-1,107332,92668
6:1:6,0,-1,107333,92667
3:6:2,1,1,107332,92668
6:3:6,0,-1,107333,92667
4:2:3,1,1,107332,92668
3:2:4,1,1,107331,92669
3:2:3,1,1,107330,92670
1:3:1,0,-1,107331,92669
5:4:1,0,-1,107332,92668
2:5:2,2,2,107330,92670
3:3:5,0,-1,107331,92669
1:6:4,0,-1,107332,92668
1:2:6,1,1,107331,92669
4:2:6,1,1,107330,92670
6:6:5,0,-1,107331,92669
3:1:4,0,-1,107332,92668
2:1:3,1,1,107331,92669
5:4:5,0,-1,107332,92668
4:3:6,0,-1,107333,92667
2:4:5,1,1,107332,92668
5:5:2,1,1,107331,92669
1:5:5,0,-1,107332,92668
4:2:5,1,1,107331,92669
4:2:4,1,1,107330,92670
5:5:6,0,-1,107331,92669
2:5:2,2,2,107329,92671
2:5:1,1,1,107328,92672
1:4:2,1,1,107327,92673
6:1:2,1,1,107326,92674
6:4:5,0,-1,107327,92673
5:4:5,0,-1,107328,92672
5:3:2,1,1,107327,92673
1:4:6,0,-1,107328,92672
2:2:4,2,2,107326,92674
6:6:1,0,-1,107327,92673
4:2:6,1,1,107326,92674
6:6:3,0,-1,107327,92673
3:4:6,0,-1,107328,92672
6:6:5,0,-1,107329,92671
5:1:2,1,1,107328,92672
1:6:3,0,-1,107329,92671
2:5:5,1,1,107328,92672
6:2:3,1,1,107327,92673
6:6:2,1,1,107326,92674
3:6:4,0,-1,107327,92673
2:6:5,1,1,107326,92674
4:2:3,1,1,107325,92675
4:4:4,0,-1,107326,92674
3:2:1,1,1,107325,92675
6:3:5,0,-1,107326,92674
1:3:4,0,-1,107327,92673
3:6:3,0,-1,107328,92672
1:1:2,1,1,107327,92673
5:4:3,0,-1,107328,92672
6:3:1,0,-1,107329,92671
5:5:1,0,-1,107330,92670
6:4:1,0,-1,107331,92669
3:5:1,0,-1,107332,92668
3:4:5,0,-1,107333,92667
5:5:2,1,1,107332,92668
6:6:3,0,-1,107333,92667
2:5:5,1,1,107332,92668
4:1:1,0,-1,107333,92667
6:3:4,0,-1,107334,92666
2:2:2,3,3,107331,92669
3:5:6,0,-1,107332,92668
2:3:3,1,1,107331,92669
2:2:6,2,2,107329,92671
1:1:1,0,-1,107330,92670
4:1:5,0,-1,107331,92669
3:6:3,0,-1,107332,92668
4:5:1,0,-1,107333,92667
5:2:2,2,2,107331,92669
1:3:3,0,-1,107332,92668
1:4:6,0,-1,107333,92667
1:2:6,1,1,107332,92668
1:3:1,0,-1,107333,92667
4:6:1,0,-1,107334,92666
3:4:2,1,1,107333,92667
1:1:5,0,-1,107334,92666
2:6:1,1,1,107333,92667
1:4:5,0,-1,107334,92666
3:1:6,0,-1,107335,92665
3:5:4,0,-1,107336,92664
3:2:2,2,2,107334,92666
6:4:3,0,-1,107335,92665
3:6:4,0,-1,107336,92664
3:4:6,0,-1,107337,92663
1:4:4,0,-1,107338,92662
6:5:2,1,1,107337,92663
3:5:2,1,1,107336,92664
3:2:5,1,1,107335,92665
1:4:1,0,-1,107336,92664
6:1:5,0,-1,107337,92663
2:4:1,1,1,107336,92664
5:4:3,0,-1,107337,92663
4:5:2,1,1,107336,92664
1:3:1,0,-1,107337,92663
2:5:1,1,1,107336,92664
4:6:4,0,-1,107337,92663
3:3:2,1,1,107336,92664
1:5:5,0,-1,107337,92663
6:6:2,1,1,107336,92664
4:5:3,0,-1,107337,92663
3:2:1,1,1,107336,92664
2:3:2,2,2,107334,92666
4:1:1,0,-1,107335,92665
3:1:2,1,1,107334,92666
3:2:1,1,1,107333,92667
5:6:1,0,-1,107334,92666
5:6:3,0,-1,107335,92665
3:5:4,0,-1,107336,92664
4:4:2,1,1,107335,92665
5:1:6,0,-1,107336,92664
2:1:3,1,1,107335,92665
4:2:3,1,1,107334,92666
6:5:4,0,-1,107335,92665
3:3:2,1,1,107334,92666
2:2:3,2,2,107332,92668
1:6:2,1,1,107331,92669
6:1:5,0,-1,107332,92668
4:3:4,0,-1,107333,92667
5:5:5,0,-1,107334,92666
4:2:3,1,1,107333,92667
4:2:6,1,1,107332,92668
4:4:5,0,-1,107333,92667
4:6:3,0,-1,107334,92666
6:4:3,0,-1,107335,92665
1:3:1,0,-1,107336,92664
5:5:2,1,1,107335,92665
3:6:1,0,-1,107336,92664
4:5:3,0,-1,107337,92663
4:2:5,1,1,107336,92664
2:2:3,2,2,107334,92666
3:3:5,0,-1,107335,92665
6:5:4,0,-1,107336,92664
2:4:3,1,1,107335,92665
1:4:6,0,-1,107336,92664
4:4:2,1,1,107335,92665
2:6:6,1,1,107334,92666
3:3:3,0,-1,107335,92665
6:5:5,0,-1,107336,92664
1:6:6,0,-1,107337,92663
4:1:4,0,-1,107338,92662
4:1:6,0,-1,107339,92661
2:3:5,1,1,107338,92662
5:4:3,0,-1,107339,92661
6:1:5,0,-1,107340,92660
2:5:2,2,2,107338,92662
1:6:2,1,1,107337,92663
6:3:5,0,-1,107338,92662
5:3:3,0,-1,107339,92661
4:1:6,0,-1,107340,92660
5:5:6,0,-1,107341,92659
2:1:6,1,1,107340,92660
3:1:5,0,-1,107341,92659
5:2:4,1,1,107340,92660
4:2:5,1,1,107339,92661
4:4:2,1,1,107338,92662
5:6:5,0,-1,107339,92661
3:3:4,0,-1,107340,92660
6:3:1,0,-1,107341,92659
6:1:4,0,-1,107342,92658
2:2:5,2,2,107340,92660
3:4:1,0,-1,107341,92659
6:3:6,0,-1,107342,92658
5:6:4,0,-1,107343,92657
5:3:2,1,1,107342,92658
4:2:3,1,1,107341,92659
1:1:4,0,-1,107342,92658
3:6:2,1,1,107341,92659
5:6:4,0,-1,107342,92658
1:4:1,0,-1,107343,92657
5:1:4,0,-1,107344,92656
3:5:5,0,-1,107345,92655
1:5:4,0,-1,107346,92654
6:4:6,0,-1,107347,92653
5:1:1,0,-1,107348,92652
4:1:1,0,-1,107349,92651
4:2:3,1,1,107348,92652
4:4:1,0,-1,107349,92651
4:1:1,0,-1,107350,92650
4:3:5,0,-1,107351,92649
4:2:5,1,1,107350,92650
3:1:5,0,-1,107351,92649
2:6:6,1,1,107350,92650
2:2:4,2,2,107348,92652
3:5:4,0,-1,107349,92651
1:1:2,1,1,107348,92652
1:4:6,0,-1,107349,92651
5:3:4,0,-1,107350,92650
5:5:3,0,-1,107351,92649
1:3:1,0,-1,107352,92648
2:3:4,1,1,107351,92649
4:4:3,0,-1,107352,92648
6:2:1,1,1,107351,92649
2:2:4,2,2,107349,92651
2:1:1,1,1,107348,92652
4:5:2,1,1,107347,92653
2:3:1,1,1,107346,92654
4:3:5,0,-1,107347,92653
1:1:5,0,-1,107348,92652
2:2:2,3,3,107345,92655
5:1:4,0,-1,107346,92654
5:2:4,1,1,107345,92655
4:1:5,0,-1,107346,92654
1:6:2,1,1,107345,92655
2:4:1,1,1,107344,92656
3:2:3,1,1,107343,92657
2:3:1,1,1,107342,92658
2:2:6,2,2,107340,92660
2:1:6,1,1,107339,92661
2:5:1,1,1,107338,92662
3:6:2,1,1,107337,92663
1:6:6,0,-1,107338,92662
3:6:3,0,-1,107339,92661
4:3:3,0,-1,107340,92660
3:2:4,1,1,107339,92661
5:2:4,1,1,107338,92662
4:4:4,0,-1,107339,92661
2:3:5,1,1,107338,92662
5:4:2,1,1,107337,92663
3:5:3,0,-1,107338,92662
6:4:2,1,1,107337,92663
5:5:1,0,-1,107338,92662
5:1:1,0,-1,107339,92661
1:4:4,0,-1,107340,92660
1:2:2,2,2,107338,92662
6:2:2,2,2,107336,92664
4:2:4,1,1,107335,92665
3:1:2,1,1,107334,92666
6:4:2,1,1,107333,92667
1:5:5,0,-1,107334,92666
4:3:1,0,-1,107335,92665
6:3:2,1,1,107334,92666
4:4:4,0,-1,107335,92665
3:4:2,1,1,107334,92666
4:5:1,0,-1,107335,92665
2:5:4,1,1,107334,92666
1:4:2,1,1,107333,92667
1:1:4,0,-1,107334,92666
2:1:3,1,1,107333,92667
4:3:3,0,-1,107334,92666
5:2:1,1,1,107333,92667
1:2:5,1,1,107332,92668
4:1:6,0,-1,107333,92667
2:2:5,2,2,107331,92669
6:6:4,0,-1,107332,92668
4:1:6,0,-1,107333,92667
4:1:4,0,-1,107334,92666
4:4:4,0,-1,107335,92665
3:5:4,0,-1,107336,92664
3:3:6,0,-1,107337,92663
4:4:2,1,1,107336,92664
6:5:3,0,-1,107337,92663
3:6:5,0,-1,107338,92662
3:1:4,0,-1,107339,92661
2:3:3,1,1,107338,92662
5:2:6,1,1,107337,92663
6:1:1,0,-1,107338,92662
1:5:4,0,-1,107339,92661
5:3:2,1,1,107338,92662
2:6:2,2,2,107336,92664
6:3:5,0,-1,107337,92663
2:1:3,1,1,107336,92664
6:5:2,1,1,107335,92665
3:2:1,1,1,107334,92666
1:2:3,1,1,107333,92667
1:3:3,0,-1,107334,92666
1:6:4,0,-1,107335,92665
6:3:5,0,-1,107336,92664
6:1:6,0,-1,107337,92663
2:5:3,1,1,107336,92664
5:1:4,0,-1,107337,92663
2:1:4,1,1,107336,92664
4:3:5,0,-1,107337,92663
3:3:2,1,1,107336,92664
3:2:4,1,1,107335,92665
6:4:6,0,-1,107336,92664
3:6:3,0,-1,107337,92663
6:3:1,0,-1,107338,92662
5:6:4,0,-1,107339,92661
5:3:3,0,-1,107340,92660
3:3:2,1,1,107339,92661
4:3:3,0,-1,107340,92660
2:1:5,1,1,107339,92661
2:1:1,1,1,107338,92662
3:5:3,0,-1,107339,92661
5:3:6,0,-1,107340,92660
2:4:1,1,1,107339,92661
4:3:6,0,-1,107340,92660
4:1:5,0,-1,107341,92659
5:6:1,0,-1,107342,92658
1:4:1,0,-1,107343,92657
6:3:6,0,-1,107344,92656
4:6:6,0,-1,107345,92655
3:1:6,0,-1,107346,92654
6:5:1,0,-1,107347,92653
6:5:2,1,1,107346,92654
3:6:5,0,-1,107347,92653
6:4:3,0,-1,107348,92652
2:5:3,1,1,107347,92653
3:3:6,0,-1,107348,92652
1:3:4,0,-1,107349,92651
1:2:5,1,1,107348,92652
6:3:3,0,-1,107349,92651
1:4:3,0,-1,107350,92650
2:2:3,2,2,107348,92652
5:3:5,0,-1,107349,92651
5:6:2,1,1,107348,92652
1:2:5,1,1,107347,92653
4:1:3,0,-1,107348,92652
1:4:1,0,-1,107349,92651
6:4:6,0,-1,107350,92650
4:3:6,0,-1,107351,92649
6:6:1,0,-1,107352,92648
2:2:2,3,3,107349,92651
2:1:1,1,1,107348,92652
3:4:1,0,-1,107349,92651
4:2:4,1,1,107348,92652
1:2:2,2,2,107346,92654
5:6:4,0,-1,107347,92653
1:2:5,1,1,107346,92654
4:5:5,0,-1,107347,92653
2:5:2,2,2,107345,92655
1:1:4,0,-1,107346,92654
1:4:2,1,1,107345,92655
1:2:6,1,1,107344,92656
3:1:2,1,1,107343,92657
4:4:3,0,-1,107344,92656
2:2:2,3,3,107341,92659
1:2:1,1,1,107340,92660
6:2:2,2,2,107338,92662
2:2:3,2,2,107336,92664
6:2:6,1,1,107335,92665
1:5:3,0,-1,107336,92664
3:3:1,0,-1,107337,92663
4:5:4,0,-1,107338,92662
2:6:1,1,1,107337,92663
6:1:6,0,-1,107338,92662
4:4:5,0,-1,107339,92661
2:2:4,2,2,107337,92663
5:6:1,0,-1,107338,92662
5:5:6,0,-1,107339,92661
3:3:4,0,-1,107340,92660
6:4:2,1,1,107339,92661
2:3:3,1,1,107338,92662
5:5:2,1,1,107337,92663
3:2:2,2,2,107335,92665
3:3:3,0,-1,107336,92664
3:6:1,0,-1,107337,92663
5:6:2,1,1,107336,92664
6:2:6,1,1,107335,92665
6:3:1,0,-1,107336,92664
6:1:1,0,-1,107337,92663
2:3:4,1,1,107336,92664
3:6:3,0,-1,107337,92663
3:2:2,2,2,107335,92665
3:4:3,0,-1,107336,92664
5:6:4,0,-1,107337,92663
1:2:4,1,1,107336,92664
3:2:6,1,1,107335,92665
6:5:4,0,-1,107336,92664
4:4:1,0,-1,107337,92663
1:3:4,0,-1,107338,92662
4:4:6,0,-1,107339,92661
5:3:4,0,-1,107340,92660
3:6:6,0,-1,107341,92659
1:1:6,0,-1,107342,92658
3:6:2,1,1,107341,92659
2:6:4,1,1,107340,92660
6:2:1,1,1,107339,92661
4:6:6,0,-1,107340,92660
3:5:2,1,1,107339,92661
3:1:2,1,1,107338,92662
6:6:4,0,-1,107339,92661
1:5:3,0,-1,107340,92660
1:4:5,0,-1,107341,92659
2:4:4,1,1,107340,92660
4:5:3,0,-1,107341,92659
6:5:3,0,-1,107342,92658
4:3:5,0,-1,107343,92657
6:1:5,0,-1,107344,92656
4:6:1,0,-1,107345,92655
6:3:1,0,-1,107346,92654
2:6:5,1,1,107345,92655
1:1:4,0,-1,107346,92654
1:4:6,0,-1,107347,92653
2:5:2,2,2,107345,92655
1:1:3,0,-1,107346,92654
6:2:5,1,1,107345,92655
3:3:1,0,-1,107346,92654
1:1:1,0,-1,107347,92653
3:6:3,0,-1,107348,92652
5:2:4,1,1,107347,92653
4:1:5,0,-1,107348,92652
5:5:2,1,1,107347,92653
5:6:3,0,-1,107348,92652
2:1:6,1,1,107347,92653
4:1:5,0,-1,107348,92652
6:3:4,0,-1,107349,92651
4:6:6,0,-1,107350,92650
2:3:2,2,2,107348,92652
5:2:3,1,1,107347,92653
4:2:6,1,1,107346,92654
1:5:4,0,-1,107347,92653
6:5:3,0,-1,107348,92652
5:1:3,0,-1,107349,92651
2:1:5,1,1,107348,92652
2:6:5,1,1,107347,92653
1:5:3,0,-1,107348,92652
5:3:1,0,-1,107349,92651
6:5:3,0,-1,107350,92650
3:4:4,0,-1,107351,92649
3:6:6,0,-1,107352,92648
2:2:4,2,2,107350,92650
2:2:6,2,2,107348,92652
1:4:2,1,1,107347,92653
4:5:3,0,-1,107348,92652
2:3:4,1,1,107347,92653
3:2:1,1,1,107346,92654
5:6:5,0,-1,107347,92653
2:3:4,1,1,107346,92654
3:5:3,0,-1,107347,92653
5:6:5,0,-1,107348,92652
4:1:1,0,-1,107349,92651
5:3:5,0,-1,107350,92650
4:4:1,0,-1,107351,92649
3:3:4,0,-1,107352,92648
3:5:6,0,-1,107353,92647
2:1:3,1,1,107352,92648
4:5:5,0,-1,107353,92647
1:4:4,0,-1,107354,92646
6:4:4,0,-1,107355,92645
5:2:5,1,1,107354,92646
1:6:2,1,1,107353,92647
6:1:1,0,-1,107354,92646
3:6:6,0,-1,107355,92645
2:6:2,2,2,107353,92647
4:1:4,0,-1,107354,92646
1:5:2,1,1,107353,92647
3:6:2,1,1,107352,92648
1:3:6,0,-1,107353,92647
2:3:6,1,1,107352,92648
1:4:4,0,-1,107353,92647
5:4:6,0,-1,107354,92646
3:1:4,0,-1,107355,92645
4:3:5,0,-1,107356,92644
3:5:6,0,-1,107357,92643
4:5:6,0,-1,107358,92642
2:4:2,2,2,107356,92644
2:4:6,1,1,107355,92645
2:1:3,1,1,107354,92646
5:2:2,2,2,107352,92648
4:4:3,0,-1,107353,92647
1:2:2,2,2,107351,92649
6:3:6,0,-1,107352,92648
2:6:1,1,1,107351,92649
6:3:6,0,-1,107352,92648
3:3:6,0,-1,107353,92647
2:1:5,1,1,107352,92648
5:2:6,1,1,107351,92649
4:3:5,0,-1,107352,92648
1:2:5,1,1,107351,92649
4:2:1,1,1,107350,92650
3:4:2,1,1,107349,92651
5:3:6,0,-1,107350,92650
4:4:2,1,1,107349,92651
3:1:4,0,-1,107350,92650
2:3:6,1,1,107349,92651
4:3:4,0,-1,107350,92650
6:5:5,0,-1,107351,92649
4:6:4,0,-1,107352,92648
1:5:3,0,-1,107353,92647
6:6:5,0,-1,107354,92646
3:3:2,1,1,107353,92647
5:1:2,1,1,107352,92648
3:2:5,1,1,107351,92649
5:5:3,0,-1,107352,92648
3:6:6,0,-1,107353,92647
5:3:5,0,-1,107354,92646
6:3:3,0,-1,107355,92645
2:6:5,1,1,107354,92646
2:3:1,1,1,107353,92647
1:4:4,0,-1,107354,92646
1:3:5,0,-1,107355,92645
2:6:1,1,1,107354,92646
6:6:6,0,-1,107355,92645
5:2:3,1,1,107354,92646
5:4:6,0,-1,107355,92645
1:4:4,0,-1,107356,92644
5:5:2,1,1,107355,92645
2:5:4,1,1,107354,92646
4:4:2,1,1,107353,92647
2:3:2,2,2,107351,92649
1:1:4,0,-1,107352,92648
2:3:6,1,1,107351,92649
4:6:1,0,-1,107352,92648
5:4:6,0,-1,107353,92647
2:4:6,1,1,107352,92648
3:3:6,0,-1,107353,92647
5:4:4,0,-1,107354,92646
4:2:3,1,1,107353,92647
2:6:6,1,1,107352,92648
4:4:4,0,-1,107353,92647
3:4:1,0,-1,107354,92646
5:5:3,0,-1,107355,92645
3:2:3,1,1,107354,92646
4:2:5,1,1,107353,92647
6:6:3,0,-1,107354,92646
1:5:6,0,-1,107355,92645
2:2:2,3,3,107352,92648
6:2:1,1,1,107351,92649
6:5:6,0,-1,107352,92648
3:6:2,1,1,107351,92649
2:2:4,2,2,107349,92651
3:1:5,0,-1,107350,92650
1:2:5,1,1,107349,92651
5:1:3,0,-1,107350,92650
2:6:5,1,1,107349,92651
1:5:5,0,-1,107350,92650
1:2:1,1,1,107349,92651
3:1:3,0,-1,107350,92650
2:5:6,1,1,107349,92651
4:4:6,0,-1,107350,92650
3:6:1,0,-1,107351,92649
3:4:5,0,-1,107352,92648
3:4:6,0,-1,107353,92647
4:2:2,2,2,107351,92649
4:1:1,0,-1,107352,92648
1:4:4,0,-1,107353,92647
2:1:5,1,1,107352,92648
5:4:2,1,1,107351,92649
3:2:4,1,1,107350,92650
5:5:6,0,-1,107351,92649
6:3:3,0,-1,107352,92648
3:6:2,1,1,107351,92649
1:5:5,0,-1,107352,92648
3:3:5,0,-1,107353,92647
1:4:4,0,-1,107354,92646
5:6:6,0,-1,107355,92645
2:1:1,1,1,107354,92646
6:5:3,0,-1,107355,92645
5:3:4,0,-1,107356,92644
4:5:3,0,-1,107357,92643
3:3:3,0,-1,107358,92642
2:3:4,1,1,107357,92643
2:4:2,2,2,107355,92645
1:2:3,1,1,107354,92646
2:2:2,3,3,107351,92649
5:1:4,0,-1,107352,92648
6:2:6,1,1,107351,92649
5:2:4,1,1,107350,92650
3:6:6,0,-1,107351,92649
4:4:1,0,-1,107352,92648
2:5:4,1,1,107351,92649
3:6:4,0,-1,107352,92648
5:6:6,0,-1,107353,92647
5:6:1,0,-1,107354,92646
1:6:4,0,-1,107355,92645
3:2:1,1,1,107354,92646
6:6:6,0,-1,107355,92645
3:3:6,0,-1,107356,92644
1:1:2,1,1,107355,92645
2:1:4,1,1,107354,92646
2:5:4,1,1,107353,92647
1:1:1,0,-1,107354,92646
3:6:3,0,-1,107355,92645
3:3:6,0,-1,107356,92644
5:1:2,1,1,107355,92645
6:2:3,1,1,107354,92646
6:4:3,0,-1,107355,92645
3:3:1,0,-1,107356,92644
6:5:4,0,-1,107357,92643
5:3:3,0,-1,107358,92642
5:6:2,1,1,107357,92643
5:1:5,0,-1,107358,92642
5:4:1,0,-1,107359,92641
6:5:3,0,-1,107360,92640
6:1:3,0,-1,107361,92639
6:3:3,0,-1,107362,92638
2:1:6,1,1,107361,92639
1:6:1,0,-1,107362,92638
5:6:2,1,1,107361,92639
1:1:1,0,-1,107362,92638
6:6:3,0,-1,107363,92637
1:6:6,0,-1,107364,92636
1:2:3,1,1,107363,92637
2:5:2,2,2,107361,92639
4:5:4,0,-1,107362,92638
2:6:1,1,1,107361,92639
3:4:1,0,-1,107362,92638
3:5:3,0,-1,107363,92637
6:1:5,0,-1,107364,92636
2:3:5,1,1,107363,92637
2:5:6,1,1,107362,92638
3:3:6,0,-1,107363,92637
3:2:1,1,1,107362,92638
3:4:3,0,-1,107363,92637
3:1:6,0,-1,107364,92636
3:2:4,1,1,107363,92637
3:4:4,0,-1,107364,92636
3:2:1,1,1,107363,92637
3:5:2,1,1,107362,92638
2:3:3,1,1,107361,92639
6:4:3,0,-1,107362,92638
1:1:2,1,1,107361,92639
1:6:6,0,-1,107362,92638
4:1:2,1,1,107361,92639
2:6:5,1,1,107360,92640
5:1:6,0,-1,107361,92639
5:2:4,1,1,107360,92640
2:4:3,1,1,107359,92641
1:3:2,1,1,107358,92642
2:2:1,2,2,107356,92644
5:3:4,0,-1,107357,92643
2:4:2,2,2,107355,92645
5:6:1,0,-1,107356,92644
2:2:2,3,3,107353,92647
4:6:2,1,1,107352,92648
5:4:2,1,1,107351,92649
3:3:4,0,-1,107352,92648
2:6:2,2,2,107350,92650
5:2:4,1,1,107349,92651
6:3:4,0,-1,107350,92650
3:4:3,0,-1,107351,92649
2:5:1,1,1,107350,92650
4:4:5,0,-1,107351,92649
3:2:5,1,1,107350,92650
6:5:6,0,-1,107351,92649
1:4:3,0,-1,107352,92648
6:4:3,0,-1,107353,92647
4:6:1,0,-1,107354,92646
4:6:1,0,-1,107355,92645
5:4:5,0,-1,107356,92644
3:5:1,0,-1,107357,92643
6:5:4,0,-1,107358,92642
5:1:1,0,-1,107359,92641
5:2:2,2,2,107357,92643
3:3:6,0,-1,107358,92642
3:3:4,0,-1,107359,92641
5:3:2,1,1,107358,92642
2:5:4,1,1,107357,92643
1:4:4,0,-1,107358,92642
2:4:4,1,1,107357,92643
4:1:4,0,-1,107358,92642
5:6:2,1,1,107357,92643
2:1:4,1,1,107356,92644
4:1:5,0,-1,107357,92643
2:5:3,1,1,107356,92644
4:4:5,0,-1,107357,92643
1:4:5,0,-1,107358,92642
3:4:5,0,-1,107359,92641
6:6:4,0,-1,107360,92640
2:1:1,1,1,107359,92641
5:1:3,0,-1,107360,92640
6:5:4,0,-1,107361,92639
4:5:2,1,1,107360,92640
6:5:2,1,1,107359,92641
1:5:6,0,-1,107360,92640
2:5:1,1,1,107359,92641
6:6:3,0,-1,107360,92640
5:1:6,0,-1,107361,92639
3:1:1,0,-1,107362,92638
4:3:4,0,-1,107363,92637
3:6:4,0,-1,107364,92636
3:4:2,1,1,107363,92637
6:1:4,0,-1,107364,92636
5:4:2,1,1,107363,92637
1:5:1,0,-1,107364,92636
3:5:6,0,-1,107365,92635
2:1:4,1,1,107364,92636
6:1:5,0,-1,107365,92635
3:1:2,1,1,107364,92636
4:6:6,0,-1,107365,92635
3:4:3,0,-1,107366,92634
3:3:4,0,-1,107367,92633
5:1:5,0,-1,107368,92632
3:2:5,1,1,107367,92633
5:6:1,0,-1,107368,92632
2:6:5,1,1,107367,92633
1:2:4,1,1,107366,92634
6:6:6,0,-1,107367,92633
4:1:3,0,-1,107368,92632
6:1:6,0,-1,107369,92631
2:2:4,2,2,107367,92633
4:3:6,0,-1,107368,92632
3:1:5,0,-1,107369,92631
2:4:1,1,1,107368,92632
4:5:6,0,-1,107369,92631
5:4:5,0,-1,107370,92630
4:4:4,0,-1,107371,92629
1:5:5,0,-1,107372,92628
1:1:6,0,-1,107373,92627
6:6:2,1,1,107372,92628
4:2:3,1,1,107371,92629
5:5:2,1,1,107370,92630
5:5:2,1,1,107369,92631
2:6:5,1,1,107368,92632
3:3:5,0,-1,107369,92631
1:5:4,0,-1,107370,92630
4:3:6,0,-1,107371,92629
6:6:3,0,-1,107372,92628
2:4:3,1,1,107371,92629
6:6:1,0,-1,107372,92628
4:6:3,0,-1,107373,92627
4:5:6,0,-1,107374,92626
3:3:5,0,-1,107375,92625
6:3:5,0,-1,107376,92624
1:3:1,0,-1,107377,92623
6:1:6,0,-1,107378,92622
4:1:1,0,-1,107379,92621
1:4:1,0,-1,107380,92620
3:3:1,0,-1,107381,92619
4:1:5,0,-1,107382,92618
1:1:6,0,-1,107383,92617
5:2:4,1,1,107382,92618
2:4:2,2,2,107380,92620
4:6:3,0,-1,107381,92619
1:2:6,1,1,107380,92620
3:3:3,0,-1,107381,92619
1:6:6,0,-1,107382,92618
4:5:2,1,1,107381,92619
2:6:6,1,1,107380,92620
4:1:4,0,-1,107381,92619
4:4:4,0,-1,107382,92618
5:5:3,0,-1,107383,92617
2:1:2,2,2,107381,92619
3:4:5,0,-1,107382,92618
5:3:6,0,-1,107383,92617
1:6:4,0,-1,107384,92616
5:1:6,0,-1,107385,92615
3:3:2,1,1,107384,92616
3:4:1,0,-1,107385,92615
3:6:1,0,-1,107386,92614
3:2:4,1,1,107385,92615
3:5:6,0,-1,107386,92614
6:4:2,1,1,107385,92615
5:3:2,1,1,107384,92616
5:5:4,0,-1,107385,92615
2:2:3,2,2,107383,92617
3:2:1,1,1,107382,92618
5:4:6,0,-1,107383,92617
2:6:4,1,1,107382,92618
3:4:3,0,-1,107383,92617
3:2:6,1,1,107382,92618
1:3:4,0,-1,107383,92617
1:3:2,1,1,107382,92618
4:3:3,0,-1,107383,92617
3:3:6,0,-1,107384,92616
2:4:2,2,2,107382,92618
5:1:1,0,-1,107383,92617
4:3:5,0,-1,107384,92616
4:6:1,0,-1,107385,92615
1:2:1,1,1,107384,92616
5:2:3,1,1,107383,92617
3:2:5,1,1,107382,92618
4:6:6,0,-1,107383,92617
4:6:5,0,-1,107384,92616
3:6:6,0,-1,107385,92615
3:3:6,0,-1,107386,92614
1:4:6,0,-1,107387,92613
2:6:5,1,1,107386,92614
4:3:4,0,-1,107387,92613
5:6:5,0,-1,107388,92612
3:5:6,0,-1,107389,92611
6:3:3,0,-1,107390,92610
3:5:6,0,-1,107391,92609
1:3:5,0,-1,107392,92608
3:2:2,2,2,107390,92610
1:1:2,1,1,107389,92611
3:3:6,0,-1,107390,92610
4:5:2,1,1,107389,92611
2:3:1,1,1,107388,92612
2:2:5,2,2,107386,92614
2:4:2,2,2,107384,92616
3:6:4,0,-1,107385,92615
5:3:1,0,-1,107386,92614
2:5:2,2,2,107384,92616
2:6:2,2,2,107382,92618
6:5:5,0,-1,107383,92617
4:4:4,0,-1,107384,92616
6:3:6,0,-1,107385,92615
1:5:2,1,1,107384,92616
1:5:4,0,-1,107385,92615
6:6:1,0,-1,107386,92614
5:4:5,0,-1,107387,92613
4:1:6,0,-1,107388,92612
2:5:4,1,1,107387,92613
2:5:2,2,2,107385,92615
4:1:5,0,-1,107386,92614
4:2:1,1,1,107385,92615
3:2:2,2,2,107383,92617
4:5:6,0,-1,107384,92616
4:1:5,0,-1,107385,92615
6:3:1,0,-1,107386,92614
6:6:1,0,-1,107387,92613
3:5:5,0,-1,107388,92612
6:1:1,0,-1,107389,92611
1:2:2,2,2,107387,92613
4:5:6,0,-1,107388,92612
1:5:5,0,-1,107389,92611
1:6:1,0,-1,107390,92610
5:2:5,1,1,107389,92611
6:5:6,0,-1,107390,92610
4:3:3,0,-1,107391,92609
5:6:5,0,-1,107392,92608
3:5:5,0,-1,107393,92607
2:2:4,2,2,107391,92609
5:1:4,0,-1,107392,92608
6:2:1,1,1,107391,92609
6:4:6,0,-1,107392,92608
6:3:5,0,-1,107393,92607
4:6:4,0,-1,107394,92606
1:1:5,0,-1,107395,92605
3:3:4,0,-1,107396,92604
2:2:5,2,2,107394,92606
3:3:3,0,-1,107395,92605
1:6:1,0,-1,107396,92604
4:5:2,1,1,107395,92605
4:4:6,0,-1,107396,92604
1:4:2,1,1,107395,92605
3:3:1,0,-1,107396,92604
6:4:5,0,-1,107397,92603
1:2:6,1,1,107396,92604
5:1:5,0,-1,107397,92603
4:1:2,1,1,107396,92604
1:3:3,0,-1,107397,92603
2:4:5,1,1,107396,92604
2:5:2,2,2,107394,92606
6:2:4,1,1,107393,92607
4:3:1,0,-1,107394,92606
6:5:1,0,-1,107395,92605
3:2:1,1,1,107394,92606
3:5:4,0,-1,107395,92605
1:5:5,0,-1,107396,92604
1:4:3,0,-1,107397,92603
2:2:6,2,2,107395,92605
1:5:2,1,1,107394,92606
4:1:1,0,-1,107395,92605
5:3:4,0,-1,107396,92604
4:5:3,0,-1,107397,92603
4:6:3,0,-1,107398,92602
4:5:6,0,-1,107399,92601
2:3:2,2,2,107397,92603
6:5:4,0,-1,107398,92602
4:6:6,0,-1,107399,92601
1:5:4,0,-1,107400,92600
4:1:1,0,-1,107401,92599
4:6:1,0,-1,107402,92598
3:2:4,1,1,107401,92599
2:1:4,1,1,107400,92600
2:6:1,1,1,107399,92601
5:2:6,1,1,107398,92602
5:3:5,0,-1,107399,92601
1:6:2,1,1,107398,92602
6:1:2,1,1,107397,92603
6:5:5,0,-1,107398,92602
2:6:5,1,1,107397,92603
2:4:4,1,1,107396,92604
4:5:6,0,-1,107397,92603
6:2:2,2,2,107395,92605
1:1:4,0,-1,107396,92604
5:4:2,1,1,107395,92605
2:4:1,1,1,107394,92606
4:5:5,0,-1,107395,92605
1:5:4,0,-1,107396,92604
2:1:1,1,1,107395,92605
5:3:6,0,-1,107396,92604
1:6:1,0,-1,107397,92603
2:4:4,1,1,107396,92604
1:2:6,1,1,107395,92605
6:6:5,0,-1,107396,92604
6:2:4,1,1,107395,92605
3:5:2,1,1,107394,92606
4:6:4,0,-1,107395,92605
3:1:5,0,-1,107396,92604
1:1:5,0,-1,107397,92603
6:1:3,0,-1,107398,92602
6:6:3,0,-1,107399,92601
6:3:6,0,-1,107400,92600
6:5:1,0,-1,107401,92599
6:6:2,1,1,107400,92600
6:4:6,0,-1,107401,92599
2:1:2,2,2,107399,92601
5:1:2,1,1,107398,92602
3:1:1,0,-1,107399,92601
1:4:4,0,-1,107400,92600
1:6:3,0,-1,107401,92599
6:4:2,1,1,107400,92600
2:6:6,1,1,107399,92601
2:2:1,2,2,107397,92603
4:4:3,0,-1,107398,92602
2:1:2,2,2,107396,92604
1:1:1,0,-1,107397,92603
4:1:4,0,-1,107398,92602
6:3:3,0,-1,107399,92601
3:1:2,1,1,107398,92602
6:2:1,1,1,107397,92603
3:5:6,0,-1,107398,92602
1:2:2,2,2,107396,92604
1:3:1,0,-1,107397,92603
2:1:1,1,1,107396,92604
2:6:6,1,1,107395,92605
3:3:6,0,-1,107396,92604
3:4:2,1,1,107395,92605
6:3:2,1,1,107394,92606
3:4:5,0,-1,107395,92605
3:4:1,0,-1,107396,92604
4:5:2,1,1,107395,92605
4:2:5,1,1,107394,92606
6:3:2,1,1,107393,92607
6:3:1,0,-1,107394,92606
1:1:6,0,-1,107395,92605
3:6:5,0,-1,107396,92604
3:1:3,0,-1,107397,92603
4:2:6,1,1,107396,92604
4:5:2,1,1,107395,92605
2:3:3,1,1,107394,92606
4:1:3,0,-1,107395,92605
1:6:3,0,-1,107396,92604
1:2:5,1,1,107395,92605
2:4:4,1,1,107394,92606
3:1:1,0,-1,107395,92605
4:4:1,0,-1,107396,92604
2:6:5,1,1,107395,92605
4:3:4,0,-1,107396,92604
5:5:6,0,-1,107397,92603
1:1:1,0,-1,107398,92602
3:1:2,1,1,107397,92603
6:3:6,0,-1,107398,92602
2:3:5,1,1,107397,92603
1:2:4,1,1,107396,92604
6:6:2,1,1,107395,92605
6:4:2,1,1,107394,92606
2:6:4,1,1,107393,92607
6:4:6,0,-1,107394,92606
4:4:4,0,-1,107395,92605
3:3:4,0,-1,107396,92604
6:2:2,2,2,107394,92606
2:2:1,2,2,107392,92608
1:2:3,1,1,107391,92609
1:5:5,0,-1,107392,92608
1:3:4,0,-1,107393,92607
4:1:6,0,-1,107394,92606
5:2:3,1,1,107393,92607
2:6:6,1,1,107392,92608
3:6:5,0,-1,107393,92607
5:3:3,0,-1,107394,92606
5:3:6,0,-1,107395,92605
5:1:4,0,-1,107396,92604
1:4:5,0,-1,107397,92603
4:4:1,0,-1,107398,92602
5:5:5,0,-1,107399,92601
4:4:1,0,-1,107400,92600
5:4:4,0,-1,107401,92599
5:4:5,0,-1,107402,92598
3:3:2,1,1,107401,92599
5:1:3,0,-1,107402,92598
2:1:1,1,1,107401,92599
5:4:1,0,-1,107402,92598
3:5:5,0,-1,107403,92597
4:6:5,0,-1,107404,92596
2:5:1,1,1,107403,92597
1:4:4,0,-1,107404,92596
3:6:2,1,1,107403,92597
5:3:5,0,-1,107404,92596
4:1:2,1,1,107403,92597
5:2:1,1,1,107402,92598
1:6:2,1,1,107401,92599
5:5:6,0,-1,107402,92598
1:3:5,0,-1,107403,92597
1:5:4,0,-1,107404,92596
1:4:6,0,-1,107405,92595
3:4:2,1,1,107404,92596
5:2:1,1,1,107403,92597
3:3:6,0,-1,107404,92596
1:1:1,0,-1,107405,92595
1:5:6,0,-1,107406,92594
1:1:4,0,-1,107407,92593
6:2:4,1,1,107406,92594
6:2:4,1,1,107405,92595
1:4:1,0,-1,107406,92594
2:3:4,1,1,107405,92595
3:2:6,1,1,107404,92596
2:6:3,1,1,107403,92597
2:3:1,1,1,107402,92598
2:2:5,2,2,107400,92600
2:1:6,1,1,107399,92601
3:3:4,0,-1,107400,92600
1:5:6,0,-1,107401,92599
4:5:1,0,-1,107402,92598
6:2:6,1,1,107401,92599
1:4:2,1,1,107400,92600
6:5:1,0,-1,107401,92599
5:1:2,1,1,107400,92600
3:1:4,0,-1,107401,92599
2:6:2,2,2,107399,92601
1:1:6,0,-1,107400,92600
5:6:3,0,-1,107401,92599
4:2:5,1,1,107400,92600
5:1:1,0,-1,107401,92599
5:2:6,1,1,107400,92600
2:3:1,1,1,107399,92601
4:1:4,0,-1,107400,92600
5:3:3,0,-1,107401,92599
4:5:2,1,1,107400,92600
5:1:2,1,1,107399,92601
2:5:5,1,1,107398,92602
5:3:4,0,-1,107399,92601
2:4:5,1,1,107398,92602
3:1:5,0,-1,107399,92601
4:2:1,1,1,107398,92602
2:4:2,2,2,107396,92604
3:1:6,0,-1,107397,92603
4:3:1,0,-1,107398,92602
3:5:2,1,1,107397,92603
5:1:5,0,-1,107398,92602
1:4:2,1,1,107397,92603
3:5:1,0,-1,107398,92602
2:3:5,1,1,107397,92603
5:3:5,0,-1,107398,92602
3:3:1,0,-1,107399,92601
2:4:1,1,1,107398,92602
5:4:5,0,-1,107399,92601
6:6:3,0,-1,107400,92600
2:3:4,1,1,107399,92601
1:6:2,1,1,107398,92602
4:6:2,1,1,107397,92603
2:6:5,1,1,107396,92604
5:5:1,0,-1,107397,92603
6:3:6,0,-1,107398,92602
1:3:2,1,1,107397,92603
3:4:2,1,1,107396,92604
6:1:2,1,1,107395,92605
3:6:3,0,-1,107396,92604
1:4:1,0,-1,107397,92603
2:5:2,2,2,107395,92605
5:5:3,0,-1,107396,92604
5:2:4,1,1,107395,92605
5:2:4,1,1,107394,92606
4:1:3,0,-1,107395,92605
3:5:3,0,-1,107396,92604
2:6:6,1,1,107395,92605
4:1:3,0,-1,107396,92604
6:3:3,0,-1,107397,92603
4:2:4,1,1,107396,92604
6:2:5,1,1,107395,92605
6:2:5,1,1,107394,92606
3:4:2,1,1,107393,92607
1:5:2,1,1,107392,92608
4:2:3,1,1,107391,92609
4:1:4,0,-1,107392,92608
4:1:1,0,-1,107393,92607
6:3:2,1,1,107392,92608
3:4:2,1,1,107391,92609
6:4:6,0,-1,107392,92608
5:4:3,0,-1,107393,92607
2:6:2,2,2,107391,92609
2:3:3,1,1,107390,92610
6:6:6,0,-1,107391,92609
5:6:1,0,-1,107392,92608
5:6:3,0,-1,107393,92607
3:5:6,0,-1,107394,92606
1:6:1,0,-1,107395,92605
3:1:2,1,1,107394,92606
5:1:4,0,-1,107395,92605
3:5:6,0,-1,107396,92604
5:6:4,0,-1,107397,92603
1:4:5,0,-1,107398,92602
1:3:2,1,1,107397,92603
3:3:4,0,-1,107398,92602
5:2:3,1,1,107397,92603
2:2:1,2,2,107395,92605
6:2:1,1,1,107394,92606
1:6:2,1,1,107393,92607
3:1:3,0,-1,107394,92606
3:2:2,2,2,107392,92608
3:5:6,0,-1,107393,92607
2:5:4,1,1,107392,92608
2:1:5,1,1,107391,92609
1:2:1,1,1,107390,92610
6:5:4,0,-1,107391,92609
5:1:2,1,1,107390,92610
4:4:2,1,1,107389,92611
5:6:5,0,-1,107390,92610
1:5:5,0,-1,107391,92609
4:6:6,0,-1,107392,92608
2:1:2,2,2,107390,92610
1:3:2,1,1,107389,92611
5:5:4,0,-1,107390,92610
4:4:6,0,-1,107391,92609
4:5:3,0,-1,107392,92608
3:1:1,0,-1,107393,92607
1:4:3,0,-1,107394,92606
6:1:2,1,1,107393,92607
3:6:1,0,-1,107394,92606
5:2:4,1,1,107393,92607
2:1:6,1,1,107392,92608
1:3:1,0,-1,107393,92607
1:1:2,1,1,107392,92608
1:1:6,0,-1,107393,92607
1:5:3,0,-1,107394,92606
5:1:5,0,-1,107395,92605
1:5:6,0,-1,107396,92604
3:5:3,0,-1,107397,92603
2:1:2,2,2,107395,92605
3:5:5,0,-1,107396,92604
1:5:4,0,-1,107397,92603
6:5:1,0,-1,107398,92602
5:4:4,0,-1,107399,92601
6:3:2,1,1,107398,92602
1:6:6,0,-1,107399,92601
2:1:4,1,1,107398,92602
5:3:3,0,-1,107399,92601
3:1:1,0,-1,107400,92600
4:6:2,1,1,107399,92601
4:6:1,0,-1,107400,92600
1:6:1,0,-1,107401,92599
2:6:6,1,1,107400,92600
5:4:3,0,-1,107401,92599
5:1:2,1,1,107400,92600
3:5:5,0,-1,107401,92599
4:3:4,0,-1,107402,92598
4:4:5,0,-1,107403,92597
5:1:2,1,1,107402,92598
4:3:2,1,1,107401,92599
5:5:5,0,-1,107402,92598
4:2:4,1,1,107401,92599
5:4:6,0,-1,107402,92598
5:6:2,1,1,107401,92599
2:4:3,1,1,107400,92600
3:6:3,0,-1,107401,92599
5:4:1,0,-1,107402,92598
4:1:5,0,-1,107403,92597
2:1:4,1,1,107402,92598
3:1:3,0,-1,107403,92597
6:4:1,0,-1,107404,92596
1:4:5,0,-1,107405,92595
4:4:2,1,1,107404,92596
2:3:3,1,1,107403,92597
3:6:3,0,-1,107404,92596
3:3:6,0,-1,107405,92595
3:5:2,1,1,107404,92596
6:2:4,1,1,107403,92597
4:5:4,0,-1,107404,92596
3:2:5,1,1,107403,92597
6:5:6,0,-1,107404,92596
5:4:1,0,-1,107405,92595
6:6:6,0,-1,107406,92594
2:4:3,1,1,107405,92595
5:2:1,1,1,107404,92596
3:3:6,0,-1,107405,92595
6:5:3,0,-1,107406,92594
3:6:6,0,-1,107407,92593
6:2:4,1,1,107406,92594
5:1:1,0,-1,107407,92593
2:4:5,1,1,107406,92594
6:5:5,0,-1,107407,92593
1:1:3,0,-1,107408,92592
1:6:2,1,1,107407,92593
6:5:4,0,-1,107408,92592
5:6:3,0,-1,107409,92591
6:3:2,1,1,107408,92592
1:1:6,0,-1,107409,92591
4:2:1,1,1,107408,92592
1:1:6,0,-1,107409,92591
4:1:4,0,-1,107410,92590
5:4:6,0,-1,107411,92589
5:1:1,0,-1,107412,92588
6:5:5,0,-1,107413,92587
3:6:4,0,-1,107414,92586
6:5:5,0,-1,107415,92585
2:4:2,2,2,107413,92587
6:2:2,2,2,107411,92589
3:1:1,0,-1,107412,92588
3:6:1,0,-1,107413,92587
5:6:5,0,-1,107414,92586
5:3:5,0,-1,107415,92585
4:3:4,0,-1,107416,92584
6:5:6,0,-1,107417,92583
4:3:6,0,-1,107418,92582
5:6:3,0,-1,107419,92581
3:2:4,1,1,107418,92582
5:3:6,0,-1,107419,92581
2:2:2,3,3,107416,92584
5:1:2,1,1,107415,92585
3:2:2,2,2,107413,92587
3:6:4,0,-1,107414,92586
4:5:2,1,1,107413,92587
5:2:1,1,1,107412,92588
3:4:2,1,1,107411,92589
6:4:4,0,-1,107412,92588
2:1:6,1,1,107411,92589
1:6:4,0,-1,107412,92588
1:4:1,0,-1,107413,92587
3:3:3,0,-1,107414,92586
1:1:3,0,-1,107415,92585
5:3:2,1,1,107414,92586
2:6:1,1,1,107413,92587
1:3:5,0,-1,107414,92586
6:3:2,1,1,107413,92587
4:6:3,0,-1,107414,92586
3:5:4,0,-1,107415,92585
6:2:1,1,1,107414,92586
3:2:4,1,1,107413,92587
2:6:4,1,1,107412,92588
1:5:4,0,-1,107413,92587
4:1:2,1,1,107412,92588
4:2:4,1,1,107411,92589
4:1:3,0,-1,107412,92588
2:3:5,1,1,107411,92589
4:2:1,1,1,107410,92590
2:6:6,1,1,107409,92591
6:3:5,0,-1,107410,92590
5:2:6,1,1,107409,92591
4:3:2,1,1,107408,92592
1:6:2,1,1,107407,92593
2:1:4,1,1,107406,92594
5:2:4,1,1,107405,92595
3:2:1,1,1,107404,92596
1:6:4,0,-1,107405,92595
6:1:3,0,-1,107406,92594
2:1:1,1,1,107405,92595
5:3:2,1,1,107404,92596
4:5:2,1,1,107403,92597
6:3:1,0,-1,107404,92596
5:2:1,1,1,107403,92597
6:6:5,0,-1,107404,92596
3:3:5,0,-1,107405,92595
5:5:3,0,-1,107406,92594
3:6:2,1,1,107405,92595
3:4:1,0,-1,107406,92594
3:3:4,0,-1,107407,92593
1:1:1,0,-1,107408,92592
3:2:6,1,1,107407,92593
3:3:1,0,-1,107408,92592
2:6:5,1,1,107407,92593
5:5:4,0,-1,107408,92592
1:2:3,1,1,107407,92593
4:2:1,1,1,107406,92594
4:3:4,0,-1,107407,92593
6:3:6,0,-1,107408,92592
3:1:6,0,-1,107409,92591
2:1:1,1,1,107408,92592
3:2:3,1,1,107407,92593
1:1:5,0,-1,107408,92592
2:6:6,1,1,107407,92593
3:6:5,0,-1,107408,92592
2:6:2,2,2,107406,92594
6:2:3,1,1,107405,92595
1:4:5,0,-1,107406,92594
6:6:5,0,-1,107407,92593
1:3:2,1,1,107406,92594
1:4:4,0,-1,107407,92593
1:4:5,0,-1,107408,92592
4:2:4,1,1,107407,92593
6:6:6,0,-1,107408,92592
2:6:6,1,1,107407,92593
4:4:6,0,-1,107408,92592
6:1:2,1,1,107407,92593
4:3:5,0,-1,107408,92592
5:3:5,0,-1,107409,92591
2:3:2,2,2,107407,92593
2:6:2,2,2,107405,92595
2:6:5,1,1,107404,92596
5:2:5,1,1,107403,92597
2:4:5,1,1,107402,92598
5:3:3,0,-1,107403,92597
1:4:3,0,-1,107404,92596
6:6:4,0,-1,107405,92595
6:3:4,0,-1,107406,92594
6:2:6,1,1,107405,92595
5:3:4,0,-1,107406,92594
5:1:4,0,-1,107407,92593
5:4:6,0,-1,107408,92592
1:1:6,0,-1,107409,92591
4:4:3,0,-1,107410,92590
6:4:4,0,-1,107411,92589
5:6:3,0,-1,107412,92588
6:1:3,0,-1,107413,92587
3:6:2,1,1,107412,92588
6:3:3,0,-1,107413,92587
1:3:1,0,-1,107414,92586
5:5:1,0,-1,107415,92585
2:5:4,1,1,107414,92586
2:3:6,1,1,107413,92587
6:4:5,0,-1,107414,92586
2:1:1,1,1,107413,92587
3:1:6,0,-1,107414,92586
5:2:6,1,1,107413,92587
5:3:4,0,-1,107414,92586
1:6:6,0,-1,107415,92585
6:2:5,1,1,107414,92586
5:5:6,0,-1,107415,92585
3:5:2,1,1,107414,92586
2:4:4,1,1,107413,92587
6:4:3,0,-1,107414,92586
5:6:6,0,-1,107415,92585
5:1:5,0,-1,107416,92584
4:2:4,1,1,107415,92585
2:6:6,1,1,107414,92586
3:3:5,0,-1,107415,92585
2:3:6,1,1,107414,92586
4:5:4,0,-1,107415,92585
4:4:5,0,-1,107416,92584
3:1:6,0,-1,107417,92583
4:6:1,0,-1,107418,92582
4:1:6,0,-1,107419,92581
4:1:1,0,-1,107420,92580
6:3:2,1,1,107419,92581
6:4:5,0,-1,107420,92580
5:3:5,0,-1,107421,92579
3:4:2,1,1,107420,92580
4:5:1,0,-1,107421,92579
3:3:1,0,-1,107422,92578
6:5:3,0,-1,107423,92577
1:6:6,0,-1,107424,92576
3:3:1,0,-1,107425,92575
6:1:3,0,-1,107426,92574
4:6:6,0,-1,107427,92573
1:1:2,1,1,107426,92574
6:2:5,1,1,107425,92575
2:3:5,1,1,107424,92576
2:2:6,2,2,107422,92578
3:4:6,0,-1,107423,92577
5:6:2,1,1,107422,92578
2:1:3,1,1,107421,92579
6:5:2,1,1,107420,92580
6:6:3,0,-1,107421,92579
2:3:1,1,1,107420,92580
1:3:4,0,-1,107421,92579
4:6:2,1,1,107420,92580
4:5:5,0,-1,107421,92579
4:5:6,0,-1,107422,92578
4:3:4,0,-1,107423,92577
2:2:3,2,2,107421,92579
6:1:6,0,-1,107422,92578
1:5:2,1,1,107421,92579
1:5:3,0,-1,107422,92578
4:6:1,0,-1,107423,92577
6:1:5,0,-1,107424,92576
6:1:2,1,1,107423,92577
4:4:4,0,-1,107424,92576
6:4:2,1,1,107423,92577
5:4:5,0,-1,107424,92576
4:1:3,0,-1,107425,92575
3:6:6,0,-1,107426,92574
2:4:1,1,1,107425,92575
5:3:6,0,-1,107426,92574
5:3:1,0,-1,107427,92573
4:5:6,0,-1,107428,92572
5:1:6,0,-1,107429,92571
1:6:4,0,-1,107430,92570
4:3:3,0,-1,107431,92569
5:3:1,0,-1,107432,92568
2:1:4,1,1,107431,92569
2:5:4,1,1,107430,92570
2:5:4,1,1,107429,92571
4:1:1,0,-1,107430,92570
6:1:2,1,1,107429,92571
4:6:2,1,1,107428,92572
3:3:3,0,-1,107429,92571
5:1:4,0,-1,107430,92570
4:6:6,0,-1,107431,92569
1:5:2,1,1,107430,92570
1:1:2,1,1,107429,92571
1:4:1,0,-1,107430,92570
2:4:5,1,1,107429,92571
1:2:2,2,2,107427,92573
3:2:4,1,1,107426,92574
2:2:5,2,2,107424,92576
5:5:3,0,-1,107425,92575
5:5:6,0,-1,107426,92574
1:4:1,0,-1,107427,92573
4:1:3,0,-1,107428,92572
5:3:1,0,-1,107429,92571
3:3:5,0,-1,107430,92570
6:5:1,0,-1,107431,92569
6:4:1,0,-1,107432,92568
2:1:4,1,1,107431,92569
4:4:3,0,-1,107432,92568
5:2:1,1,1,107431,92569
1:4:2,1,1,107430,92570
3:2:5,1,1,107429,92571
1:4:1,0,-1,107430,92570
5:4:4,0,-1,107431,92569
6:5:1,0,-1,107432,92568
1:1:6,0,-1,107433,92567
4:6:4,0,-1,107434,92566
3:4:3,0,-1,107435,92565
4:1:2,1,1,107434,92566
1:2:1,1,1,107433,92567
4:5:6,0,-1,107434,92566
5:6:6,0,-1,107435,92565
6:3:5,0,-1,107436,92564
4:5:4,0,-1,107437,92563
5:1:1,0,-1,107438,92562
4:2:1,1,1,107437,92563
5:3:5,0,-1,107438,92562
4:2:2,2,2,107436,92564
1:4:1,0,-1,107437,92563
6:6:6,0,-1,107438,92562
3:3:2,1,1,107437,92563
1:3:2,1,1,107436,92564
3:4:3,0,-1,107437,92563
2:1:1,1,1,107436,92564
4:6:4,0,-1,107437,92563
2:4:2,2,2,107435,92565
6:4:1,0,-1,107436,92564
4:4:6,0,-1,107437,92563
1:4:6,0,-1,107438,92562
1:1:1,0,-1,107439,92561
4:5:6,0,-1,107440,92560
6:6:5,0,-1,107441,92559
4:6:6,0,-1,107442,92558
1:1:3,0,-1,107443,92557
4:6:2,1,1,107442,92558
6:3:3,0,-1,107443,92557
5:3:6,0,-1,107444,92556
3:2:6,1,1,107443,92557
6:6:3,0,-1,107444,92556
3:5:1,0,-1,107445,92555
1:1:3,0,-1,107446,92554
6:2:2,2,2,107444,92556
5:6:5,0,-1,107445,92555
2:1:1,1,1,107444,92556
3:1:4,0,-1,107445,92555
4:6:3,0,-1,107446,92554
1:3:4,0,-1,107447,92553
1:4:2,1,1,107446,92554
6:2:5,1,1,107445,92555
6:1:6,0,-1,107446,92554
6:2:5,1,1,107445,92555
1:3:4,0,-1,107446,92554
1:4:5,0,-1,107447,92553
6:4:3,0,-1,107448,92552
5:3:1,0,-1,107449,92551
6:5:5,0,-1,107450,92550
4:2:5,1,1,107449,92551
5:6:3,0,-1,107450,92550
5:1:2,1,1,107449,92551
3:2:6,1,1,107448,92552
2:1:6,1,1,107447,92553
4:1:4,0,-1,107448,92552
5:3:3,0,-1,107449,92551
3:3:4,0,-1,107450,92550
2:6:1,1,1,107449,92551
3:4:3,0,-1,107450,92550
1:3:6,0,-1,107451,92549
1:4:2,1,1,107450,92550
1:2:1,1,1,107449,92551
5:6:6,0,-1,107450,92550
2:1:4,1,1,107449,92551
2:5:1,1,1,107448,92552
5:6:2,1,1,107447,92553
4:3:2,1,1,107446,92554
5:3:3,0,-1,107447,92553
3:2:4,1,1,107446,92554
4:5:5,0,-1,107447,92553
5:1:5,0,-1,107448,92552
6:1:1,0,-1,107449,92551
5:5:5,0,-1,107450,92550
1:1:5,0,-1,107451,92549
3:2:4,1,1,107450,92550
6:5:4,0,-1,107451,92549
1:2:6,1,1,107450,92550
5:1:6,0,-1,107451,92549
2:3:1,1,1,107450,92550
1:3:4,0,-1,107451,92549
5:5:3,0,-1,107452,92548
3:4:3,0,-1,107453,92547
6:6:2,1,1,107452,92548
4:1:1,0,-1,107453,92547
1:6:1,0,-1,107454,92546
2:5:4,1,1,107453,92547
3:5:4,0,-1,107454,92546
2:5:1,1,1,107453,92547
3:4:4,0,-1,107454,92546
2:6:6,1,1,107453,92547
1:5:1,0,-1,107454,92546
2:4:2,2,2,107452,92548
6:4:2,1,1,107451,92549
6:6:4,0,-1,107452,92548
4:4:2,1,1,107451,92549
1:5:3,0,-1,107452,92548
1:6:5,0,-1,107453,92547
5:3:5,0,-1,107454,92546
2:5:4,1,1,107453,92547
1:5:6,0,-1,107454,92546
6:5:2,1,1,107453,92547
2:2:2,3,3,107450,92550
6:5:6,0,-1,107451,92549
1:4:6,0,-1,107452,92548
5:1:5,0,-1,107453,92547
2:1:1,1,1,107452,92548
6:2:4,1,1,107451,92549
2:1:1,1,1,107450,92550
1:6:4,0,-1,107451,92549
4:5:5,0,-1,107452,92548
6:5:2,1,1,107451,92549
5:1:4,0,-1,107452,92548
1:1:5,0,-1,107453,92547
1:4:5,0,-1,107454,92546
1:6:5,0,-1,107455,92545
6:2:6,1,1,107454,92546
4:2:5,1,1,107453,92547
3:1:3,0,-1,107454,92546
4:5:6,0,-1,107455,92545
3:6:3,0,-1,107456,92544
5:2:4,1,1,107455,92545
6:4:6,0,-1,107456,92544
2:3:2,2,2,107454,92546
1:6:5,0,-1,107455,92545
5:5:2,1,1,107454,92546
6:3:3,0,-1,107455,92545
5:3:5,0,-1,107456,92544
4:1:5,0,-1,107457,92543
3:5:4,0,-1,107458,92542
3:6:6,0,-1,107459,92541
6:1:1,0,-1,107460,92540
3:3:4,0,-1,107461,92539
6:2:5,1,1,107460,92540
2:2:1,2,2,107458,92542
6:4:4,0,-1,107459,92541
2:5:3,1,1,107458,92542
1:6:5,0,-1,107459,92541
1:3:5,0,-1,107460,92540
6:3:6,0,-1,107461,92539
6:4:5,0,-1,107462,92538
3:2:3,1,1,107461,92539
4:2:5,1,1,107460,92540
2:3:1,1,1,107459,92541
1:3:5,0,-1,107460,92540
5:3:1,0,-1,107461,92539
4:4:5,0,-1,107462,92538
4:5:2,1,1,107461,92539
6:2:5,1,1,107460,92540
2:5:4,1,1,107459,92541
3:5:3,0,-1,107460,92540
4:5:2,1,1,107459,92541
4:6:1,0,-1,107460,92540
1:2:1,1,1,107459,92541
2:6:6,1,1,107458,92542
1:5:4,0,-1,107459,92541
5:2:4,1,1,107458,92542
3:2:1,1,1,107457,92543
2:3:3,1,1,107456,92544
6:5:5,0,-1,107457,92543
5:6:5,0,-1,107458,92542
2:3:4,1,1,107457,92543
2:5:6,1,1,107456,92544
3:2:1,1,1,107455,92545
4:5:2,1,1,107454,92546
4:6:6,0,-1,107455,92545
2:6:4,1,1,107454,92546
6:3:3,0,-1,107455,92545
6:3:3,0,-1,107456,92544
2:3:1,1,1,107455,92545
1:4:5,0,-1,107456,92544
4:6:3,0,-1,107457,92543
5:4:4,0,-1,107458,92542
4:1:3,0,-1,107459,92541
3:5:6,0,-1,107460,92540
5:6:3,0,-1,107461,92539
6:1:1,0,-1,107462,92538
3:5:2,1,1,107461,92539
6:2:3,1,1,107460,92540
3:3:1,0,-1,107461,92539
2:6:1,1,1,107460,92540
4:2:5,1,1,107459,92541
1:2:6,1,1,107458,92542
4:6:2,1,1,107457,92543
3:1:1,0,-1,107458,92542
6:1:2,1,1,107457,92543
3:6:6,0,-1,107458,92542
6:6:2,1,1,107457,92543
6:1:5,0,-1,107458,92542
6:2:5,1,1,107457,92543
1:3:2,1,1,107456,92544
5:6:3,0,-1,107457,92543
6:5:1,0,-1,107458,92542
4:6:2,1,1,107457,92543
5:3:5,0,-1,107458,92542
4:3:4,0,-1,107459,92541
5:3:2,1,1,107458,92542
1:1:2,1,1,107457,92543
2:6:1,1,1,107456,92544
6:4:1,0,-1,107457,92543
4:5:6,0,-1,107458,92542
5:3:5,0,-1,107459,92541
1:1:6,0,-1,107460,92540
4:3:3,0,-1,107461,92539
6:3:1,0,-1,107462,92538
6:5:6,0,-1,107463,92537
3:1:5,0,-1,107464,92536
5:5:4,0,-1,107465,92535
2:4:2,2,2,107463,92537
1:1:2,1,1,107462,92538
1:6:2,1,1,107461,92539
1:3:6,0,-1,107462,92538
6:3:5,0,-1,107463,92537
3:3:2,1,1,107462,92538
1:6:5,0,-1,107463,92537
1:3:1,0,-1,107464,92536
6:2:3,1,1,107463,92537
3:6:3,0,-1,107464,92536
2:6:1,1,1,107463,92537
4:3:5,0,-1,107464,92536
1:6:2,1,1,107463,92537
1:4:6,0,-1,107464,92536
1:3:2,1,1,107463,92537
1:4:3,0,-1,107464,92536
3:5:3,0,-1,107465,92535
4:2:1,1,1,107464,92536
5:5:3,0,-1,107465,92535
1:3:2,1,1,107464,92536
1:6:2,1,1,107463,92537
2:1:1,1,1,107462,92538
2:5:2,2,2,107460,92540
4:6:3,0,-1,107461,92539
2:6:1,1,1,107460,92540
5:4:5,0,-1,107461,92539
2:1:6,1,1,107460,92540
2:3:3,1,1,107459,92541
4:2:2,2,2,107457,92543
3:2:4,1,1,107456,92544
4:1:3,0,-1,107457,92543
3:6:5,0,-1,107458,92542
1:6:3,0,-1,107459,92541
2:2:1,2,2,107457,92543
1:2:4,1,1,107456,92544
3:2:1,1,1,107455,92545
4:1:4,0,-1,107456,92544
4:6:6,0,-1,107457,92543
2:4:6,1,1,107456,92544
3:4:3,0,-1,107457,92543
4:3:2,1,1,107456,92544
6:2:2,2,2,107454,92546
6:3:3,0,-1,107455,92545
5:1:6,0,-1,107456,92544
6:3:2,1,1,107455,92545
4:5:5,0,-1,107456,92544
1:4:3,0,-1,107457,92543
6:4:1,0,-1,107458,92542
2:3:2,2,2,107456,92544
1:2:5,1,1,107455,92545
3:3:3,0,-1,107456,92544
2:1:4,1,1,107455,92545
1:6:2,1,1,107454,92546
1:5:2,1,1,107453,92547
2:2:4,2,2,107451,92549
5:2:2,2,2,107449,92551
5:2:3,1,1,107448,92552
6:3:1,0,-1,107449,92551
6:4:5,0,-1,107450,92550
6:6:5,0,-1,107451,92549
5:6:2,1,1,107450,92550
4:2:5,1,1,107449,92551
4:6:3,0,-1,107450,92550
3:2:3,1,1,107449,92551
3:4:4,0,-1,107450,92550
4:6:1,0,-1,107451,92549
5:4:5,0,-1,107452,92548
1:3:2,1,1,107451,92549
6:5:2,1,1,107450,92550
6:6:4,0,-1,107451,92549
5:4:5,0,-1,107452,92548
1:1:4,0,-1,107453,92547
4:6:6,0,-1,107454,92546
2:1:1,1,1,107453,92547
6:6:5,0,-1,107454,92546
1:1:5,0,-1,107455,92545
1:3:1,0,-1,107456,92544
1:6:5,0,-1,107457,92543
2:2:4,2,2,107455,92545
4:6:2,1,1,107454,92546
1:5:6,0,-1,107455,92545
6:5:2,1,1,107454,92546
6:2:6,1,1,107453,92547
1:1:3,0,-1,107454,92546
4:5:5,0,-1,107455,92545
2:1:1,1,1,107454,92546
5:2:2,2,2,107452,92548
5:3:1,0,-1,107453,92547
5:6:2,1,1,107452,92548
1:5:1,0,-1,107453,92547
3:3:3,0,-1,107454,92546
1:1:4,0,-1,107455,92545
6:4:6,0,-1,107456,92544
1:6:5,0,-1,107457,92543
1:6:3,0,-1,107458,92542
5:6:1,0,-1,107459,92541
5:6:6,0,-1,107460,92540
6:4:1,0,-1,107461,92539
3:4:6,0,-1,107462,92538
4:6:2,1,1,107461,92539
1:6:3,0,-1,107462,92538
5:4:3,0,-1,107463,92537
5:3:4,0,-1,107464,92536
5:1:1,0,-1,107465,92535
3:3:3,0,-1,107466,92534
1:6:4,0,-1,107467,92533
3:2:2,2,2,107465,92535
3:4:5,0,-1,107466,92534
6:2:6,1,1,107465,92535
6:2:3,1,1,107464,92536
3:3:3,0,-1,107465,92535
2:3:6,1,1,107464,92536
6:3:3,0,-1,107465,92535
3:3:4,0,-1,107466,92534
6:4:5,0,-1,107467,92533
6:3:6,0,-1,107468,92532
1:4:2,1,1,107467,92533
4:2:2,2,2,107465,92535
1:6:6,0,-1,107466,92534
5:1:3,0,-1,107467,92533
4:4:2,1,1,107466,92534
4:2:5,1,1,107465,92535
3:5:3,0,-1,107466,92534
3:5:5,0,-1,107467,92533
4:4:4,0,-1,107468,92532
1:4:1,0,-1,107469,92531
3:5:2,1,1,107468,92532
2:3:3,1,1,107467,92533
2:4:6,1,1,107466,92534
1:2:1,1,1,107465,92535
2:2:1,2,2,107463,92537
3:5:5,0,-1,107464,92536
1:4:4,0,-1,107465,92535
6:3:6,0,-1,107466,92534
4:6:3,0,-1,107467,92533
3:4:5,0,-1,107468,92532
3:5:5,0,-1,107469,92531
6:1:1,0,-1,107470,92530
3:4:4,0,-1,107471,92529
1:4:4,0,-1,107472,92528
5:4:2,1,1,107471,92529
4:4:6,0,-1,107472,92528
4:4:5,0,-1,107473,92527
5:1:3,0,-1,107474,92526
4:1:5,0,-1,107475,92525
4:6:5,0,-1,107476,92524
1:4:1,0,-1,107477,92523
1:1:3,0,-1,107478,92522
3:3:6,0,-1,107479,92521
3:5:6,0,-1,107480,92520
1:6:2,1,1,107479,92521
6:4:1,0,-1,107480,92520
1:2:3,1,1,107479,92521
6:4:1,0,-1,107480,92520
4:4:3,0,-1,107481,92519
6:2:2,2,2,107479,92521
2:4:3,1,1,107478,92522
1:3:2,1,1,107477,92523
2:5:6,1,1,107476,92524
2:2:1,2,2,107474,92526
6:5:1,0,-1,107475,92525
1:1:2,1,1,107474,92526
3:6:5,0,-1,107475,92525
1:5:3,0,-1,107476,92524
2:4:4,1,1,107475,92525
2:4:4,1,1,107474,92526
4:4:3,0,-1,107475,92525
5:3:2,1,1,107474,92526
6:5:5,0,-1,107475,92525
6:2:2,2,2,107473,92527
1:4:3,0,-1,107474,92526
3:1:2,1,1,107473,92527
3:5:1,0,-1,107474,92526
3:4:1,0,-1,107475,92525
4:5:4,0,-1,107476,92524
1:3:4,0,-1,107477,92523
3:3:5,0,-1,107478,92522
3:3:5,0,-1,107479,92521
3:2:2,2,2,107477,92523
1:2:2,2,2,107475,92525
2:2:1,2,2,107473,92527
4:1:3,0,-1,107474,92526
4:4:1,0,-1,107475,92525
3:3:3,0,-1,107476,92524
1:1:6,0,-1,107477,92523
3:4:5,0,-1,107478,92522
4:6:2,1,1,107477,92523
3:2:5,1,1,107476,92524
3:1:5,0,-1,107477,92523
6:3:2,1,1,107476,92524
2:2:2,3,3,107473,92527
1:3:6,0,-1,107474,92526
4:1:1,0,-1,107475,92525
2:6:6,1,1,107474,92526
4:2:5,1,1,107473,92527
2:1:5,1,1,107472,92528
3:3:1,0,-1,107473,92527
6:4:1,0,-1,107474,92526
4:2:6,1,1,107473,92527
3:4:1,0,-1,107474,92526
5:4:1,0,-1,107475,92525
1:5:6,0,-1,107476,92524
5:6:1,0,-1,107477,92523
3:4:3,0,-1,107478,92522
5:1:6,0,-1,107479,92521
1:2:3,1,1,107478,92522
1:6:3,0,-1,107479,92521
1:3:5,0,-1,107480,92520
1:1:3,0,-1,107481,92519
2:6:3,1,1,107480,92520
2:4:3,1,1,107479,92521
5:5:3,0,-1,107480,92520
1:1:3,0,-1,107481,92519
6:6:1,0,-1,107482,92518
3:6:5,0,-1,107483,92517
5:5:4,0,-1,107484,92516
1:3:3,0,-1,107485,92515
3:3:1,0,-1,107486,92514
1:5:3,0,-1,107487,92513
1:4:1,0,-1,107488,92512
5:6:5,0,-1,107489,92511
4:1:5,0,-1,107490,92510
5:4:2,1,1,107489,92511
3:6:2,1,1,107488,92512
3:5:3,0,-1,107489,92511
4:6:3,0,-1,107490,92510
6:3:6,0,-1,107491,92509
5:2:1,1,1,107490,92510
3:5:3,0,-1,107491,92509
5:1:5,0,-1,107492,92508
1:2:6,1,1,107491,92509
1:6:1,0,-1,107492,92508
1:3:3,0,-1,107493,92507
2:4:3,1,1,107492,92508
6:4:4,0,-1,107493,92507
6:2:5,1,1,107492,92508
3:4:6,0,-1,107493,92507
4:4:1,0,-1,107494,92506
3:2:2,2,2,107492,92508
6:3:1,0,-1,107493,92507
6:3:6,0,-1,107494,92506
6:1:6,0,-1,107495,92505
6:6:2,1,1,107494,92506
2:4:3,1,1,107493,92507
4:3:5,0,-1,107494,92506
1:6:5,0,-1,107495,92505
6:2:6,1,1,107494,92506
5:5:1,0,-1,107495,92505
5:3:4,0,-1,107496,92504
2:4:4,1,1,107495,92505
6:4:2,1,1,107494,92506
1:1:4,0,-1,107495,92505
4:6:5,0,-1,107496,92504
2:2:1,2,2,107494,92506
3:1:2,1,1,107493,92507
6:3:3,0,-1,107494,92506
1:5:1,0,-1,107495,92505
4:2:3,1,1,107494,92506
6:3:5,0,-1,107495,92505
3:6:6,0,-1,107496,92504
1:2:4,1,1,107495,92505
1:1:6,0,-1,107496,92504
1:1:6,0,-1,107497,92503
6:2:5,1,1,107496,92504
6:3:4,0,-1,107497,92503
2:1:2,2,2,107495,92505
6:3:6,0,-1,107496,92504
1:1:6,0,-1,107497,92503
6:3:5,0,-1,107498,92502
4:2:3,1,1,107497,92503
4:5:4,0,-1,107498,92502
3:4:2,1,1,107497,92503
4:4:5,0,-1,107498,92502
3:6:4,0,-1,107499,92501
3:3:4,0,-1,107500,92500
4:1:1,0,-1,107501,92499
1:4:1,0,-1,107502,92498
5:3:4,0,-1,107503,92497
3:5:1,0,-1,107504,92496
3:3:1,0,-1,107505,92495
2:5:1,1,1,107504,92496
1:2:5,1,1,107503,92497
1:4:4,0,-1,107504,92496
1:1:2,1,1,107503,92497
3:2:6,1,1,107502,92498
5:6:6,0,-1,107503,92497
1:6:2,1,1,107502,92498
1:2:3,1,1,107501,92499
5:2:1,1,1,107500,92500
2:5:4,1,1,107499,92501
3:5:1,0,-1,107500,92500
2:2:4,2,2,107498,92502
1:4:2,1,1,107497,92503
3:5:5,0,-1,107498,92502
4:3:1,0,-1,107499,92501
3:2:1,1,1,107498,92502
2:3:3,1,1,107497,92503
6:3:1,0,-1,107498,92502
5:2:2,2,2,107496,92504
1:2:3,1,1,107495,92505
2:5:1,1,1,107494,92506
4:2:1,1,1,107493,92507
2:6:6,1,1,107492,92508
3:4:3,0,-1,107493,92507
5:5:3,0,-1,107494,92506
3:4:3,0,-1,107495,92505
1:2:2,2,2,107493,92507
4:2:6,1,1,107492,92508
4:1:2,1,1,107491,92509
3:4:3,0,-1,107492,92508
6:3:1,0,-1,107493,92507
3:4:2,1,1,107492,92508
2:3:1,1,1,107491,92509
4:3:5,0,-1,107492,92508
5:5:1,0,-1,107493,92507
1:2:6,1,1,107492,92508
5:6:1,0,-1,107493,92507
3:1:1,0,-1,107494,92506
3:3:1,0,-1,107495,92505
6:3:3,0,-1,107496,92504
5:1:6,0,-1,107497,92503
5:3:6,0,-1,107498,92502
6:1:6,0,-1,107499,92501
4:5:4,0,-1,107500,92500
6:5:5,0,-1,107501,92499
4:3:2,1,1,107500,92500
4:4:1,0,-1,107501,92499
4:4:2,1,1,107500,92500
6:2:4,1,1,107499,92501
3:4:2,1,1,107498,92502
1:6:4,0,-1,107499,92501
1:4:2,1,1,107498,92502
1:5:3,0,-1,107499,92501
1:1:1,0,-1,107500,92500
3:4:5,0,-1,107501,92499
1:5:6,0,-1,107502,92498
2:2:4,2,2,107500,92500
3:6:1,0,-1,107501,92499
1:3:4,0,-1,107502,92498
1:3:5,0,-1,107503,92497
5:1:1,0,-1,107504,92496
3:1:3,0,-1,107505,92495
3:2:2,2,2,107503,92497
6:6:3,0,-1,107504,92496
5:5:3,0,-1,107505,92495
3:1:5,0,-1,107506,92494
2:4:3,1,1,107505,92495
2:6:1,1,1,107504,92496
4:1:5,0,-1,107505,92495
6:5:1,0,-1,107506,92494
3:6:5,0,-1,107507,92493
4:1:6,0,-1,107508,92492
1:1:6,0,-1,107509,92491
3:6:6,0,-1,107510,92490
4:1:2,1,1,107509,92491
1:2:4,1,1,107508,92492
3:1:2,1,1,107507,92493
2:5:5,1,1,107506,92494
2:6:3,1,1,107505,92495
1:3:2,1,1,107504,92496
6:3:3,0,-1,107505,92495
4:5:1,0,-1,107506,92494
3:2:1,1,1,107505,92495
1:5:2,1,1,107504,92496
3:1:6,0,-1,107505,92495
3:5:3,0,-1,107506,92494
3:2:2,2,2,107504,92496
3:6:3,0,-1,107505,92495
6:4:1,0,-1,107506,92494
3:2:3,1,1,107505,92495
5:5:4,0,-1,107506,92494
4:1:1,0,-1,107507,92493
4:2:4,1,1,107506,92494
6:3:6,0,-1,107507,92493
6:4:6,0,-1,107508,92492
2:4:1,1,1,107507,92493
6:3:4,0,-1,107508,92492
3:2:3,1,1,107507,92493
1:5:5,0,-1,107508,92492
5:5:5,0,-1,107509,92491
5:1:4,0,-1,107510,92490
3:5:6,0,-1,107511,92489
1:1:3,0,-1,107512,92488
2:2:5,2,2,107510,92490
1:1:4,0,-1,107511,92489
5:5:5,0,-1,107512,92488
4:5:4,0,-1,107513,92487
2:1:2,2,2,107511,92489
5:5:5,0,-1,107512,92488
5:5:6,0,-1,107513,92487
5:4:5,0,-1,107514,92486
5:3:4,0,-1,107515,92485
4:3:6,0,-1,107516,92484
2:3:1,1,1,107515,92485
5:5:1,0,-1,107516,92484
6:3:5,0,-1,107517,92483
3:3:5,0,-1,107518,92482
5:4:5,0,-1,107519,92481
4:2:2,2,2,107517,92483
1:2:4,1,1,107516,92484
3:1:2,1,1,107515,92485
3:1:5,0,-1,107516,92484
1:5:3,0,-1,107517,92483
5:5:1,0,-1,107518,92482
4:1:5,0,-1,107519,92481
4:3:1,0,-1,107520,92480
3:1:1,0,-1,107521,92479
2:4:2,2,2,107519,92481
5:6:6,0,-1,107520,92480
6:6:6,0,-1,107521,92479
3:3:2,1,1,107520,92480
4:4:2,1,1,107519,92481
3:6:6,0,-1,107520,92480
1:1:5,0,-1,107521,92479
3:4:2,1,1,107520,92480
4:1:2,1,1,107519,92481
2:1:5,1,1,107518,92482
2:3:1,1,1,107517,92483
2:2:1,2,2,107515,92485
2:3:2,2,2,107513,92487
4:6:3,0,-1,107514,92486
6:6:2,1,1,107513,92487
6:1:3,0,-1,107514,92486
1:6:5,0,-1,107515,92485
1:1:5,0,-1,107516,92484
2:2:4,2,2,107514,92486
6:6:6,0,-1,107515,92485
3:1:2,1,1,107514,92486
5:5:2,1,1,107513,92487
2:2:3,2,2,107511,92489
5:5:6,0,-1,107512,92488
6:2:2,2,2,107510,92490
2:2:4,2,2,107508,92492
1:6:5,0,-1,107509,92491
5:4:4,0,-1,107510,92490
3:6:2,1,1,107509,92491
1:5:6,0,-1,107510,92490
3:1:1,0,-1,107511,92489
6:1:6,0,-1,107512,92488
3:4:1,0,-1,107513,92487
5:2:4,1,1,107512,92488
4:5:6,0,-1,107513,92487
1:5:2,1,1,107512,92488
1:1:5,0,-1,107513,92487
4:2:3,1,1,107512,92488
6:3:2,1,1,107511,92489
5:6:5,0,-1,107512,92488
3:4:2,1,1,107511,92489
1:6:2,1,1,107510,92490
6:5:5,0,-1,107511,92489
4:6:1,0,-1,107512,92488
2:4:5,1,1,107511,92489
3:1:4,0,-1,107512,92488
2:1:4,1,1,107511,92489
6:5:5,0,-1,107512,92488
2:4:2,2,2,107510,92490
2:3:1,1,1,107509,92491
6:6:2,1,1,107508,92492
3:3:5,0,-1,107509,92491
6:6:1,0,-1,107510,92490
2:6:1,1,1,107509,92491
3:3:3,0,-1,107510,92490
2:4:3,1,1,107509,92491
1:4:1,0,-1,107510,92490
4:3:1,0,-1,107511,92489
5:3:6,0,-1,107512,92488
3:2:4,1,1,107511,92489
5:5:5,0,-1,107512,92488
6:6:6,0,-1,107513,92487
5:5:2,1,1,107512,92488
6:1:2,1,1,107511,92489
6:3:5,0,-1,107512,92488
2:1:4,1,1,107511,92489
2:2:4,2,2,107509,92491
6:5:5,0,-1,107510,92490
6:6:5,0,-1,107511,92489
4:2:4,1,1,107510,92490
4:1:2,1,1,107509,92491
2:5:3,1,1,107508,92492
2:1:2,2,2,107506,92494
2:2:1,2,2,107504,92496
4:5:6,0,-1,107505,92495
5:5:6,0,-1,107506,92494
1:6:6,0,-1,107507,92493
2:6:4,1,1,107506,92494
3:5:5,0,-1,107507,92493
4:3:2,1,1,107506,92494
5:5:3,0,-1,107507,92493
1:5:5,0,-1,107508,92492
6:2:2,2,2,107506,92494
4:2:5,1,1,107505,92495
3:5:2,1,1,107504,92496
4:3:6,0,-1,107505,92495
3:5:2,1,1,107504,92496
2:6:6,1,1,107503,92497
4:4:5,0,-1,107504,92496
1:1:4,0,-1,107505,92495
4:3:6,0,-1,107506,92494
1:5:3,0,-1,107507,92493
4:3:2,1,1,107506,92494
4:6:2,1,1,107505,92495
5:5:1,0,-1,107506,92494
3:3:2,1,1,107505,92495
5:2:3,1,1,107504,92496
3:4:2,1,1,107503,92497
3:6:5,0,-1,107504,92496
6:1:1,0,-1,107505,92495
2:2:3,2,2,107503,92497
1:2:5,1,1,107502,92498
4:4:6,0,-1,107503,92497
1:4:2,1,1,107502,92498
1:1:5,0,-1,107503,92497
1:3:4,0,-1,107504,92496
1:5:3,0,-1,107505,92495
2:3:6,1,1,107504,92496
5:5:1,0,-1,107505,92495
6:5:3,0,-1,107506,92494
4:1:2,1,1,107505,92495
4:5:4,0,-1,107506,92494
2:1:2,2,2,107504,92496
4:1:3,0,-1,107505,92495
2:2:3,2,2,107503,92497
6:1:5,0,-1,107504,92496
4:1:5,0,-1,107505,92495
4:1:5,0,-1,107506,92494
5:1:4,0,-1,107507,92493
3:5:4,0,-1,107508,92492
6:2:4,1,1,107507,92493
4:2:3,1,1,107506,92494
4:4:5,0,-1,107507,92493
1:1:1,0,-1,107508,92492
4:5:1,0,-1,107509,92491
4:5:1,0,-1,107510,92490
5:5:2,1,1,107509,92491
2:1:1,1,1,107508,92492
2:6:2,2,2,107506,92494
3:3:2,1,1,107505,92495
5:3:4,0,-1,107506,92494
3:1:6,0,-1,107507,92493
5:3:6,0,-1,107508,92492
5:1:2,1,1,107507,92493
1:2:2,2,2,107505,92495
6:1:5,0,-1,107506,92494
4:1:3,0,-1,107507,92493
3:5:6,0,-1,107508,92492
5:1:5,0,-1,107509,92491
4:5:1,0,-1,107510,92490
5:5:4,0,-1,107511,92489
1:2:1,1,1,107510,92490
4:6:1,0,-1,107511,92489
2:4:2,2,2,107509,92491
3:2:5,1,1,107508,92492
4:3:4,0,-1,107509,92491
5:4:6,0,-1,107510,92490
2:3:4,1,1,107509,92491
3:3:3,0,-1,107510,92490
6:3:4,0,-1,107511,92489
1:4:3,0,-1,107512,92488
4:2:4,1,1,107511,92489
1:3:1,0,-1,107512,92488
3:6:4,0,-1,107513,92487
2:6:4,1,1,107512,92488
3:1:1,0,-1,107513,92487
5:4:5,0,-1,107514,92486
2:1:5,1,1,107513,92487
6:5:4,0,-1,107514,92486
2:3:2,2,2,107512,92488
4:1:4,0,-1,107513,92487
4:3:5,0,-1,107514,92486
6:6:4,0,-1,107515,92485
4:4:3,0,-1,107516,92484
2:5:3,1,1,107515,92485
2:5:6,1,1,107514,92486
3:2:1,1,1,107513,92487
3:4:3,0,-1,107514,92486
5:2:6,1,1,107513,92487
6:1:4,0,-1,107514,92486
6:3:6,0,-1,107515,92485
4:5:6,0,-1,107516,92484
3:1:1,0,-1,107517,92483
2:3:6,1,1,107516,92484
3:1:5,0,-1,107517,92483
1:5:2,1,1,107516,92484
5:4:1,0,-1,107517,92483
2:1:5,1,1,107516,92484
5:6:2,1,1,107515,92485
3:6:6,0,-1,107516,92484
2:4:5,1,1,107515,92485
4:4:4,0,-1,107516,92484
1:5:5,0,-1,107517,92483
4:4:2,1,1,107516,92484
1:1:3,0,-1,107517,92483
6:1:5,0,-1,107518,92482
5:3:1,0,-1,107519,92481
6:2:4,1,1,107518,92482
1:5:4,0,-1,107519,92481
2:4:1,1,1,107518,92482
3:2:6,1,1,107517,92483
5:4:4,0,-1,107518,92482
6:2:1,1,1,107517,92483
2:3:1,1,1,107516,92484
3:4:5,0,-1,107517,92483
3:6:4,0,-1,107518,92482
5:6:3,0,-1,107519,92481
2:1:2,2,2,107517,92483
5:1:6,0,-1,107518,92482
1:4:1,0,-1,107519,92481
3:1:4,0,-1,107520,92480
6:4:6,0,-1,107521,92479
4:6:1,0,-1,107522,92478
2:3:5,1,1,107521,92479
4:5:4,0,-1,107522,92478
4:2:2,2,2,107520,92480
3:3:6,0,-1,107521,92479
6:5:6,0,-1,107522,92478
5:2:5,1,1,107521,92479
6:1:5,0,-1,107522,92478
6:3:5,0,-1,107523,92477
2:1:2,2,2,107521,92479
2:3:2,2,2,107519,92481
2:5:6,1,1,107518,92482
4:4:3,0,-1,107519,92481
3:4:4,0,-1,107520,92480
2:6:5,1,1,107519,92481
2:5:2,2,2,107517,92483
5:4:6,0,-1,107518,92482
5:6:4,0,-1,107519,92481
1:2:4,1,1,107518,92482
5:2:6,1,1,107517,92483
3:4:1,0,-1,107518,92482
3:4:2,1,1,107517,92483
6:3:1,0,-1,107518,92482
4:6:6,0,-1,107519,92481
5:3:6,0,-1,107520,92480
5:6:6,0,-1,107521,92479
6:1:2,1,1,107520,92480
2:6:6,1,1,107519,92481
1:2:2,2,2,107517,92483
3:5:2,1,1,107516,92484
2:1:1,1,1,107515,92485
5:3:5,0,-1,107516,92484
3:4:6,0,-1,107517,92483
6:6:4,0,-1,107518,92482
2:6:3,1,1,107517,92483
5:3:2,1,1,107516,92484
2:2:4,2,2,107514,92486
1:6:1,0,-1,107515,92485
5:1:1,0,-1,107516,92484
4:1:5,0,-1,107517,92483
5:2:6,1,1,107516,92484
4:1:3,0,-1,107517,92483
4:1:1,0,-1,107518,92482
5:5:3,0,-1,107519,92481
2:1:2,2,2,107517,92483
2:6:2,2,2,107515,92485
6:3:5,0,-1,107516,92484
5:1:6,0,-1,107517,92483
1:3:6,0,-1,107518,92482
6:3:5,0,-1,107519,92481
2:6:1,1,1,107518,92482
4:3:4,0,-1,107519,92481
3:6:4,0,-1,107520,92480
6:3:1,0,-1,107521,92479
2:4:3,1,1,107520,92480
2:5:1,1,1,107519,92481
6:4:1,0,-1,107520,92480
6:5:5,0,-1,107521,92479
2:5:1,1,1,107520,92480
5:6:1,0,-1,107521,92479
3:6:3,0,-1,107522,92478
6:5:5,0,-1,107523,92477
6:3:1,0,-1,107524,92476
2:6:6,1,1,107523,92477
5:6:1,0,-1,107524,92476
2:4:6,1,1,107523,92477
3:2:3,1,1,107522,92478
4:6:4,0,-1,107523,92477
1:6:6,0,-1,107524,92476
4:1:4,0,-1,107525,92475
4:4:4,0,-1,107526,92474
5:6:6,0,-1,107527,92473
2:1:4,1,1,107526,92474
2:1:3,1,1,107525,92475
1:5:2,1,1,107524,92476
5:6:6,0,-1,107525,92475
1:4:6,0,-1,107526,92474
2:6:6,1,1,107525,92475
5:2:2,2,2,107523,92477
3:4:4,0,-1,107524,92476
6:6:3,0,-1,107525,92475
6:6:5,0,-1,107526,92474
1:2:4,1,1,107525,92475
3:2:3,1,1,107524,92476
4:2:5,1,1,107523,92477
1:2:5,1,1,107522,92478
5:2:5,1,1,107521,92479
1:5:1,0,-1,107522,92478
1:5:1,0,-1,107523,92477
3:2:1,1,1,107522,92478
3:1:2,1,1,107521,92479
3:1:5,0,-1,107522,92478
2:2:2,3,3,107519,92481
4:3:1,0,-1,107520,92480
2:4:1,1,1,107519,92481
2:3:2,2,2,107517,92483
5:2:3,1,1,107516,92484
2:3:5,1,1,107515,92485
2:5:1,1,1,107514,92486
4:3:5,0,-1,107515,92485
3:5:6,0,-1,107516,92484
2:2:1,2,2,107514,92486
2:1:4,1,1,107513,92487
2:4:1,1,1,107512,92488
2:1:4,1,1,107511,92489
5:5:1,0,-1,107512,92488
3:5:4,0,-1,107513,92487
5:5:3,0,-1,107514,92486
6:1:6,0,-1,107515,92485
3:5:6,0,-1,107516,92484
6:2:4,1,1,107515,92485
2:5:5,1,1,107514,92486
2:6:1,1,1,107513,92487
6:4:1,0,-1,107514,92486
5:1:2,1,1,107513,92487
4:5:1,0,-1,107514,92486
5:2:4,1,1,107513,92487
6:5:1,0,-1,107514,92486
6:4:6,0,-1,107515,92485
3:6:5,0,-1,107516,92484
6:3:6,0,-1,107517,92483
1:5:3,0,-1,107518,92482
4:3:4,0,-1,107519,92481
1:3:1,0,-1,107520,92480
6:3:5,0,-1,107521,92479
1:1:4,0,-1,107522,92478
4:4:4,0,-1,107523,92477
5:5:6,0,-1,107524,92476
5:5:5,0,-1,107525,92475
3:3:4,0,-1,107526,92474
1:6:4,0,-1,107527,92473
3:1:6,0,-1,107528,92472
3:3:6,0,-1,107529,92471
2:6:6,1,1,107528,92472
1:4:3,0,-1,107529,92471
5:1:4,0,-1,107530,92470
5:6:5,0,-1,107531,92469
4:4:4,0,-1,107532,92468
6:1:2,1,1,107531,92469
6:3:3,0,-1,107532,92468
1:5:3,0,-1,107533,92467
1:2:5,1,1,107532,92468
4:3:3,0,-1,107533,92467
6:3:1,0,-1,107534,92466
5:2:5,1,1,107533,92467
2:4:1,1,1,107532,92468
5:4:1,0,-1,107533,92467
4:2:1,1,1,107532,92468
1:4:6,0,-1,107533,92467
1:6:2,1,1,107532,92468
1:5:3,0,-1,107533,92467
6:1:2,1,1,107532,92468
6:4:3,0,-1,107533,92467
3:6:3,0,-1,107534,92466
3:2:6,1,1,107533,92467
2:4:2,2,2,107531,92469
3:1:3,0,-1,107532,92468
3:1:4,0,-1,107533,92467
2:3:3,1,1,107532,92468
6:5:2,1,1,107531,92469
3:4:3,0,-1,107532,92468
3:1:3,0,-1,107533,92467
3:2:5,1,1,107532,92468
5:2:1,1,1,107531,92469
6:6:4,0,-1,107532,92468
4:4:5,0,-1,107533,92467
2:3:5,1,1,107532,92468
6:6:5,0,-1,107533,92467
2:5:2,2,2,107531,92469
4:4:2,1,1,107530,92470
3:2:2,2,2,107528,92472
2:5:2,2,2,107526,92474
5:2:2,2,2,107524,92476
6:2:6,1,1,107523,92477
3:4:1,0,-1,107524,92476
1:6:4,0,-1,107525,92475
5:5:3,0,-1,107526,92474
1:1:6,0,-1,107527,92473
1:6:1,0,-1,107528,92472
4:5:5,0,-1,107529,92471
2:4:5,1,1,107528,92472
4:3:1,0,-1,107529,92471
2:1:5,1,1,107528,92472
1:1:1,0,-1,107529,92471
4:3:1,0,-1,107530,92470
2:4:2,2,2,107528,92472
3:2:3,1,1,107527,92473
1:2:4,1,1,107526,92474
4:5:5,0,-1,107527,92473
6:1:2,1,1,107526,92474
1:5:1,0,-1,107527,92473
5:4:1,0,-1,107528,92472
2:4:2,2,2,107526,92474
2:2:2,3,3,107523,92477
1:4:4,0,-1,107524,92476
4:2:2,2,2,107522,92478
3:4:5,0,-1,107523,92477
6:2:4,1,1,107522,92478
4:4:4,0,-1,107523,92477
3:1:4,0,-1,107524,92476
3:6:5,0,-1,107525,92475
5:4:3,0,-1,107526,92474
5:6:5,0,-1,107527,92473
3:6:2,1,1,107526,92474
6:3:2,1,1,107525,92475
4:3:1,0,-1,107526,92474
6:2:2,2,2,107524,92476
4:1:4,0,-1,107525,92475
3:5:1,0,-1,107526,92474
3:6:1,0,-1,107527,92473
5:2:2,2,2,107525,92475
4:2:5,1,1,107524,92476
4:1:1,0,-1,107525,92475
2:1:6,1,1,107524,92476
6:6:1,0,-1,107525,92475
5:5:3,0,-1,107526,92474
3:5:3,0,-1,107527,92473
3:6:5,0,-1,107528,92472
4:3:1,0,-1,107529,92471
5:2:1,1,1,107528,92472
6:2:1,1,1,107527,92473
3:6:3,0,-1,107528,92472
2:5:1,1,1,107527,92473
6:2:6,1,1,107526,92474
6:6:1,0,-1,107527,92473
2:6:4,1,1,107526,92474
6:3:6,0,-1,107527,92473
6:2:6,1,1,107526,92474
5:5:1,0,-1,107527,92473
3:5:5,0,-1,107528,92472
4:2:6,1,1,107527,92473
2:1:4,1,1,107526,92474
4:3:3,0,-1,107527,92473
4:1:1,0,-1,107528,92472
1:3:2,1,1,107527,92473
3:4:5,0,-1,107528,92472
2:6:3,1,1,107527,92473
1:6:5,0,-1,107528,92472
1:5:1,0,-1,107529,92471
1:2:3,1,1,107528,92472
3:4:2,1,1,107527,92473
2:2:4,2,2,107525,92475
5:1:1,0,-1,107526,92474
4:4:1,0,-1,107527,92473
2:6:1,1,1,107526,92474
3:3:5,0,-1,107527,92473
5:2:6,1,1,107526,92474
6:4:2,1,1,107525,92475
1:1:1,0,-1,107526,92474
6:6:5,0,-1,107527,92473
6:6:5,0,-1,107528,92472
3:1:5,0,-1,107529,92471
1:5:5,0,-1,107530,92470
6:1:5,0,-1,107531,92469
6:3:4,0,-1,107532,92468
5:5:3,0,-1,107533,92467
3:3:4,0,-1,107534,92466
2:3:1,1,1,107533,92467
2:3:4,1,1,107532,92468
2:4:6,1,1,107531,92469
1:3:6,0,-1,107532,92468
4:4:1,0,-1,107533,92467
2:3:6,1,1,107532,92468
4:3:6,0,-1,107533,92467
4:3:6,0,-1,107534,92466
4:6:5,0,-1,107535,92465
1:5:1,0,-1,107536,92464
1:2:4,1,1,107535,92465
6:1:2,1,1,107534,92466
2:4:4,1,1,107533,92467
6:6:3,0,-1,107534,92466
4:4:1,0,-1,107535,92465
5:2:6,1,1,107534,92466
1:2:1,1,1,107533,92467
1:5:1,0,-1,107534,92466
4:2:6,1,1,107533,92467
2:4:6,1,1,107532,92468
1:4:1,0,-1,107533,92467
2:5:5,1,1,107532,92468
1:2:1,1,1,107531,92469
2:5:3,1,1,107530,92470
6:2:6,1,1,107529,92471
2:1:6,1,1,107528,92472
5:3:1,0,-1,107529,92471
2:5:3,1,1,107528,92472
3:2:2,2,2,107526,92474
1:2:6,1,1,107525,92475
6:5:5,0,-1,107526,92474
5:1:6,0,-1,107527,92473
5:6:6,0,-1,107528,92472
4:1:2,1,1,107527,92473
4:3:4,0,-1,107528,92472
1:1:1,0,-1,107529,92471
4:6:3,0,-1,107530,92470
1:1:3,0,-1,107531,92469
2:5:6,1,1,107530,92470
1:6:6,0,-1,107531,92469
1:1:5,0,-1,107532,92468
6:5:2,1,1,107531,92469
5:5:6,0,-1,107532,92468
6:5:1,0,-1,107533,92467
4:1:4,0,-1,107534,92466
5:3:4,0,-1,107535,92465
2:5:3,1,1,107534,92466
3:5:4,0,-1,107535,92465
1:1:6,0,-1,107536,92464
3:6:5,0,-1,107537,92463
4:4:5,0,-1,107538,92462
4:4:2,1,1,107537,92463
4:2:1,1,1,107536,92464
5:5:5,0,-1,107537,92463
3:1:4,0,-1,107538,92462
1:1:3,0,-1,107539,92461
4:5:1,0,-1,107540,92460
2:4:4,1,1,107539,92461
2:2:6,2,2,107537,92463
2:2:3,2,2,107535,92465
4:2:3,1,1,107534,92466
4:2:5,1,1,107533,92467
2:5:2,2,2,107531,92469
1:2:4,1,1,107530,92470
4:3:5,0,-1,107531,92469
6:5:4,0,-1,107532,92468
3:4:1,0,-1,107533,92467
4:3:6,0,-1,107534,92466
6:3:1,0,-1,107535,92465
4:1:1,0,-1,107536,92464
5:5:6,0,-1,107537,92463
1:6:3,0,-1,107538,92462
4:2:6,1,1,107537,92463
5:2:5,1,1,107536,92464
3:4:5,0,-1,107537,92463
2:4:4,1,1,107536,92464
1:3:6,0,-1,107537,92463
3:5:1,0,-1,107538,92462
1:3:3,0,-1,107539,92461
4:3:4,0,-1,107540,92460
3:4:6,0,-1,107541,92459
6:3:5,0,-1,107542,92458
4:5:5,0,-1,107543,92457
6:5:1,0,-1,107544,92456
5:4:6,0,-1,107545,92455
6:3:3,0,-1,107546,92454
4:6:4,0,-1,107547,92453
1:2:3,1,1,107546,92454
5:3:6,0,-1,107547,92453
3:1:3,0,-1,107548,92452
3:3:4,0,-1,107549,92451
5:6:5,0,-1,107550,92450
6:5:1,0,-1,107551,92449
6:5:4,0,-1,107552,92448
3:2:5,1,1,107551,92449
6:3:3,0,-1,107552,92448
2:5:2,2,2,107550,92450
4:5:4,0,-1,107551,92449
1:1:4,0,-1,107552,92448
2:2:2,3,3,107549,92451
5:4:5,0,-1,107550,92450
2:6:3,1,1,107549,92451
5:3:5,0,-1,107550,92450
6:6:5,0,-1,107551,92449
4:5:4,0,-1,107552,92448
2:4:1,1,1,107551,92449
1:3:3,0,-1,107552,92448
3:6:6,0,-1,107553,92447
3:1:2,1,1,107552,92448
4:4:3,0,-1,107553,92447
2:4:4,1,1,107552,92448
3:6:2,1,1,107551,92449
2:3:4,1,1,107550,92450
5:4:4,0,-1,107551,92449
5:1:6,0,-1,107552,92448
4:5:4,0,-1,107553,92447
6:5:4,0,-1,107554,92446
5:5:6,0,-1,107555,92445
3:4:2,1,1,107554,92446
3:5:5,0,-1,107555,92445
6:6:4,0,-1,107556,92444
1:6:4,0,-1,107557,92443
5:6:4,0,-1,107558,92442
1:1:4,0,-1,107559,92441
5:4:5,0,-1,107560,92440
2:5:2,2,2,107558,92442
4:1:1,0,-1,107559,92441
2:6:5,1,1,107558,92442
6:2:1,1,1,107557,92443
6:6:1,0,-1,107558,92442
5:2:5,1,1,107557,92443
1:1:4,0,-1,107558,92442
1:1:4,0,-1,107559,92441
5:1:4,0,-1,107560,92440
2:1:2,2,2,107558,92442
2:5:3,1,1,107557,92443
1:1:3,0,-1,107558,92442
4:5:2,1,1,107557,92443
5:3:6,0,-1,107558,92442
2:2:4,2,2,107556,92444
4:1:2,1,1,107555,92445
4:6:4,0,-1,107556,92444
6:1:3,0,-1,107557,92443
5:1:1,0,-1,107558,92442
4:6:2,1,1,107557,92443
2:2:3,2,2,107555,92445
2:5:5,1,1,107554,92446
2:6:3,1,1,107553,92447
2:6:3,1,1,107552,92448
5:1:6,0,-1,107553,92447
1:6:6,0,-1,107554,92446
4:2:4,1,1,107553,92447
1:3:4,0,-1,107554,92446
5:2:3,1,1,107553,92447
4:1:6,0,-1,107554,92446
5:4:5,0,-1,107555,92445
4:4:3,0,-1,107556,92444
2:6:4,1,1,107555,92445
4:6:2,1,1,107554,92446
6:5:1,0,-1,107555,92445
4:3:6,0,-1,107556,92444
6:5:6,0,-1,107557,92443
5:2:1,1,1,107556,92444
5:3:6,0,-1,107557,92443
3:5:4,0,-1,107558,92442
2:4:4,1,1,107557,92443
4:1:6,0,-1,107558,92442
2:3:6,1,1,107557,92443
5:5:2,1,1,107556,92444
2:2:5,2,2,107554,92446
5:5:6,0,-1,107555,92445
4:6:3,0,-1,107556,92444
4:6:4,0,-1,107557,92443
6:1:5,0,-1,107558,92442
2:6:1,1,1,107557,92443
2:1:4,1,1,107556,92444
2:6:2,2,2,107554,92446
2:2:2,3,3,107551,92449
1:1:6,0,-1,107552,92448
4:2:6,1,1,107551,92449
4:1:4,0,-1,107552,92448
4:4:2,1,1,107551,92449
1:1:5,0,-1,107552,92448
4:3:4,0,-1,107553,92447
4:3:6,0,-1,107554,92446
1:1:4,0,-1,107555,92445
2:4:2,2,2,107553,92447
1:2:4,1,1,107552,92448
5:4:1,0,-1,107553,92447
5:6:1,0,-1,107554,92446
1:2:4,1,1,107553,92447
6:4:2,1,1,107552,92448
4:6:6,0,-1,107553,92447
4:4:4,0,-1,107554,92446
6:3:4,0,-1,107555,92445
3:2:6,1,1,107554,92446
4:3:2,1,1,107553,92447
1:2:2,2,2,107551,92449
6:2:2,2,2,107549,92451
1:1:5,0,-1,107550,92450
1:2:1,1,1,107549,92451
6:4:6,0,-1,107550,92450
5:5:5,0,-1,107551,92449
1:6:6,0,-1,107552,92448
6:1:5,0,-1,107553,92447
6:3:3,0,-1,107554,92446
1:6:1,0,-1,107555,92445
5:4:4,0,-1,107556,92444
2:3:4,1,1,107555,92445
5:6:1,0,-1,107556,92444
1:5:5,0,-1,107557,92443
3:3:3,0,-1,107558,92442
6:3:6,0,-1,107559,92441
2:5:2,2,2,107557,92443
5:2:4,1,1,107556,92444
4:3:2,1,1,107555,92445
5:6:6,0,-1,107556,92444
6:5:6,0,-1,107557,92443
3:3:6,0,-1,107558,92442
2:4:4,1,1,107557,92443
4:2:6,1,1,107556,92444
1:6:1,0,-1,107557,92443
3:4:2,1,1,107556,92444
1:3:5,0,-1,107557,92443
5:1:2,1,1,107556,92444
6:1:2,1,1,107555,92445
3:1:1,0,-1,107556,92444
2:2:4,2,2,107554,92446
3:5:4,0,-1,107555,92445
5:4:2,1,1,107554,92446
3:5:2,1,1,107553,92447
4:3:1,0,-1,107554,92446
6:2:4,1,1,107553,92447
4:3:2,1,1,107552,92448
3:1:1,0,-1,107553,92447
3:4:4,0,-1,107554,92446
6:1:1,0,-1,107555,92445
2:5:5,1,1,107554,92446
1:1:3,0,-1,107555,92445
5:1:5,0,-1,107556,92444
5:4:1,0,-1,107557,92443
4:2:5,1,1,107556,92444
6:2:3,1,1,107555,92445
2:5:1,1,1,107554,92446
6:3:5,0,-1,107555,92445
2:5:3,1,1,107554,92446
3:4:6,0,-1,107555,92445
6:6:4,0,-1,107556,92444
2:6:1,1,1,107555,92445
5:5:5,0,-1,107556,92444
6:5:3,0,-1,107557,92443
5:5:2,1,1,107556,92444
2:1:4,1,1,107555,92445
2:4:3,1,1,107554,92446
6:1:5,0,-1,107555,92445
6:6:5,0,-1,107556,92444
4:2:2,2,2,107554,92446
4:4:4,0,-1,107555,92445
5:4:2,1,1,107554,92446
1:6:3,0,-1,107555,92445
6:6:2,1,1,107554,92446
5:2:4,1,1,107553,92447
5:5:6,0,-1,107554,92446
1:2:1,1,1,107553,92447
2:1:5,1,1,107552,92448
1:2:6,1,1,107551,92449
1:4:5,0,-1,107552,92448
6:1:1,0,-1,107553,92447
2:2:5,2,2,107551,92449
1:5:1,0,-1,107552,92448
4:5:6,0,-1,107553,92447
3:3:6,0,-1,107554,92446
5:2:6,1,1,107553,92447
3:3:1,0,-1,107554,92446
5:6:2,1,1,107553,92447
1:4:6,0,-1,107554,92446
3:3:2,1,1,107553,92447
1:6:6,0,-1,107554,92446
4:3:1,0,-1,107555,92445
3:3:3,0,-1,107556,92444
4:3:1,0,-1,107557,92443
5:5:6,0,-1,107558,92442
6:3:3,0,-1,107559,92441
4:2:4,1,1,107558,92442
6:2:5,1,1,107557,92443
5:1:4,0,-1,107558,92442
5:6:3,0,-1,107559,92441
6:4:6,0,-1,107560,92440
5:4:2,1,1,107559,92441
6:1:4,0,-1,107560,92440
3:6:1,0,-1,107561,92439
1:1:5,0,-1,107562,92438
1:6:3,0,-1,107563,92437
6:3:2,1,1,107562,92438
4:1:1,0,-1,107563,92437
6:4:3,0,-1,107564,92436
2:5:1,1,1,107563,92437
5:2:1,1,1,107562,92438
4:1:4,0,-1,107563,92437
4:4:1,0,-1,107564,92436
3:6:5,0,-1,107565,92435
2:1:5,1,1,107564,92436
3:1:4,0,-1,107565,92435
5:3:6,0,-1,107566,92434
3:3:6,0,-1,107567,92433
1:1:2,1,1,107566,92434
5:6:4,0,-1,107567,92433
1:3:5,0,-1,107568,92432
2:1:2,2,2,107566,92434
2:3:5,1,1,107565,92435
3:1:1,0,-1,107566,92434
2:3:5,1,1,107565,92435
6:4:2,1,1,107564,92436
3:4:3,0,-1,107565,92435
3:6:1,0,-1,107566,92434
3:3:4,0,-1,107567,92433
1:3:3,0,-1,107568,92432
3:3:4,0,-1,107569,92431
6:5:2,1,1,107568,92432
2:1:6,1,1,107567,92433
4:2:1,1,1,107566,92434
6:2:4,1,1,107565,92435
3:1:4,0,-1,107566,92434
1:3:3,0,-1,107567,92433
5:3:2,1,1,107566,92434
6:1:2,1,1,107565,92435
5:2:4,1,1,107564,92436
4:1:2,1,1,107563,92437
6:1:3,0,-1,107564,92436
6:3:1,0,-1,107565,92435
3:3:5,0,-1,107566,92434
4:2:4,1,1,107565,92435
5:4:2,1,1,107564,92436
6:5:5,0,-1,107565,92435
6:3:6,0,-1,107566,92434
2:5:1,1,1,107565,92435
3:6:1,0,-1,107566,92434
4:2:2,2,2,107564,92436
1:6:5,0,-1,107565,92435
4:5:4,0,-1,107566,92434
5:3:2,1,1,107565,92435
3:2:5,1,1,107564,92436
1:4:5,0,-1,107565,92435
3:5:2,1,1,107564,92436
6:4:6,0,-1,107565,92435
3:3:1,0,-1,107566,92434
2:4:1,1,1,107565,92435
6:2:3,1,1,107564,92436
4:1:4,0,-1,107565,92435
1:6:2,1,1,107564,92436
3:5:4,0,-1,107565,92435
3:4:2,1,1,107564,92436
3:5:5,0,-1,107565,92435
3:6:3,0,-1,107566,92434
6:4:5,0,-1,107567,92433
4:1:2,1,1,107566,92434
3:4:6,0,-1,107567,92433
2:6:3,1,1,107566,92434
5:2:2,2,2,107564,92436
1:1:5,0,-1,107565,92435
6:3:5,0,-1,107566,92434
6:6:2,1,1,107565,92435
5:6:6,0,-1,107566,92434
4:6:1,0,-1,107567,92433
1:5:6,0,-1,107568,92432
1:5:5,0,-1,107569,92431
2:6:3,1,1,107568,92432
1:2:4,1,1,107567,92433
4:2:4,1,1,107566,92434
3:5:3,0,-1,107567,92433
3:6:3,0,-1,107568,92432
3:2:3,1,1,107567,92433
1:4:1,0,-1,107568,92432
6:5:1,0,-1,107569,92431
2:3:1,1,1,107568,92432
1:4:6,0,-1,107569,92431
1:3:6,0,-1,107570,92430
5:4:3,0,-1,107571,92429
3:2:4,1,1,107570,92430
3:4:4,0,-1,107571,92429
6:5:2,1,1,107570,92430
4:6:5,0,-1,107571,92429
6:6:6,0,-1,107572,92428
2:3:2,2,2,107570,92430
6:2:1,1,1,107569,92431
6:1:4,0,-1,107570,92430
6:1:6,0,-1,107571,92429
1:1:2,1,1,107570,92430
3:1:3,0,-1,107571,92429
3:5:2,1,1,107570,92430
1:4:4,0,-1,107571,92429
2:4:5,1,1,107570,92430
6:2:4,1,1,107569,92431
5:3:5,0,-1,107570,92430
1:5:5,0,-1,107571,92429
5:6:1,0,-1,107572,92428
2:3:4,1,1,107571,92429
3:5:3,0,-1,107572,92428
6:2:6,1,1,107571,92429
2:5:3,1,1,107570,92430
1:5:4,0,-1,107571,92429
4:6:6,0,-1,107572,92428
5:5:2,1,1,107571,92429
2:5:2,2,2,107569,92431
4:2:6,1,1,107568,92432
4:6:2,1,1,107567,92433
5:3:1,0,-1,107568,92432
6:3:4,0,-1,107569,92431
5:2:2,2,2,107567,92433
5:1:2,1,1,107566,92434
6:4:3,0,-1,107567,92433
6:2:2,2,2,107565,92435
4:3:4,0,-1,107566,92434
4:6:5,0,-1,107567,92433
2:6:3,1,1,107566,92434
2:4:6,1,1,107565,92435
1:6:1,0,-1,107566,92434
4:1:5,0,-1,107567,92433
4:5:1,0,-1,107568,92432
2:1:2,2,2,107566,92434
1:6:6,0,-1,107567,92433
5:5:2,1,1,107566,92434
2:1:6,1,1,107565,92435
1:3:6,0,-1,107566,92434
6:6:2,1,1,107565,92435
5:2:2,2,2,107563,92437
3:6:6,0,-1,107564,92436
3:3:6,0,-1,107565,92435
5:6:5,0,-1,107566,92434
2:4:3,1,1,107565,92435
1:1:1,0,-1,107566,92434
4:2:6,1,1,107565,92435
6:1:4,0,-1,107566,92434
5:2:1,1,1,107565,92435
4:6:6,0,-1,107566,92434
3:2:2,2,2,107564,92436
6:2:6,1,1,107563,92437
4:3:1,0,-1,107564,92436
6:4:3,0,-1,107565,92435
6:1:6,0,-1,107566,92434
4:1:2,1,1,107565,92435
1:6:3,0,-1,107566,92434
2:5:3,1,1,107565,92435
3:1:3,0,-1,107566,92434
3:3:2,1,1,107565,92435
6:2:6,1,1,107564,92436
4:6:1,0,-1,107565,92435
1:6:2,1,1,107564,92436
1:2:2,2,2,107562,92438
3:5:1,0,-1,107563,92437
6:5:2,1,1,107562,92438
4:6:4,0,-1,107563,92437
4:6:3,0,-1,107564,92436
2:3:3,1,1,107563,92437
6:2:6,1,1,107562,92438
6:4:2,1,1,107561,92439
4:4:3,0,-1,107562,92438
3:3:6,0,-1,107563,92437
1:4:5,0,-1,107564,92436
2:6:2,2,2,107562,92438
1:2:2,2,2,107560,92440
2:5:4,1,1,107559,92441
3:1:6,0,-1,107560,92440
5:2:4,1,1,107559,92441
3:6:6,0,-1,107560,92440
2:1:2,2,2,107558,92442
5:3:1,0,-1,107559,92441
5:2:1,1,1,107558,92442
3:4:4,0,-1,107559,92441
6:2:1,1,1,107558,92442
5:5:4,0,-1,107559,92441
1:2:1,1,1,107558,92442
1:6:5,0,-1,107559,92441
5:5:4,0,-1,107560,92440
1:6:5,0,-1,107561,92439
3:3:1,0,-1,107562,92438
3:4:6,0,-1,107563,92437
3:1:1,0,-1,107564,92436
3:4:5,0,-1,107565,92435
2:6:3,1,1,107564,92436
2:4:1,1,1,107563,92437
2:3:6,1,1,107562,92438
3:4:4,0,-1,107563,92437
3:5:5,0,-1,107564,92436
4:3:2,1,1,107563,92437
2:5:1,1,1,107562,92438
4:3:2,1,1,107561,92439
5:1:6,0,-1,107562,92438
4:4:6,0,-1,107563,92437
3:5:5,0,-1,107564,92436
6:1:4,0,-1,107565,92435
4:6:3,0,-1,107566,92434
2:3:1,1,1,107565,92435
5:2:1,1,1,107564,92436
1:1:5,0,-1,107565,92435
3:6:4,0,-1,107566,92434
6:1:2,1,1,107565,92435
4:6:5,0,-1,107566,92434
6:1:6,0,-1,107567,92433
2:3:3,1,1,107566,92434
1:2:6,1,1,107565,92435
3:5:5,0,-1,107566,92434
5:3:4,0,-1,107567,92433
5:5:5,0,-1,107568,92432
2:2:1,2,2,107566,92434
6:6:3,0,-1,107567,92433
3:4:5,0,-1,107568,92432
4:3:3,0,-1,107569,92431
3:6:6,0,-1,107570,92430
4:5:4,0,-1,107571,92429
2:4:1,1,1,107570,92430
5:6:6,0,-1,107571,92429
1:4:5,0,-1,107572,92428
6:2:4,1,1,107571,92429
6:5:6,0,-1,107572,92428
3:1:1,0,-1,107573,92427
2:1:5,1,1,107572,92428
2:2:4,2,2,107570,92430
6:1:1,0,-1,107571,92429
2:2:4,2,2,107569,92431
5:3:3,0,-1,107570,92430
2:6:4,1,1,107569,92431
4:5:2,1,1,107568,92432
3:1:1,0,-1,107569,92431
1:6:4,0,-1,107570,92430
4:3:4,0,-1,107571,92429
6:1:4,0,-1,107572,92428
4:5:1,0,-1,107573,92427
1:4:3,0,-1,107574,92426
6:3:2,1,1,107573,92427
5:2:1,1,1,107572,92428
1:6:5,0,-1,107573,92427
3:1:6,0,-1,107574,92426
2:6:4,1,1,107573,92427
6:2:6,1,1,107572,92428
3:3:1,0,-1,107573,92427
2:4:1,1,1,107572,92428
2:1:2,2,2,107570,92430
3:3:4,0,-1,107571,92429
3:5:4,0,-1,107572,92428
3:4:6,0,-1,107573,92427
2:3:2,2,2,107571,92429
1:5:1,0,-1,107572,92428
6:2:3,1,1,107571,92429
5:5:2,1,1,107570,92430
3:4:1,0,-1,107571,92429
6:3:2,1,1,107570,92430
4:3:6,0,-1,107571,92429
5:5:3,0,-1,107572,92428
3:6:3,0,-1,107573,92427
3:4:4,0,-1,107574,92426
6:2:3,1,1,107573,92427
5:6:1,0,-1,107574,92426
1:6:1,0,-1,107575,92425
6:6:5,0,-1,107576,92424
2:4:3,1,1,107575,92425
3:2:3,1,1,107574,92426
3:6:6,0,-1,107575,92425
1:4:1,0,-1,107576,92424
5:2:6,1,1,107575,92425
6:4:5,0,-1,107576,92424
6:5:3,0,-1,107577,92423
5:2:5,1,1,107576,92424
6:3:4,0,-1,107577,92423
6:2:3,1,1,107576,92424
4:5:5,0,-1,107577,92423
4:4:3,0,-1,107578,92422
3:5:1,0,-1,107579,92421
3:1:5,0,-1,107580,92420
5:1:6,0,-1,107581,92419
2:1:3,1,1,107580,92420
3:3:2,1,1,107579,92421
2:5:3,1,1,107578,92422
5:1:4,0,-1,107579,92421
5:4:6,0,-1,107580,92420
2:6:3,1,1,107579,92421
5:5:2,1,1,107578,92422
1:3:5,0,-1,107579,92421
1:5:3,0,-1,107580,92420
5:3:4,0,-1,107581,92419
1:4:4,0,-1,107582,92418
5:3:1,0,-1,107583,92417
1:3:4,0,-1,107584,92416
3:1:6,0,-1,107585,92415
1:2:2,2,2,107583,92417
3:6:2,1,1,107582,92418
2:6:5,1,1,107581,92419
4:2:1,1,1,107580,92420
3:4:3,0,-1,107581,92419
3:2:1,1,1,107580,92420
6:2:1,1,1,107579,92421
3:4:5,0,-1,107580,92420
3:3:6,0,-1,107581,92419
3:4:4,0,-1,107582,92418
1:1:5,0,-1,107583,92417
3:5:4,0,-1,107584,92416
1:6:5,0,-1,107585,92415
2:5:3,1,1,107584,92416
1:4:3,0,-1,107585,92415
2:3:2,2,2,107583,92417
3:5:3,0,-1,107584,92416
5:3:3,0,-1,107585,92415
5:6:2,1,1,107584,92416
3:5:5,0,-1,107585,92415
1:2:6,1,1,107584,92416
5:1:1,0,-1,107585,92415
6:2:4,1,1,107584,92416
1:4:5,0,-1,107585,92415
6:2:5,1,1,107584,92416
3:2:2,2,2,107582,92418
3:4:2,1,1,107581,92419
4:1:1,0,-1,107582,92418
5:2:1,1,1,107581,92419
2:1:1,1,1,107580,92420
1:2:1,1,1,107579,92421
3:1:4,0,-1,107580,92420
2:6:2,2,2,107578,92422
4:2:6,1,1,107577,92423
5:3:1,0,-1,107578,92422
6:1:3,0,-1,107579,92421
5:5:2,1,1,107578,92422
5:4:6,0,-1,107579,92421
6:2:5,1,1,107578,92422
2:1:3,1,1,107577,92423
6:2:6,1,1,107576,92424
3:1:3,0,-1,107577,92423
1:3:3,0,-1,107578,92422
3:3:1,0,-1,107579,92421
2:4:1,1,1,107578,92422
1:5:2,1,1,107577,92423
2:6:3,1,1,107576,92424
1:1:5,0,-1,107577,92423
1:1:5,0,-1,107578,92422
2:3:2,2,2,107576,92424
6:1:3,0,-1,107577,92423
5:2:6,1,1,107576,92424
1:3:2,1,1,107575,92425
1:5:5,0,-1,107576,92424
2:5:5,1,1,107575,92425
5:4:6,0,-1,107576,92424
3:6:1,0,-1,107577,92423
6:2:1,1,1,107576,92424
5:4:6,0,-1,107577,92423
3:5:5,0,-1,107578,92422
1:1:6,0,-1,107579,92421
4:4:6,0,-1,107580,92420
5:3:6,0,-1,107581,92419
3:6:2,1,1,107580,92420
3:6:6,0,-1,107581,92419
3:2:3,1,1,107580,92420
5:3:5,0,-1,107581,92419
1:1:2,1,1,107580,92420
1:5:3,0,-1,107581,92419
1:6:3,0,-1,107582,92418
4:2:2,2,2,107580,92420
1:4:4,0,-1,107581,92419
1:6:4,0,-1,107582,92418
5:3:3,0,-1,107583,92417
3:5:3,0,-1,107584,92416
6:2:2,2,2,107582,92418
4:3:3,0,-1,107583,92417
5:3:2,1,1,107582,92418
6:6:4,0,-1,107583,92417
5:2:2,2,2,107581,92419
5:3:5,0,-1,107582,92418
1:3:6,0,-1,107583,92417
4:5:6,0,-1,107584,92416
1:5:1,0,-1,107585,92415
5:4:3,0,-1,107586,92414
5:2:1,1,1,107585,92415
5:3:2,1,1,107584,92416
4:6:3,0,-1,107585,92415
3:2:4,1,1,107584,92416
3:2:4,1,1,107583,92417
6:6:6,0,-1,107584,92416
3:2:1,1,1,107583,92417
2:1:6,1,1,107582,92418
2:1:4,1,1,107581,92419
1:2:2,2,2,107579,92421
4:2:2,2,2,107577,92423
4:4:4,0,-1,107578,92422
3:5:5,0,-1,107579,92421
2:3:2,2,2,107577,92423
3:2:2,2,2,107575,92425
5:3:4,0,-1,107576,92424
6:5:1,0,-1,107577,92423
4:4:3,0,-1,107578,92422
4:6:3,0,-1,107579,92421
3:5:4,0,-1,107580,92420
2:2:4,2,2,107578,92422
2:3:4,1,1,107577,92423
2:1:5,1,1,107576,92424
1:6:6,0,-1,107577,92423
4:5:6,0,-1,107578,92422
6:6:4,0,-1,107579,92421
6:5:6,0,-1,107580,92420
3:3:4,0,-1,107581,92419
3:6:5,0,-1,107582,92418
1:5:3,0,-1,107583,92417
1:1:3,0,-1,107584,92416
6:5:3,0,-1,107585,92415
5:2:2,2,2,107583,92417
4:1:5,0,-1,107584,92416
1:4:1,0,-1,107585,92415
2:3:6,1,1,107584,92416
4:1:6,0,-1,107585,92415
6:4:5,0,-1,107586,92414
1:2:3,1,1,107585,92415
3:4:2,1,1,107584,92416
4:2:5,1,1,107583,92417
6:4:5,0,-1,107584,92416
5:5:2,1,1,107583,92417
5:5:6,0,-1,107584,92416
4:1:6,0,-1,107585,92415
4:5:6,0,-1,107586,92414
5:2:6,1,1,107585,92415
6:4:2,1,1,107584,92416
2:4:4,1,1,107583,92417
3:2:5,1,1,107582,92418
3:5:2,1,1,107581,92419
2:1:6,1,1,107580,92420
6:2:3,1,1,107579,92421
6:1:3,0,-1,107580,92420
3:2:1,1,1,107579,92421
2:2:2,3,3,107576,92424
1:3:2,1,1,107575,92425
2:1:1,1,1,107574,92426
5:6:5,0,-1,107575,92425
6:3:6,0,-1,107576,92424
5:1:6,0,-1,107577,92423
2:6:5,1,1,107576,92424
6:2:6,1,1,107575,92425
4:2:1,1,1,107574,92426
6:2:5,1,1,107573,92427
4:2:3,1,1,107572,92428
5:4:2,1,1,107571,92429
6:3:5,0,-1,107572,92428
4:3:4,0,-1,107573,92427
5:2:3,1,1,107572,92428
3:5:2,1,1,107571,92429
4:5:6,0,-1,107572,92428
2:1:5,1,1,107571,92429
1:3:3,0,-1,107572,92428
5:2:6,1,1,107571,92429
3:3:4,0,-1,107572,92428
1:1:3,0,-1,107573,92427
2:5:3,1,1,107572,92428
5:6:3,0,-1,107573,92427
1:3:6,0,-1,107574,92426
1:3:3,0,-1,107575,92425
4:1:4,0,-1,107576,92424
1:3:2,1,1,107575,92425
4:6:6,0,-1,107576,92424
4:1:3,0,-1,107577,92423
5:6:4,0,-1,107578,92422
1:4:3,0,-1,107579,92421
3:4:2,1,1,107578,92422
4:6:3,0,-1,107579,92421
6:1:4,0,-1,107580,92420
4:5:2,1,1,107579,92421
1:4:6,0,-1,107580,92420
5:4:1,0,-1,107581,92419
3:5:1,0,-1,107582,92418
3:1:3,0,-1,107583,92417
6:6:3,0,-1,107584,92416
3:3:4,0,-1,107585,92415
1:4:1,0,-1,107586,92414
3:4:6,0,-1,107587,92413
5:5:2,1,1,107586,92414
1:4:5,0,-1,107587,92413
5:4:1,0,-1,107588,92412
3:5:6,0,-1,107589,92411
5:1:1,0,-1,107590,92410
6:2:3,1,1,107589,92411
1:6:2,1,1,107588,92412
5:2:1,1,1,107587,92413
3:3:5,0,-1,107588,92412
2:4:6,1,1,107587,92413
5:4:5,0,-1,107588,92412
4:1:3,0,-1,107589,92411
4:4:3,0,-1,107590,92410
2:3:2,2,2,107588,92412
6:6:5,0,-1,107589,92411
6:4:6,0,-1,107590,92410
1:4:4,0,-1,107591,92409
6:3:6,0,-1,107592,92408
5:1:5,0,-1,107593,92407
3:1:4,0,-1,107594,92406
5:6:4,0,-1,107595,92405
3:2:1,1,1,107594,92406
6:6:5,0,-1,107595,92405
2:6:3,1,1,107594,92406
5:2:6,1,1,107593,92407
2:4:3,1,1,107592,92408
3:3:3,0,-1,107593,92407
6:4:3,0,-1,107594,92406
2:2:1,2,2,107592,92408
5:4:4,0,-1,107593,92407
6:3:4,0,-1,107594,92406
3:3:1,0,-1,107595,92405
6:4:1,0,-1,107596,92404
4:6:6,0,-1,107597,92403
4:2:6,1,1,107596,92404
3:3:1,0,-1,107597,92403
6:5:4,0,-1,107598,92402
5:4:3,0,-1,107599,92401
5:6:1,0,-1,107600,92400
5:4:2,1,1,107599,92401
5:1:6,0,-1,107600,92400
6:1:6,0,-1,107601,92399
2:2:2,3,3,107598,92402
4:3:4,0,-1,107599,92401
6:5:1,0,-1,107600,92400
5:3:5,0,-1,107601,92399
4:2:4,1,1,107600,92400
6:1:4,0,-1,107601,92399
2:4:1,1,1,107600,92400
5:5:1,0,-1,107601,92399
5:3:4,0,-1,107602,92398
1:6:5,0,-1,107603,92397
1:3:6,0,-1,107604,92396
6:1:4,0,-1,107605,92395
6:5:5,0,-1,107606,92394
5:4:3,0,-1,107607,92393
1:3:4,0,-1,107608,92392
2:1:5,1,1,107607,92393
4:4:2,1,1,107606,92394
2:1:3,1,1,107605,92395
3:4:3,0,-1,107606,92394
3:3:1,0,-1,107607,92393
6:6:3,0,-1,107608,92392
2:6:4,1,1,107607,92393
2:3:1,1,1,107606,92394
6:1:3,0,-1,107607,92393
5:2:3,1,1,107606,92394
6:3:1,0,-1,107607,92393
6:2:2,2,2,107605,92395
6:1:3,0,-1,107606,92394
5:2:3,1,1,107605,92395
3:1:6,0,-1,107606,92394
5:5:6,0,-1,107607,92393
4:5:5,0,-1,107608,92392
5:6:3,0,-1,107609,92391
6:2:2,2,2,107607,92393
2:1:6,1,1,107606,92394
2:2:2,3,3,107603,92397
6:2:2,2,2,107601,92399
3:4:1,0,-1,107602,92398
1:4:3,0,-1,107603,92397
4:6:4,0,-1,107604,92396
2:2:2,3,3,107601,92399
1:5:2,1,1,107600,92400
6:3:3,0,-1,107601,92399
2:1:1,1,1,107600,92400
4:6:6,0,-1,107601,92399
5:4:1,0,-1,107602,92398
4:3:5,0,-1,107603,92397
5:1:3,0,-1,107604,92396
4:6:6,0,-1,107605,92395
5:5:1,0,-1,107606,92394
3:2:4,1,1,107605,92395
6:3:2,1,1,107604,92396
4:3:4,0,-1,107605,92395
2:1:6,1,1,107604,92396
3:5:1,0,-1,107605,92395
3:2:6,1,1,107604,92396
3:6:5,0,-1,107605,92395
4:6:6,0,-1,107606,92394
1:3:4,0,-1,107607,92393
4:5:2,1,1,107606,92394
2:1:3,1,1,107605,92395
1:1:6,0,-1,107606,92394
2:4:3,1,1,107605,92395
2:3:4,1,1,107604,92396
3:5:3,0,-1,107605,92395
2:6:1,1,1,107604,92396
3:6:5,0,-1,107605,92395
3:6:5,0,-1,107606,92394
5:2:5,1,1,107605,92395
5:1:6,0,-1,107606,92394
6:4:4,0,-1,107607,92393
4:3:5,0,-1,107608,92392
6:1:1,0,-1,107609,92391
5:4:4,0,-1,107610,92390
6:1:1,0,-1,107611,92389
1:1:4,0,-1,107612,92388
6:6:5,0,-1,107613,92387
5:4:6,0,-1,107614,92386
3:4:2,1,1,107613,92387
4:6:6,0,-1,107614,92386
4:6:4,0,-1,107615,92385
3:1:5,0,-1,107616,92384
4:2:4,1,1,107615,92385
5:4:4,0,-1,107616,92384
1:4:2,1,1,107615,92385
3:4:5,0,-1,107616,92384
4:6:6,0,-1,107617,92383
3:6:6,0,-1,107618,92382
5:6:6,0,-1,107619,92381
5:4:5,0,-1,107620,92380
6:2:6,1,1,107619,92381
1:3:1,0,-1,107620,92380
2:4:1,1,1,107619,92381
3:3:3,0,-1,107620,92380
4:6:3,0,-1,107621,92379
4:5:3,0,-1,107622,92378
6:5:6,0,-1,107623,92377
6:3:1,0,-1,107624,92376
5:6:4,0,-1,107625,92375
4:4:1,0,-1,107626,92374
4:3:5,0,-1,107627,92373
6:6:5,0,-1,107628,92372
4:6:1,0,-1,107629,92371
6:5:5,0,-1,107630,92370
6:3:4,0,-1,107631,92369
4:6:1,0,-1,107632,92368
5:5:1,0,-1,107633,92367
5:6:4,0,-1,107634,92366
5:2:5,1,1,107633,92367
4:1:6,0,-1,107634,92366
6:5:4,0,-1,107635,92365
6:3:4,0,-1,107636,92364
6:5:3,0,-1,107637,92363
1:1:5,0,-1,107638,92362
6:5:3,0,-1,107639,92361
5:3:6,0,-1,107640,92360
2:1:3,1,1,107639,92361
5:1:4,0,-1,107640,92360
6:5:1,0,-1,107641,92359
2:5:4,1,1,107640,92360
4:2:5,1,1,107639,92361
3:4:4,0,-1,107640,92360
4:5:5,0,-1,107641,92359
3:1:5,0,-1,107642,92358
2:5:3,1,1,107641,92359
4:5:2,1,1,107640,92360
4:2:6,1,1,107639,92361
3:1:5,0,-1,107640,92360
5:2:6,1,1,107639,92361
3:6:6,0,-1,107640,92360
6:3:2,1,1,107639,92361
1:5:3,0,-1,107640,92360
2:6:4,1,1,107639,92361
2:1:5,1,1,107638,92362
3:6:5,0,-1,107639,92361
6:3:4,0,-1,107640,92360
4:3:3,0,-1,107641,92359
1:3:5,0,-1,107642,92358
4:5:3,0,-1,107643,92357
5:3:1,0,-1,107644,92356
1:5:5,0,-1,107645,92355
3:6:4,0,-1,107646,92354
1:4:3,0,-1,107647,92353
2:6:4,1,1,107646,92354
4:1:2,1,1,107645,92355
4:6:5,0,-1,107646,92354
3:3:3,0,-1,107647,92353
6:5:2,1,1,107646,92354
4:5:4,0,-1,107647,92353
3:4:4,0,-1,107648,92352
4:1:4,0,-1,107649,92351
6:4:4,0,-1,107650,92350
1:5:2,1,1,107649,92351
3:6:1,0,-1,107650,92350
6:1:5,0,-1,107651,92349
4:4:6,0,-1,107652,92348
2:4:2,2,2,107650,92350
1:5:1,0,-1,107651,92349
5:1:2,1,1,107650,92350
1:6:6,0,-1,107651,92349
5:5:5,0,-1,107652,92348
6:1:5,0,-1,107653,92347
5:3:1,0,-1,107654,92346
6:2:1,1,1,107653,92347
2:1:6,1,1,107652,92348
2:2:2,3,3,107649,92351
5:1:3,0,-1,107650,92350
2:3:2,2,2,107648,92352
2:5:3,1,1,107647,92353
3:4:2,1,1,107646,92354
5:3:4,0,-1,107647,92353
3:3:4,0,-1,107648,92352
6:6:5,0,-1,107649,92351
2:5:1,1,1,107648,92352
6:5:1,0,-1,107649,92351
1:2:6,1,1,107648,92352
2:6:6,1,1,107647,92353
4:2:4,1,1,107646,92354
1:2:4,1,1,107645,92355
3:3:4,0,-1,107646,92354
3:3:1,0,-1,107647,92353
2:2:6,2,2,107645,92355
1:2:6,1,1,107644,92356
4:5:5,0,-1,107645,92355
3:2:6,1,1,107644,92356
5:1:3,0,-1,107645,92355
1:2:6,1,1,107644,92356
3:3:2,1,1,107643,92357
5:1:4,0,-1,107644,92356
3:1:2,1,1,107643,92357
1:3:2,1,1,107642,92358
2:6:1,1,1,107641,92359
4:6:2,1,1,107640,92360
2:5:3,1,1,107639,92361
6:4:2,1,1,107638,92362
3:3:5,0,-1,107639,92361
1:6:4,0,-1,107640,92360
4:4:3,0,-1,107641,92359
6:3:1,0,-1,107642,92358
6:3:3,0,-1,107643,92357
6:3:6,0,-1,107644,92356
4:5:6,0,-1,107645,92355
4:2:4,1,1,107644,92356
1:3:3,0,-1,107645,92355
1:2:2,2,2,107643,92357
3:1:4,0,-1,107644,92356
5:5:5,0,-1,107645,92355
5:6:1,0,-1,107646,92354
3:6:5,0,-1,107647,92353
6:5:1,0,-1,107648,92352
4:5:1,0,-1,107649,92351
4:4:4,0,-1,107650,92350
2:4:5,1,1,107649,92351
5:3:6,0,-1,107650,92350
1:5:6,0,-1,107651,92349
6:4:5,0,-1,107652,92348
3:1:6,0,-1,107653,92347
1:4:3,0,-1,107654,92346
3:4:4,0,-1,107655,92345
1:1:1,0,-1,107656,92344
5:2:1,1,1,107655,92345
6:3:2,1,1,107654,92346
1:6:1,0,-1,107655,92345
3:5:3,0,-1,107656,92344
5:5:1,0,-1,107657,92343
6:5:1,0,-1,107658,92342
5:5:2,1,1,107657,92343
3:2:4,1,1,107656,92344
2:2:5,2,2,107654,92346
2:6:1,1,1,107653,92347
3:6:3,0,-1,107654,92346
4:6:4,0,-1,107655,92345
5:4:4,0,-1,107656,92344
3:1:3,0,-1,107657,92343
2:5:6,1,1,107656,92344
2:6:1,1,1,107655,92345
1:2:3,1,1,107654,92346
3:4:1,0,-1,107655,92345
2:1:5,1,1,107654,92346
6:3:4,0,-1,107655,92345
2:6:2,2,2,107653,92347
3:1:3,0,-1,107654,92346
1:6:1,0,-1,107655,92345
1:1:3,0,-1,107656,92344
3:3:3,0,-1,107657,92343
6:6:4,0,-1,107658,92342
3:6:4,0,-1,107659,92341
2:5:6,1,1,107658,92342
1:3:1,0,-1,107659,92341
4:3:2,1,1,107658,92342
2:4:3,1,1,107657,92343
3:6:5,0,-1,107658,92342
2:1:4,1,1,107657,92343
6:4:3,0,-1,107658,92342
6:1:3,0,-1,107659,92341
2:3:5,1,1,107658,92342
2:6:2,2,2,107656,92344
6:5:6,0,-1,107657,92343
6:4:3,0,-1,107658,92342
3:2:4,1,1,107657,92343
3:4:5,0,-1,107658,92342
6:2:5,1,1,107657,92343
4:6:1,0,-1,107658,92342
6:5:2,1,1,107657,92343
3:3:6,0,-1,107658,92342
5:3:4,0,-1,107659,92341
6:5:6,0,-1,107660,92340
2:4:4,1,1,107659,92341
2:6:5,1,1,107658,92342
6:4:6,0,-1,107659,92341
4:4:5,0,-1,107660,92340
1:4:3,0,-1,107661,92339
5:6:3,0,-1,107662,92338
3:3:3,0,-1,107663,92337
2:5:6,1,1,107662,92338
5:1:5,0,-1,107663,92337
4:2:1,1,1,107662,92338
6:6:4,0,-1,107663,92337
5:3:4,0,-1,107664,92336
6:3:3,0,-1,107665,92335
6:5:2,1,1,107664,92336
1:1:2,1,1,107663,92337
1:4:3,0,-1,107664,92336
5:5:6,0,-1,107665,92335
6:5:4,0,-1,107666,92334
4:6:1,0,-1,107667,92333
3:5:6,0,-1,107668,92332
4:3:6,0,-1,107669,92331
2:5:1,1,1,107668,92332
5:6:4,0,-1,107669,92331
4:4:4,0,-1,107670,92330
1:2:5,1,1,107669,92331
3:4:5,0,-1,107670,92330
2:2:3,2,2,107668,92332
4:6:5,0,-1,107669,92331
3:5:4,0,-1,107670,92330
3:1:2,1,1,107669,92331
2:4:3,1,1,107668,92332
6:2:1,1,1,107667,92333
1:3:3,0,-1,107668,92332
4:4:1,0,-1,107669,92331
4:6:1,0,-1,107670,92330
4:2:4,1,1,107669,92331
4:6:1,0,-1,107670,92330
5:6:6,0,-1,107671,92329
1:4:1,0,-1,107672,92328
5:4:4,0,-1,107673,92327
3:5:2,1,1,107672,92328
2:6:3,1,1,107671,92329
3:2:2,2,2,107669,92331
5:2:3,1,1,107668,92332
3:3:6,0,-1,107669,92331
4:5:5,0,-1,107670,92330
2:6:6,1,1,107669,92331
4:5:4,0,-1,107670,92330
3:4:5,0,-1,107671,92329
1:5:6,0,-1,107672,92328
1:3:6,0,-1,107673,92327
3:1:1,0,-1,107674,92326
3:2:2,2,2,107672,92328
1:5:3,0,-1,107673,92327
1:1:3,0,-1,107674,92326
6:2:4,1,1,107673,92327
4:3:3,0,-1,107674,92326
4:3:2,1,1,107673,92327
2:4:1,1,1,107672,92328
5:2:6,1,1,107671,92329
6:4:3,0,-1,107672,92328
4:4:3,0,-1,107673,92327
5:6:5,0,-1,107674,92326
4:4:3,0,-1,107675,92325
6:4:6,0,-1,107676,92324
5:6:5,0,-1,107677,92323
2:3:4,1,1,107676,92324
3:1:1,0,-1,107677,92323
4:5:4,0,-1,107678,92322
4:2:1,1,1,107677,92323
6:4:6,0,-1,107678,92322
6:4:2,1,1,107677,92323
6:5:1,0,-1,107678,92322
5:3:5,0,-1,107679,92321
2:4:1,1,1,107678,92322
5:4:1,0,-1,107679,92321
1:5:6,0,-1,107680,92320
6:2:2,2,2,107678,92322
5:6:1,0,-1,107679,92321
2:1:4,1,1,107678,92322
1:6:2,1,1,107677,92323
4:1:5,0,-1,107678,92322
3:3:2,1,1,107677,92323
4:6:4,0,-1,107678,92322
5:1:3,0,-1,107679,92321
3:6:6,0,-1,107680,92320
2:4:5,1,1,107679,92321
5:6:3,0,-1,107680,92320
1:3:1,0,-1,107681,92319
2:6:2,2,2,107679,92321
5:2:6,1,1,107678,92322
2:6:3,1,1,107677,92323
3:6:2,1,1,107676,92324
5:3:5,0,-1,107677,92323
1:5:4,0,-1,107678,92322
1:6:3,0,-1,107679,92321
1:2:2,2,2,107677,92323
6:4:6,0,-1,107678,92322
4:3:3,0,-1,107679,92321
6:1:1,0,-1,107680,92320
2:1:3,1,1,107679,92321
3:3:2,1,1,107678,92322
4:4:5,0,-1,107679,92321
2:4:1,1,1,107678,92322
2:3:3,1,1,107677,92323
3:5:5,0,-1,107678,92322
3:2:4,1,1,107677,92323
3:4:2,1,1,107676,92324
3:1:6,0,-1,107677,92323
4:2:6,1,1,107676,92324
5:2:5,1,1,107675,92325
4:2:6,1,1,107674,92326
6:3:5,0,-1,107675,92325
5:2:4,1,1,107674,92326
6:4:5,0,-1,107675,92325
5:4:2,1,1,107674,92326
1:6:1,0,-1,107675,92325
6:6:6,0,-1,107676,92324
5:5:6,0,-1,107677,92323
1:5:1,0,-1,107678,92322
6:1:2,1,1,107677,92323
4:6:4,0,-1,107678,92322
5:3:3,0,-1,107679,92321
3:1:1,0,-1,107680,92320
6:4:2,1,1,107679,92321
6:3:4,0,-1,107680,92320
2:4:4,1,1,107679,92321
6:5:1,0,-1,107680,92320
1:5:1,0,-1,107681,92319
3:4:2,1,1,107680,92320
3:2:5,1,1,107679,92321
4:2:5,1,1,107678,92322
5:2:5,1,1,107677,92323
3:1:3,0,-1,107678,92322
5:1:1,0,-1,107679,92321
2:3:2,2,2,107677,92323
4:5:6,0,-1,107678,92322
3:2:5,1,1,107677,92323
5:3:5,0,-1,107678,92322
4:1:5,0,-1,107679,92321
2:6:4,1,1,107678,92322
3:1:4,0,-1,107679,92321
4:4:5,0,-1,107680,92320
2:4:1,1,1,107679,92321
2:5:2,2,2,107677,92323
5:2:6,1,1,107676,92324
4:6:4,0,-1,107677,92323
4:6:4,0,-1,107678,92322
5:2:6,1,1,107677,92323
6:1:6,0,-1,107678,92322
2:4:3,1,1,107677,92323
2:1:2,2,2,107675,92325
1:1:2,1,1,107674,92326
4:2:3,1,1,107673,92327
1:4:2,1,1,107672,92328
2:2:3,2,2,107670,92330
3:4:5,0,-1,107671,92329
4:5:6,0,-1,107672,92328
5:2:5,1,1,107671,92329
5:5:5,0,-1,107672,92328
2:4:6,1,1,107671,92329
5:6:5,0,-1,107672,92328
5:2:1,1,1,107671,92329
2:4:5,1,1,107670,92330
2:5:6,1,1,107669,92331
2:5:2,2,2,107667,92333
2:1:3,1,1,107666,92334
3:1:5,0,-1,107667,92333
2:4:2,2,2,107665,92335
1:1:5,0,-1,107666,92334
2:2:3,2,2,107664,92336
5:6:2,1,1,107663,92337
3:2:2,2,2,107661,92339
2:5:1,1,1,107660,92340
2:3:5,1,1,107659,92341
2:3:2,2,2,107657,92343
5:5:2,1,1,107656,92344
5:2:1,1,1,107655,92345
1:6:2,1,1,107654,92346
2:4:1,1,1,107653,92347
5:6:1,0,-1,107654,92346
4:2:4,1,1,107653,92347
3:4:1,0,-1,107654,92346
6:1:3,0,-1,107655,92345
2:5:1,1,1,107654,92346
1:6:5,0,-1,107655,92345
1:2:1,1,1,107654,92346
3:6:3,0,-1,107655,92345
3:1:5,0,-1,107656,92344
3:3:6,0,-1,107657,92343
3:6:5,0,-1,107658,92342
4:2:1,1,1,107657,92343
6:3:6,0,-1,107658,92342
5:3:2,1,1,107657,92343
1:5:5,0,-1,107658,92342
2:1:3,1,1,107657,92343
2:1:6,1,1,107656,92344
4:5:1,0,-1,107657,92343
3:5:4,0,-1,107658,92342
3:5:5,0,-1,107659,92341
4:4:3,0,-1,107660,92340
4:6:6,0,-1,107661,92339
2:3:3,1,1,107660,92340
3:5:4,0,-1,107661,92339
3:5:2,1,1,107660,92340
4:4:2,1,1,107659,92341
1:4:1,0,-1,107660,92340
2:3:1,1,1,107659,92341
4:3:5,0,-1,107660,92340
4:6:6,0,-1,107661,92339
4:4:4,0,-1,107662,92338
5:3:3,0,-1,107663,92337
5:3:6,0,-1,107664,92336
1:5:3,0,-1,107665,92335
5:1:5,0,-1,107666,92334
2:3:1,1,1,107665,92335
3:1:2,1,1,107664,92336
2:2:5,2,2,107662,92338
1:6:3,0,-1,107663,92337
4:3:1,0,-1,107664,92336
5:2:3,1,1,107663,92337
5:6:1,0,-1,107664,92336
1:5:2,1,1,107663,92337
3:1:3,0,-1,107664,92336
1:4:3,0,-1,107665,92335
2:5:4,1,1,107664,92336
1:1:4,0,-1,107665,92335
3:3:3,0,-1,107666,92334
2:5:3,1,1,107665,92335
2:5:4,1,1,107664,92336
3:3:1,0,-1,107665,92335
2:1:3,1,1,107664,92336
1:6:1,0,-1,107665,92335
1:4:3,0,-1,107666,92334
3:5:3,0,-1,107667,92333
1:4:3,0,-1,107668,92332
3:5:3,0,-1,107669,92331
5:2:6,1,1,107668,92332
1:2:6,1,1,107667,92333
6:2:6,1,1,107666,92334
3:1:4,0,-1,107667,92333
5:6:3,0,-1,107668,92332
1:4:2,1,1,107667,92333
4:2:1,1,1,107666,92334
5:6:3,0,-1,107667,92333
6:3:1,0,-1,107668,92332
1:4:4,0,-1,107669,92331
5:2:4,1,1,107668,92332
6:6:2,1,1,107667,92333
3:6:2,1,1,107666,92334
6:5:5,0,-1,107667,92333
3:1:4,0,-1,107668,92332
6:5:5,0,-1,107669,92331
5:4:2,1,1,107668,92332
4:1:4,0,-1,107669,92331
4:3:2,1,1,107668,92332
6:5:4,0,-1,107669,92331
3:6:3,0,-1,107670,92330
2:6:6,1,1,107669,92331
3:6:4,0,-1,107670,92330
1:2:4,1,1,107669,92331
3:5:5,0,-1,107670,92330
3:2:3,1,1,107669,92331
2:4:5,1,1,107668,92332
5:5:3,0,-1,107669,92331
4:2:2,2,2,107667,92333
2:1:5,1,1,107666,92334
3:1:1,0,-1,107667,92333
4:1:5,0,-1,107668,92332
1:5:1,0,-1,107669,92331
5:1:5,0,-1,107670,92330
3:4:3,0,-1,107671,92329
6:3:1,0,-1,107672,92328
4:5:4,0,-1,107673,92327
5:4:4,0,-1,107674,92326
4:1:3,0,-1,107675,92325
1:5:1,0,-1,107676,92324
1:6:1,0,-1,107677,92323
2:5:2,2,2,107675,92325
4:6:2,1,1,107674,92326
6:5:3,0,-1,107675,92325
4:2:4,1,1,107674,92326
2:4:1,1,1,107673,92327
2:6:4,1,1,107672,92328
2:1:6,1,1,107671,92329
4:1:4,0,-1,107672,92328
4:1:5,0,-1,107673,92327
4:6:4,0,-1,107674,92326
2:1:4,1,1,107673,92327
6:4:2,1,1,107672,92328
1:4:6,0,-1,107673,92327
1:3:1,0,-1,107674,92326
5:4:4,0,-1,107675,92325
4:3:4,0,-1,107676,92324
1:6:1,0,-1,107677,92323
4:5:1,0,-1,107678,92322
2:3:5,1,1,107677,92323
1:6:1,0,-1,107678,92322
3:3:2,1,1,107677,92323
5:6:2,1,1,107676,92324
6:1:3,0,-1,107677,92323
2:2:2,3,3,107674,92326
3:5:2,1,1,107673,92327
5:5:6,0,-1,107674,92326
3:6:2,1,1,107673,92327
2:1:4,1,1,107672,92328
1:2:6,1,1,107671,92329
6:5:3,0,-1,107672,92328
6:5:3,0,-1,107673,92327
5:5:4,0,-1,107674,92326
2:5:3,1,1,107673,92327
4:2:6,1,1,107672,92328
6:2:1,1,1,107671,92329
1:6:1,0,-1,107672,92328
1:5:1,0,-1,107673,92327
2:6:2,2,2,107671,92329
6:6:3,0,-1,107672,92328
2:6:3,1,1,107671,92329
3:1:4,0,-1,107672,92328
2:6:5,1,1,107671,92329
4:5:6,0,-1,107672,92328
1:5:6,0,-1,107673,92327
2:6:5,1,1,107672,92328
2:2:1,2,2,107670,92330
2:4:3,1,1,107669,92331
5:2:5,1,1,107668,92332
1:6:5,0,-1,107669,92331
2:1:4,1,1,107668,92332
4:6:4,0,-1,107669,92331
1:4:1,0,-1,107670,92330
2:3:5,1,1,107669,92331
3:5:1,0,-1,107670,92330
6:6:6,0,-1,107671,92329
6:2:6,1,1,107670,92330
1:5:4,0,-1,107671,92329
4:2:1,1,1,107670,92330
1:5:1,0,-1,107671,92329
1:6:1,0,-1,107672,92328
6:3:3,0,-1,107673,92327
2:3:4,1,1,107672,92328
2:2:6,2,2,107670,92330
1:5:4,0,-1,107671,92329
6:2:1,1,1,107670,92330
2:2:6,2,2,107668,92332
1:2:5,1,1,107667,92333
5:4:3,0,-1,107668,92332
5:4:3,0,-1,107669,92331
3:4:5,0,-1,107670,92330
3:3:3,0,-1,107671,92329
1:5:1,0,-1,107672,92328
4:2:2,2,2,107670,92330
4:1:5,0,-1,107671,92329
6:2:6,1,1,107670,92330
6:2:5,1,1,107669,92331
3:2:6,1,1,107668,92332
1:5:4,0,-1,107669,92331
4:1:3,0,-1,107670,92330
3:4:4,0,-1,107671,92329
4:2:6,1,1,107670,92330
5:2:4,1,1,107669,92331
2:6:3,1,1,107668,92332
2:1:1,1,1,107667,92333
6:6:3,0,-1,107668,92332
1:1:3,0,-1,107669,92331
1:6:4,0,-1,107670,92330
4:4:4,0,-1,107671,92329
5:5:2,1,1,107670,92330
4:2:5,1,1,107669,92331
4:1:2,1,1,107668,92332
6:5:6,0,-1,107669,92331
3:3:2,1,1,107668,92332
3:3:2,1,1,107667,92333
6:5:4,0,-1,107668,92332
6:6:3,0,-1,107669,92331
1:4:4,0,-1,107670,92330
2:2:4,2,2,107668,92332
4:4:2,1,1,107667,92333
4:5:3,0,-1,107668,92332
6:5:1,0,-1,107669,92331
6:6:6,0,-1,107670,92330
3:6:2,1,1,107669,92331
1:2:3,1,1,107668,92332
1:3:5,0,-1,107669,92331
3:1:4,0,-1,107670,92330
1:1:1,0,-1,107671,92329
5:4:3,0,-1,107672,92328
4:1:5,0,-1,107673,92327
4:3:5,0,-1,107674,92326
1:1:3,0,-1,107675,92325
1:1:5,0,-1,107676,92324
6:3:3,0,-1,107677,92323
1:3:4,0,-1,107678,92322
2:1:6,1,1,107677,92323
5:2:3,1,1,107676,92324
6:1:1,0,-1,107677,92323
1:3:1,0,-1,107678,92322
2:6:4,1,1,107677,92323
4:5:6,0,-1,107678,92322
1:1:3,0,-1,107679,92321
2:1:4,1,1,107678,92322
6:2:2,2,2,107676,92324
2:6:1,1,1,107675,92325
3:3:2,1,1,107674,92326
5:2:3,1,1,107673,92327
1:6:1,0,-1,107674,92326
5:6:1,0,-1,107675,92325
5:4:1,0,-1,107676,92324
6:3:6,0,-1,107677,92323
1:4:6,0,-1,107678,92322
4:6:4,0,-1,107679,92321
3:6:1,0,-1,107680,92320
1:1:1,0,-1,107681,92319
3:3:4,0,-1,107682,92318
2:2:5,2,2,107680,92320
6:3:6,0,-1,107681,92319
6:3:2,1,1,107680,92320
3:2:4,1,1,107679,92321
5:2:5,1,1,107678,92322
4:2:3,1,1,107677,92323
1:5:6,0,-1,107678,92322
4:6:1,0,-1,107679,92321
4:2:3,1,1,107678,92322
4:3:6,0,-1,107679,92321
1:3:5,0,-1,107680,92320
2:1:2,2,2,107678,92322
4:4:6,0,-1,107679,92321
2:1:5,1,1,107678,92322
1:1:4,0,-1,107679,92321
1:2:3,1,1,107678,92322
4:6:1,0,-1,107679,92321
3:4:4,0,-1,107680,92320
6:5:3,0,-1,107681,92319
2:2:5,2,2,107679,92321
1:5:3,0,-1,107680,92320
6:6:2,1,1,107679,92321
3:5:3,0,-1,107680,92320
1:3:3,0,-1,107681,92319
3:2:5,1,1,107680,92320
3:3:5,0,-1,107681,92319
2:5:1,1,1,107680,92320
5:5:6,0,-1,107681,92319
6:1:3,0,-1,107682,92318
6:1:1,0,-1,107683,92317
2:1:2,2,2,107681,92319
2:4:4,1,1,107680,92320
4:2:3,1,1,107679,92321
6:3:3,0,-1,107680,92320
6:5:6,0,-1,107681,92319
3:6:2,1,1,107680,92320
2:4:6,1,1,107679,92321
1:6:5,0,-1,107680,92320
3:2:3,1,1,107679,92321
1:2:4,1,1,107678,92322
6:3:4,0,-1,107679,92321
2:1:4,1,1,107678,92322
1:5:5,0,-1,107679,92321
2:5:4,1,1,107678,92322
4:6:2,1,1,107677,92323
5:2:3,1,1,107676,92324
1:3:2,1,1,107675,92325
5:5:5,0,-1,107676,92324
3:3:4,0,-1,107677,92323
2:3:4,1,1,107676,92324
5:2:3,1,1,107675,92325
2:6:5,1,1,107674,92326
4:6:1,0,-1,107675,92325
1:1:2,1,1,107674,92326
1:2:6,1,1,107673,92327
2:5:2,2,2,107671,92329
2:3:6,1,1,107670,92330
5:6:1,0,-1,107671,92329
6:3:4,0,-1,107672,92328
3:1:6,0,-1,107673,92327
4:3:5,0,-1,107674,92326
5:4:6,0,-1,107675,92325
6:1:2,1,1,107674,92326
5:4:5,0,-1,107675,92325
6:5:4,0,-1,107676,92324
3:2:5,1,1,107675,92325
2:5:3,1,1,107674,92326
3:6:5,0,-1,107675,92325
1:5:4,0,-1,107676,92324
1:6:6,0,-1,107677,92323
3:3:2,1,1,107676,92324
3:2:6,1,1,107675,92325
2:6:4,1,1,107674,92326
2:3:6,1,1,107673,92327
4:6:4,0,-1,107674,92326
6:5:6,0,-1,107675,92325
5:4:2,1,1,107674,92326
2:6:3,1,1,107673,92327
4:5:2,1,1,107672,92328
3:2:4,1,1,107671,92329
5:3:1,0,-1,107672,92328
1:5:1,0,-1,107673,92327
1:6:4,0,-1,107674,92326
3:1:2,1,1,107673,92327
3:6:3,0,-1,107674,92326
1:6:3,0,-1,107675,92325
1:4:6,0,-1,107676,92324
1:5:1,0,-1,107677,92323
4:3:2,1,1,107676,92324
6:3:5,0,-1,107677,92323
4:1:1,0,-1,107678,92322
2:4:4,1,1,107677,92323
3:2:2,2,2,107675,92325
6:1:4,0,-1,107676,92324
6:5:6,0,-1,107677,92323
4:2:1,1,1,107676,92324
4:1:3,0,-1,107677,92323
5:6:5,0,-1,107678,92322
6:2:6,1,1,107677,92323
4:6:2,1,1,107676,92324
5:5:6,0,-1,107677,92323
4:4:4,0,-1,107678,92322
3:1:4,0,-1,107679,92321
3:3:1,0,-1,107680,92320
4:6:6,0,-1,107681,92319
2:6:4,1,1,107680,92320
4:6:3,0,-1,107681,92319
3:2:3,1,1,107680,92320
3:2:1,1,1,107679,92321
5:3:2,1,1,107678,92322
2:5:5,1,1,107677,92323
4:2:2,2,2,107675,92325
2:2:1,2,2,107673,92327
4:1:6,0,-1,107674,92326
2:5:2,2,2,107672,92328
3:6:1,0,-1,107673,92327
6:6:2,1,1,107672,92328
1:2:5,1,1,107671,92329
5:2:3,1,1,107670,92330
4:1:4,0,-1,107671,92329
1:6:2,1,1,107670,92330
1:3:3,0,-1,107671,92329
3:3:1,0,-1,107672,92328
4:3:3,0,-1,107673,92327
5:2:4,1,1,107672,92328
3:2:5,1,1,107671,92329
4:3:3,0,-1,107672,92328
3:1:4,0,-1,107673,92327
1:6:2,1,1,107672,92328
6:3:2,1,1,107671,92329
2:3:4,1,1,107670,92330
4:2:5,1,1,107669,92331
2:3:5,1,1,107668,92332
5:6:6,0,-1,107669,92331
1:5:5,0,-1,107670,92330
6:3:6,0,-1,107671,92329
6:4:4,0,-1,107672,92328
5:5:4,0,-1,107673,92327
3:5:2,1,1,107672,92328
5:3:2,1,1,107671,92329
1:2:6,1,1,107670,92330
2:5:3,1,1,107669,92331
5:5:4,0,-1,107670,92330
1:4:5,0,-1,107671,92329
1:6:1,0,-1,107672,92328
5:3:5,0,-1,107673,92327
5:1:2,1,1,107672,92328
2:4:5,1,1,107671,92329
6:3:4,0,-1,107672,92328
1:5:5,0,-1,107673,92327
3:6:6,0,-1,107674,92326
5:3:1,0,-1,107675,92325
1:2:1,1,1,107674,92326
5:2:4,1,1,107673,92327
3:4:1,0,-1,107674,92326
4:2:3,1,1,107673,92327
2:4:2,2,2,107671,92329
2:5:1,1,1,107670,92330
5:2:5,1,1,107669,92331
1:6:1,0,-1,107670,92330
5:1:6,0,-1,107671,92329
5:1:3,0,-1,107672,92328
1:6:5,0,-1,107673,92327
1:3:4,0,-1,107674,92326
3:6:1,0,-1,107675,92325
4:1:1,0,-1,107676,92324
2:1:6,1,1,107675,92325
4:6:1,0,-1,107676,92324
3:6:5,0,-1,107677,92323
5:4:2,1,1,107676,92324
2:4:6,1,1,107675,92325
1:4:1,0,-1,107676,92324
3:3:6,0,-1,107677,92323
6:1:6,0,-1,107678,92322
2:6:4,1,1,107677,92323
1:2:3,1,1,107676,92324
6:3:2,1,1,107675,92325
1:2:3,1,1,107674,92326
3:1:5,0,-1,107675,92325
2:5:4,1,1,107674,92326
1:3:6,0,-1,107675,92325
4:2:1,1,1,107674,92326
2:3:4,1,1,107673,92327
1:3:5,0,-1,107674,92326
1:5:4,0,-1,107675,92325
4:3:5,0,-1,107676,92324
6:1:3,0,-1,107677,92323
3:3:1,0,-1,107678,92322
6:2:4,1,1,107677,92323
4:5:2,1,1,107676,92324
3:2:1,1,1,107675,92325
3:5:2,1,1,107674,92326
6:6:2,1,1,107673,92327
6:5:3,0,-1,107674,92326
4:3:2,1,1,107673,92327
1:5:1,0,-1,107674,92326
1:3:5,0,-1,107675,92325
1:4:6,0,-1,107676,92324
1:3:1,0,-1,107677,92323
1:2:6,1,1,107676,92324
3:1:5,0,-1,107677,92323
3:3:2,1,1,107676,92324
6:3:6,0,-1,107677,92323
3:4:2,1,1,107676,92324
5:6:3,0,-1,107677,92323
6:3:3,0,-1,107678,92322
1:3:2,1,1,107677,92323
3:5:1,0,-1,107678,92322
5:3:2,1,1,107677,92323
2:4:1,1,1,107676,92324
5:2:2,2,2,107674,92326
4:5:6,0,-1,107675,92325
3:3:4,0,-1,107676,92324
6:5:6,0,-1,107677,92323
3:3:1,0,-1,107678,92322
1:5:2,1,1,107677,92323
6:4:1,0,-1,107678,92322
3:1:5,0,-1,107679,92321
4:4:1,0,-1,107680,92320
3:1:1,0,-1,107681,92319
5:1:3,0,-1,107682,92318
2:3:5,1,1,107681,92319
2:2:1,2,2,107679,92321
2:4:5,1,1,107678,92322
2:5:5,1,1,107677,92323
4:5:4,0,-1,107678,92322
6:3:2,1,1,107677,92323
6:2:1,1,1,107676,92324
6:5:3,0,-1,107677,92323
6:4:1,0,-1,107678,92322
4:4:4,0,-1,107679,92321
6:2:5,1,1,107678,92322
6:5:6,0,-1,107679,92321
1:4:3,0,-1,107680,92320
3:3:2,1,1,107679,92321
5:2:2,2,2,107677,92323
2:2:1,2,2,107675,92325
6:1:6,0,-1,107676,92324
4:2:2,2,2,107674,92326
6:3:2,1,1,107673,92327
6:3:5,0,-1,107674,92326
1:2:2,2,2,107672,92328
1:2:1,1,1,107671,92329
3:4:3,0,-1,107672,92328
6:4:6,0,-1,107673,92327
5:4:6,0,-1,107674,92326
2:2:1,2,2,107672,92328
2:5:5,1,1,107671,92329
5:5:4,0,-1,107672,92328
3:1:5,0,-1,107673,92327
4:6:1,0,-1,107674,92326
2:1:4,1,1,107673,92327
3:4:2,1,1,107672,92328
6:4:4,0,-1,107673,92327
2:5:4,1,1,107672,92328
1:2:1,1,1,107671,92329
3:1:5,0,-1,107672,92328
6:6:5,0,-1,107673,92327
2:1:3,1,1,107672,92328
6:3:2,1,1,107671,92329
6:1:2,1,1,107670,92330
2:3:2,2,2,107668,92332
3:3:5,0,-1,107669,92331
2:1:2,2,2,107667,92333
1:5:1,0,-1,107668,92332
1:3:1,0,-1,107669,92331
4:1:3,0,-1,107670,92330
5:4:3,0,-1,107671,92329
6:1:1,0,-1,107672,92328
2:1:6,1,1,107671,92329
6:6:2,1,1,107670,92330
3:3:5,0,-1,107671,92329
4:6:6,0,-1,107672,92328
2:2:1,2,2,107670,92330
5:4:4,0,-1,107671,92329
6:4:5,0,-1,107672,92328
2:6:6,1,1,107671,92329
4:4:3,0,-1,107672,92328
4:3:4,0,-1,107673,92327
4:6:4,0,-1,107674,92326
4:2:3,1,1,107673,92327
5:4:6,0,-1,107674,92326
1:3:6,0,-1,107675,92325
4:1:4,0,-1,107676,92324
4:4:4,0,-1,107677,92323
5:6:1,0,-1,107678,92322
6:6:6,0,-1,107679,92321
2:3:2,2,2,107677,92323
5:1:5,0,-1,107678,92322
5:3:3,0,-1,107679,92321
4:1:6,0,-1,107680,92320
1:6:3,0,-1,107681,92319
4:1:2,1,1,107680,92320
5:2:1,1,1,107679,92321
2:4:2,2,2,107677,92323
2:5:6,1,1,107676,92324
4:1:4,0,-1,107677,92323
4:5:1,0,-1,107678,92322
6:5:5,0,-1,107679,92321
6:4:4,0,-1,107680,92320
1:1:1,0,-1,107681,92319
4:2:4,1,1,107680,92320
6:4:5,0,-1,107681,92319
3:4:5,0,-1,107682,92318
4:4:5,0,-1,107683,92317
6:4:4,0,-1,107684,92316
3:1:1,0,-1,107685,92315
2:4:1,1,1,107684,92316
6:1:6,0,-1,107685,92315
3:5:1,0,-1,107686,92314
2:3:1,1,1,107685,92315
4:1:1,0,-1,107686,92314
2:3:5,1,1,107685,92315
3:2:1,1,1,107684,92316
4:3:3,0,-1,107685,92315
3:2:1,1,1,107684,92316
1:6:3,0,-1,107685,92315
4:1:2,1,1,107684,92316
3:1:2,1,1,107683,92317
4:4:1,0,-1,107684,92316
2:3:3,1,1,107683,92317
6:1:4,0,-1,107684,92316
3:1:1,0,-1,107685,92315
2:1:5,1,1,107684,92316
5:2:2,2,2,107682,92318
2:4:3,1,1,107681,92319
3:1:6,0,-1,107682,92318
4:3:5,0,-1,107683,92317
1:2:6,1,1,107682,92318
1:2:4,1,1,107681,92319
4:1:6,0,-1,107682,92318
5:1:1,0,-1,107683,92317
1:1:4,0,-1,107684,92316
3:6:4,0,-1,107685,92315
5:6:2,1,1,107684,92316
6:3:5,0,-1,107685,92315
4:4:3,0,-1,107686,92314
5:2:1,1,1,107685,92315
1:1:2,1,1,107684,92316
5:2:4,1,1,107683,92317
1:6:2,1,1,107682,92318
4:4:5,0,-1,107683,92317
2:4:1,1,1,107682,92318
5:5:4,0,-1,107683,92317
5:4:3,0,-1,107684,92316
5:4:2,1,1,107683,92317
3:4:6,0,-1,107684,92316
5:2:6,1,1,107683,92317
2:3:1,1,1,107682,92318
1:6:2,1,1,107681,92319
4:6:4,0,-1,107682,92318
3:2:3,1,1,107681,92319
5:6:6,0,-1,107682,92318
5:1:3,0,-1,107683,92317
1:6:6,0,-1,107684,92316
5:5:5,0,-1,107685,92315
3:3:2,1,1,107684,92316
3:4:5,0,-1,107685,92315
5:5:5,0,-1,107686,92314
6:3:2,1,1,107685,92315
3:3:2,1,1,107684,92316
4:5:4,0,-1,107685,92315
6:5:2,1,1,107684,92316
6:1:4,0,-1,107685,92315
3:1:1,0,-1,107686,92314
3:5:1,0,-1,107687,92313
6:4:4,0,-1,107688,92312
1:2:5,1,1,107687,92313
1:6:6,0,-1,107688,92312
5:5:6,0,-1,107689,92311
3:2:2,2,2,107687,92313
3:1:6,0,-1,107688,92312
4:1:1,0,-1,107689,92311
5:5:1,0,-1,107690,92310
5:4:6,0,-1,107691,92309
6:5:6,0,-1,107692,92308
4:1:3,0,-1,107693,92307
5:6:4,0,-1,107694,92306
1:1:6,0,-1,107695,92305
2:2:6,2,2,107693,92307
2:6:1,1,1,107692,92308
1:4:2,1,1,107691,92309
1:6:3,0,-1,107692,92308
3:6:5,0,-1,107693,92307
3:3:2,1,1,107692,92308
4:5:5,0,-1,107693,92307
6:2:3,1,1,107692,92308
3:1:4,0,-1,107693,92307
4:2:5,1,1,107692,92308
4:5:6,0,-1,107693,92307
6:1:3,0,-1,107694,92306
3:6:4,0,-1,107695,92305
3:2:6,1,1,107694,92306
6:5:1,0,-1,107695,92305
2:6:5,1,1,107694,92306
1:1:1,0,-1,107695,92305
1:4:1,0,-1,107696,92304
3:6:4,0,-1,107697,92303
1:1:5,0,-1,107698,92302
1:5:5,0,-1,107699,92301
1:3:6,0,-1,107700,92300
1:5:4,0,-1,107701,92299
2:4:4,1,1,107700,92300
4:2:2,2,2,107698,92302
1:3:1,0,-1,107699,92301
1:4:5,0,-1,107700,92300
1:4:4,0,-1,107701,92299
2:4:2,2,2,107699,92301
6:5:6,0,-1,107700,92300
5:5:3,0,-1,107701,92299
3:3:2,1,1,107700,92300
1:5:6,0,-1,107701,92299
6:3:3,0,-1,107702,92298
4:1:1,0,-1,107703,92297
5:4:3,0,-1,107704,92296
1:5:6,0,-1,107705,92295
1:6:2,1,1,107704,92296
1:2:2,2,2,107702,92298
4:2:4,1,1,107701,92299
3:5:1,0,-1,107702,92298
1:3:4,0,-1,107703,92297
4:4:3,0,-1,107704,92296
1:4:3,0,-1,107705,92295
1:4:5,0,-1,107706,92294
6:1:2,1,1,107705,92295
2:1:2,2,2,107703,92297
1:5:1,0,-1,107704,92296
1:5:2,1,1,107703,92297
6:6:6,0,-1,107704,92296
2:4:2,2,2,107702,92298
6:6:2,1,1,107701,92299
5:5:3,0,-1,107702,92298
2:5:3,1,1,107701,92299
1:6:2,1,1,107700,92300
1:1:6,0,-1,107701,92299
4:4:3,0,-1,107702,92298
5:5:4,0,-1,107703,92297
6:3:1,0,-1,107704,92296
3:5:3,0,-1,107705,92295
4:2:3,1,1,107704,92296
4:1:1,0,-1,107705,92295
6:1:1,0,-1,107706,92294
5:5:4,0,-1,107707,92293
1:2:5,1,1,107706,92294
5:3:3,0,-1,107707,92293
2:3:2,2,2,107705,92295
2:5:2,2,2,107703,92297
2:3:3,1,1,107702,92298
3:1:4,0,-1,107703,92297
3:3:6,0,-1,107704,92296
1:6:1,0,-1,107705,92295
3:3:1,0,-1,107706,92294
2:1:6,1,1,107705,92295
3:1:5,0,-1,107706,92294
4:6:2,1,1,107705,92295
1:2:4,1,1,107704,92296
6:2:2,2,2,107702,92298
5:4:4,0,-1,107703,92297
1:6:1,0,-1,107704,92296
1:1:6,0,-1,107705,92295
1:2:4,1,1,107704,92296
6:6:2,1,1,107703,92297
5:6:5,0,-1,107704,92296
3:5:1,0,-1,107705,92295
1:3:1,0,-1,107706,92294
6:6:3,0,-1,107707,92293
6:1:2,1,1,107706,92294
5:4:2,1,1,107705,92295
4:5:4,0,-1,107706,92294
1:5:1,0,-1,107707,92293
4:5:3,0,-1,107708,92292
3:5:1,0,-1,107709,92291
1:3:5,0,-1,107710,92290
4:5:1,0,-1,107711,92289
1:2:4,1,1,107710,92290
3:5:5,0,-1,107711,92289
5:4:1,0,-1,107712,92288
4:2:4,1,1,107711,92289
6:6:5,0,-1,107712,92288
2:3:1,1,1,107711,92289
6:1:3,0,-1,107712,92288
1:4:6,0,-1,107713,92287
5:1:3,0,-1,107714,92286
2:4:2,2,2,107712,92288
5:2:2,2,2,107710,92290
4:3:6,0,-1,107711,92289
6:6:4,0,-1,107712,92288
3:5:2,1,1,107711,92289
2:3:3,1,1,107710,92290
5:4:6,0,-1,107711,92289
1:1:3,0,-1,107712,92288
5:2:5,1,1,107711,92289
1:3:3,0,-1,107712,92288
6:5:2,1,1,107711,92289
1:3:4,0,-1,107712,92288
2:5:5,1,1,107711,92289
6:5:6,0,-1,107712,92288
3:3:4,0,-1,107713,92287
1:4:6,0,-1,107714,92286
1:4:5,0,-1,107715,92285
3:5:1,0,-1,107716,92284
5:6:2,1,1,107715,92285
1:4:1,0,-1,107716,92284
3:3:2,1,1,107715,92285
3:1:6,0,-1,107716,92284
1:6:2,1,1,107715,92285
5:5:4,0,-1,107716,92284
2:6:4,1,1,107715,92285
3:5:3,0,-1,107716,92284
5:3:3,0,-1,107717,92283
3:4:6,0,-1,107718,92282
2:2:1,2,2,107716,92284
2:3:1,1,1,107715,92285
4:6:2,1,1,107714,92286
2:5:3,1,1,107713,92287
3:5:6,0,-1,107714,92286
4:5:4,0,-1,107715,92285
4:1:4,0,-1,107716,92284
5:5:6,0,-1,107717,92283
3:1:2,1,1,107716,92284
4:6:5,0,-1,107717,92283
1:2:3,1,1,107716,92284
4:6:2,1,1,107715,92285
1:5:1,0,-1,107716,92284
1:1:2,1,1,107715,92285
6:5:1,0,-1,107716,92284
1:1:6,0,-1,107717,92283
1:2:4,1,1,107716,92284
1:5:6,0,-1,107717,92283
2:4:1,1,1,107716,92284
6:1:6,0,-1,107717,92283
5:3:2,1,1,107716,92284
4:4:3,0,-1,107717,92283
4:6:5,0,-1,107718,92282
2:1:2,2,2,107716,92284
5:2:6,1,1,107715,92285
5:5:2,1,1,107714,92286
2:2:1,2,2,107712,92288
1:3:2,1,1,107711,92289
1:1:4,0,-1,107712,92288
4:6:6,0,-1,107713,92287
1:3:2,1,1,107712,92288
2:3:5,1,1,107711,92289
1:5:5,0,-1,107712,92288
6:5:3,0,-1,107713,92287
1:2:6,1,1,107712,92288
5:6:4,0,-1,107713,92287
4:5:1,0,-1,107714,92286
4:2:6,1,1,107713,92287
4:4:4,0,-1,107714,92286
1:6:5,0,-1,107715,92285
4:2:3,1,1,107714,92286
1:3:1,0,-1,107715,92285
2:5:4,1,1,107714,92286
5:6:2,1,1,107713,92287
4:1:2,1,1,107712,92288
6:3:1,0,-1,107713,92287
5:3:5,0,-1,107714,92286
3:5:5,0,-1,107715,92285
1:6:1,0,-1,107716,92284
3:1:5,0,-1,107717,92283
2:5:4,1,1,107716,92284
3:3:4,0,-1,107717,92283
4:2:5,1,1,107716,92284
1:3:3,0,-1,107717,92283
5:3:5,0,-1,107718,92282
5:3:1,0,-1,107719,92281
2:4:4,1,1,107718,92282
1:2:4,1,1,107717,92283
1:4:2,1,1,107716,92284
6:2:5,1,1,107715,92285
6:3:5,0,-1,107716,92284
1:5:1,0,-1,107717,92283
5:4:6,0,-1,107718,92282
6:1:4,0,-1,107719,92281
3:4:1,0,-1,107720,92280
2:5:5,1,1,107719,92281
6:6:1,0,-1,107720,92280
6:4:1,0,-1,107721,92279
5:6:5,0,-1,107722,92278
6:6:3,0,-1,107723,92277
1:1:3,0,-1,107724,92276
4:5:6,0,-1,107725,92275
1:6:2,1,1,107724,92276
4:1:4,0,-1,107725,92275
2:6:4,1,1,107724,92276
4:3:1,0,-1,107725,92275
1:6:5,0,-1,107726,92274
4:6:1,0,-1,107727,92273
2:1:2,2,2,107725,92275
3:4:2,1,1,107724,92276
6:5:6,0,-1,107725,92275
1:1:6,0,-1,107726,92274
3:2:4,1,1,107725,92275
4:5:5,0,-1,107726,92274
3:1:2,1,1,107725,92275
5:3:2,1,1,107724,92276
1:3:3,0,-1,107725,92275
1:6:5,0,-1,107726,92274
6:5:3,0,-1,107727,92273
2:2:6,2,2,107725,92275
2:2:3,2,2,107723,92277
1:4:4,0,-1,107724,92276
3:6:6,0,-1,107725,92275
2:4:6,1,1,107724,92276
1:4:3,0,-1,107725,92275
4:6:5,0,-1,107726,92274
6:4:5,0,-1,107727,92273
6:5:1,0,-1,107728,92272
5:6:2,1,1,107727,92273
5:1:6,0,-1,107728,92272
2:6:5,1,1,107727,92273
4:6:5,0,-1,107728,92272
6:1:4,0,-1,107729,92271
3:2:4,1,1,107728,92272
2:5:6,1,1,107727,92273
6:2:1,1,1,107726,92274
2:5:2,2,2,107724,92276
6:4:3,0,-1,107725,92275
4:6:3,0,-1,107726,92274
6:4:3,0,-1,107727,92273
3:5:3,0,-1,107728,92272
6:5:5,0,-1,107729,92271
6:4:1,0,-1,107730,92270
5:3:1,0,-1,107731,92269
1:1:6,0,-1,107732,92268
2:3:4,1,1,107731,92269
4:1:1,0,-1,107732,92268
3:3:3,0,-1,107733,92267
5:1:6,0,-1,107734,92266
2:6:2,2,2,107732,92268
3:2:1,1,1,107731,92269
6:3:3,0,-1,107732,92268
4:3:1,0,-1,107733,92267
5:6:3,0,-1,107734,92266
6:3:6,0,-1,107735,92265
3:5:4,0,-1,107736,92264
5:5:3,0,-1,107737,92263
2:3:6,1,1,107736,92264
1:3:4,0,-1,107737,92263
5:6:6,0,-1,107738,92262
5:6:5,0,-1,107739,92261
1:6:5,0,-1,107740,92260
6:4:6,0,-1,107741,92259
5:2:5,1,1,107740,92260
2:2:3,2,2,107738,92262
5:6:1,0,-1,107739,92261
3:5:5,0,-1,107740,92260
6:3:1,0,-1,107741,92259
2:5:3,1,1,107740,92260
1:6:1,0,-1,107741,92259
3:5:6,0,-1,107742,92258
5:6:6,0,-1,107743,92257
2:2:6,2,2,107741,92259
2:2:3,2,2,107739,92261
4:3:3,0,-1,107740,92260
1:1:3,0,-1,107741,92259
3:1:5,0,-1,107742,92258
5:6:6,0,-1,107743,92257
6:2:1,1,1,107742,92258
2:3:3,1,1,107741,92259
4:1:2,1,1,107740,92260
3:5:3,0,-1,107741,92259
5:6:2,1,1,107740,92260
4:4:6,0,-1,107741,92259
4:2:4,1,1,107740,92260
4:6:4,0,-1,107741,92259
6:2:4,1,1,107740,92260
2:3:5,1,1,107739,92261
2:3:6,1,1,107738,92262
6:2:6,1,1,107737,92263
4:6:6,0,-1,107738,92262
4:5:5,0,-1,107739,92261
3:5:6,0,-1,107740,92260
2:2:4,2,2,107738,92262
5:2:6,1,1,107737,92263
4:3:2,1,1,107736,92264
3:2:2,2,2,107734,92266
1:5:2,1,1,107733,92267
5:6:1,0,-1,107734,92266
6:4:1,0,-1,107735,92265
3:1:2,1,1,107734,92266
1:3:5,0,-1,107735,92265
1:5:3,0,-1,107736,92264
2:5:3,1,1,107735,92265
5:3:1,0,-1,107736,92264
3:5:2,1,1,107735,92265
5:5:2,1,1,107734,92266
4:4:3,0,-1,107735,92265
1:6:4,0,-1,107736,92264
5:6:1,0,-1,107737,92263
1:6:5,0,-1,107738,92262
6:4:3,0,-1,107739,92261
4:1:5,0,-1,107740,92260
6:6:4,0,-1,107741,92259
4:3:6,0,-1,107742,92258
5:1:4,0,-1,107743,92257
1:6:3,0,-1,107744,92256
1:1:4,0,-1,107745,92255
4:5:4,0,-1,107746,92254
5:3:4,0,-1,107747,92253
4:1:4,0,-1,107748,92252
6:6:1,0,-1,107749,92251
6:6:1,0,-1,107750,92250
6:6:4,0,-1,107751,92249
2:1:5,1,1,107750,92250
1:5:5,0,-1,107751,92249
5:3:3,0,-1,107752,92248
6:1:2,1,1,107751,92249
3:5:4,0,-1,107752,92248
6:6:4,0,-1,107753,92247
1:5:2,1,1,107752,92248
1:2:4,1,1,107751,92249
5:1:4,0,-1,107752,92248
2:1:1,1,1,107751,92249
3:2:6,1,1,107750,92250
4:6:4,0,-1,107751,92249
4:1:3,0,-1,107752,92248
1:3:6,0,-1,107753,92247
2:2:3,2,2,107751,92249
6:1:6,0,-1,107752,92248
4:1:4,0,-1,107753,92247
3:1:4,0,-1,107754,92246
6:2:2,2,2,107752,92248
6:6:6,0,-1,107753,92247
1:2:6,1,1,107752,92248
1:4:5,0,-1,107753,92247
4:3:6,0,-1,107754,92246
3:2:5,1,1,107753,92247
6:1:3,0,-1,107754,92246
6:4:3,0,-1,107755,92245
5:2:6,1,1,107754,92246
6:1:1,0,-1,107755,92245
6:6:2,1,1,107754,92246
4:2:5,1,1,107753,92247
1:4:1,0,-1,107754,92246
4:5:2,1,1,107753,92247
1:6:2,1,1,107752,92248
1:6:3,0,-1,107753,92247
2:6:3,1,1,107752,92248
3:3:1,0,-1,107753,92247
6:4:2,1,1,107752,92248
1:2:2,2,2,107750,92250
1:6:4,0,-1,107751,92249
4:4:2,1,1,107750,92250
6:5:4,0,-1,107751,92249
4:6:2,1,1,107750,92250
1:5:6,0,-1,107751,92249
4:3:4,0,-1,107752,92248
4:4:4,0,-1,107753,92247
4:4:3,0,-1,107754,92246
4:3:3,0,-1,107755,92245
6:5:6,0,-1,107756,92244
1:6:2,1,1,107755,92245
4:1:1,0,-1,107756,92244
6:4:1,0,-1,107757,92243
4:3:6,0,-1,107758,92242
4:2:4,1,1,107757,92243
2:6:5,1,1,107756,92244
5:4:4,0,-1,107757,92243
6:5:1,0,-1,107758,92242
6:4:2,1,1,107757,92243
2:2:1,2,2,107755,92245
6:4:3,0,-1,107756,92244
6:2:1,1,1,107755,92245
6:4:4,0,-1,107756,92244
2:2:6,2,2,107754,92246
6:3:3,0,-1,107755,92245
4:2:3,1,1,107754,92246
2:5:1,1,1,107753,92247
3:2:3,1,1,107752,92248
1:6:2,1,1,107751,92249
2:5:4,1,1,107750,92250
6:4:1,0,-1,107751,92249
5:3:3,0,-1,107752,92248
1:6:2,1,1,107751,92249
3:6:1,0,-1,107752,92248
5:3:1,0,-1,107753,92247
1:6:1,0,-1,107754,92246
4:3:6,0,-1,107755,92245
4:4:6,0,-1,107756,92244
4:3:4,0,-1,107757,92243
2:2:5,2,2,107755,92245
2:2:1,2,2,107753,92247
3:5:6,0,-1,107754,92246
1:3:5,0,-1,107755,92245
3:1:6,0,-1,107756,92244
2:4:1,1,1,107755,92245
6:2:6,1,1,107754,92246
3:1:5,0,-1,107755,92245
4:6:2,1,1,107754,92246
1:3:1,0,-1,107755,92245
1:1:6,0,-1,107756,92244
2:4:1,1,1,107755,92245
6:1:3,0,-1,107756,92244
5:5:6,0,-1,107757,92243
6:1:3,0,-1,107758,92242
6:2:5,1,1,107757,92243
5:4:2,1,1,107756,92244
4:3:2,1,1,107755,92245
6:4:1,0,-1,107756,92244
3:3:6,0,-1,107757,92243
6:4:5,0,-1,107758,92242
3:5:5,0,-1,107759,92241
3:6:2,1,1,107758,92242
4:2:6,1,1,107757,92243
1:3:2,1,1,107756,92244
4:2:2,2,2,107754,92246
4:2:5,1,1,107753,92247
2:5:4,1,1,107752,92248
5:6:6,0,-1,107753,92247
1:1:3,0,-1,107754,92246
4:3:1,0,-1,107755,92245
3:5:5,0,-1,107756,92244
2:3:4,1,1,107755,92245
5:5:2,1,1,107754,92246
1:2:1,1,1,107753,92247
3:4:2,1,1,107752,92248
5:6:6,0,-1,107753,92247
1:1:3,0,-1,107754,92246
5:2:1,1,1,107753,92247
1:3:4,0,-1,107754,92246
2:1:2,2,2,107752,92248
3:2:6,1,1,107751,92249
5:2:3,1,1,107750,92250
5:3:5,0,-1,107751,92249
5:6:5,0,-1,107752,92248
1:4:4,0,-1,107753,92247
6:5:6,0,-1,107754,92246
5:3:5,0,-1,107755,92245
5:6:6,0,-1,107756,92244
5:4:3,0,-1,107757,92243
3:6:4,0,-1,107758,92242
5:4:4,0,-1,107759,92241
5:3:2,1,1,107758,92242
3:2:6,1,1,107757,92243
4:4:3,0,-1,107758,92242
4:3:1,0,-1,107759,92241
1:1:1,0,-1,107760,92240
6:3:1,0,-1,107761,92239
3:4:6,0,-1,107762,92238
5:1:5,0,-1,107763,92237
1:1:3,0,-1,107764,92236
3:4:4,0,-1,107765,92235
2:3:4,1,1,107764,92236
3:2:1,1,1,107763,92237
2:6:4,1,1,107762,92238
4:3:5,0,-1,107763,92237
2:1:1,1,1,107762,92238
3:3:1,0,-1,107763,92237
6:3:6,0,-1,107764,92236
6:6:1,0,-1,107765,92235
4:5:1,0,-1,107766,92234
2:3:6,1,1,107765,92235
5:6:4,0,-1,107766,92234
1:2:3,1,1,107765,92235
2:5:1,1,1,107764,92236
5:4:5,0,-1,107765,92235
1:2:1,1,1,107764,92236
3:6:5,0,-1,107765,92235
5:6:1,0,-1,107766,92234
6:4:5,0,-1,107767,92233
3:4:2,1,1,107766,92234
1:6:2,1,1,107765,92235
4:4:2,1,1,107764,92236
5:3:2,1,1,107763,92237
6:4:2,1,1,107762,92238
4:5:2,1,1,107761,92239
6:6:5,0,-1,107762,92238
2:5:2,2,2,107760,92240
5:4:4,0,-1,107761,92239
2:2:6,2,2,107759,92241
2:6:5,1,1,107758,92242
6:3:4,0,-1,107759,92241
1:5:5,0,-1,107760,92240
6:6:4,0,-1,107761,92239
4:3:4,0,-1,107762,92238
5:6:2,1,1,107761,92239
4:1:1,0,-1,107762,92238
3:6:6,0,-1,107763,92237
2:1:4,1,1,107762,92238
4:4:2,1,1,107761,92239
6:3:5,0,-1,107762,92238
6:1:6,0,-1,107763,92237
5:3:2,1,1,107762,92238
3:3:1,0,-1,107763,92237
3:5:5,0,-1,107764,92236
5:4:6,0,-1,107765,92235
3:3:5,0,-1,107766,92234
2:2:2,3,3,107763,92237
5:4:1,0,-1,107764,92236
3:3:3,0,-1,107765,92235
5:1:1,0,-1,107766,92234
3:4:1,0,-1,107767,92233
3:2:6,1,1,107766,92234
3:4:2,1,1,107765,92235
4:1:1,0,-1,107766,92234
1:4:5,0,-1,107767,92233
2:1:6,1,1,107766,92234
3:4:3,0,-1,107767,92233
5:1:6,0,-1,107768,92232
3:4:5,0,-1,107769,92231
2:4:4,1,1,107768,92232
4:5:5,0,-1,107769,92231
2:5:3,1,1,107768,92232
3:1:2,1,1,107767,92233
5:2:3,1,1,107766,92234
4:2:4,1,1,107765,92235
2:4:6,1,1,107764,92236
2:4:2,2,2,107762,92238
1:2:4,1,1,107761,92239
4:5:6,0,-1,107762,92238
6:5:3,0,-1,107763,92237
5:2:3,1,1,107762,92238
3:5:4,0,-1,107763,92237
2:5:5,1,1,107762,92238
1:3:3,0,-1,107763,92237
2:6:6,1,1,107762,92238
6:5:6,0,-1,107763,92237
5:5:5,0,-1,107764,92236
3:1:2,1,1,107763,92237
2:4:4,1,1,107762,92238
5:6:2,1,1,107761,92239
4:2:3,1,1,107760,92240
3:3:2,1,1,107759,92241
2:4:4,1,1,107758,92242
3:1:2,1,1,107757,92243
1:2:5,1,1,107756,92244
4:6:5,0,-1,107757,92243
5:1:3,0,-1,107758,92242
2:3:4,1,1,107757,92243
4:4:5,0,-1,107758,92242
2:3:5,1,1,107757,92243
5:3:5,0,-1,107758,92242
6:6:1,0,-1,107759,92241
2:1:2,2,2,107757,92243
4:1:5,0,-1,107758,92242
1:4:4,0,-1,107759,92241
3:1:6,0,-1,107760,92240
2:1:6,1,1,107759,92241
1:5:4,0,-1,107760,92240
4:5:5,0,-1,107761,92239
5:1:2,1,1,107760,92240
2:1:5,1,1,107759,92241
4:5:2,1,1,107758,92242
1:2:3,1,1,107757,92243
6:2:3,1,1,107756,92244
3:3:1,0,-1,107757,92243
5:4:6,0,-1,107758,92242
5:1:4,0,-1,107759,92241
6:3:5,0,-1,107760,92240
1:5:6,0,-1,107761,92239
6:6:5,0,-1,107762,92238
4:1:1,0,-1,107763,92237
4:5:3,0,-1,107764,92236
2:4:3,1,1,107763,92237
1:2:3,1,1,107762,92238
3:6:2,1,1,107761,92239
1:3:1,0,-1,107762,92238
6:1:3,0,-1,107763,92237
4:4:1,0,-1,107764,92236
3:4:2,1,1,107763,92237
1:2:1,1,1,107762,92238
4:1:3,0,-1,107763,92237
6:4:2,1,1,107762,92238
2:5:6,1,1,107761,92239
1:2:5,1,1,107760,92240
3:6:3,0,-1,107761,92239
6:2:5,1,1,107760,92240
5:4:3,0,-1,107761,92239
6:6:3,0,-1,107762,92238
6:6:2,1,1,107761,92239
3:5:3,0,-1,107762,92238
2:4:1,1,1,107761,92239
2:1:5,1,1,107760,92240
2:4:1,1,1,107759,92241
6:4:3,0,-1,107760,92240
4:3:1,0,-1,107761,92239
1:1:3,0,-1,107762,92238
2:6:3,1,1,107761,92239
6:2:6,1,1,107760,92240
6:6:3,0,-1,107761,92239
6:1:1,0,-1,107762,92238
6:4:6,0,-1,107763,92237
2:1:5,1,1,107762,92238
3:1:3,0,-1,107763,92237
6:6:2,1,1,107762,92238
1:4:2,1,1,107761,92239
5:5:6,0,-1,107762,92238
3:1:2,1,1,107761,92239
4:5:3,0,-1,107762,92238
3:6:4,0,-1,107763,92237
3:5:1,0,-1,107764,92236
2:3:2,2,2,107762,92238
5:6:1,0,-1,107763,92237
4:2:6,1,1,107762,92238
4:3:3,0,-1,107763,92237
1:4:2,1,1,107762,92238
3:5:6,0,-1,107763,92237
4:4:5,0,-1,107764,92236
4:6:3,0,-1,107765,92235
6:3:4,0,-1,107766,92234
2:6:5,1,1,107765,92235
2:3:4,1,1,107764,92236
4:2:5,1,1,107763,92237
6:6:6,0,-1,107764,92236
3:4:5,0,-1,107765,92235
4:3:3,0,-1,107766,92234
3:4:4,0,-1,107767,92233
4:3:6,0,-1,107768,92232
5:3:2,1,1,107767,92233
1:6:1,0,-1,107768,92232
2:3:1,1,1,107767,92233
5:2:3,1,1,107766,92234
5:3:4,0,-1,107767,92233
2:4:6,1,1,107766,92234
1:2:4,1,1,107765,92235
3:1:6,0,-1,107766,92234
3:2:1,1,1,107765,92235
6:1:2,1,1,107764,92236
6:1:2,1,1,107763,92237
3:3:5,0,-1,107764,92236
5:1:1,0,-1,107765,92235
5:3:5,0,-1,107766,92234
4:2:1,1,1,107765,92235
4:4:1,0,-1,107766,92234
2:2:6,2,2,107764,92236
3:5:6,0,-1,107765,92235
6:3:2,1,1,107764,92236
2:2:3,2,2,107762,92238
3:1:1,0,-1,107763,92237
6:1:3,0,-1,107764,92236
2:6:2,2,2,107762,92238
3:4:1,0,-1,107763,92237
1:3:6,0,-1,107764,92236
3:2:2,2,2,107762,92238
1:1:3,0,-1,107763,92237
2:3:3,1,1,107762,92238
2:2:2,3,3,107759,92241
2:4:2,2,2,107757,92243
1:3:4,0,-1,107758,92242
5:5:6,0,-1,107759,92241
1:1:1,0,-1,107760,92240
6:2:1,1,1,107759,92241
1:1:5,0,-1,107760,92240
3:2:3,1,1,107759,92241
4:3:4,0,-1,107760,92240
1:6:1,0,-1,107761,92239
2:4:6,1,1,107760,92240
1:6:1,0,-1,107761,92239
1:1:2,1,1,107760,92240
1:4:4,0,-1,107761,92239
1:4:4,0,-1,107762,92238
3:1:3,0,-1,107763,92237
4:6:4,0,-1,107764,92236
3:5:3,0,-1,107765,92235
2:6:1,1,1,107764,92236
4:2:3,1,1,107763,92237
3:3:4,0,-1,107764,92236
6:2:3,1,1,107763,92237
5:3:1,0,-1,107764,92236
3:1:4,0,-1,107765,92235
2:1:5,1,1,107764,92236
1:4:1,0,-1,107765,92235
3:4:5,0,-1,107766,92234
5:4:3,0,-1,107767,92233
6:6:4,0,-1,107768,92232
2:4:2,2,2,107766,92234
6:3:3,0,-1,107767,92233
6:6:5,0,-1,107768,92232
5:4:6,0,-1,107769,92231
4:2:3,1,1,107768,92232
3:3:3,0,-1,107769,92231
4:6:1,0,-1,107770,92230
5:3:4,0,-1,107771,92229
6:3:3,0,-1,107772,92228
6:6:5,0,-1,107773,92227
1:3:3,0,-1,107774,92226
4:1:1,0,-1,107775,92225
5:2:1,1,1,107774,92226
3:2:4,1,1,107773,92227
1:4:4,0,-1,107774,92226
4:1:6,0,-1,107775,92225
2:6:3,1,1,107774,92226
5:6:5,0,-1,107775,92225
6:5:3,0,-1,107776,92224
4:4:6,0,-1,107777,92223
2:4:6,1,1,107776,92224
1:2:3,1,1,107775,92225
2:6:6,1,1,107774,92226
4:1:1,0,-1,107775,92225
5:6:2,1,1,107774,92226
2:4:4,1,1,107773,92227
5:2:4,1,1,107772,92228
1:2:4,1,1,107771,92229
6:3:6,0,-1,107772,92228
2:1:2,2,2,107770,92230
2:5:1,1,1,107769,92231
5:2:5,1,1,107768,92232
4:4:4,0,-1,107769,92231
1:3:1,0,-1,107770,92230
4:6:3,0,-1,107771,92229
6:6:3,0,-1,107772,92228
5:2:4,1,1,107771,92229
1:3:3,0,-1,107772,92228
2:6:1,1,1,107771,92229
2:2:1,2,2,107769,92231
3:6:4,0,-1,107770,92230
1:6:2,1,1,107769,92231
5:4:6,0,-1,107770,92230
6:3:1,0,-1,107771,92229
4:2:5,1,1,107770,92230
3:6:5,0,-1,107771,92229
1:6:3,0,-1,107772,92228
2:4:6,1,1,107771,92229
1:6:4,0,-1,107772,92228
6:2:3,1,1,107771,92229
4:5:5,0,-1,107772,92228
4:1:2,1,1,107771,92229
6:2:3,1,1,107770,92230
2:6:2,2,2,107768,92232
4:3:5,0,-1,107769,92231
1:3:3,0,-1,107770,92230
1:2:1,1,1,107769,92231
3:5:4,0,-1,107770,92230
5:2:2,2,2,107768,92232
2:3:2,2,2,107766,92234
4:3:6,0,-1,107767,92233
4:5:6,0,-1,107768,92232
2:5:2,2,2,107766,92234
5:3:1,0,-1,107767,92233
4:1:1,0,-1,107768,92232
1:6:4,0,-1,107769,92231
5:3:5,0,-1,107770,92230
1:6:2,1,1,107769,92231
6:6:3,0,-1,107770,92230
4:2:3,1,1,107769,92231
1:2:2,2,2,107767,92233
1:1:3,0,-1,107768,92232
6:2:3,1,1,107767,92233
3:2:5,1,1,107766,92234
5:5:6,0,-1,107767,92233
5:3:4,0,-1,107768,92232
4:5:4,0,-1,107769,92231
5:5:3,0,-1,107770,92230
1:4:3,0,-1,107771,92229
3:1:6,0,-1,107772,92228
4:6:6,0,-1,107773,92227
3:3:3,0,-1,107774,92226
5:2:5,1,1,107773,92227
3:6:2,1,1,107772,92228
4:1:2,1,1,107771,92229
6:5:2,1,1,107770,92230
5:2:5,1,1,107769,92231
1:6:5,0,-1,107770,92230
5:1:2,1,1,107769,92231
6:1:4,0,-1,107770,92230
4:5:4,0,-1,107771,92229
3:2:5,1,1,107770,92230
5:4:4,0,-1,107771,92229
5:3:6,0,-1,107772,92228
3:4:3,0,-1,107773,92227
1:5:1,0,-1,107774,92226
6:6:3,0,-1,107775,92225
3:1:4,0,-1,107776,92224
2:2:2,3,3,107773,92227
1:1:6,0,-1,107774,92226
1:4:1,0,-1,107775,92225
3:2:5,1,1,107774,92226
2:2:2,3,3,107771,92229
2:4:6,1,1,107770,92230
4:6:3,0,-1,107771,92229
3:5:5,0,-1,107772,92228
2:3:3,1,1,107771,92229
2:5:4,1,1,107770,92230
4:2:1,1,1,107769,92231
5:2:5,1,1,107768,92232
3:3:6,0,-1,107769,92231
6:5:3,0,-1,107770,92230
1:1:1,0,-1,107771,92229
2:2:3,2,2,107769,92231
2:5:5,1,1,107768,92232
2:1:2,2,2,107766,92234
2:6:2,2,2,107764,92236
6:1:6,0,-1,107765,92235
1:2:2,2,2,107763,92237
1:2:2,2,2,107761,92239
5:6:4,0,-1,107762,92238
6:1:5,0,-1,107763,92237
2:4:6,1,1,107762,92238
6:2:6,1,1,107761,92239
2:2:6,2,2,107759,92241
4:2:4,1,1,107758,92242
3:3:5,0,-1,107759,92241
3:1:1,0,-1,107760,92240
6:6:5,0,-1,107761,92239
6:5:2,1,1,107760,92240
6:3:6,0,-1,107761,92239
4:3:2,1,1,107760,92240
2:4:3,1,1,107759,92241
1:3:4,0,-1,107760,92240
5:4:3,0,-1,107761,92239
2:3:6,1,1,107760,92240
4:2:6,1,1,107759,92241
6:5:6,0,-1,107760,92240
5:5:5,0,-1,107761,92239
2:2:4,2,2,107759,92241
5:2:4,1,1,107758,92242
3:1:3,0,-1,107759,92241
5:6:6,0,-1,107760,92240
1:5:5,0,-1,107761,92239
6:4:3,0,-1,107762,92238
6:6:5,0,-1,107763,92237
5:3:3,0,-1,107764,92236
2:4:4,1,1,107763,92237
3:2:1,1,1,107762,92238
6:5:2,1,1,107761,92239
1:4:2,1,1,107760,92240
5:6:3,0,-1,107761,92239
5:6:2,1,1,107760,92240
4:4:1,0,-1,107761,92239
3:6:5,0,-1,107762,92238
5:2:4,1,1,107761,92239
5:4:6,0,-1,107762,92238
2:2:6,2,2,107760,92240
3:1:3,0,-1,107761,92239
5:6:1,0,-1,107762,92238
3:4:6,0,-1,107763,92237
2:4:1,1,1,107762,92238
1:4:5,0,-1,107763,92237
4:4:1,0,-1,107764,92236
1:4:1,0,-1,107765,92235
1:5:4,0,-1,107766,92234
2:1:2,2,2,107764,92236
3:3:4,0,-1,107765,92235
6:1:6,0,-1,107766,92234
3:4:1,0,-1,107767,92233
2:5:6,1,1,107766,92234
2:3:3,1,1,107765,92235
6:3:2,1,1,107764,92236
2:6:3,1,1,107763,92237
2:3:2,2,2,107761,92239
5:4:1,0,-1,107762,92238
2:1:2,2,2,107760,92240
4:3:4,0,-1,107761,92239
6:4:1,0,-1,107762,92238
6:3:4,0,-1,107763,92237
1:6:1,0,-1,107764,92236
1:3:6,0,-1,107765,92235
4:2:6,1,1,107764,92236
1:2:4,1,1,107763,92237
4:6:4,0,-1,107764,92236
6:4:2,1,1,107763,92237
6:2:4,1,1,107762,92238
5:2:2,2,2,107760,92240
2:2:1,2,2,107758,92242
2:3:6,1,1,107757,92243
3:4:4,0,-1,107758,92242
2:2:3,2,2,107756,92244
5:1:1,0,-1,107757,92243
3:5:3,0,-1,107758,92242
3:2:4,1,1,107757,92243
5:5:1,0,-1,107758,92242
4:5:4,0,-1,107759,92241
1:1:6,0,-1,107760,92240
5:1:1,0,-1,107761,92239
1:4:1,0,-1,107762,92238
4:3:4,0,-1,107763,92237
3:3:5,0,-1,107764,92236
6:1:2,1,1,107763,92237
5:6:5,0,-1,107764,92236
5:6:6,0,-1,107765,92235
3:6:1,0,-1,107766,92234
2:5:6,1,1,107765,92235
3:2:4,1,1,107764,92236
3:4:2,1,1,107763,92237
1:6:2,1,1,107762,92238
6:3:4,0,-1,107763,92237
6:3:2,1,1,107762,92238
1:1:4,0,-1,107763,92237
2:6:1,1,1,107762,92238
3:1:1,0,-1,107763,92237
4:3:4,0,-1,107764,92236
6:2:2,2,2,107762,92238
3:2:5,1,1,107761,92239
5:6:5,0,-1,107762,92238
4:1:3,0,-1,107763,92237
1:5:3,0,-1,107764,92236
5:3:4,0,-1,107765,92235
1:4:4,0,-1,107766,92234
4:6:6,0,-1,107767,92233
2:4:3,1,1,107766,92234
2:6:1,1,1,107765,92235
6:4:4,0,-1,107766,92234
6:2:2,2,2,107764,92236
6:4:5,0,-1,107765,92235
1:3:2,1,1,107764,92236
4:1:2,1,1,107763,92237
6:4:1,0,-1,107764,92236
1:5:2,1,1,107763,92237
4:4:6,0,-1,107764,92236
1:6:2,1,1,107763,92237
5:6:6,0,-1,107764,92236
1:5:1,0,-1,107765,92235
3:3:4,0,-1,107766,92234
5:5:4,0,-1,107767,92233
4:4:6,0,-1,107768,92232
5:2:6,1,1,107767,92233
3:1:4,0,-1,107768,92232
4:5:4,0,-1,107769,92231
2:4:2,2,2,107767,92233
1:2:3,1,1,107766,92234
5:1:1,0,-1,107767,92233
5:6:4,0,-1,107768,92232
1:5:6,0,-1,107769,92231
5:6:3,0,-1,107770,92230
5:6:5,0,-1,107771,92229
6:4:6,0,-1,107772,92228
5:3:6,0,-1,107773,92227
5:4:2,1,1,107772,92228
2:5:5,1,1,107771,92229
6:6:2,1,1,107770,92230
5:4:5,0,-1,107771,92229
1:5:1,0,-1,107772,92228
2:1:2,2,2,107770,92230
3:4:4,0,-1,107771,92229
6:2:3,1,1,107770,92230
6:3:5,0,-1,107771,92229
6:1:3,0,-1,107772,92228
3:2:6,1,1,107771,92229
3:1:2,1,1,107770,92230
4:2:2,2,2,107768,92232
6:3:6,0,-1,107769,92231
5:1:1,0,-1,107770,92230
1:5:3,0,-1,107771,92229
3:6:3,0,-1,107772,92228
3:3:2,1,1,107771,92229
6:5:5,0,-1,107772,92228
6:1:5,0,-1,107773,92227
4:5:4,0,-1,107774,92226
3:4:5,0,-1,107775,92225
6:5:6,0,-1,107776,92224
6:4:2,1,1,107775,92225
5:6:5,0,-1,107776,92224
4:2:1,1,1,107775,92225
4:2:2,2,2,107773,92227
5:5:5,0,-1,107774,92226
2:2:4,2,2,107772,92228
3:1:4,0,-1,107773,92227
6:4:4,0,-1,107774,92226
1:1:3,0,-1,107775,92225
6:4:2,1,1,107774,92226
3:5:5,0,-1,107775,92225
6:2:3,1,1,107774,92226
1:3:3,0,-1,107775,92225
1:2:5,1,1,107774,92226
3:6:1,0,-1,107775,92225
3:1:2,1,1,107774,92226
1:4:6,0,-1,107775,92225
4:5:6,0,-1,107776,92224
6:2:6,1,1,107775,92225
3:2:6,1,1,107774,92226
6:4:3,0,-1,107775,92225
2:5:3,1,1,107774,92226
2:3:6,1,1,107773,92227
5:2:5,1,1,107772,92228
6:2:1,1,1,107771,92229
1:3:3,0,-1,107772,92228
5:6:6,0,-1,107773,92227
5:2:6,1,1,107772,92228
4:5:1,0,-1,107773,92227
3:1:2,1,1,107772,92228
2:1:5,1,1,107771,92229
6:1:4,0,-1,107772,92228
5:4:6,0,-1,107773,92227
4:6:1,0,-1,107774,92226
4:2:2,2,2,107772,92228
4:3:6,0,-1,107773,92227
1:6:2,1,1,107772,92228
5:5:3,0,-1,107773,92227
2:1:3,1,1,107772,92228
4:1:6,0,-1,107773,92227
4:4:1,0,-1,107774,92226
1:1:3,0,-1,107775,92225
3:3:3,0,-1,107776,92224
6:5:6,0,-1,107777,92223
4:4:6,0,-1,107778,92222
3:5:6,0,-1,107779,92221
5:6:6,0,-1,107780,92220
4:3:5,0,-1,107781,92219
4:3:2,1,1,107780,92220
6:6:4,0,-1,107781,92219
3:2:5,1,1,107780,92220
2:5:4,1,1,107779,92221
1:2:1,1,1,107778,92222
2:6:3,1,1,107777,92223
3:2:6,1,1,107776,92224
5:4:5,0,-1,107777,92223
6:1:5,0,-1,107778,92222
6:5:2,1,1,107777,92223
5:2:2,2,2,107775,92225
4:2:4,1,1,107774,92226
5:1:2,1,1,107773,92227
3:2:6,1,1,107772,92228
4:2:2,2,2,107770,92230
2:2:1,2,2,107768,92232
3:2:4,1,1,107767,92233
3:1:4,0,-1,107768,92232
6:4:4,0,-1,107769,92231
6:4:2,1,1,107768,92232
5:3:4,0,-1,107769,92231
1:2:2,2,2,107767,92233
2:1:4,1,1,107766,92234
4:6:2,1,1,107765,92235
4:6:4,0,-1,107766,92234
4:2:3,1,1,107765,92235
5:4:3,0,-1,107766,92234
6:6:5,0,-1,107767,92233
6:3:6,0,-1,107768,92232
1:1:5,0,-1,107769,92231
6:5:6,0,-1,107770,92230
6:3:1,0,-1,107771,92229
5:3:5,0,-1,107772,92228
6:3:6,0,-1,107773,92227
5:5:1,0,-1,107774,92226
2:1:5,1,1,107773,92227
1:6:1,0,-1,107774,92226
5:6:4,0,-1,107775,92225
1:1:3,0,-1,107776,92224
1:2:2,2,2,107774,92226
6:5:4,0,-1,107775,92225
1:3:5,0,-1,107776,92224
4:3:3,0,-1,107777,92223
6:6:4,0,-1,107778,92222
4:6:1,0,-1,107779,92221
5:4:5,0,-1,107780,92220
6:3:3,0,-1,107781,92219
2:6:4,1,1,107780,92220
4:3:3,0,-1,107781,92219
6:2:2,2,2,107779,92221
1:4:6,0,-1,107780,92220
5:3:3,0,-1,107781,92219
1:5:5,0,-1,107782,92218
2:4:4,1,1,107781,92219
4:1:4,0,-1,107782,92218
4:5:3,0,-1,107783,92217
4:2:6,1,1,107782,92218
4:4:6,0,-1,107783,92217
1:4:4,0,-1,107784,92216
2:2:2,3,3,107781,92219
2:1:5,1,1,107780,92220
4:2:5,1,1,107779,92221
6:1:5,0,-1,107780,92220
2:6:2,2,2,107778,92222
3:3:3,0,-1,107779,92221
3:4:5,0,-1,107780,92220
4:5:2,1,1,107779,92221
5:6:2,1,1,107778,92222
4:6:6,0,-1,107779,92221
1:4:5,0,-1,107780,92220
2:3:3,1,1,107779,92221
2:5:2,2,2,107777,92223
6:3:6,0,-1,107778,92222
6:1:5,0,-1,107779,92221
6:4:6,0,-1,107780,92220
5:1:4,0,-1,107781,92219
4:4:2,1,1,107780,92220
3:2:3,1,1,107779,92221
2:3:2,2,2,107777,92223
6:3:6,0,-1,107778,92222
3:5:1,0,-1,107779,92221
6:5:5,0,-1,107780,92220
5:5:3,0,-1,107781,92219
2:2:1,2,2,107779,92221
1:3:2,1,1,107778,92222
4:3:4,0,-1,107779,92221
3:4:2,1,1,107778,92222
5:3:1,0,-1,107779,92221
1:6:6,0,-1,107780,92220
6:6:6,0,-1,107781,92219
3:5:4,0,-1,107782,92218
3:1:3,0,-1,107783,92217
3:4:6,0,-1,107784,92216
4:1:6,0,-1,107785,92215
4:3:2,1,1,107784,92216
2:2:3,2,2,107782,92218
1:2:1,1,1,107781,92219
6:1:1,0,-1,107782,92218
1:3:1,0,-1,107783,92217
2:5:6,1,1,107782,92218
6:1:1,0,-1,107783,92217
6:4:2,1,1,107782,92218
1:4:2,1,1,107781,92219
1:3:4,0,-1,107782,92218
4:6:3,0,-1,107783,92217
6:1:2,1,1,107782,92218
2:3:4,1,1,107781,92219
1:4:4,0,-1,107782,92218
5:4:5,0,-1,107783,92217
2:5:3,1,1,107782,92218
1:4:2,1,1,107781,92219
5:1:3,0,-1,107782,92218
4:1:3,0,-1,107783,92217
5:4:4,0,-1,107784,92216
6:5:3,0,-1,107785,92215
5:2:5,1,1,107784,92216
6:6:6,0,-1,107785,92215
3:6:3,0,-1,107786,92214
3:5:6,0,-1,107787,92213
1:6:4,0,-1,107788,92212
3:5:1,0,-1,107789,92211
5:1:2,1,1,107788,92212
4:6:5,0,-1,107789,92211
5:3:4,0,-1,107790,92210
3:6:1,0,-1,107791,92209
6:2:5,1,1,107790,92210
3:3:5,0,-1,107791,92209
6:1:6,0,-1,107792,92208
5:6:2,1,1,107791,92209
3:1:3,0,-1,107792,92208
3:3:3,0,-1,107793,92207
3:4:3,0,-1,107794,92206
3:5:3,0,-1,107795,92205
3:1:2,1,1,107794,92206
4:5:4,0,-1,107795,92205
6:3:6,0,-1,107796,92204
2:1:2,2,2,107794,92206
5:5:3,0,-1,107795,92205
1:3:5,0,-1,107796,92204
2:5:4,1,1,107795,92205
3:4:6,0,-1,107796,92204
6:3:1,0,-1,107797,92203
1:5:2,1,1,107796,92204
2:1:1,1,1,107795,92205
6:3:5,0,-1,107796,92204
3:5:6,0,-1,107797,92203
6:6:3,0,-1,107798,92202
3:5:5,0,-1,107799,92201
4:4:6,0,-1,107800,92200
2:3:3,1,1,107799,92201
5:1:2,1,1,107798,92202
6:5:6,0,-1,107799,92201
2:4:6,1,1,107798,92202
6:5:2,1,1,107797,92203
5:4:2,1,1,107796,92204
1:4:4,0,-1,107797,92203
5:6:3,0,-1,107798,92202
3:5:6,0,-1,107799,92201
6:2:1,1,1,107798,92202
3:2:6,1,1,107797,92203
2:5:3,1,1,107796,92204
6:3:5,0,-1,107797,92203
6:3:2,1,1,107796,92204
6:2:3,1,1,107795,92205
1:4:2,1,1,107794,92206
2:1:4,1,1,107793,92207
6:6:4,0,-1,107794,92206
3:4:5,0,-1,107795,92205
4:1:1,0,-1,107796,92204
6:3:6,0,-1,107797,92203
1:6:1,0,-1,107798,92202
6:4:3,0,-1,107799,92201
5:2:2,2,2,107797,92203
2:3:1,1,1,107796,92204
2:3:2,2,2,107794,92206
5:1:2,1,1,107793,92207
5:1:6,0,-1,107794,92206
5:5:2,1,1,107793,92207
6:2:3,1,1,107792,92208
3:6:2,1,1,107791,92209
4:1:5,0,-1,107792,92208
4:5:1,0,-1,107793,92207
3:4:2,1,1,107792,92208
5:6:6,0,-1,107793,92207
2:5:6,1,1,107792,92208
3:2:5,1,1,107791,92209
2:2:4,2,2,107789,92211
2:6:5,1,1,107788,92212
5:6:2,1,1,107787,92213
2:3:4,1,1,107786,92214
4:5:6,0,-1,107787,92213
6:2:5,1,1,107786,92214
6:4:5,0,-1,107787,92213
6:3:6,0,-1,107788,92212
6:3:6,0,-1,107789,92211
2:5:2,2,2,107787,92213
6:2:3,1,1,107786,92214
6:2:4,1,1,107785,92215
2:5:3,1,1,107784,92216
3:6:2,1,1,107783,92217
1:4:1,0,-1,107784,92216
6:1:6,0,-1,107785,92215
2:2:3,2,2,107783,92217
1:2:3,1,1,107782,92218
3:3:3,0,-1,107783,92217
1:5:2,1,1,107782,92218
5:6:3,0,-1,107783,92217
3:1:6,0,-1,107784,92216
4:5:2,1,1,107783,92217
1:4:5,0,-1,107784,92216
5:4:6,0,-1,107785,92215
2:3:2,2,2,107783,92217
1:6:6,0,-1,107784,92216
1:5:6,0,-1,107785,92215
4:5:1,0,-1,107786,92214
6:1:1,0,-1,107787,92213
4:4:6,0,-1,107788,92212
2:2:1,2,2,107786,92214
6:2:2,2,2,107784,92216
2:3:3,1,1,107783,92217
6:5:3,0,-1,107784,92216
5:6:2,1,1,107783,92217
1:3:3,0,-1,107784,92216
4:1:4,0,-1,107785,92215
6:6:3,0,-1,107786,92214
3:5:6,0,-1,107787,92213
2:2:5,2,2,107785,92215
5:5:6,0,-1,107786,92214
6:5:1,0,-1,107787,92213
3:4:3,0,-1,107788,92212
1:5:1,0,-1,107789,92211
5:2:1,1,1,107788,92212
6:4:2,1,1,107787,92213
4:3:2,1,1,107786,92214
3:6:2,1,1,107785,92215
3:3:6,0,-1,107786,92214
1:5:2,1,1,107785,92215
3:2:4,1,1,107784,92216
3:1:5,0,-1,107785,92215
3:6:1,0,-1,107786,92214
4:1:5,0,-1,107787,92213
3:4:3,0,-1,107788,92212
5:6:6,0,-1,107789,92211
4:4:5,0,-1,107790,92210
1:5:4,0,-1,107791,92209
5:6:5,0,-1,107792,92208
2:4:5,1,1,107791,92209
1:6:3,0,-1,107792,92208
4:6:4,0,-1,107793,92207
5:3:3,0,-1,107794,92206
2:3:2,2,2,107792,92208
5:1:2,1,1,107791,92209
5:3:3,0,-1,107792,92208
5:5:2,1,1,107791,92209
2:1:2,2,2,107789,92211
5:2:1,1,1,107788,92212
4:4:5,0,-1,107789,92211
5:2:1,1,1,107788,92212
5:1:6,0,-1,107789,92211
2:2:3,2,2,107787,92213
5:1:1,0,-1,107788,92212
5:3:4,0,-1,107789,92211
6:3:2,1,1,107788,92212
1:5:1,0,-1,107789,92211
1:1:5,0,-1,107790,92210
5:5:2,1,1,107789,92211
3:6:1,0,-1,107790,92210
6:6:5,0,-1,107791,92209
4:5:1,0,-1,107792,92208
5:3:2,1,1,107791,92209
3:4:2,1,1,107790,92210
5:6:5,0,-1,107791,92209
4:2:3,1,1,107790,92210
4:3:3,0,-1,107791,92209
4:5:6,0,-1,107792,92208
1:1:5,0,-1,107793,92207
3:5:4,0,-1,107794,92206
6:2:5,1,1,107793,92207
3:4:5,0,-1,107794,92206
4:4:1,0,-1,107795,92205
1:6:4,0,-1,107796,92204
5:4:5,0,-1,107797,92203
5:1:6,0,-1,107798,92202
4:1:3,0,-1,107799,92201
2:2:6,2,2,107797,92203
5:6:2,1,1,107796,92204
6:2:4,1,1,107795,92205
3:2:6,1,1,107794,92206
1:1:1,0,-1,107795,92205
1:6:4,0,-1,107796,92204
3:4:6,0,-1,107797,92203
4:3:4,0,-1,107798,92202
5:1:5,0,-1,107799,92201
4:2:1,1,1,107798,92202
3:4:3,0,-1,107799,92201
4:1:6,0,-1,107800,92200
3:5:3,0,-1,107801,92199
6:4:3,0,-1,107802,92198
4:2:1,1,1,107801,92199
5:6:1,0,-1,107802,92198
3:3:3,0,-1,107803,92197
3:2:5,1,1,107802,92198
5:2:2,2,2,107800,92200
4:1:5,0,-1,107801,92199
3:4:1,0,-1,107802,92198
5:3:5,0,-1,107803,92197
3:2:4,1,1,107802,92198
3:6:5,0,-1,107803,92197
1:4:4,0,-1,107804,92196
3:5:4,0,-1,107805,92195
6:1:5,0,-1,107806,92194
3:1:6,0,-1,107807,92193
3:5:6,0,-1,107808,92192
1:1:2,1,1,107807,92193
1:6:3,0,-1,107808,92192
2:2:5,2,2,107806,92194
4:5:4,0,-1,107807,92193
5:5:1,0,-1,107808,92192
1:1:1,0,-1,107809,92191
4:2:3,1,1,107808,92192
5:5:4,0,-1,107809,92191
5:6:5,0,-1,107810,92190
6:5:1,0,-1,107811,92189
2:6:1,1,1,107810,92190
6:5:5,0,-1,107811,92189
6:1:5,0,-1,107812,92188
6:5:5,0,-1,107813,92187
2:4:4,1,1,107812,92188
5:2:2,2,2,107810,92190
4:4:5,0,-1,107811,92189
5:2:1,1,1,107810,92190
4:4:2,1,1,107809,92191
1:1:6,0,-1,107810,92190
5:1:6,0,-1,107811,92189
1:4:3,0,-1,107812,92188
2:1:2,2,2,107810,92190
1:4:6,0,-1,107811,92189
5:3:6,0,-1,107812,92188
5:2:6,1,1,107811,92189
1:1:1,0,-1,107812,92188
4:1:2,1,1,107811,92189
5:1:5,0,-1,107812,92188
5:1:4,0,-1,107813,92187
5:1:2,1,1,107812,92188
1:5:1,0,-1,107813,92187
5:3:3,0,-1,107814,92186
1:3:5,0,-1,107815,92185
2:2:1,2,2,107813,92187
4:5:4,0,-1,107814,92186
6:3:4,0,-1,107815,92185
3:6:4,0,-1,107816,92184
6:5:4,0,-1,107817,92183
6:6:1,0,-1,107818,92182
6:4:5,0,-1,107819,92181
2:5:5,1,1,107818,92182
2:4:4,1,1,107817,92183
3:3:3,0,-1,107818,92182
6:6:5,0,-1,107819,92181
1:5:1,0,-1,107820,92180
5:3:4,0,-1,107821,92179
6:3:3,0,-1,107822,92178
2:3:4,1,1,107821,92179
3:6:3,0,-1,107822,92178
3:1:4,0,-1,107823,92177
3:6:4,0,-1,107824,92176
1:1:5,0,-1,107825,92175
5:2:5,1,1,107824,92176
4:2:1,1,1,107823,92177
4:5:2,1,1,107822,92178
1:2:3,1,1,107821,92179
1:5:1,0,-1,107822,92178
5:5:4,0,-1,107823,92177
1:4:3,0,-1,107824,92176
4:3:4,0,-1,107825,92175
2:6:1,1,1,107824,92176
1:2:2,2,2,107822,92178
6:1:6,0,-1,107823,92177
2:4:3,1,1,107822,92178
6:6:3,0,-1,107823,92177
4:6:5,0,-1,107824,92176
6:4:6,0,-1,107825,92175
2:1:2,2,2,107823,92177
3:6:1,0,-1,107824,92176
5:3:2,1,1,107823,92177
6:1:6,0,-1,107824,92176
2:1:5,1,1,107823,92177
6:5:1,0,-1,107824,92176
1:6:5,0,-1,107825,92175
6:6:6,0,-1,107826,92174
1:5:6,0,-1,107827,92173
6:4:3,0,-1,107828,92172
1:1:4,0,-1,107829,92171
5:5:1,0,-1,107830,92170
5:2:5,1,1,107829,92171
5:2:4,1,1,107828,92172
1:5:5,0,-1,107829,92171
3:4:5,0,-1,107830,92170
2:4:5,1,1,107829,92171
6:1:4,0,-1,107830,92170
1:3:3,0,-1,107831,92169
2:6:1,1,1,107830,92170
4:4:4,0,-1,107831,92169
2:5:6,1,1,107830,92170
3:2:4,1,1,107829,92171
6:2:2,2,2,107827,92173
6:1:3,0,-1,107828,92172
1:2:6,1,1,107827,92173
3:5:3,0,-1,107828,92172
1:5:2,1,1,107827,92173
5:5:1,0,-1,107828,92172
6:6:1,0,-1,107829,92171
4:3:4,0,-1,107830,92170
4:3:5,0,-1,107831,92169
1:3:4,0,-1,107832,92168
2:3:5,1,1,107831,92169
3:3:2,1,1,107830,92170
4:5:1,0,-1,107831,92169
6:6:2,1,1,107830,92170
3:2:5,1,1,107829,92171
6:1:3,0,-1,107830,92170
1:1:6,0,-1,107831,92169
6:3:1,0,-1,107832,92168
3:1:2,1,1,107831,92169
2:5:1,1,1,107830,92170
2:3:4,1,1,107829,92171
6:1:3,0,-1,107830,92170
1:5:3,0,-1,107831,92169
4:2:4,1,1,107830,92170
4:3:6,0,-1,107831,92169
4:5:5,0,-1,107832,92168
1:3:5,0,-1,107833,92167
5:5:1,0,-1,107834,92166
6:4:1,0,-1,107835,92165
1:6:5,0,-1,107836,92164
4:5:6,0,-1,107837,92163
6:4:4,0,-1,107838,92162
3:4:3,0,-1,107839,92161
2:1:5,1,1,107838,92162
5:2:1,1,1,107837,92163
2:3:5,1,1,107836,92164
1:1:2,1,1,107835,92165
6:4:2,1,1,107834,92166
3:1:1,0,-1,107835,92165
4:6:3,0,-1,107836,92164
6:5:4,0,-1,107837,92163
4:5:6,0,-1,107838,92162
2:5:2,2,2,107836,92164
3:6:1,0,-1,107837,92163
4:1:4,0,-1,107838,92162
3:1:4,0,-1,107839,92161
2:1:1,1,1,107838,92162
2:6:6,1,1,107837,92163
2:1:5,1,1,107836,92164
6:2:2,2,2,107834,92166
2:4:6,1,1,107833,92167
5:1:4,0,-1,107834,92166
6:4:3,0,-1,107835,92165
3:3:2,1,1,107834,92166
2:6:5,1,1,107833,92167
3:6:2,1,1,107832,92168
1:4:4,0,-1,107833,92167
4:3:2,1,1,107832,92168
6:5:3,0,-1,107833,92167
4:5:3,0,-1,107834,92166
5:2:2,2,2,107832,92168
6:1:5,0,-1,107833,92167
3:4:6,0,-1,107834,92166
2:3:4,1,1,107833,92167
6:1:6,0,-1,107834,92166
6:4:1,0,-1,107835,92165
2:1:6,1,1,107834,92166
5:1:4,0,-1,107835,92165
5:1:6,0,-1,107836,92164
2:2:2,3,3,107833,92167
6:2:6,1,1,107832,92168
6:5:5,0,-1,107833,92167
3:3:1,0,-1,107834,92166
1:1:3,0,-1,107835,92165
4:4:3,0,-1,107836,92164
4:2:1,1,1,107835,92165
5:3:2,1,1,107834,92166
1:2:3,1,1,107833,92167
5:3:5,0,-1,107834,92166
4:5:2,1,1,107833,92167
4:5:6,0,-1,107834,92166
1:4:5,0,-1,107835,92165
1:6:6,0,-1,107836,92164
4:1:3,0,-1,107837,92163
3:1:5,0,-1,107838,92162
2:1:4,1,1,107837,92163
1:1:3,0,-1,107838,92162
3:5:4,0,-1,107839,92161
5:6:2,1,1,107838,92162
3:6:5,0,-1,107839,92161
6:2:2,2,2,107837,92163
1:2:1,1,1,107836,92164
6:1:1,0,-1,107837,92163
6:5:3,0,-1,107838,92162
6:2:3,1,1,107837,92163
6:3:3,0,-1,107838,92162
6:2:5,1,1,107837,92163
6:1:5,0,-1,107838,92162
6:1:1,0,-1,107839,92161
3:5:1,0,-1,107840,92160
5:1:5,0,-1,107841,92159
1:5:3,0,-1,107842,92158
6:3:3,0,-1,107843,92157
2:3:3,1,1,107842,92158
3:5:3,0,-1,107843,92157
6:4:1,0,-1,107844,92156
3:6:6,0,-1,107845,92155
3:4:1,0,-1,107846,92154
4:6:6,0,-1,107847,92153
4:5:5,0,-1,107848,92152
5:6:1,0,-1,107849,92151
6:2:1,1,1,107848,92152
3:2:4,1,1,107847,92153
2:3:3,1,1,107846,92154
2:1:5,1,1,107845,92155
5:3:6,0,-1,107846,92154
6:5:6,0,-1,107847,92153
5:3:3,0,-1,107848,92152
6:3:3,0,-1,107849,92151
4:2:1,1,1,107848,92152
5:5:6,0,-1,107849,92151
5:6:1,0,-1,107850,92150
5:4:6,0,-1,107851,92149
1:3:1,0,-1,107852,92148
4:1:4,0,-1,107853,92147
3:4:5,0,-1,107854,92146
6:5:2,1,1,107853,92147
4:6:1,0,-1,107854,92146
4:4:6,0,-1,107855,92145
1:4:5,0,-1,107856,92144
4:5:3,0,-1,107857,92143
3:3:4,0,-1,107858,92142
6:5:5,0,-1,107859,92141
3:2:4,1,1,107858,92142
3:2:2,2,2,107856,92144
3:6:6,0,-1,107857,92143
4:5:6,0,-1,107858,92142
1:1:2,1,1,107857,92143
5:6:6,0,-1,107858,92142
5:5:6,0,-1,107859,92141
3:3:2,1,1,107858,92142
1:2:5,1,1,107857,92143
5:5:5,0,-1,107858,92142
5:6:1,0,-1,107859,92141
3:2:3,1,1,107858,92142
4:3:2,1,1,107857,92143
5:6:1,0,-1,107858,92142
4:2:1,1,1,107857,92143
4:3:5,0,-1,107858,92142
4:5:1,0,-1,107859,92141
5:3:3,0,-1,107860,92140
6:3:2,1,1,107859,92141
2:6:1,1,1,107858,92142
5:3:5,0,-1,107859,92141
6:3:2,1,1,107858,92142
1:3:6,0,-1,107859,92141
3:5:6,0,-1,107860,92140
1:3:3,0,-1,107861,92139
2:1:4,1,1,107860,92140
6:6:2,1,1,107859,92141
4:4:1,0,-1,107860,92140
4:4:3,0,-1,107861,92139
5:1:3,0,-1,107862,92138
6:2:1,1,1,107861,92139
6:5:2,1,1,107860,92140
1:4:3,0,-1,107861,92139
3:4:4,0,-1,107862,92138
5:3:2,1,1,107861,92139
4:5:2,1,1,107860,92140
6:5:1,0,-1,107861,92139
3:2:4,1,1,107860,92140
6:2:6,1,1,107859,92141
6:5:2,1,1,107858,92142
1:2:2,2,2,107856,92144
1:6:5,0,-1,107857,92143
2:4:5,1,1,107856,92144
1:2:2,2,2,107854,92146
3:4:4,0,-1,107855,92145
6:1:4,0,-1,107856,92144
4:6:4,0,-1,107857,92143
4:5:2,1,1,107856,92144
1:3:1,0,-1,107857,92143
3:5:2,1,1,107856,92144
4:3:2,1,1,107855,92145
3:3:3,0,-1,107856,92144
3:2:1,1,1,107855,92145
3:5:6,0,-1,107856,92144
2:4:4,1,1,107855,92145
6:2:6,1,1,107854,92146
2:3:4,1,1,107853,92147
1:5:4,0,-1,107854,92146
6:6:3,0,-1,107855,92145
1:3:6,0,-1,107856,92144
2:6:6,1,1,107855,92145
6:3:4,0,-1,107856,92144
3:2:2,2,2,107854,92146
3:6:1,0,-1,107855,92145
5:4:2,1,1,107854,92146
5:1:1,0,-1,107855,92145
4:1:1,0,-1,107856,92144
5:6:1,0,-1,107857,92143
1:1:5,0,-1,107858,92142
1:4:3,0,-1,107859,92141
2:4:3,1,1,107858,92142
5:6:4,0,-1,107859,92141
2:4:5,1,1,107858,92142
2:1:6,1,1,107857,92143
1:5:5,0,-1,107858,92142
6:1:6,0,-1,107859,92141
1:3:2,1,1,107858,92142
1:2:6,1,1,107857,92143
6:4:4,0,-1,107858,92142
3:2:3,1,1,107857,92143
2:6:1,1,1,107856,92144
2:2:1,2,2,107854,92146
3:4:3,0,-1,107855,92145
4:3:3,0,-1,107856,92144
6:2:6,1,1,107855,92145
1:1:6,0,-1,107856,92144
5:5:6,0,-1,107857,92143
1:2:2,2,2,107855,92145
3:5:6,0,-1,107856,92144
6:4:3,0,-1,107857,92143
2:2:6,2,2,107855,92145
2:3:3,1,1,107854,92146
6:6:3,0,-1,107855,92145
3:2:2,2,2,107853,92147
1:6:1,0,-1,107854,92146
3:2:5,1,1,107853,92147
4:6:1,0,-1,107854,92146
4:4:5,0,-1,107855,92145
1:2:2,2,2,107853,92147
4:6:1,0,-1,107854,92146
1:1:6,0,-1,107855,92145
2:5:2,2,2,107853,92147
5:6:3,0,-1,107854,92146
4:2:1,1,1,107853,92147
3:3:4,0,-1,107854,92146
2:5:4,1,1,107853,92147
3:1:2,1,1,107852,92148
6:2:6,1,1,107851,92149
3:4:1,0,-1,107852,92148
2:3:6,1,1,107851,92149
6:1:1,0,-1,107852,92148
1:5:3,0,-1,107853,92147
1:6:3,0,-1,107854,92146
5:5:3,0,-1,107855,92145
4:1:5,0,-1,107856,92144
5:2:2,2,2,107854,92146
2:5:2,2,2,107852,92148
4:2:2,2,2,107850,92150
6:5:3,0,-1,107851,92149
6:4:3,0,-1,107852,92148
6:3:4,0,-1,107853,92147
5:6:5,0,-1,107854,92146
2:1:3,1,1,107853,92147
1:3:3,0,-1,107854,92146
4:2:2,2,2,107852,92148
2:4:6,1,1,107851,92149
4:4:3,0,-1,107852,92148
1:4:2,1,1,107851,92149
3:4:4,0,-1,107852,92148
4:5:4,0,-1,107853,92147
3:6:5,0,-1,107854,92146
4:4:6,0,-1,107855,92145
5:2:4,1,1,107854,92146
1:3:4,0,-1,107855,92145
6:6:4,0,-1,107856,92144
3:3:1,0,-1,107857,92143
5:1:1,0,-1,107858,92142
4:2:3,1,1,107857,92143
2:4:2,2,2,107855,92145
4:1:4,0,-1,107856,92144
6:4:2,1,1,107855,92145
3:6:6,0,-1,107856,92144
4:4:2,1,1,107855,92145
5:3:3,0,-1,107856,92144
4:3:6,0,-1,107857,92143
6:6:6,0,-1,107858,92142
4:2:5,1,1,107857,92143
1:2:1,1,1,107856,92144
6:3:2,1,1,107855,92145
4:5:2,1,1,107854,92146
1:6:1,0,-1,107855,92145
2:3:3,1,1,107854,92146
4:1:1,0,-1,107855,92145
3:3:2,1,1,107854,92146
6:5:4,0,-1,107855,92145
2:2:6,2,2,107853,92147
3:1:5,0,-1,107854,92146
1:2:1,1,1,107853,92147
2:5:1,1,1,107852,92148
3:3:6,0,-1,107853,92147
2:4:3,1,1,107852,92148
5:6:6,0,-1,107853,92147
3:4:1,0,-1,107854,92146
5:6:6,0,-1,107855,92145
6:2:1,1,1,107854,92146
6:1:5,0,-1,107855,92145
3:3:3,0,-1,107856,92144
1:2:2,2,2,107854,92146
4:6:3,0,-1,107855,92145
4:3:1,0,-1,107856,92144
4:3:4,0,-1,107857,92143
1:1:3,0,-1,107858,92142
5:3:5,0,-1,107859,92141
6:4:4,0,-1,107860,92140
5:5:5,0,-1,107861,92139
2:1:6,1,1,107860,92140
5:4:3,0,-1,107861,92139
5:6:6,0,-1,107862,92138
4:5:4,0,-1,107863,92137
5:6:4,0,-1,107864,92136
5:5:5,0,-1,107865,92135
2:4:6,1,1,107864,92136
5:6:6,0,-1,107865,92135
1:2:2,2,2,107863,92137
1:4:5,0,-1,107864,92136
6:3:5,0,-1,107865,92135
2:2:4,2,2,107863,92137
6:5:1,0,-1,107864,92136
3:6:4,0,-1,107865,92135
3:2:3,1,1,107864,92136
3:2:5,1,1,107863,92137
1:2:4,1,1,107862,92138
6:5:5,0,-1,107863,92137
2:1:1,1,1,107862,92138
3:4:3,0,-1,107863,92137
3:5:1,0,-1,107864,92136
4:6:5,0,-1,107865,92135
3:4:4,0,-1,107866,92134
3:2:6,1,1,107865,92135
3:6:2,1,1,107864,92136
2:3:4,1,1,107863,92137
6:5:2,1,1,107862,92138
5:5:1,0,-1,107863,92137
4:5:4,0,-1,107864,92136
1:1:1,0,-1,107865,92135
3:3:2,1,1,107864,92136
5:2:5,1,1,107863,92137
2:4:4,1,1,107862,92138
1:2:5,1,1,107861,92139
4:5:4,0,-1,107862,92138
4:1:1,0,-1,107863,92137
1:6:6,0,-1,107864,92136
6:5:1,0,-1,107865,92135
6:3:2,1,1,107864,92136
2:5:2,2,2,107862,92138
1:2:5,1,1,107861,92139
4:4:5,0,-1,107862,92138
6:6:3,0,-1,107863,92137
3:6:1,0,-1,107864,92136
6:6:2,1,1,107863,92137
5:1:3,0,-1,107864,92136
5:3:2,1,1,107863,92137
2:1:4,1,1,107862,92138
6:1:1,0,-1,107863,92137
2:3:2,2,2,107861,92139
5:3:4,0,-1,107862,92138
2:5:6,1,1,107861,92139
2:4:2,2,2,107859,92141
1:6:4,0,-1,107860,92140
2:4:6,1,1,107859,92141
5:4:5,0,-1,107860,92140
5:1:2,1,1,107859,92141
1:3:1,0,-1,107860,92140
6:3:3,0,-1,107861,92139
6:5:5,0,-1,107862,92138
4:2:4,1,1,107861,92139
2:2:5,2,2,107859,92141
3:2:6,1,1,107858,92142
1:4:5,0,-1,107859,92141
3:2:1,1,1,107858,92142
4:6:6,0,-1,107859,92141
6:1:2,1,1,107858,92142
1:3:5,0,-1,107859,92141
5:6:5,0,-1,107860,92140
1:4:6,0,-1,107861,92139
4:4:3,0,-1,107862,92138
3:4:1,0,-1,107863,92137
4:4:6,0,-1,107864,92136
4:1:1,0,-1,107865,92135
1:1:5,0,-1,107866,92134
1:4:5,0,-1,107867,92133
5:1:1,0,-1,107868,92132
3:3:1,0,-1,107869,92131
4:1:1,0,-1,107870,92130
4:2:2,2,2,107868,92132
2:6:2,2,2,107866,92134
3:2:5,1,1,107865,92135
5:3:3,0,-1,107866,92134
1:5:4,0,-1,107867,92133
2:6:6,1,1,107866,92134
1:2:3,1,1,107865,92135
2:2:5,2,2,107863,92137
2:5:2,2,2,107861,92139
2:6:6,1,1,107860,92140
6:1:6,0,-1,107861,92139
1:5:1,0,-1,107862,92138
3:5:3,0,-1,107863,92137
5:6:4,0,-1,107864,92136
2:4:2,2,2,107862,92138
5:6:5,0,-1,107863,92137
6:5:6,0,-1,107864,92136
1:6:3,0,-1,107865,92135
6:5:4,0,-1,107866,92134
1:4:4,0,-1,107867,92133
1:4:1,0,-1,107868,92132
3:3:1,0,-1,107869,92131
3:6:1,0,-1,107870,92130
1:3:1,0,-1,107871,92129
2:3:6,1,1,107870,92130
1:2:1,1,1,107869,92131
2:2:6,2,2,107867,92133
2:4:4,1,1,107866,92134
2:6:3,1,1,107865,92135
1:6:1,0,-1,107866,92134
2:6:1,1,1,107865,92135
3:3:6,0,-1,107866,92134
1:6:1,0,-1,107867,92133
5:5:6,0,-1,107868,92132
2:1:3,1,1,107867,92133
3:4:4,0,-1,107868,92132
5:3:6,0,-1,107869,92131
1:5:5,0,-1,107870,92130
4:4:4,0,-1,107871,92129
4:1:5,0,-1,107872,92128
4:4:3,0,-1,107873,92127
1:3:4,0,-1,107874,92126
5:1:6,0,-1,107875,92125
6:5:1,0,-1,107876,92124
1:6:4,0,-1,107877,92123
1:6:4,0,-1,107878,92122
2:6:3,1,1,107877,92123
5:1:1,0,-1,107878,92122
5:4:2,1,1,107877,92123
1:1:5,0,-1,107878,92122
6:4:1,0,-1,107879,92121
5:3:6,0,-1,107880,92120
1:2:6,1,1,107879,92121
2:4:4,1,1,107878,92122
4:4:4,0,-1,107879,92121
5:3:5,0,-1,107880,92120
4:4:4,0,-1,107881,92119
1:6:4,0,-1,107882,92118
5:2:1,1,1,107881,92119
4:4:4,0,-1,107882,92118
1:5:4,0,-1,107883,92117
3:1:4,0,-1,107884,92116
6:1:2,1,1,107883,92117
2:3:5,1,1,107882,92118
3:4:3,0,-1,107883,92117
3:1:1,0,-1,107884,92116
2:1:3,1,1,107883,92117
4:6:2,1,1,107882,92118
1:2:4,1,1,107881,92119
3:1:2,1,1,107880,92120
5:4:5,0,-1,107881,92119
4:5:4,0,-1,107882,92118
5:2:1,1,1,107881,92119
1:6:4,0,-1,107882,92118
5:5:2,1,1,107881,92119
1:6:3,0,-1,107882,92118
5:1:1,0,-1,107883,92117
3:5:1,0,-1,107884,92116
4:2:6,1,1,107883,92117
3:6:1,0,-1,107884,92116
5:6:2,1,1,107883,92117
5:1:4,0,-1,107884,92116
1:1:2,1,1,107883,92117
2:5:3,1,1,107882,92118
6:5:1,0,-1,107883,92117
1:2:4,1,1,107882,92118
1:3:2,1,1,107881,92119
5:2:2,2,2,107879,92121
3:2:3,1,1,107878,92122
4:3:2,1,1,107877,92123
2:3:6,1,1,107876,92124
6:6:4,0,-1,107877,92123
5:5:3,0,-1,107878,92122
4:1:2,1,1,107877,92123
2:6:3,1,1,107876,92124
3:6:1,0,-1,107877,92123
4:5:2,1,1,107876,92124
4:4:3,0,-1,107877,92123
5:6:5,0,-1,107878,92122
5:1:2,1,1,107877,92123
3:3:2,1,1,107876,92124
5:4:3,0,-1,107877,92123
2:1:4,1,1,107876,92124
1:3:2,1,1,107875,92125
5:4:3,0,-1,107876,92124
3:5:4,0,-1,107877,92123
4:5:6,0,-1,107878,92122
3:6:5,0,-1,107879,92121
4:2:6,1,1,107878,92122
5:2:3,1,1,107877,92123
3:1:1,0,-1,107878,92122
4:4:2,1,1,107877,92123
6:3:6,0,-1,107878,92122
2:1:3,1,1,107877,92123
3:6:3,0,-1,107878,92122
3:5:1,0,-1,107879,92121
4:3:3,0,-1,107880,92120
4:2:4,1,1,107879,92121
2:4:2,2,2,107877,92123
4:4:1,0,-1,107878,92122
5:3:5,0,-1,107879,92121
3:4:2,1,1,107878,92122
1:6:3,0,-1,107879,92121
6:4:1,0,-1,107880,92120
3:2:6,1,1,107879,92121
3:2:4,1,1,107878,92122
2:3:4,1,1,107877,92123
2:3:1,1,1,107876,92124
2:3:6,1,1,107875,92125
1:6:5,0,-1,107876,92124
2:5:2,2,2,107874,92126
3:4:2,1,1,107873,92127
5:2:6,1,1,107872,92128
1:6:4,0,-1,107873,92127
3:2:3,1,1,107872,92128
6:4:5,0,-1,107873,92127
5:4:5,0,-1,107874,92126
4:2:4,1,1,107873,92127
3:6:6,0,-1,107874,92126
5:2:6,1,1,107873,92127
5:3:3,0,-1,107874,92126
6:6:6,0,-1,107875,92125
4:3:1,0,-1,107876,92124
6:3:2,1,1,107875,92125
5:2:3,1,1,107874,92126
1:6:2,1,1,107873,92127
5:1:1,0,-1,107874,92126
6:4:3,0,-1,107875,92125
3:1:5,0,-1,107876,92124
2:4:3,1,1,107875,92125
6:6:5,0,-1,107876,92124
3:4:1,0,-1,107877,92123
1:3:2,1,1,107876,92124
1:3:5,0,-1,107877,92123
3:6:4,0,-1,107878,92122
1:1:5,0,-1,107879,92121
6:3:4,0,-1,107880,92120
2:4:6,1,1,107879,92121
2:3:2,2,2,107877,92123
4:4:1,0,-1,107878,92122
4:6:2,1,1,107877,92123
1:4:3,0,-1,107878,92122
2:6:5,1,1,107877,92123
5:3:4,0,-1,107878,92122
2:3:6,1,1,107877,92123
6:6:3,0,-1,107878,92122
2:1:3,1,1,107877,92123
1:6:6,0,-1,107878,92122
2:1:5,1,1,107877,92123
5:5:3,0,-1,107878,92122
2:1:3,1,1,107877,92123
5:5:2,1,1,107876,92124
4:3:6,0,-1,107877,92123
4:5:6,0,-1,107878,92122
4:2:6,1,1,107877,92123
4:3:1,0,-1,107878,92122
4:6:4,0,-1,107879,92121
4:4:2,1,1,107878,92122
4:6:1,0,-1,107879,92121
2:1:4,1,1,107878,92122
3:3:1,0,-1,107879,92121
1:4:6,0,-1,107880,92120
6:4:1,0,-1,107881,92119
6:2:2,2,2,107879,92121
2:4:1,1,1,107878,92122
2:3:4,1,1,107877,92123
4:3:4,0,-1,107878,92122
3:2:6,1,1,107877,92123
5:4:4,0,-1,107878,92122
1:2:3,1,1,107877,92123
5:4:3,0,-1,107878,92122
3:1:2,1,1,107877,92123
2:6:3,1,1,107876,92124
6:1:3,0,-1,107877,92123
6:1:5,0,-1,107878,92122
6:2:5,1,1,107877,92123
5:2:2,2,2,107875,92125
5:5:6,0,-1,107876,92124
6:5:6,0,-1,107877,92123
4:3:3,0,-1,107878,92122
6:6:3,0,-1,107879,92121
3:1:4,0,-1,107880,92120
1:1:4,0,-1,107881,92119
4:2:5,1,1,107880,92120
4:3:1,0,-1,107881,92119
1:6:3,0,-1,107882,92118
4:4:4,0,-1,107883,92117
3:3:5,0,-1,107884,92116
5:5:3,0,-1,107885,92115
6:1:5,0,-1,107886,92114
2:1:5,1,1,107885,92115
3:5:1,0,-1,107886,92114
2:3:4,1,1,107885,92115
6:5:1,0,-1,107886,92114
6:6:1,0,-1,107887,92113
1:2:5,1,1,107886,92114
5:1:2,1,1,107885,92115
3:5:5,0,-1,107886,92114
2:1:5,1,1,107885,92115
4:2:6,1,1,107884,92116
6:3:1,0,-1,107885,92115
5:1:4,0,-1,107886,92114
4:6:4,0,-1,107887,92113
1:4:5,0,-1,107888,92112
6:4:5,0,-1,107889,92111
2:1:6,1,1,107888,92112
5:3:1,0,-1,107889,92111
2:4:2,2,2,107887,92113
4:6:6,0,-1,107888,92112
4:3:4,0,-1,107889,92111
2:1:5,1,1,107888,92112
5:5:1,0,-1,107889,92111
3:3:1,0,-1,107890,92110
1:4:4,0,-1,107891,92109
2:6:3,1,1,107890,92110
1:5:3,0,-1,107891,92109
1:5:5,0,-1,107892,92108
1:2:2,2,2,107890,92110
5:5:4,0,-1,107891,92109
6:3:4,0,-1,107892,92108
1:4:6,0,-1,107893,92107
5:3:3,0,-1,107894,92106
3:6:4,0,-1,107895,92105
5:5:6,0,-1,107896,92104
5:1:4,0,-1,107897,92103
6:2:6,1,1,107896,92104
3:2:5,1,1,107895,92105
2:1:5,1,1,107894,92106
5:2:4,1,1,107893,92107
6:5:3,0,-1,107894,92106
3:6:2,1,1,107893,92107
5:2:1,1,1,107892,92108
6:5:5,0,-1,107893,92107
2:5:3,1,1,107892,92108
4:1:2,1,1,107891,92109
5:4:3,0,-1,107892,92108
5:1:4,0,-1,107893,92107
4:4:6,0,-1,107894,92106
6:3:4,0,-1,107895,92105
5:1:6,0,-1,107896,92104
6:2:6,1,1,107895,92105
4:5:2,1,1,107894,92106
2:2:1,2,2,107892,92108
1:1:2,1,1,107891,92109
6:4:4,0,-1,107892,92108
2:1:6,1,1,107891,92109
1:5:4,0,-1,107892,92108
1:4:2,1,1,107891,92109
5:6:3,0,-1,107892,92108
5:2:6,1,1,107891,92109
5:2:6,1,1,107890,92110
5:5:3,0,-1,107891,92109
5:2:2,2,2,107889,92111
2:6:1,1,1,107888,92112
4:1:5,0,-1,107889,92111
5:1:6,0,-1,107890,92110
1:5:5,0,-1,107891,92109
1:6:1,0,-1,107892,92108
1:3:2,1,1,107891,92109
2:2:1,2,2,107889,92111
4:6:4,0,-1,107890,92110
5:3:5,0,-1,107891,92109
4:4:2,1,1,107890,92110
5:4:4,0,-1,107891,92109
4:2:6,1,1,107890,92110
5:5:5,0,-1,107891,92109
4:6:2,1,1,107890,92110
3:2:6,1,1,107889,92111
6:3:3,0,-1,107890,92110
5:6:4,0,-1,107891,92109
2:1:5,1,1,107890,92110
6:2:1,1,1,107889,92111
1:4:1,0,-1,107890,92110
5:6:5,0,-1,107891,92109
5:4:6,0,-1,107892,92108
2:6:4,1,1,107891,92109
2:4:5,1,1,107890,92110
3:2:3,1,1,107889,92111
4:2:5,1,1,107888,92112
5:2:1,1,1,107887,92113
2:6:1,1,1,107886,92114
3:1:5,0,-1,107887,92113
2:3:5,1,1,107886,92114
5:5:2,1,1,107885,92115
1:3:6,0,-1,107886,92114
3:2:3,1,1,107885,92115
6:2:6,1,1,107884,92116
4:4:4,0,-1,107885,92115
4:4:6,0,-1,107886,92114
2:6:1,1,1,107885,92115
3:1:6,0,-1,107886,92114
3:3:6,0,-1,107887,92113
3:3:2,1,1,107886,92114
1:6:4,0,-1,107887,92113
6:4:4,0,-1,107888,92112
6:5:2,1,1,107887,92113
5:2:1,1,1,107886,92114
1:3:5,0,-1,107887,92113
1:5:5,0,-1,107888,92112
5:5:3,0,-1,107889,92111
6:2:5,1,1,107888,92112
5:5:2,1,1,107887,92113
4:6:3,0,-1,107888,92112
5:3:1,0,-1,107889,92111
6:3:4,0,-1,107890,92110
4:4:3,0,-1,107891,92109
5:1:5,0,-1,107892,92108
3:3:4,0,-1,107893,92107
3:3:2,1,1,107892,92108
4:1:2,1,1,107891,92109
6:5:3,0,-1,107892,92108
4:3:1,0,-1,107893,92107
4:4:5,0,-1,107894,92106
5:6:1,0,-1,107895,92105
5:6:4,0,-1,107896,92104
2:6:4,1,1,107895,92105
2:4:5,1,1,107894,92106
3:6:2,1,1,107893,92107
3:1:3,0,-1,107894,92106
3:6:6,0,-1,107895,92105
5:2:6,1,1,107894,92106
5:5:6,0,-1,107895,92105
1:4:2,1,1,107894,92106
4:3:3,0,-1,107895,92105
4:3:6,0,-1,107896,92104
2:3:4,1,1,107895,92105
2:1:3,1,1,107894,92106
3:5:6,0,-1,107895,92105
3:4:2,1,1,107894,92106
4:1:6,0,-1,107895,92105
5:6:6,0,-1,107896,92104
3:4:4,0,-1,107897,92103
5:6:2,1,1,107896,92104
5:3:1,0,-1,107897,92103
1:5:4,0,-1,107898,92102
4:2:4,1,1,107897,92103
5:3:5,0,-1,107898,92102
4:2:4,1,1,107897,92103
1:4:6,0,-1,107898,92102
2:2:1,2,2,107896,92104
5:2:5,1,1,107895,92105
1:4:5,0,-1,107896,92104
1:4:3,0,-1,107897,92103
6:3:4,0,-1,107898,92102
4:3:2,1,1,107897,92103
4:1:1,0,-1,107898,92102
1:2:6,1,1,107897,92103
3:5:1,0,-1,107898,92102
2:1:4,1,1,107897,92103
2:4:1,1,1,107896,92104
5:4:6,0,-1,107897,92103
4:2:6,1,1,107896,92104
1:5:5,0,-1,107897,92103
2:3:2,2,2,107895,92105
5:3:1,0,-1,107896,92104
6:1:6,0,-1,107897,92103
3:1:3,0,-1,107898,92102
2:1:2,2,2,107896,92104
1:4:4,0,-1,107897,92103
5:2:2,2,2,107895,92105
2:1:1,1,1,107894,92106
3:6:4,0,-1,107895,92105
6:5:2,1,1,107894,92106
6:3:2,1,1,107893,92107
1:4:3,0,-1,107894,92106
4:2:1,1,1,107893,92107
5:2:1,1,1,107892,92108
1:5:1,0,-1,107893,92107
2:5:2,2,2,107891,92109
5:6:6,0,-1,107892,92108
3:6:6,0,-1,107893,92107
3:4:6,0,-1,107894,92106
1:1:5,0,-1,107895,92105
2:4:2,2,2,107893,92107
4:2:6,1,1,107892,92108
4:1:3,0,-1,107893,92107
6:4:2,1,1,107892,92108
5:2:1,1,1,107891,92109
5:2:5,1,1,107890,92110
2:5:2,2,2,107888,92112
2:1:4,1,1,107887,92113
5:4:3,0,-1,107888,92112
3:6:3,0,-1,107889,92111
2:2:4,2,2,107887,92113
1:1:3,0,-1,107888,92112
2:1:4,1,1,107887,92113
5:1:6,0,-1,107888,92112
4:6:6,0,-1,107889,92111
3:2:3,1,1,107888,92112
2:5:2,2,2,107886,92114
3:5:6,0,-1,107887,92113
3:5:6,0,-1,107888,92112
3:5:5,0,-1,107889,92111
4:2:6,1,1,107888,92112
5:3:4,0,-1,107889,92111
6:5:4,0,-1,107890,92110
5:2:2,2,2,107888,92112
3:5:6,0,-1,107889,92111
3:3:4,0,-1,107890,92110
2:2:6,2,2,107888,92112
4:5:6,0,-1,107889,92111
2:2:1,2,2,107887,92113
1:4:6,0,-1,107888,92112
4:3:3,0,-1,107889,92111
3:1:2,1,1,107888,92112
6:3:6,0,-1,107889,92111
2:5:5,1,1,107888,92112
6:6:3,0,-1,107889,92111
3:4:6,0,-1,107890,92110
3:6:5,0,-1,107891,92109
2:3:3,1,1,107890,92110
2:1:5,1,1,107889,92111
2:6:4,1,1,107888,92112
1:6:2,1,1,107887,92113
2:3:2,2,2,107885,92115
6:2:1,1,1,107884,92116
6:6:6,0,-1,107885,92115
6:6:6,0,-1,107886,92114
4:3:5,0,-1,107887,92113
1:1:5,0,-1,107888,92112
3:3:3,0,-1,107889,92111
1:4:5,0,-1,107890,92110
5:6:4,0,-1,107891,92109
3:4:6,0,-1,107892,92108
5:5:1,0,-1,107893,92107
6:5:5,0,-1,107894,92106
3:4:2,1,1,107893,92107
3:3:6,0,-1,107894,92106
1:5:4,0,-1,107895,92105
1:1:5,0,-1,107896,92104
3:2:2,2,2,107894,92106
3:6:6,0,-1,107895,92105
2:5:2,2,2,107893,92107
5:6:6,0,-1,107894,92106
4:2:5,1,1,107893,92107
5:3:1,0,-1,107894,92106
3:4:1,0,-1,107895,92105
2:3:5,1,1,107894,92106
4:2:3,1,1,107893,92107
5:5:4,0,-1,107894,92106
1:3:4,0,-1,107895,92105
1:2:3,1,1,107894,92106
2:5:6,1,1,107893,92107
5:6:4,0,-1,107894,92106
5:4:1,0,-1,107895,92105
2:5:3,1,1,107894,92106
4:6:3,0,-1,107895,92105
6:1:3,0,-1,107896,92104
5:6:3,0,-1,107897,92103
4:1:1,0,-1,107898,92102
4:4:4,0,-1,107899,92101
6:2:6,1,1,107898,92102
4:3:6,0,-1,107899,92101
1:3:1,0,-1,107900,92100
6:5:1,0,-1,107901,92099
4:2:1,1,1,107900,92100
2:5:4,1,1,107899,92101
1:2:3,1,1,107898,92102
2:5:3,1,1,107897,92103
6:6:3,0,-1,107898,92102
1:5:4,0,-1,107899,92101
6:5:5,0,-1,107900,92100
5:5:4,0,-1,107901,92099
2:3:2,2,2,107899,92101
3:3:5,0,-1,107900,92100
4:3:1,0,-1,107901,92099
2:6:1,1,1,107900,92100
6:5:1,0,-1,107901,92099
2:3:3,1,1,107900,92100
5:3:6,0,-1,107901,92099
3:2:3,1,1,107900,92100
5:5:3,0,-1,107901,92099
4:6:5,0,-1,107902,92098
1:3:1,0,-1,107903,92097
3:3:1,0,-1,107904,92096
6:1:6,0,-1,107905,92095
4:3:4,0,-1,107906,92094
6:6:2,1,1,107905,92095
4:5:6,0,-1,107906,92094
1:6:3,0,-1,107907,92093
3:3:2,1,1,107906,92094
4:3:3,0,-1,107907,92093
6:5:4,0,-1,107908,92092
5:5:4,0,-1,107909,92091
1:4:2,1,1,107908,92092
1:4:4,0,-1,107909,92091
5:2:1,1,1,107908,92092
5:5:4,0,-1,107909,92091
4:6:6,0,-1,107910,92090
5:3:6,0,-1,107911,92089
1:2:6,1,1,107910,92090
3:5:5,0,-1,107911,92089
6:6:2,1,1,107910,92090
5:5:3,0,-1,107911,92089
3:6:4,0,-1,107912,92088
4:4:1,0,-1,107913,92087
2:4:5,1,1,107912,92088
1:4:2,1,1,107911,92089
6:6:3,0,-1,107912,92088
5:4:3,0,-1,107913,92087
6:2:3,1,1,107912,92088
4:5:1,0,-1,107913,92087
6:2:4,1,1,107912,92088
6:6:2,1,1,107911,92089
3:5:1,0,-1,107912,92088
6:5:3,0,-1,107913,92087
5:6:2,1,1,107912,92088
6:2:1,1,1,107911,92089
3:3:5,0,-1,107912,92088
1:1:4,0,-1,107913,92087
5:4:1,0,-1,107914,92086
4:3:4,0,-1,107915,92085
1:2:2,2,2,107913,92087
4:3:4,0,-1,107914,92086
4:3:1,0,-1,107915,92085
4:2:1,1,1,107914,92086
2:3:1,1,1,107913,92087
2:4:2,2,2,107911,92089
2:1:5,1,1,107910,92090
2:4:6,1,1,107909,92091
1:6:3,0,-1,107910,92090
5:3:2,1,1,107909,92091
2:4:5,1,1,107908,92092
4:3:3,0,-1,107909,92091
3:5:2,1,1,107908,92092
1:4:4,0,-1,107909,92091
6:3:1,0,-1,107910,92090
6:3:3,0,-1,107911,92089
5:3:6,0,-1,107912,92088
6:1:1,0,-1,107913,92087
1:6:5,0,-1,107914,92086
2:4:5,1,1,107913,92087
5:4:1,0,-1,107914,92086
2:3:1,1,1,107913,92087
6:2:4,1,1,107912,92088
2:1:2,2,2,107910,92090
5:3:2,1,1,107909,92091
5:6:4,0,-1,107910,92090
3:4:1,0,-1,107911,92089
4:1:6,0,-1,107912,92088
2:6:4,1,1,107911,92089
1:2:1,1,1,107910,92090
3:5:1,0,-1,107911,92089
1:4:4,0,-1,107912,92088
1:6:4,0,-1,107913,92087
2:2:6,2,2,107911,92089
4:6:1,0,-1,107912,92088
6:2:5,1,1,107911,92089
6:3:5,0,-1,107912,92088
3:5:4,0,-1,107913,92087
1:1:3,0,-1,107914,92086
3:1:4,0,-1,107915,92085
4:2:6,1,1,107914,92086
5:1:2,1,1,107913,92087
2:1:2,2,2,107911,92089
1:1:4,0,-1,107912,92088
1:1:4,0,-1,107913,92087
2:4:5,1,1,107912,92088
2:3:4,1,1,107911,92089
6:5:2,1,1,107910,92090
3:2:6,1,1,107909,92091
1:5:6,0,-1,107910,92090
1:6:4,0,-1,107911,92089
6:4:4,0,-1,107912,92088
5:3:4,0,-1,107913,92087
1:3:5,0,-1,107914,92086
5:1:2,1,1,107913,92087
1:6:1,0,-1,107914,92086
2:1:3,1,1,107913,92087
5:1:6,0,-1,107914,92086
3:1:2,1,1,107913,92087
1:5:3,0,-1,107914,92086
1:5:6,0,-1,107915,92085
1:5:6,0,-1,107916,92084
1:5:3,0,-1,107917,92083
1:2:1,1,1,107916,92084
5:1:5,0,-1,107917,92083
2:1:5,1,1,107916,92084
3:6:1,0,-1,107917,92083
4:5:2,1,1,107916,92084
2:5:3,1,1,107915,92085
5:4:1,0,-1,107916,92084
2:3:3,1,1,107915,92085
3:2:6,1,1,107914,92086
1:1:1,0,-1,107915,92085
3:5:3,0,-1,107916,92084
4:4:1,0,-1,107917,92083
4:1:2,1,1,107916,92084
6:6:5,0,-1,107917,92083
3:1:1,0,-1,107918,92082
6:2:4,1,1,107917,92083
1:4:4,0,-1,107918,92082
6:1:1,0,-1,107919,92081
3:3:2,1,1,107918,92082
5:5:1,0,-1,107919,92081
2:4:1,1,1,107918,92082
4:1:4,0,-1,107919,92081
2:4:4,1,1,107918,92082
1:6:4,0,-1,107919,92081
5:5:5,0,-1,107920,92080
4:6:6,0,-1,107921,92079
3:2:6,1,1,107920,92080
4:4:4,0,-1,107921,92079
1:5:2,1,1,107920,92080
6:3:2,1,1,107919,92081
3:5:3,0,-1,107920,92080
4:6:1,0,-1,107921,92079
3:5:4,0,-1,107922,92078
3:4:5,0,-1,107923,92077
1:1:3,0,-1,107924,92076
5:1:1,0,-1,107925,92075
2:3:5,1,1,107924,92076
4:2:6,1,1,107923,92077
3:5:5,0,-1,107924,92076
1:6:5,0,-1,107925,92075
2:1:5,1,1,107924,92076
6:3:1,0,-1,107925,92075
2:1:4,1,1,107924,92076
2:2:5,2,2,107922,92078
1:3:2,1,1,107921,92079
4:1:4,0,-1,107922,92078
1:1:6,0,-1,107923,92077
5:1:5,0,-1,107924,92076
3:4:6,0,-1,107925,92075
3:3:1,0,-1,107926,92074
5:4:3,0,-1,107927,92073
3:1:5,0,-1,107928,92072
4:5:3,0,-1,107929,92071
1:6:6,0,-1,107930,92070
5:5:6,0,-1,107931,92069
4:2:6,1,1,107930,92070
6:3:6,0,-1,107931,92069
2:2:5,2,2,107929,92071
3:4:1,0,-1,107930,92070
5:3:1,0,-1,107931,92069
5:2:4,1,1,107930,92070
1:2:6,1,1,107929,92071
6:6:6,0,-1,107930,92070
3:4:1,0,-1,107931,92069
5:3:1,0,-1,107932,92068
5:2:6,1,1,107931,92069
1:5:4,0,-1,107932,92068
4:1:6,0,-1,107933,92067
4:2:3,1,1,107932,92068
1:2:3,1,1,107931,92069
2:6:2,2,2,107929,92071
5:5:6,0,-1,107930,92070
2:2:4,2,2,107928,92072
4:6:6,0,-1,107929,92071
2:1:6,1,1,107928,92072
4:3:4,0,-1,107929,92071
6:5:3,0,-1,107930,92070
3:5:1,0,-1,107931,92069
1:1:4,0,-1,107932,92068
3:5:2,1,1,107931,92069
4:1:1,0,-1,107932,92068
1:6:2,1,1,107931,92069
5:6:2,1,1,107930,92070
5:6:4,0,-1,107931,92069
6:4:5,0,-1,107932,92068
3:1:6,0,-1,107933,92067
3:5:1,0,-1,107934,92066
2:6:6,1,1,107933,92067
3:6:1,0,-1,107934,92066
6:3:1,0,-1,107935,92065
5:5:6,0,-1,107936,92064
4:4:3,0,-1,107937,92063
3:2:6,1,1,107936,92064
1:6:4,0,-1,107937,92063
2:2:2,3,3,107934,92066
2:5:3,1,1,107933,92067
6:2:6,1,1,107932,92068
2:4:4,1,1,107931,92069
6:2:2,2,2,107929,92071
5:1:1,0,-1,107930,92070
6:3:3,0,-1,107931,92069
5:1:5,0,-1,107932,92068
3:3:6,0,-1,107933,92067
3:4:2,1,1,107932,92068
2:5:2,2,2,107930,92070
3:6:3,0,-1,107931,92069
3:1:2,1,1,107930,92070
1:6:5,0,-1,107931,92069
1:4:4,0,-1,107932,92068
1:1:1,0,-1,107933,92067
5:1:1,0,-1,107934,92066
5:5:3,0,-1,107935,92065
1:4:6,0,-1,107936,92064
4:2:3,1,1,107935,92065
1:4:3,0,-1,107936,92064
3:5:3,0,-1,107937,92063
6:4:6,0,-1,107938,92062
4:4:6,0,-1,107939,92061
2:2:1,2,2,107937,92063
3:6:1,0,-1,107938,92062
4:3:3,0,-1,107939,92061
3:2:3,1,1,107938,92062
1:6:5,0,-1,107939,92061
2:3:4,1,1,107938,92062
1:3:2,1,1,107937,92063
2:5:4,1,1,107936,92064
3:5:6,0,-1,107937,92063
2:2:3,2,2,107935,92065
2:2:1,2,2,107933,92067
2:1:3,1,1,107932,92068
5:3:1,0,-1,107933,92067
5:5:4,0,-1,107934,92066
1:5:3,0,-1,107935,92065
1:6:5,0,-1,107936,92064
1:6:2,1,1,107935,92065
4:2:1,1,1,107934,92066
1:1:5,0,-1,107935,92065
3:4:1,0,-1,107936,92064
3:5:5,0,-1,107937,92063
5:2:6,1,1,107936,92064
1:2:5,1,1,107935,92065
2:1:2,2,2,107933,92067
2:3:1,1,1,107932,92068
3:2:1,1,1,107931,92069
2:3:5,1,1,107930,92070
2:1:2,2,2,107928,92072
5:3:6,0,-1,107929,92071
2:2:6,2,2,107927,92073
1:1:1,0,-1,107928,92072
2:5:4,1,1,107927,92073
6:5:4,0,-1,107928,92072
1:2:1,1,1,107927,92073
6:5:6,0,-1,107928,92072
5:2:2,2,2,107926,92074
2:3:2,2,2,107924,92076
4:1:1,0,-1,107925,92075
5:2:6,1,1,107924,92076
4:5:5,0,-1,107925,92075
5:1:6,0,-1,107926,92074
6:2:3,1,1,107925,92075
3:3:3,0,-1,107926,92074
1:3:4,0,-1,107927,92073
3:2:4,1,1,107926,92074
6:6:5,0,-1,107927,92073
3:4:1,0,-1,107928,92072
5:2:3,1,1,107927,92073
2:5:2,2,2,107925,92075
6:3:6,0,-1,107926,92074
4:4:3,0,-1,107927,92073
2:3:6,1,1,107926,92074
4:6:3,0,-1,107927,92073
5:4:4,0,-1,107928,92072
1:5:1,0,-1,107929,92071
6:5:6,0,-1,107930,92070
4:6:3,0,-1,107931,92069
2:5:6,1,1,107930,92070
6:5:3,0,-1,107931,92069
6:3:4,0,-1,107932,92068
5:3:6,0,-1,107933,92067
6:3:6,0,-1,107934,92066
4:3:5,0,-1,107935,92065
6:1:3,0,-1,107936,92064
2:5:6,1,1,107935,92065
5:6:1,0,-1,107936,92064
6:5:6,0,-1,107937,92063
3:6:3,0,-1,107938,92062
5:5:6,0,-1,107939,92061
1:1:6,0,-1,107940,92060
1:1:3,0,-1,107941,92059
5:3:1,0,-1,107942,92058
3:4:6,0,-1,107943,92057
4:4:1,0,-1,107944,92056
5:4:2,1,1,107943,92057
1:1:4,0,-1,107944,92056
2:4:3,1,1,107943,92057
6:3:2,1,1,107942,92058
6:4:5,0,-1,107943,92057
5:6:5,0,-1,107944,92056
2:3:2,2,2,107942,92058
3:5:4,0,-1,107943,92057
4:3:4,0,-1,107944,92056
5:2:2,2,2,107942,92058
1:3:4,0,-1,107943,92057
4:1:3,0,-1,107944,92056
6:5:5,0,-1,107945,92055
1:4:6,0,-1,107946,92054
3:4:5,0,-1,107947,92053
4:1:6,0,-1,107948,92052
5:4:1,0,-1,107949,92051
3:4:5,0,-1,107950,92050
3:2:4,1,1,107949,92051
1:5:6,0,-1,107950,92050
4:4:1,0,-1,107951,92049
4:6:2,1,1,107950,92050
3:1:6,0,-1,107951,92049
1:5:5,0,-1,107952,92048
5:3:5,0,-1,107953,92047
5:3:2,1,1,107952,92048
6:1:4,0,-1,107953,92047
3:6:5,0,-1,107954,92046
2:5:1,1,1,107953,92047
5:1:4,0,-1,107954,92046
1:2:4,1,1,107953,92047
6:2:1,1,1,107952,92048
5:6:1,0,-1,107953,92047
6:5:3,0,-1,107954,92046
3:1:6,0,-1,107955,92045
4:2:3,1,1,107954,92046
6:4:2,1,1,107953,92047
2:2:6,2,2,107951,92049
6:1:1,0,-1,107952,92048
6:4:5,0,-1,107953,92047
3:3:1,0,-1,107954,92046
1:5:3,0,-1,107955,92045
1:5:6,0,-1,107956,92044
3:5:2,1,1,107955,92045
1:5:3,0,-1,107956,92044
1:2:4,1,1,107955,92045
4:4:1,0,-1,107956,92044
1:4:4,0,-1,107957,92043
2:1:4,1,1,107956,92044
2:1:4,1,1,107955,92045
4:1:2,1,1,107954,92046
1:3:4,0,-1,107955,92045
1:4:4,0,-1,107956,92044
5:3:1,0,-1,107957,92043
6:5:2,1,1,107956,92044
3:5:5,0,-1,107957,92043
3:6:1,0,-1,107958,92042
4:5:2,1,1,107957,92043
3:1:3,0,-1,107958,92042
2:2:4,2,2,107956,92044
3:6:2,1,1,107955,92045
2:5:6,1,1,107954,92046
6:3:4,0,-1,107955,92045
2:5:3,1,1,107954,92046
2:6:4,1,1,107953,92047
6:3:3,0,-1,107954,92046
1:3:3,0,-1,107955,92045
1:3:5,0,-1,107956,92044
1:3:2,1,1,107955,92045
2:6:3,1,1,107954,92046
2:3:6,1,1,107953,92047
4:5:6,0,-1,107954,92046
6:1:5,0,-1,107955,92045
5:2:5,1,1,107954,92046
5:2:4,1,1,107953,92047
3:6:4,0,-1,107954,92046
3:5:1,0,-1,107955,92045
2:6:6,1,1,107954,92046
2:1:3,1,1,107953,92047
4:3:3,0,-1,107954,92046
3:3:5,0,-1,107955,92045
4:6:6,0,-1,107956,92044
5:6:3,0,-1,107957,92043
4:4:3,0,-1,107958,92042
3:3:3,0,-1,107959,92041
6:1:1,0,-1,107960,92040
1:4:5,0,-1,107961,92039
5:1:5,0,-1,107962,92038
2:3:4,1,1,107961,92039
4:3:5,0,-1,107962,92038
2:5:6,1,1,107961,92039
5:2:6,1,1,107960,92040
6:2:1,1,1,107959,92041
1:5:4,0,-1,107960,92040
6:1:6,0,-1,107961,92039
5:1:5,0,-1,107962,92038
3:4:4,0,-1,107963,92037
4:4:1,0,-1,107964,92036
4:4:6,0,-1,107965,92035
2:3:3,1,1,107964,92036
4:4:1,0,-1,107965,92035
2:1:5,1,1,107964,92036
3:5:4,0,-1,107965,92035
4:6:2,1,1,107964,92036
5:1:5,0,-1,107965,92035
6:3:6,0,-1,107966,92034
4:1:4,0,-1,107967,92033
1:4:1,0,-1,107968,92032
2:5:5,1,1,107967,92033
2:2:5,2,2,107965,92035
3:6:1,0,-1,107966,92034
4:6:4,0,-1,107967,92033
4:4:6,0,-1,107968,92032
4:4:1,0,-1,107969,92031
1:5:6,0,-1,107970,92030
1:1:4,0,-1,107971,92029
3:5:6,0,-1,107972,92028
1:6:2,1,1,107971,92029
1:2:6,1,1,107970,92030
5:4:2,1,1,107969,92031
1:2:1,1,1,107968,92032
4:1:6,0,-1,107969,92031
5:1:5,0,-1,107970,92030
1:2:1,1,1,107969,92031
2:4:5,1,1,107968,92032
2:4:6,1,1,107967,92033
2:2:1,2,2,107965,92035
3:2:1,1,1,107964,92036
3:2:2,2,2,107962,92038
3:4:6,0,-1,107963,92037
4:4:4,0,-1,107964,92036
5:2:1,1,1,107963,92037
3:3:4,0,-1,107964,92036
2:2:4,2,2,107962,92038
1:1:1,0,-1,107963,92037
5:2:5,1,1,107962,92038
3:6:6,0,-1,107963,92037
1:4:4,0,-1,107964,92036
2:3:2,2,2,107962,92038
5:2:6,1,1,107961,92039
2:4:2,2,2,107959,92041
5:5:2,1,1,107958,92042
4:5:3,0,-1,107959,92041
6:1:1,0,-1,107960,92040
2:3:4,1,1,107959,92041
2:6:1,1,1,107958,92042
4:3:4,0,-1,107959,92041
1:3:4,0,-1,107960,92040
5:1:1,0,-1,107961,92039
3:5:3,0,-1,107962,92038
3:3:5,0,-1,107963,92037
5:1:6,0,-1,107964,92036
1:2:2,2,2,107962,92038
6:5:1,0,-1,107963,92037
2:5:1,1,1,107962,92038
2:4:6,1,1,107961,92039
2:3:3,1,1,107960,92040
6:4:6,0,-1,107961,92039
5:5:6,0,-1,107962,92038
6:3:4,0,-1,107963,92037
3:3:3,0,-1,107964,92036
1:1:1,0,-1,107965,92035
5:1:6,0,-1,107966,92034
3:1:1,0,-1,107967,92033
4:2:6,1,1,107966,92034
6:1:4,0,-1,107967,92033
2:1:6,1,1,107966,92034
3:6:3,0,-1,107967,92033
1:3:4,0,-1,107968,92032
6:2:6,1,1,107967,92033
6:3:5,0,-1,107968,92032
5:4:1,0,-1,107969,92031
6:1:1,0,-1,107970,92030
1:1:2,1,1,107969,92031
2:3:6,1,1,107968,92032
5:2:2,2,2,107966,92034
2:1:1,1,1,107965,92035
6:6:3,0,-1,107966,92034
5:4:4,0,-1,107967,92033
2:5:1,1,1,107966,92034
1:5:4,0,-1,107967,92033
3:4:5,0,-1,107968,92032
1:6:5,0,-1,107969,92031
3:5:1,0,-1,107970,92030
1:2:4,1,1,107969,92031
6:5:2,1,1,107968,92032
6:3:4,0,-1,107969,92031
1:3:6,0,-1,107970,92030
1:4:4,0,-1,107971,92029
2:4:5,1,1,107970,92030
2:4:1,1,1,107969,92031
1:3:4,0,-1,107970,92030
5:4:1,0,-1,107971,92029
3:5:5,0,-1,107972,92028
3:5:2,1,1,107971,92029
6:6:4,0,-1,107972,92028
1:5:1,0,-1,107973,92027
6:6:1,0,-1,107974,92026
3:1:2,1,1,107973,92027
2:6:5,1,1,107972,92028
2:5:6,1,1,107971,92029
6:4:4,0,-1,107972,92028
1:1:6,0,-1,107973,92027
4:4:2,1,1,107972,92028
5:4:6,0,-1,107973,92027
3:1:2,1,1,107972,92028
5:1:1,0,-1,107973,92027
6:2:2,2,2,107971,92029
1:5:6,0,-1,107972,92028
4:5:4,0,-1,107973,92027
1:2:5,1,1,107972,92028
1:1:5,0,-1,107973,92027
1:4:6,0,-1,107974,92026
6:2:6,1,1,107973,92027
3:6:1,0,-1,107974,92026
5:2:3,1,1,107973,92027
5:5:5,0,-1,107974,92026
3:6:2,1,1,107973,92027
4:5:2,1,1,107972,92028
3:1:6,0,-1,107973,92027
1:6:2,1,1,107972,92028
5:1:4,0,-1,107973,92027
1:3:3,0,-1,107974,92026
4:4:5,0,-1,107975,92025
1:6:2,1,1,107974,92026
2:4:1,1,1,107973,92027
5:5:5,0,-1,107974,92026
1:1:3,0,-1,107975,92025
1:5:3,0,-1,107976,92024
4:3:6,0,-1,107977,92023
1:5:5,0,-1,107978,92022
5:2:4,1,1,107977,92023
1:1:4,0,-1,107978,92022
4:1:5,0,-1,107979,92021
4:3:3,0,-1,107980,92020
5:4:1,0,-1,107981,92019
2:4:1,1,1,107980,92020
2:1:3,1,1,107979,92021
4:4:1,0,-1,107980,92020
2:6:4,1,1,107979,92021
2:4:4,1,1,107978,92022
2:2:5,2,2,107976,92024
6:2:1,1,1,107975,92025
2:2:4,2,2,107973,92027
1:5:6,0,-1,107974,92026
1:6:2,1,1,107973,92027
1:5:2,1,1,107972,92028
5:1:3,0,-1,107973,92027
5:4:3,0,-1,107974,92026
3:2:5,1,1,107973,92027
4:5:4,0,-1,107974,92026
1:3:5,0,-1,107975,92025
3:5:3,0,-1,107976,92024
3:5:6,0,-1,107977,92023
2:3:3,1,1,107976,92024
1:6:2,1,1,107975,92025
2:6:5,1,1,107974,92026
3:4:2,1,1,107973,92027
4:5:1,0,-1,107974,92026
3:1:4,0,-1,107975,92025
3:6:1,0,-1,107976,92024
5:2:4,1,1,107975,92025
1:5:2,1,1,107974,92026
5:3:1,0,-1,107975,92025
3:5:4,0,-1,107976,92024
5:4:3,0,-1,107977,92023
4:6:6,0,-1,107978,92022
4:4:2,1,1,107977,92023
5:4:4,0,-1,107978,92022
3:1:6,0,-1,107979,92021
6:2:1,1,1,107978,92022
4:4:4,0,-1,107979,92021
3:1:2,1,1,107978,92022
3:6:1,0,-1,107979,92021
2:4:1,1,1,107978,92022
2:1:3,1,1,107977,92023
5:2:6,1,1,107976,92024
3:4:4,0,-1,107977,92023
1:3:2,1,1,107976,92024
5:5:3,0,-1,107977,92023
2:5:2,2,2,107975,92025
3:1:6,0,-1,107976,92024
4:2:5,1,1,107975,92025
3:1:5,0,-1,107976,92024
5:5:5,0,-1,107977,92023
4:3:5,0,-1,107978,92022
5:5:2,1,1,107977,92023
2:2:4,2,2,107975,92025
2:4:4,1,1,107974,92026
2:6:3,1,1,107973,92027
1:3:6,0,-1,107974,92026
4:2:4,1,1,107973,92027
5:1:2,1,1,107972,92028
6:4:4,0,-1,107973,92027
4:4:3,0,-1,107974,92026
3:5:6,0,-1,107975,92025
2:5:6,1,1,107974,92026
4:5:1,0,-1,107975,92025
2:6:4,1,1,107974,92026
1:1:1,0,-1,107975,92025
3:3:5,0,-1,107976,92024
6:6:6,0,-1,107977,92023
6:4:3,0,-1,107978,92022
5:1:3,0,-1,107979,92021
2:4:5,1,1,107978,92022
5:3:6,0,-1,107979,92021
1:6:2,1,1,107978,92022
1:4:6,0,-1,107979,92021
5:1:5,0,-1,107980,92020
1:4:3,0,-1,107981,92019
2:2:4,2,2,107979,92021
6:3:1,0,-1,107980,92020
5:2:1,1,1,107979,92021
3:6:3,0,-1,107980,92020
2:3:6,1,1,107979,92021
3:2:5,1,1,107978,92022
5:4:1,0,-1,107979,92021
1:2:2,2,2,107977,92023
3:4:6,0,-1,107978,92022
1:3:5,0,-1,107979,92021
2:5:1,1,1,107978,92022
2:4:3,1,1,107977,92023
2:1:4,1,1,107976,92024
5:3:6,0,-1,107977,92023
4:1:3,0,-1,107978,92022
2:3:6,1,1,107977,92023
1:2:2,2,2,107975,92025
6:6:5,0,-1,107976,92024
3:5:1,0,-1,107977,92023
6:3:3,0,-1,107978,92022
1:2:2,2,2,107976,92024
3:1:3,0,-1,107977,92023
4:6:2,1,1,107976,92024
6:5:2,1,1,107975,92025
1:4:4,0,-1,107976,92024
5:1:4,0,-1,107977,92023
5:3:4,0,-1,107978,92022
6:2:2,2,2,107976,92024
1:3:3,0,-1,107977,92023
4:2:3,1,1,107976,92024
4:2:1,1,1,107975,92025
4:1:6,0,-1,107976,92024
1:4:1,0,-1,107977,92023
2:2:2,3,3,107974,92026
1:1:4,0,-1,107975,92025
3:5:1,0,-1,107976,92024
2:6:6,1,1,107975,92025
3:3:4,0,-1,107976,92024
3:3:5,0,-1,107977,92023
6:6:5,0,-1,107978,92022
3:6:5,0,-1,107979,92021
6:1:3,0,-1,107980,92020
6:6:4,0,-1,107981,92019
6:3:6,0,-1,107982,92018
1:4:4,0,-1,107983,92017
5:1:4,0,-1,107984,92016
1:5:3,0,-1,107985,92015
2:4:6,1,1,107984,92016
4:3:2,1,1,107983,92017
5:2:2,2,2,107981,92019
2:1:4,1,1,107980,92020
3:3:1,0,-1,107981,92019
5:1:4,0,-1,107982,92018
1:4:3,0,-1,107983,92017
1:4:1,0,-1,107984,92016
6:1:5,0,-1,107985,92015
6:1:4,0,-1,107986,92014
3:1:4,0,-1,107987,92013
5:4:5,0,-1,107988,92012
3:3:6,0,-1,107989,92011
1:6:4,0,-1,107990,92010
2:3:3,1,1,107989,92011
5:1:6,0,-1,107990,92010
3:3:4,0,-1,107991,92009
1:4:6,0,-1,107992,92008
2:5:4,1,1,107991,92009
6:5:6,0,-1,107992,92008
5:5:3,0,-1,107993,92007
3:3:5,0,-1,107994,92006
3:2:4,1,1,107993,92007
2:4:3,1,1,107992,92008
5:5:3,0,-1,107993,92007
1:3:4,0,-1,107994,92006
6:5:1,0,-1,107995,92005
3:5:6,0,-1,107996,92004
6:1:5,0,-1,107997,92003
6:5:4,0,-1,107998,92002
2:6:1,1,1,107997,92003
4:2:3,1,1,107996,92004
5:5:1,0,-1,107997,92003
1:5:6,0,-1,107998,92002
3:3:1,0,-1,107999,92001
5:5:1,0,-1,108000,92000
4:3:6,0,-1,108001,91999
1:6:5,0,-1,108002,91998
2:5:3,1,1,108001,91999
5:6:2,1,1,108000,92000
3:3:2,1,1,107999,92001
4:6:1,0,-1,108000,92000
1:4:4,0,-1,108001,91999
4:1:2,1,1,108000,92000
2:2:6,2,2,107998,92002
6:1:6,0,-1,107999,92001
6:5:1,0,-1,108000,92000
5:6:6,0,-1,108001,91999
4:5:1,0,-1,108002,91998
1:3:4,0,-1,108003,91997
3:3:2,1,1,108002,91998
1:1:1,0,-1,108003,91997
3:4:5,0,-1,108004,91996
6:4:3,0,-1,108005,91995
3:4:1,0,-1,108006,91994
3:1:1,0,-1,108007,91993
6:1:6,0,-1,108008,91992
4:4:1,0,-1,108009,91991
3:6:1,0,-1,108010,91990
4:5:5,0,-1,108011,91989
6:5:3,0,-1,108012,91988
2:4:3,1,1,108011,91989
1:6:1,0,-1,108012,91988
5:5:2,1,1,108011,91989
3:1:6,0,-1,108012,91988
4:4:6,0,-1,108013,91987
3:4:2,1,1,108012,91988
1:6:1,0,-1,108013,91987
1:2:1,1,1,108012,91988
1:4:5,0,-1,108013,91987
4:4:6,0,-1,108014,91986
2:5:5,1,1,108013,91987
2:4:2,2,2,108011,91989
2:2:6,2,2,108009,91991
4:6:5,0,-1,108010,91990
6:4:5,0,-1,108011,91989
5:2:6,1,1,108010,91990
5:3:5,0,-1,108011,91989
4:2:6,1,1,108010,91990
1:3:4,0,-1,108011,91989
2:3:2,2,2,108009,91991
2:4:5,1,1,108008,91992
2:5:1,1,1,108007,91993
5:6:3,0,-1,108008,91992
4:4:4,0,-1,108009,91991
5:6:3,0,-1,108010,91990
2:1:1,1,1,108009,91991
6:5:1,0,-1,108010,91990
3:1:5,0,-1,108011,91989
2:5:5,1,1,108010,91990
3:1:2,1,1,108009,91991
1:1:5,0,-1,108010,91990
4:5:1,0,-1,108011,91989
4:2:1,1,1,108010,91990
5:6:6,0,-1,108011,91989
3:6:1,0,-1,108012,91988
3:1:3,0,-1,108013,91987
5:1:6,0,-1,108014,91986
6:3:2,1,1,108013,91987
3:3:4,0,-1,108014,91986
2:5:1,1,1,108013,91987
5:3:1,0,-1,108014,91986
6:6:6,0,-1,108015,91985
2:1:1,1,1,108014,91986
4:2:2,2,2,108012,91988
6:3:3,0,-1,108013,91987
4:3:3,0,-1,108014,91986
1:4:2,1,1,108013,91987
2:4:3,1,1,108012,91988
5:4:6,0,-1,108013,91987
4:3:2,1,1,108012,91988
1:5:1,0,-1,108013,91987
3:3:3,0,-1,108014,91986
2:4:2,2,2,108012,91988
1:6:1,0,-1,108013,91987
5:2:3,1,1,108012,91988
6:1:1,0,-1,108013,91987
3:2:6,1,1,108012,91988
4:5:1,0,-1,108013,91987
4:1:4,0,-1,108014,91986
3:1:6,0,-1,108015,91985
2:3:1,1,1,108014,91986
6:1:1,0,-1,108015,91985
4:5:6,0,-1,108016,91984
5:4:1,0,-1,108017,91983
4:2:4,1,1,108016,91984
6:2:5,1,1,108015,91985
3:6:6,0,-1,108016,91984
4:2:6,1,1,108015,91985
6:2:4,1,1,108014,91986
4:4:3,0,-1,108015,91985
6:1:5,0,-1,108016,91984
5:3:4,0,-1,108017,91983
5:3:3,0,-1,108018,91982
4:4:1,0,-1,108019,91981
4:6:2,1,1,108018,91982
5:3:3,0,-1,108019,91981
6:5:5,0,-1,108020,91980
6:6:1,0,-1,108021,91979
6:3:1,0,-1,108022,91978
5:3:5,0,-1,108023,91977
4:6:1,0,-1,108024,91976
6:1:5,0,-1,108025,91975
4:1:6,0,-1,108026,91974
4:5:4,0,-1,108027,91973
4:2:2,2,2,108025,91975
5:3:2,1,1,108024,91976
2:5:5,1,1,108023,91977
1:1:3,0,-1,108024,91976
4:2:4,1,1,108023,91977
6:1:6,0,-1,108024,91976
6:3:1,0,-1,108025,91975
4:1:3,0,-1,108026,91974
4:6:4,0,-1,108027,91973
1:5:1,0,-1,108028,91972
2:6:1,1,1,108027,91973
1:3:6,0,-1,108028,91972
3:4:4,0,-1,108029,91971
4:6:2,1,1,108028,91972
4:2:3,1,1,108027,91973
1:5:5,0,-1,108028,91972
2:4:3,1,1,108027,91973
4:4:2,1,1,108026,91974
6:2:3,1,1,108025,91975
5:1:5,0,-1,108026,91974
5:4:4,0,-1,108027,91973
6:2:1,1,1,108026,91974
2:3:1,1,1,108025,91975
1:2:6,1,1,108024,91976
5:2:2,2,2,108022,91978
4:3:6,0,-1,108023,91977
3:5:3,0,-1,108024,91976
2:4:2,2,2,108022,91978
1:1:1,0,-1,108023,91977
3:5:3,0,-1,108024,91976
5:1:2,1,1,108023,91977
1:6:2,1,1,108022,91978
1:6:2,1,1,108021,91979
6:1:3,0,-1,108022,91978
5:1:1,0,-1,108023,91977
4:5:2,1,1,108022,91978
4:3:3,0,-1,108023,91977
4:4:5,0,-1,108024,91976
4:4:1,0,-1,108025,91975
6:2:2,2,2,108023,91977
5:4:2,1,1,108022,91978
1:2:6,1,1,108021,91979
2:6:3,1,1,108020,91980
1:4:5,0,-1,108021,91979
6:3:2,1,1,108020,91980
1:1:5,0,-1,108021,91979
5:6:4,0,-1,108022,91978
5:4:5,0,-1,108023,91977
6:5:3,0,-1,108024,91976
4:6:6,0,-1,108025,91975
6:1:1,0,-1,108026,91974
2:2:2,3,3,108023,91977
3:1:2,1,1,108022,91978
4:1:2,1,1,108021,91979
4:5:3,0,-1,108022,91978
5:5:6,0,-1,108023,91977
1:5:1,0,-1,108024,91976
1:3:4,0,-1,108025,91975
2:3:6,1,1,108024,91976
6:5:2,1,1,108023,91977
2:2:5,2,2,108021,91979
2:2:4,2,2,108019,91981
6:5:1,0,-1,108020,91980
5:6:2,1,1,108019,91981
5:1:4,0,-1,108020,91980
2:1:4,1,1,108019,91981
6:6:1,0,-1,108020,91980
4:5:4,0,-1,108021,91979
1:3:3,0,-1,108022,91978
5:1:5,0,-1,108023,91977
1:3:6,0,-1,108024,91976
3:5:6,0,-1,108025,91975
4:4:3,0,-1,108026,91974
3:6:2,1,1,108025,91975
1:6:4,0,-1,108026,91974
5:2:4,1,1,108025,91975
4:3:3,0,-1,108026,91974
3:4:3,0,-1,108027,91973
2:3:1,1,1,108026,91974
6:6:3,0,-1,108027,91973
3:2:1,1,1,108026,91974
4:5:1,0,-1,108027,91973
3:3:6,0,-1,108028,91972
4:3:1,0,-1,108029,91971
6:1:2,1,1,108028,91972
6:5:1,0,-1,108029,91971
6:3:1,0,-1,108030,91970
3:2:3,1,1,108029,91971
6:6:4,0,-1,108030,91970
2:3:2,2,2,108028,91972
2:4:5,1,1,108027,91973
5:1:3,0,-1,108028,91972
2:1:6,1,1,108027,91973
2:4:1,1,1,108026,91974
1:2:2,2,2,108024,91976
2:2:4,2,2,108022,91978
2:1:1,1,1,108021,91979
4:3:3,0,-1,108022,91978
2:3:1,1,1,108021,91979
5:4:3,0,-1,108022,91978
1:1:5,0,-1,108023,91977
3:6:1,0,-1,108024,91976
5:6:4,0,-1,108025,91975
2:3:3,1,1,108024,91976
6:5:3,0,-1,108025,91975
3:2:3,1,1,108024,91976
5:3:5,0,-1,108025,91975
3:1:1,0,-1,108026,91974
2:3:5,1,1,108025,91975
5:2:4,1,1,108024,91976
4:3:6,0,-1,108025,91975
1:4:2,1,1,108024,91976
1:4:3,0,-1,108025,91975
2:4:2,2,2,108023,91977
2:1:1,1,1,108022,91978
3:1:5,0,-1,108023,91977
1:6:5,0,-1,108024,91976
1:6:6,0,-1,108025,91975
5:3:1,0,-1,108026,91974
6:3:6,0,-1,108027,91973
1:6:5,0,-1,108028,91972
5:5:1,0,-1,108029,91971
5:5:4,0,-1,108030,91970
1:2:3,1,1,108029,91971
3:5:1,0,-1,108030,91970
6:2:3,1,1,108029,91971
6:4:2,1,1,108028,91972
5:2:3,1,1,108027,91973
6:4:2,1,1,108026,91974
5:2:2,2,2,108024,91976
3:2:2,2,2,108022,91978
1:3:2,1,1,108021,91979
2:3:1,1,1,108020,91980
1:4:4,0,-1,108021,91979
5:5:6,0,-1,108022,91978
1:5:2,1,1,108021,91979
2:2:5,2,2,108019,91981
3:4:1,0,-1,108020,91980
3:6:4,0,-1,108021,91979
1:5:3,0,-1,108022,91978
3:6:6,0,-1,108023,91977
4:1:2,1,1,108022,91978
4:2:5,1,1,108021,91979
2:3:1,1,1,108020,91980
2:5:4,1,1,108019,91981
1:6:6,0,-1,108020,91980
1:1:5,0,-1,108021,91979
3:1:3,0,-1,108022,91978
6:2:3,1,1,108021,91979
2:6:2,2,2,108019,91981
4:6:5,0,-1,108020,91980
5:6:4,0,-1,108021,91979
5:6:3,0,-1,108022,91978
3:2:2,2,2,108020,91980
4:2:3,1,1,108019,91981
2:4:6,1,1,108018,91982
5:3:1,0,-1,108019,91981
2:6:3,1,1,108018,91982
6:1:5,0,-1,108019,91981
1:2:3,1,1,108018,91982
3:5:1,0,-1,108019,91981
1:1:3,0,-1,108020,91980
6:3:6,0,-1,108021,91979
3:3:3,0,-1,108022,91978
3:1:5,0,-1,108023,91977
6:4:1,0,-1,108024,91976
3:4:3,0,-1,108025,91975
6:4:6,0,-1,108026,91974
6:6:1,0,-1,108027,91973
6:4:4,0,-1,108028,91972
3:6:4,0,-1,108029,91971
5:5:2,1,1,108028,91972
2:2:5,2,2,108026,91974
2:2:3,2,2,108024,91976
1:2:3,1,1,108023,91977
1:3:4,0,-1,108024,91976
2:3:6,1,1,108023,91977
5:3:5,0,-1,108024,91976
5:4:5,0,-1,108025,91975
1:1:4,0,-1,108026,91974
2:6:1,1,1,108025,91975
1:3:1,0,-1,108026,91974
3:5:6,0,-1,108027,91973
4:5:4,0,-1,108028,91972
1:3:4,0,-1,108029,91971
5:3:5,0,-1,108030,91970
6:4:3,0,-1,108031,91969
3:3:1,0,-1,108032,91968
4:6:6,0,-1,108033,91967
3:4:3,0,-1,108034,91966
2:4:2,2,2,108032,91968
2:5:4,1,1,108031,91969
2:4:6,1,1,108030,91970
2:5:2,2,2,108028,91972
5:3:5,0,-1,108029,91971
6:5:3,0,-1,108030,91970
1:3:1,0,-1,108031,91969
2:5:1,1,1,108030,91970
3:3:2,1,1,108029,91971
1:4:6,0,-1,108030,91970
5:3:6,0,-1,108031,91969
4:5:2,1,1,108030,91970
2:5:2,2,2,108028,91972
6:4:5,0,-1,108029,91971
4:5:1,0,-1,108030,91970
5:6:4,0,-1,108031,91969
6:1:1,0,-1,108032,91968
6:2:4,1,1,108031,91969
4:6:2,1,1,108030,91970
5:5:1,0,-1,108031,91969
1:5:3,0,-1,108032,91968
2:6:1,1,1,108031,91969
4:6:1,0,-1,108032,91968
6:2:2,2,2,108030,91970
3:2:3,1,1,108029,91971
1:6:2,1,1,108028,91972
1:1:2,1,1,108027,91973
4:4:3,0,-1,108028,91972
6:5:3,0,-1,108029,91971
5:4:5,0,-1,108030,91970
2:4:3,1,1,108029,91971
2:1:6,1,1,108028,91972
1:3:4,0,-1,108029,91971
6:4:2,1,1,108028,91972
2:1:3,1,1,108027,91973
5:3:4,0,-1,108028,91972
6:4:1,0,-1,108029,91971
1:5:2,1,1,108028,91972
2:3:5,1,1,108027,91973
2:1:5,1,1,108026,91974
2:6:6,1,1,108025,91975
4:6:6,0,-1,108026,91974
2:6:5,1,1,108025,91975
6:6:4,0,-1,108026,91974
5:6:6,0,-1,108027,91973
4:1:5,0,-1,108028,91972
4:4:5,0,-1,108029,91971
4:2:3,1,1,108028,91972
5:3:4,0,-1,108029,91971
5:3:5,0,-1,108030,91970
6:3:3,0,-1,108031,91969
3:3:4,0,-1,108032,91968
1:6:3,0,-1,108033,91967
2:1:1,1,1,108032,91968
6:4:2,1,1,108031,91969
1:2:5,1,1,108030,91970
5:2:6,1,1,108029,91971
5:6:6,0,-1,108030,91970
3:3:1,0,-1,108031,91969
2:5:1,1,1,108030,91970
2:2:3,2,2,108028,91972
1:2:3,1,1,108027,91973
5:5:4,0,-1,108028,91972
5:3:3,0,-1,108029,91971
6:2:6,1,1,108028,91972
5:1:6,0,-1,108029,91971
3:3:1,0,-1,108030,91970
2:6:6,1,1,108029,91971
6:3:2,1,1,108028,91972
2:5:3,1,1,108027,91973
4:2:1,1,1,108026,91974
4:2:4,1,1,108025,91975
5:5:6,0,-1,108026,91974
3:6:1,0,-1,108027,91973
2:1:5,1,1,108026,91974
1:3:2,1,1,108025,91975
5:1:2,1,1,108024,91976
5:4:2,1,1,108023,91977
4:4:6,0,-1,108024,91976
6:3:5,0,-1,108025,91975
1:2:5,1,1,108024,91976
3:4:4,0,-1,108025,91975
3:2:2,2,2,108023,91977
4:5:6,0,-1,108024,91976
1:2:4,1,1,108023,91977
5:2:3,1,1,108022,91978
3:4:2,1,1,108021,91979
4:1:5,0,-1,108022,91978
5:1:2,1,1,108021,91979
4:2:3,1,1,108020,91980
5:4:1,0,-1,108021,91979
3:1:6,0,-1,108022,91978
2:6:2,2,2,108020,91980
6:1:2,1,1,108019,91981
3:2:2,2,2,108017,91983
2:1:3,1,1,108016,91984
3:6:1,0,-1,108017,91983
5:4:3,0,-1,108018,91982
1:2:3,1,1,108017,91983
5:6:6,0,-1,108018,91982
2:1:6,1,1,108017,91983
6:2:1,1,1,108016,91984
4:4:4,0,-1,108017,91983
3:2:1,1,1,108016,91984
3:3:2,1,1,108015,91985
4:4:4,0,-1,108016,91984
4:4:1,0,-1,108017,91983
4:1:1,0,-1,108018,91982
2:5:2,2,2,108016,91984
3:2:6,1,1,108015,91985
4:5:3,0,-1,108016,91984
1:1:1,0,-1,108017,91983
2:6:1,1,1,108016,91984
2:6:6,1,1,108015,91985
4:2:3,1,1,108014,91986
5:6:6,0,-1,108015,91985
4:3:2,1,1,108014,91986
3:1:4,0,-1,108015,91985
5:5:5,0,-1,108016,91984
4:2:6,1,1,108015,91985
3:4:5,0,-1,108016,91984
3:5:6,0,-1,108017,91983
2:5:2,2,2,108015,91985
6:1:3,0,-1,108016,91984
4:4:2,1,1,108015,91985
2:6:3,1,1,108014,91986
4:6:1,0,-1,108015,91985
3:3:2,1,1,108014,91986
6:4:5,0,-1,108015,91985
4:5:4,0,-1,108016,91984
4:4:3,0,-1,108017,91983
4:3:1,0,-1,108018,91982
4:6:4,0,-1,108019,91981
6:5:1,0,-1,108020,91980
3:4:1,0,-1,108021,91979
3:6:6,0,-1,108022,91978
3:5:1,0,-1,108023,91977
2:2:4,2,2,108021,91979
3:1:4,0,-1,108022,91978
6:3:1,0,-1,108023,91977
2:2:1,2,2,108021,91979
4:3:3,0,-1,108022,91978
5:6:3,0,-1,108023,91977
2:3:5,1,1,108022,91978
1:1:4,0,-1,108023,91977
3:6:3,0,-1,108024,91976
5:1:5,0,-1,108025,91975
4:2:5,1,1,108024,91976
3:5:4,0,-1,108025,91975
2:2:3,2,2,108023,91977
3:4:4,0,-1,108024,91976
2:4:1,1,1,108023,91977
1:5:2,1,1,108022,91978
3:2:2,2,2,108020,91980
5:4:2,1,1,108019,91981
1:6:2,1,1,108018,91982
6:3:1,0,-1,108019,91981
3:1:5,0,-1,108020,91980
3:3:6,0,-1,108021,91979
4:1:3,0,-1,108022,91978
3:2:4,1,1,108021,91979
2:3:3,1,1,108020,91980
2:2:4,2,2,108018,91982
1:2:2,2,2,108016,91984
1:5:5,0,-1,108017,91983
1:4:4,0,-1,108018,91982
5:1:3,0,-1,108019,91981
3:4:1,0,-1,108020,91980
4:3:6,0,-1,108021,91979
4:2:5,1,1,108020,91980
2:4:4,1,1,108019,91981
5:2:4,1,1,108018,91982
4:3:4,0,-1,108019,91981
2:2:4,2,2,108017,91983
1:6:5,0,-1,108018,91982
6:6:4,0,-1,108019,91981
4:4:1,0,-1,108020,91980
3:3:3,0,-1,108021,91979
6:1:3,0,-1,108022,91978
3:3:2,1,1,108021,91979
5:4:4,0,-1,108022,91978
4:6:4,0,-1,108023,91977
5:4:2,1,1,108022,91978
6:4:3,0,-1,108023,91977
2:3:3,1,1,108022,91978
5:1:5,0,-1,108023,91977
5:6:6,0,-1,108024,91976
3:2:2,2,2,108022,91978
1:5:3,0,-1,108023,91977
6:5:3,0,-1,108024,91976
4:6:4,0,-1,108025,91975
5:3:4,0,-1,108026,91974
3:4:2,1,1,108025,91975
6:1:2,1,1,108024,91976
3:5:6,0,-1,108025,91975
5:4:5,0,-1,108026,91974
3:6:1,0,-1,108027,91973
2:1:4,1,1,108026,91974
4:2:6,1,1,108025,91975
5:6:2,1,1,108024,91976
4:2:3,1,1,108023,91977
1:4:2,1,1,108022,91978
3:3:6,0,-1,108023,91977
4:4:2,1,1,108022,91978
2:4:5,1,1,108021,91979
6:2:3,1,1,108020,91980
1:6:4,0,-1,108021,91979
4:3:3,0,-1,108022,91978
5:4:6,0,-1,108023,91977
3:1:4,0,-1,108024,91976
4:3:3,0,-1,108025,91975
5:2:6,1,1,108024,91976
5:5:5,0,-1,108025,91975
2:2:5,2,2,108023,91977
6:5:2,1,1,108022,91978
4:1:3,0,-1,108023,91977
2:6:5,1,1,108022,91978
3:4:1,0,-1,108023,91977
4:5:2,1,1,108022,91978
1:5:1,0,-1,108023,91977
2:5:6,1,1,108022,91978
5:5:4,0,-1,108023,91977
4:4:6,0,-1,108024,91976
1:4:3,0,-1,108025,91975
1:1:2,1,1,108024,91976
6:4:4,0,-1,108025,91975
5:4:3,0,-1,108026,91974
5:1:5,0,-1,108027,91973
6:1:5,0,-1,108028,91972
1:4:4,0,-1,108029,91971
4:3:2,1,1,108028,91972
1:6:4,0,-1,108029,91971
3:6:3,0,-1,108030,91970
6:1:6,0,-1,108031,91969
6:5:3,0,-1,108032,91968
4:5:4,0,-1,108033,91967
3:2:2,2,2,108031,91969
3:4:6,0,-1,108032,91968
4:2:1,1,1,108031,91969
6:4:6,0,-1,108032,91968
5:4:2,1,1,108031,91969
1:4:1,0,-1,108032,91968
3:4:4,0,-1,108033,91967
6:6:6,0,-1,108034,91966
2:5:1,1,1,108033,91967
3:5:3,0,-1,108034,91966
2:6:3,1,1,108033,91967
1:2:1,1,1,108032,91968
6:5:5,0,-1,108033,91967
2:6:3,1,1,108032,91968
6:6:5,0,-1,108033,91967
6:6:6,0,-1,108034,91966
1:4:1,0,-1,108035,91965
5:3:2,1,1,108034,91966
2:3:4,1,1,108033,91967
2:4:4,1,1,108032,91968
3:5:3,0,-1,108033,91967
2:6:2,2,2,108031,91969
6:2:6,1,1,108030,91970
4:1:1,0,-1,108031,91969
2:5:2,2,2,108029,91971
5:2:1,1,1,108028,91972
5:5:5,0,-1,108029,91971
6:1:1,0,-1,108030,91970
1:2:5,1,1,108029,91971
5:2:3,1,1,108028,91972
4:1:5,0,-1,108029,91971
1:6:4,0,-1,108030,91970
5:5:5,0,-1,108031,91969
2:4:3,1,1,108030,91970
5:1:3,0,-1,108031,91969
6:5:3,0,-1,108032,91968
5:6:4,0,-1,108033,91967
2:3:2,2,2,108031,91969
2:6:2,2,2,108029,91971
4:2:3,1,1,108028,91972
2:6:1,1,1,108027,91973
3:1:4,0,-1,108028,91972
2:5:3,1,1,108027,91973
6:4:5,0,-1,108028,91972
5:6:1,0,-1,108029,91971
5:3:5,0,-1,108030,91970
4:5:6,0,-1,108031,91969
5:6:5,0,-1,108032,91968
5:2:3,1,1,108031,91969
2:1:5,1,1,108030,91970
6:1:5,0,-1,108031,91969
2:2:1,2,2,108029,91971
3:6:3,0,-1,108030,91970
6:3:2,1,1,108029,91971
5:4:1,0,-1,108030,91970
1:6:3,0,-1,108031,91969
4:4:6,0,-1,108032,91968
2:6:1,1,1,108031,91969
3:4:5,0,-1,108032,91968
1:3:6,0,-1,108033,91967
1:6:3,0,-1,108034,91966
4:5:2,1,1,108033,91967
4:5:5,0,-1,108034,91966
5:1:5,0,-1,108035,91965
3:6:1,0,-1,108036,91964
5:4:4,0,-1,108037,91963
1:6:3,0,-1,108038,91962
5:3:4,0,-1,108039,91961
2:3:1,1,1,108038,91962
4:2:2,2,2,108036,91964
4:2:3,1,1,108035,91965
2:1:2,2,2,108033,91967
6:4:3,0,-1,108034,91966
1:1:2,1,1,108033,91967
4:2:2,2,2,108031,91969
6:4:5,0,-1,108032,91968
4:5:2,1,1,108031,91969
1:6:6,0,-1,108032,91968
4:1:4,0,-1,108033,91967
3:1:6,0,-1,108034,91966
6:1:4,0,-1,108035,91965
1:2:1,1,1,108034,91966
1:4:4,0,-1,108035,91965
4:6:5,0,-1,108036,91964
3:5:5,0,-1,108037,91963
2:4:6,1,1,108036,91964
3:6:2,1,1,108035,91965
6:3:5,0,-1,108036,91964
2:6:4,1,1,108035,91965
2:1:3,1,1,108034,91966
2:3:1,1,1,108033,91967
6:6:4,0,-1,108034,91966
3:1:4,0,-1,108035,91965
1:5:2,1,1,108034,91966
2:3:4,1,1,108033,91967
5:1:6,0,-1,108034,91966
2:1:3,1,1,108033,91967
2:4:2,2,2,108031,91969
3:3:4,0,-1,108032,91968
5:6:6,0,-1,108033,91967
4:2:5,1,1,108032,91968
6:5:5,0,-1,108033,91967
4:1:1,0,-1,108034,91966
6:6:2,1,1,108033,91967
2:2:2,3,3,108030,91970
2:2:4,2,2,108028,91972
2:3:5,1,1,108027,91973
4:4:2,1,1,108026,91974
1:4:2,1,1,108025,91975
6:2:1,1,1,108024,91976
3:2:3,1,1,108023,91977
4:4:4,0,-1,108024,91976
4:3:2,1,1,108023,91977
4:4:4,0,-1,108024,91976
5:1:3,0,-1,108025,91975
5:4:2,1,1,108024,91976
3:1:1,0,-1,108025,91975
5:5:6,0,-1,108026,91974
4:3:6,0,-1,108027,91973
3:5:1,0,-1,108028,91972
3:2:3,1,1,108027,91973
3:6:5,0,-1,108028,91972
6:6:6,0,-1,108029,91971
3:3:3,0,-1,108030,91970
1:2:4,1,1,108029,91971
5:4:3,0,-1,108030,91970
4:2:6,1,1,108029,91971
1:4:5,0,-1,108030,91970
1:6:2,1,1,108029,91971
5:5:5,0,-1,108030,91970
4:6:4,0,-1,108031,91969
5:6:1,0,-1,108032,91968
6:5:5,0,-1,108033,91967
4:2:6,1,1,108032,91968
2:2:5,2,2,108030,91970
1:6:3,0,-1,108031,91969
3:4:2,1,1,108030,91970
2:3:6,1,1,108029,91971
5:1:3,0,-1,108030,91970
2:5:1,1,1,108029,91971
1:5:4,0,-1,108030,91970
6:3:3,0,-1,108031,91969
6:6:2,1,1,108030,91970
4:1:4,0,-1,108031,91969
5:6:6,0,-1,108032,91968
2:1:3,1,1,108031,91969
6:5:5,0,-1,108032,91968
4:2:4,1,1,108031,91969
5:3:5,0,-1,108032,91968
1:4:3,0,-1,108033,91967
6:3:5,0,-1,108034,91966
3:3:3,0,-1,108035,91965
5:4:6,0,-1,108036,91964
2:3:2,2,2,108034,91966
3:5:2,1,1,108033,91967
2:1:1,1,1,108032,91968
1:2:3,1,1,108031,91969
1:5:3,0,-1,108032,91968
5:1:5,0,-1,108033,91967
4:6:2,1,1,108032,91968
1:5:2,1,1,108031,91969
3:5:5,0,-1,108032,91968
6:3:6,0,-1,108033,91967
3:2:1,1,1,108032,91968
5:3:3,0,-1,108033,91967
2:1:6,1,1,108032,91968
6:3:1,0,-1,108033,91967
3:4:1,0,-1,108034,91966
4:6:1,0,-1,108035,91965
1:4:5,0,-1,108036,91964
3:5:4,0,-1,108037,91963
5:4:1,0,-1,108038,91962
1:3:4,0,-1,108039,91961
2:1:4,1,1,108038,91962
3:5:6,0,-1,108039,91961
2:1:1,1,1,108038,91962
4:4:5,0,-1,108039,91961
4:2:2,2,2,108037,91963
2:4:2,2,2,108035,91965
4:4:6,0,-1,108036,91964
2:5:3,1,1,108035,91965
6:2:4,1,1,108034,91966
6:6:5,0,-1,108035,91965
5:4:6,0,-1,108036,91964
1:6:5,0,-1,108037,91963
4:6:5,0,-1,108038,91962
6:5:3,0,-1,108039,91961
4:5:2,1,1,108038,91962
6:1:3,0,-1,108039,91961
3:2:3,1,1,108038,91962
4:6:2,1,1,108037,91963
3:3:1,0,-1,108038,91962
5:1:4,0,-1,108039,91961
5:2:2,2,2,108037,91963
4:4:2,1,1,108036,91964
3:3:1,0,-1,108037,91963
6:3:6,0,-1,108038,91962
2:3:2,2,2,108036,91964
3:5:1,0,-1,108037,91963
2:5:3,1,1,108036,91964
1:2:4,1,1,108035,91965
1:3:6,0,-1,108036,91964
6:6:3,0,-1,108037,91963
5:4:1,0,-1,108038,91962
1:2:4,1,1,108037,91963
2:5:2,2,2,108035,91965
6:6:4,0,-1,108036,91964
5:1:2,1,1,108035,91965
4:5:4,0,-1,108036,91964
2:1:2,2,2,108034,91966
5:5:6,0,-1,108035,91965
6:3:2,1,1,108034,91966
6:3:1,0,-1,108035,91965
2:3:3,1,1,108034,91966
3:2:1,1,1,108033,91967
1:1:1,0,-1,108034,91966
3:2:4,1,1,108033,91967
5:6:6,0,-1,108034,91966
2:4:4,1,1,108033,91967
1:5:3,0,-1,108034,91966
6:1:6,0,-1,108035,91965
2:1:3,1,1,108034,91966
1:1:4,0,-1,108035,91965
4:3:5,0,-1,108036,91964
2:2:5,2,2,108034,91966
4:6:6,0,-1,108035,91965
2:1:3,1,1,108034,91966
3:1:1,0,-1,108035,91965
6:4:4,0,-1,108036,91964
3:1:5,0,-1,108037,91963
6:1:2,1,1,108036,91964
3:1:5,0,-1,108037,91963
4:5:3,0,-1,108038,91962
5:6:3,0,-1,108039,91961
5:5:3,0,-1,108040,91960
6:3:3,0,-1,108041,91959
3:6:5,0,-1,108042,91958
2:4:3,1,1,108041,91959
2:3:4,1,1,108040,91960
3:3:5,0,-1,108041,91959
4:3:3,0,-1,108042,91958
1:2:3,1,1,108041,91959
6:1:6,0,-1,108042,91958
5:5:4,0,-1,108043,91957
5:5:3,0,-1,108044,91956
6:4:1,0,-1,108045,91955
3:2:4,1,1,108044,91956
4:5:5,0,-1,108045,91955
2:3:4,1,1,108044,91956
2:2:3,2,2,108042,91958
1:5:4,0,-1,108043,91957
5:6:3,0,-1,108044,91956
2:5:3,1,1,108043,91957
1:3:3,0,-1,108044,91956
2:6:2,2,2,108042,91958
3:5:2,1,1,108041,91959
1:3:4,0,-1,108042,91958
2:3:4,1,1,108041,91959
5:5:6,0,-1,108042,91958
6:4:2,1,1,108041,91959
2:1:1,1,1,108040,91960
3:3:2,1,1,108039,91961
1:5:6,0,-1,108040,91960
1:6:1,0,-1,108041,91959
5:3:1,0,-1,108042,91958
1:2:6,1,1,108041,91959
5:1:6,0,-1,108042,91958
3:1:2,1,1,108041,91959
3:5:2,1,1,108040,91960
4:1:3,0,-1,108041,91959
1:5:6,0,-1,108042,91958
5:1:6,0,-1,108043,91957
5:1:6,0,-1,108044,91956
3:3:6,0,-1,108045,91955
5:4:4,0,-1,108046,91954
5:1:1,0,-1,108047,91953
5:5:2,1,1,108046,91954
1:3:4,0,-1,108047,91953
2:1:6,1,1,108046,91954
1:3:6,0,-1,108047,91953
3:3:2,1,1,108046,91954
4:3:1,0,-1,108047,91953
5:5:3,0,-1,108048,91952
5:1:4,0,-1,108049,91951
4:3:5,0,-1,108050,91950
4:6:4,0,-1,108051,91949
6:6:2,1,1,108050,91950
4:6:5,0,-1,108051,91949
4:4:2,1,1,108050,91950
4:6:3,0,-1,108051,91949
5:5:4,0,-1,108052,91948
1:4:4,0,-1,108053,91947
4:3:6,0,-1,108054,91946
4:2:2,2,2,108052,91948
4:3:3,0,-1,108053,91947
2:4:1,1,1,108052,91948
3:5:1,0,-1,108053,91947
1:4:5,0,-1,108054,91946
3:2:3,1,1,108053,91947
5:5:3,0,-1,108054,91946
3:1:6,0,-1,108055,91945
6:4:4,0,-1,108056,91944
1:1:6,0,-1,108057,91943
3:6:2,1,1,108056,91944
3:2:5,1,1,108055,91945
3:1:1,0,-1,108056,91944
1:5:3,0,-1,108057,91943
5:3:6,0,-1,108058,91942
4:5:1,0,-1,108059,91941
2:4:1,1,1,108058,91942
3:5:2,1,1,108057,91943
1:5:3,0,-1,108058,91942
1:4:2,1,1,108057,91943
6:1:5,0,-1,108058,91942
4:6:2,1,1,108057,91943
1:2:2,2,2,108055,91945
5:1:1,0,-1,108056,91944
1:3:6,0,-1,108057,91943
4:3:5,0,-1,108058,91942
3:3:3,0,-1,108059,91941
5:2:1,1,1,108058,91942
3:4:4,0,-1,108059,91941
1:6:6,0,-1,108060,91940
4:6:6,0,-1,108061,91939
2:4:2,2,2,108059,91941
2:2:5,2,2,108057,91943
2:2:3,2,2,108055,91945
6:1:4,0,-1,108056,91944
4:3:6,0,-1,108057,91943
5:5:6,0,-1,108058,91942
5:3:1,0,-1,108059,91941
2:1:1,1,1,108058,91942
4:1:1,0,-1,108059,91941
2:5:5,1,1,108058,91942
5:6:4,0,-1,108059,91941
1:5:5,0,-1,108060,91940
2:5:5,1,1,108059,91941
6:3:3,0,-1,108060,91940
6:3:5,0,-1,108061,91939
5:1:3,0,-1,108062,91938
6:6:6,0,-1,108063,91937
3:5:2,1,1,108062,91938
5:4:1,0,-1,108063,91937
2:3:1,1,1,108062,91938
5:6:4,0,-1,108063,91937
2:6:2,2,2,108061,91939
5:1:1,0,-1,108062,91938
4:5:5,0,-1,108063,91937
4:6:5,0,-1,108064,91936
1:6:5,0,-1,108065,91935
2:2:1,2,2,108063,91937
6:3:1,0,-1,108064,91936
6:5:1,0,-1,108065,91935
3:6:1,0,-1,108066,91934
3:2:1,1,1,108065,91935
6:2:1,1,1,108064,91936
4:1:2,1,1,108063,91937
2:1:5,1,1,108062,91938
3:2:4,1,1,108061,91939
4:4:3,0,-1,108062,91938
5:3:2,1,1,108061,91939
3:1:2,1,1,108060,91940
6:1:3,0,-1,108061,91939
1:1:5,0,-1,108062,91938
6:2:3,1,1,108061,91939
5:6:5,0,-1,108062,91938
6:1:4,0,-1,108063,91937
2:6:3,1,1,108062,91938
1:5:6,0,-1,108063,91937
1:6:5,0,-1,108064,91936
1:3:6,0,-1,108065,91935
2:2:2,3,3,108062,91938
4:4:3,0,-1,108063,91937
6:1:5,0,-1,108064,91936
1:3:2,1,1,108063,91937
6:6:5,0,-1,108064,91936
2:4:3,1,1,108063,91937
3:3:2,1,1,108062,91938
6:2:5,1,1,108061,91939
5:4:2,1,1,108060,91940
6:6:4,0,-1,108061,91939
2:5:3,1,1,108060,91940
6:1:6,0,-1,108061,91939
5:5:4,0,-1,108062,91938
6:6:3,0,-1,108063,91937
5:1:6,0,-1,108064,91936
5:2:1,1,1,108063,91937
2:6:4,1,1,108062,91938
5:6:3,0,-1,108063,91937
5:1:4,0,-1,108064,91936
2:3:6,1,1,108063,91937
2:4:6,1,1,108062,91938
4:3:5,0,-1,108063,91937
4:4:5,0,-1,108064,91936
3:1:3,0,-1,108065,91935
5:6:2,1,1,108064,91936
6:1:4,0,-1,108065,91935
6:2:3,1,1,108064,91936
1:6:2,1,1,108063,91937
1:2:3,1,1,108062,91938
6:3:2,1,1,108061,91939
6:1:1,0,-1,108062,91938
1:6:3,0,-1,108063,91937
3:5:4,0,-1,108064,91936
4:1:4,0,-1,108065,91935
3:6:5,0,-1,108066,91934
5:1:6,0,-1,108067,91933
2:2:3,2,2,108065,91935
1:6:4,0,-1,108066,91934
3:5:1,0,-1,108067,91933
2:5:4,1,1,108066,91934
6:2:6,1,1,108065,91935
3:5:5,0,-1,108066,91934
6:3:1,0,-1,108067,91933
1:1:3,0,-1,108068,91932
5:6:3,0,-1,108069,91931
1:1:3,0,-1,108070,91930
3:2:1,1,1,108069,91931
5:4:1,0,-1,108070,91930
4:1:2,1,1,108069,91931
3:3:4,0,-1,108070,91930
1:1:1,0,-1,108071,91929
3:6:6,0,-1,108072,91928
1:3:4,0,-1,108073,91927
4:2:2,2,2,108071,91929
6:1:4,0,-1,108072,91928
1:6:6,0,-1,108073,91927
5:2:3,1,1,108072,91928
5:1:4,0,-1,108073,91927
5:5:2,1,1,108072,91928
4:5:4,0,-1,108073,91927
4:6:2,1,1,108072,91928
5:6:4,0,-1,108073,91927
4:3:2,1,1,108072,91928
3:5:4,0,-1,108073,91927
2:5:6,1,1,108072,91928
6:2:6,1,1,108071,91929
3:1:4,0,-1,108072,91928
6:1:2,1,1,108071,91929
6:1:4,0,-1,108072,91928
6:6:6,0,-1,108073,91927
1:4:4,0,-1,108074,91926
5:3:5,0,-1,108075,91925
5:4:2,1,1,108074,91926
1:4:5,0,-1,108075,91925
5:4:2,1,1,108074,91926
1:6:2,1,1,108073,91927
4:4:4,0,-1,108074,91926
6:5:2,1,1,108073,91927
2:5:4,1,1,108072,91928
5:5:2,1,1,108071,91929
6:5:4,0,-1,108072,91928
5:4:4,0,-1,108073,91927
5:3:5,0,-1,108074,91926
4:3:3,0,-1,108075,91925
3:3:5,0,-1,108076,91924
2:3:2,2,2,108074,91926
1:2:1,1,1,108073,91927
4:2:5,1,1,108072,91928
6:2:6,1,1,108071,91929
6:1:1,0,-1,108072,91928
6:3:1,0,-1,108073,91927
2:3:2,2,2,108071,91929
4:4:5,0,-1,108072,91928
2:5:4,1,1,108071,91929
4:4:6,0,-1,108072,91928
6:5:5,0,-1,108073,91927
1:1:2,1,1,108072,91928
2:1:6,1,1,108071,91929
1:4:4,0,-1,108072,91928
3:6:3,0,-1,108073,91927
5:3:4,0,-1,108074,91926
3:4:3,0,-1,108075,91925
5:1:2,1,1,108074,91926
5:5:1,0,-1,108075,91925
2:3:6,1,1,108074,91926
2:2:5,2,2,108072,91928
5:6:1,0,-1,108073,91927
3:4:4,0,-1,108074,91926
1:2:1,1,1,108073,91927
4:2:2,2,2,108071,91929
4:1:3,0,-1,108072,91928
6:4:1,0,-1,108073,91927
6:4:4,0,-1,108074,91926
4:4:5,0,-1,108075,91925
2:6:5,1,1,108074,91926
1:2:1,1,1,108073,91927
4:5:2,1,1,108072,91928
3:3:5,0,-1,108073,91927
4:4:6,0,-1,108074,91926
3:3:4,0,-1,108075,91925
5:6:5,0,-1,108076,91924
6:2:3,1,1,108075,91925
5:4:2,1,1,108074,91926
6:1:5,0,-1,108075,91925
4:1:6,0,-1,108076,91924
6:5:2,1,1,108075,91925
6:3:6,0,-1,108076,91924
5:6:6,0,-1,108077,91923
3:5:1,0,-1,108078,91922
1:2:3,1,1,108077,91923
6:4:5,0,-1,108078,91922
1:4:5,0,-1,108079,91921
3:5:3,0,-1,108080,91920
6:6:2,1,1,108079,91921
2:5:2,2,2,108077,91923
3:6:6,0,-1,108078,91922
5:3:2,1,1,108077,91923
6:2:1,1,1,108076,91924
1:4:5,0,-1,108077,91923
2:4:2,2,2,108075,91925
1:1:5,0,-1,108076,91924
4:3:1,0,-1,108077,91923
5:3:2,1,1,108076,91924
1:6:4,0,-1,108077,91923
6:6:1,0,-1,108078,91922
5:1:2,1,1,108077,91923
6:5:1,0,-1,108078,91922
4:4:6,0,-1,108079,91921
2:3:5,1,1,108078,91922
6:1:6,0,-1,108079,91921
3:3:4,0,-1,108080,91920
5:4:1,0,-1,108081,91919
6:6:4,0,-1,108082,91918
2:6:2,2,2,108080,91920
6:6:2,1,1,108079,91921
3:2:2,2,2,108077,91923
2:4:2,2,2,108075,91925
2:6:1,1,1,108074,91926
2:3:5,1,1,108073,91927
3:4:4,0,-1,108074,91926
4:1:5,0,-1,108075,91925
4:3:1,0,-1,108076,91924
5:2:4,1,1,108075,91925
2:4:1,1,1,108074,91926
4:3:3,0,-1,108075,91925
6:1:3,0,-1,108076,91924
6:6:5,0,-1,108077,91923
2:3:4,1,1,108076,91924
4:2:3,1,1,108075,91925
6:1:5,0,-1,108076,91924
4:6:3,0,-1,108077,91923
6:4:4,0,-1,108078,91922
6:3:6,0,-1,108079,91921
2:2:2,3,3,108076,91924
1:6:4,0,-1,108077,91923
3:5:3,0,-1,108078,91922
4:5:2,1,1,108077,91923
2:4:4,1,1,108076,91924
1:4:6,0,-1,108077,91923
2:2:1,2,2,108075,91925
2:1:3,1,1,108074,91926
4:1:2,1,1,108073,91927
5:2:1,1,1,108072,91928
3:4:6,0,-1,108073,91927
1:6:5,0,-1,108074,91926
6:2:4,1,1,108073,91927
5:3:4,0,-1,108074,91926
4:6:2,1,1,108073,91927
2:1:3,1,1,108072,91928
5:1:6,0,-1,108073,91927
6:1:1,0,-1,108074,91926
1:5:6,0,-1,108075,91925
4:3:5,0,-1,108076,91924
1:5:1,0,-1,108077,91923
3:6:1,0,-1,108078,91922
1:2:6,1,1,108077,91923
1:3:3,0,-1,108078,91922
4:6:4,0,-1,108079,91921
1:6:6,0,-1,108080,91920
5:5:4,0,-1,108081,91919
5:4:5,0,-1,108082,91918
5:3:2,1,1,108081,91919
4:2:1,1,1,108080,91920
4:6:4,0,-1,108081,91919
4:1:4,0,-1,108082,91918
6:5:2,1,1,108081,91919
5:1:4,0,-1,108082,91918
4:1:3,0,-1,108083,91917
5:6:1,0,-1,108084,91916
5:6:2,1,1,108083,91917
2:6:5,1,1,108082,91918
4:1:2,1,1,108081,91919
5:3:3,0,-1,108082,91918
5:5:6,0,-1,108083,91917
4:3:1,0,-1,108084,91916
4:3:1,0,-1,108085,91915
1:5:4,0,-1,108086,91914
2:6:4,1,1,108085,91915
2:2:6,2,2,108083,91917
6:5:5,0,-1,108084,91916
3:3:3,0,-1,108085,91915
5:4:2,1,1,108084,91916
2:2:5,2,2,108082,91918
1:2:2,2,2,108080,91920
4:2:5,1,1,108079,91921
5:5:1,0,-1,108080,91920
4:2:1,1,1,108079,91921
2:1:1,1,1,108078,91922
3:6:4,0,-1,108079,91921
5:1:4,0,-1,108080,91920
6:1:2,1,1,108079,91921
2:5:6,1,1,108078,91922
3:3:1,0,-1,108079,91921
6:2:3,1,1,108078,91922
1:3:2,1,1,108077,91923
3:4:4,0,-1,108078,91922
6:5:3,0,-1,108079,91921
3:5:4,0,-1,108080,91920
1:6:2,1,1,108079,91921
1:2:4,1,1,108078,91922
5:1:6,0,-1,108079,91921
3:3:6,0,-1,108080,91920
6:6:4,0,-1,108081,91919
6:2:6,1,1,108080,91920
1:3:4,0,-1,108081,91919
3:4:1,0,-1,108082,91918
1:2:3,1,1,108081,91919
2:6:3,1,1,108080,91920
4:1:2,1,1,108079,91921
3:5:4,0,-1,108080,91920
6:4:2,1,1,108079,91921
2:1:4,1,1,108078,91922
1:2:3,1,1,108077,91923
5:3:4,0,-1,108078,91922
2:1:6,1,1,108077,91923
6:6:5,0,-1,108078,91922
1:5:1,0,-1,108079,91921
2:5:4,1,1,108078,91922
6:1:5,0,-1,108079,91921
2:5:2,2,2,108077,91923
4:4:1,0,-1,108078,91922
6:5:6,0,-1,108079,91921
2:6:3,1,1,108078,91922
6:2:5,1,1,108077,91923
6:1:1,0,-1,108078,91922
1:2:3,1,1,108077,91923
1:3:3,0,-1,108078,91922
1:4:2,1,1,108077,91923
3:1:3,0,-1,108078,91922
2:5:1,1,1,108077,91923
5:6:5,0,-1,108078,91922
1:2:5,1,1,108077,91923
3:3:4,0,-1,108078,91922
2:1:1,1,1,108077,91923
2:2:5,2,2,108075,91925
1:3:3,0,-1,108076,91924
2:5:1,1,1,108075,91925
6:6:3,0,-1,108076,91924
2:4:6,1,1,108075,91925
3:3:5,0,-1,108076,91924
1:6:5,0,-1,108077,91923
3:4:1,0,-1,108078,91922
3:5:1,0,-1,108079,91921
2:3:3,1,1,108078,91922
1:5:1,0,-1,108079,91921
3:1:3,0,-1,108080,91920
6:1:4,0,-1,108081,91919
5:1:1,0,-1,108082,91918
5:3:1,0,-1,108083,91917
1:3:4,0,-1,108084,91916
4:2:6,1,1,108083,91917
3:6:6,0,-1,108084,91916
5:3:3,0,-1,108085,91915
4:5:5,0,-1,108086,91914
1:1:2,1,1,108085,91915
4:2:6,1,1,108084,91916
6:4:2,1,1,108083,91917
2:1:5,1,1,108082,91918
4:4:1,0,-1,108083,91917
4:4:6,0,-1,108084,91916
5:4:3,0,-1,108085,91915
4:2:3,1,1,108084,91916
5:3:4,0,-1,108085,91915
4:1:2,1,1,108084,91916
4:1:3,0,-1,108085,91915
5:1:6,0,-1,108086,91914
5:6:5,0,-1,108087,91913
5:3:3,0,-1,108088,91912
4:1:6,0,-1,108089,91911
5:1:1,0,-1,108090,91910
6:6:1,0,-1,108091,91909
1:3:4,0,-1,108092,91908
5:2:6,1,1,108091,91909
2:6:3,1,1,108090,91910
5:2:3,1,1,108089,91911
1:6:1,0,-1,108090,91910
2:1:6,1,1,108089,91911
3:5:2,1,1,108088,91912
5:5:5,0,-1,108089,91911
4:3:4,0,-1,108090,91910
2:1:3,1,1,108089,91911
4:6:6,0,-1,108090,91910
1:3:6,0,-1,108091,91909
4:4:2,1,1,108090,91910
5:1:4,0,-1,108091,91909
3:3:1,0,-1,108092,91908
2:5:6,1,1,108091,91909
5:4:4,0,-1,108092,91908
3:2:3,1,1,108091,91909
4:3:3,0,-1,108092,91908
4:4:5,0,-1,108093,91907
5:5:4,0,-1,108094,91906
3:3:4,0,-1,108095,91905
5:2:6,1,1,108094,91906
1:6:3,0,-1,108095,91905
2:6:5,1,1,108094,91906
5:5:3,0,-1,108095,91905
2:3:3,1,1,108094,91906
3:5:2,1,1,108093,91907
6:2:5,1,1,108092,91908
5:5:1,0,-1,108093,91907
6:2:5,1,1,108092,91908
2:1:4,1,1,108091,91909
5:2:2,2,2,108089,91911
1:1:1,0,-1,108090,91910
6:4:6,0,-1,108091,91909
4:1:4,0,-1,108092,91908
5:4:4,0,-1,108093,91907
5:5:4,0,-1,108094,91906
2:2:2,3,3,108091,91909
1:6:4,0,-1,108092,91908
2:4:3,1,1,108091,91909
3:5:1,0,-1,108092,91908
5:5:5,0,-1,108093,91907
3:2:4,1,1,108092,91908
6:1:1,0,-1,108093,91907
4:4:4,0,-1,108094,91906
6:1:6,0,-1,108095,91905
6:5:5,0,-1,108096,91904
4:3:3,0,-1,108097,91903
2:5:2,2,2,108095,91905
1:2:5,1,1,108094,91906
5:2:5,1,1,108093,91907
4:4:5,0,-1,108094,91906
1:1:2,1,1,108093,91907
1:2:6,1,1,108092,91908
1:4:5,0,-1,108093,91907
2:4:6,1,1,108092,91908
3:4:6,0,-1,108093,91907
2:4:4,1,1,108092,91908
3:3:4,0,-1,108093,91907
2:1:1,1,1,108092,91908
2:3:2,2,2,108090,91910
3:2:6,1,1,108089,91911
1:3:1,0,-1,108090,91910
5:3:2,1,1,108089,91911
4:4:6,0,-1,108090,91910
5:6:4,0,-1,108091,91909
6:6:1,0,-1,108092,91908
6:1:5,0,-1,108093,91907
5:2:1,1,1,108092,91908
3:1:1,0,-1,108093,91907
2:5:3,1,1,108092,91908
6:5:3,0,-1,108093,91907
5:5:2,1,1,108092,91908
4:2:1,1,1,108091,91909
5:1:5,0,-1,108092,91908
6:1:1,0,-1,108093,91907
6:2:4,1,1,108092,91908
4:4:3,0,-1,108093,91907
1:4:3,0,-1,108094,91906
3:4:6,0,-1,108095,91905
1:2:5,1,1,108094,91906
3:5:3,0,-1,108095,91905
5:3:3,0,-1,108096,91904
5:1:1,0,-1,108097,91903
3:6:4,0,-1,108098,91902
6:2:5,1,1,108097,91903
6:6:5,0,-1,108098,91902
1:3:6,0,-1,108099,91901
2:6:2,2,2,108097,91903
6:4:4,0,-1,108098,91902
4:5:6,0,-1,108099,91901
1:6:5,0,-1,108100,91900
2:2:3,2,2,108098,91902
1:4:3,0,-1,108099,91901
5:5:6,0,-1,108100,91900
6:3:5,0,-1,108101,91899
6:2:3,1,1,108100,91900
2:5:4,1,1,108099,91901
5:2:2,2,2,108097,91903
1:5:1,0,-1,108098,91902
6:1:5,0,-1,108099,91901
5:1:5,0,-1,108100,91900
2:1:2,2,2,108098,91902
1:4:1,0,-1,108099,91901
6:6:2,1,1,108098,91902
5:6:4,0,-1,108099,91901
1:5:2,1,1,108098,91902
3:5:4,0,-1,108099,91901
2:6:4,1,1,108098,91902
6:3:1,0,-1,108099,91901
3:2:4,1,1,108098,91902
2:5:3,1,1,108097,91903
5:6:4,0,-1,108098,91902
6:6:4,0,-1,108099,91901
4:1:3,0,-1,108100,91900
1:3:1,0,-1,108101,91899
6:6:4,0,-1,108102,91898
3:5:2,1,1,108101,91899
1:2:1,1,1,108100,91900
3:6:5,0,-1,108101,91899
1:4:4,0,-1,108102,91898
1:1:4,0,-1,108103,91897
6:6:6,0,-1,108104,91896
1:3:3,0,-1,108105,91895
5:5:4,0,-1,108106,91894
5:3:3,0,-1,108107,91893
2:4:2,2,2,108105,91895
6:1:3,0,-1,108106,91894
6:3:2,1,1,108105,91895
4:1:1,0,-1,108106,91894
6:4:6,0,-1,108107,91893
6:5:6,0,-1,108108,91892
3:3:6,0,-1,108109,91891
6:3:3,0,-1,108110,91890
6:3:3,0,-1,108111,91889
3:3:4,0,-1,108112,91888
2:1:4,1,1,108111,91889
2:4:6,1,1,108110,91890
3:1:3,0,-1,108111,91889
1:5:4,0,-1,108112,91888
6:3:6,0,-1,108113,91887
1:2:1,1,1,108112,91888
3:6:2,1,1,108111,91889
1:3:5,0,-1,108112,91888
6:2:4,1,1,108111,91889
1:3:1,0,-1,108112,91888
4:6:4,0,-1,108113,91887
3:2:4,1,1,108112,91888
6:3:1,0,-1,108113,91887
6:5:6,0,-1,108114,91886
1:4:2,1,1,108113,91887
1:1:2,1,1,108112,91888
6:5:2,1,1,108111,91889
1:6:2,1,1,108110,91890
6:4:1,0,-1,108111,91889
6:1:1,0,-1,108112,91888
1:3:4,0,-1,108113,91887
2:3:3,1,1,108112,91888
3:2:2,2,2,108110,91890
3:2:4,1,1,108109,91891
2:2:5,2,2,108107,91893
4:3:2,1,1,108106,91894
5:4:3,0,-1,108107,91893
3:6:3,0,-1,108108,91892
4:3:2,1,1,108107,91893
2:3:1,1,1,108106,91894
2:1:3,1,1,108105,91895
4:1:4,0,-1,108106,91894
1:6:5,0,-1,108107,91893
6:1:4,0,-1,108108,91892
5:5:6,0,-1,108109,91891
2:4:5,1,1,108108,91892
1:5:4,0,-1,108109,91891
2:6:3,1,1,108108,91892
5:1:4,0,-1,108109,91891
1:6:3,0,-1,108110,91890
3:3:1,0,-1,108111,91889
6:3:4,0,-1,108112,91888
4:6:3,0,-1,108113,91887
4:4:2,1,1,108112,91888
4:6:1,0,-1,108113,91887
5:6:5,0,-1,108114,91886
5:4:4,0,-1,108115,91885
3:3:5,0,-1,108116,91884
6:5:4,0,-1,108117,91883
2:2:6,2,2,108115,91885
4:5:4,0,-1,108116,91884
3:6:5,0,-1,108117,91883
1:4:3,0,-1,108118,91882
4:1:6,0,-1,108119,91881
4:6:2,1,1,108118,91882
5:6:3,0,-1,108119,91881
1:3:4,0,-1,108120,91880
6:2:5,1,1,108119,91881
3:4:3,0,-1,108120,91880
4:6:6,0,-1,108121,91879
5:6:2,1,1,108120,91880
2:5:5,1,1,108119,91881
4:1:5,0,-1,108120,91880
3:3:5,0,-1,108121,91879
1:1:3,0,-1,108122,91878
4:5:1,0,-1,108123,91877
3:3:4,0,-1,108124,91876
2:1:1,1,1,108123,91877
5:4:3,0,-1,108124,91876
1:2:5,1,1,108123,91877
5:1:3,0,-1,108124,91876
5:3:1,0,-1,108125,91875
5:2:6,1,1,108124,91876
5:4:3,0,-1,108125,91875
5:2:2,2,2,108123,91877
5:1:6,0,-1,108124,91876
1:6:2,1,1,108123,91877
3:6:1,0,-1,108124,91876
2:5:3,1,1,108123,91877
3:5:3,0,-1,108124,91876
5:4:1,0,-1,108125,91875
5:5:4,0,-1,108126,91874
4:5:2,1,1,108125,91875
2:6:3,1,1,108124,91876
4:4:4,0,-1,108125,91875
5:3:6,0,-1,108126,91874
3:2:4,1,1,108125,91875
2:3:1,1,1,108124,91876
5:5:5,0,-1,108125,91875
3:5:3,0,-1,108126,91874
3:5:6,0,-1,108127,91873
1:4:1,0,-1,108128,91872
2:2:1,2,2,108126,91874
5:6:5,0,-1,108127,91873
4:1:2,1,1,108126,91874
4:6:5,0,-1,108127,91873
6:2:3,1,1,108126,91874
3:3:2,1,1,108125,91875
4:1:6,0,-1,108126,91874
4:6:3,0,-1,108127,91873
5:1:5,0,-1,108128,91872
1:1:3,0,-1,108129,91871
4:2:4,1,1,108128,91872
2:3:5,1,1,108127,91873
5:3:4,0,-1,108128,91872
1:1:5,0,-1,108129,91871
5:6:1,0,-1,108130,91870
5:4:3,0,-1,108131,91869
1:3:3,0,-1,108132,91868
2:5:3,1,1,108131,91869
2:6:5,1,1,108130,91870
3:1:5,0,-1,108131,91869
3:1:4,0,-1,108132,91868
2:2:4,2,2,108130,91870
6:2:5,1,1,108129,91871
2:5:4,1,1,108128,91872
2:3:3,1,1,108127,91873
3:2:5,1,1,108126,91874
5:3:4,0,-1,108127,91873
6:3:2,1,1,108126,91874
5:1:3,0,-1,108127,91873
3:1:3,0,-1,108128,91872
1:3:4,0,-1,108129,91871
3:4:1,0,-1,108130,91870
2:6:5,1,1,108129,91871
5:4:6,0,-1,108130,91870
3:4:6,0,-1,108131,91869
2:4:2,2,2,108129,91871
3:2:3,1,1,108128,91872
4:4:2,1,1,108127,91873
1:4:4,0,-1,108128,91872
3:4:3,0,-1,108129,91871
6:6:4,0,-1,108130,91870
2:4:1,1,1,108129,91871
4:3:5,0,-1,108130,91870
6:6:4,0,-1,108131,91869
2:4:2,2,2,108129,91871
4:6:5,0,-1,108130,91870
5:5:2,1,1,108129,91871
3:2:1,1,1,108128,91872
6:1:5,0,-1,108129,91871
5:2:2,2,2,108127,91873
1:2:5,1,1,108126,91874
2:2:4,2,2,108124,91876
3:2:2,2,2,108122,91878
1:5:2,1,1,108121,91879
4:6:2,1,1,108120,91880
2:1:4,1,1,108119,91881
3:1:5,0,-1,108120,91880
4:3:2,1,1,108119,91881
5:5:6,0,-1,108120,91880
6:5:3,0,-1,108121,91879
1:5:3,0,-1,108122,91878
1:6:6,0,-1,108123,91877
4:6:3,0,-1,108124,91876
1:1:5,0,-1,108125,91875
2:1:5,1,1,108124,91876
5:3:1,0,-1,108125,91875
6:3:3,0,-1,108126,91874
5:2:5,1,1,108125,91875
3:4:6,0,-1,108126,91874
2:3:1,1,1,108125,91875
2:1:4,1,1,108124,91876
3:1:5,0,-1,108125,91875
4:5:3,0,-1,108126,91874
6:4:5,0,-1,108127,91873
4:4:6,0,-1,108128,91872
2:5:4,1,1,108127,91873
2:3:3,1,1,108126,91874
3:5:5,0,-1,108127,91873
2:6:6,1,1,108126,91874
2:2:3,2,2,108124,91876
4:1:5,0,-1,108125,91875
6:1:4,0,-1,108126,91874
1:6:6,0,-1,108127,91873
3:6:2,1,1,108126,91874
6:4:1,0,-1,108127,91873
2:2:4,2,2,108125,91875
6:6:2,1,1,108124,91876
5:2:5,1,1,108123,91877
2:3:5,1,1,108122,91878
2:5:5,1,1,108121,91879
1:1:2,1,1,108120,91880
2:4:3,1,1,108119,91881
4:5:5,0,-1,108120,91880
2:5:4,1,1,108119,91881
1:2:5,1,1,108118,91882
6:5:1,0,-1,108119,91881
4:6:4,0,-1,108120,91880
1:4:5,0,-1,108121,91879
1:4:1,0,-1,108122,91878
6:6:1,0,-1,108123,91877
1:4:1,0,-1,108124,91876
2:4:4,1,1,108123,91877
2:4:5,1,1,108122,91878
5:1:2,1,1,108121,91879
3:3:6,0,-1,108122,91878
1:4:3,0,-1,108123,91877
1:1:2,1,1,108122,91878
1:4:2,1,1,108121,91879
3:6:6,0,-1,108122,91878
3:2:1,1,1,108121,91879
6:6:2,1,1,108120,91880
5:2:2,2,2,108118,91882
4:2:6,1,1,108117,91883
6:4:2,1,1,108116,91884
5:2:6,1,1,108115,91885
5:2:6,1,1,108114,91886
5:4:2,1,1,108113,91887
4:1:5,0,-1,108114,91886
3:4:1,0,-1,108115,91885
6:6:4,0,-1,108116,91884
3:5:4,0,-1,108117,91883
6:6:5,0,-1,108118,91882
2:6:4,1,1,108117,91883
3:3:5,0,-1,108118,91882
6:3:2,1,1,108117,91883
3:2:5,1,1,108116,91884
1:6:6,0,-1,108117,91883
2:6:6,1,1,108116,91884
4:1:1,0,-1,108117,91883
5:5:1,0,-1,108118,91882
5:5:2,1,1,108117,91883
3:3:5,0,-1,108118,91882
4:1:5,0,-1,108119,91881
1:2:3,1,1,108118,91882
3:3:6,0,-1,108119,91881
2:2:3,2,2,108117,91883
4:4:3,0,-1,108118,91882
2:3:2,2,2,108116,91884
4:2:5,1,1,108115,91885
3:2:3,1,1,108114,91886
5:1:1,0,-1,108115,91885
5:5:2,1,1,108114,91886
3:3:5,0,-1,108115,91885
4:1:4,0,-1,108116,91884
4:5:4,0,-1,108117,91883
3:5:2,1,1,108116,91884
2:5:1,1,1,108115,91885
3:3:3,0,-1,108116,91884
5:2:5,1,1,108115,91885
5:6:5,0,-1,108116,91884
5:5:3,0,-1,108117,91883
6:4:3,0,-1,108118,91882
2:1:4,1,1,108117,91883
1:6:5,0,-1,108118,91882
6:6:5,0,-1,108119,91881
2:4:6,1,1,108118,91882
5:6:2,1,1,108117,91883
4:1:6,0,-1,108118,91882
4:4:4,0,-1,108119,91881
3:5:3,0,-1,108120,91880
5:6:1,0,-1,108121,91879
3:1:2,1,1,108120,91880
3:3:1,0,-1,108121,91879
4:1:6,0,-1,108122,91878
6:6:2,1,1,108121,91879
3:1:6,0,-1,108122,91878
3:3:4,0,-1,108123,91877
5:5:3,0,-1,108124,91876
6:5:6,0,-1,108125,91875
1:2:5,1,1,108124,91876
5:5:5,0,-1,108125,91875
3:1:1,0,-1,108126,91874
5:4:3,0,-1,108127,91873
2:2:3,2,2,108125,91875
1:6:3,0,-1,108126,91874
5:5:5,0,-1,108127,91873
6:1:1,0,-1,108128,91872
3:3:2,1,1,108127,91873
5:6:5,0,-1,108128,91872
4:6:3,0,-1,108129,91871
5:1:2,1,1,108128,91872
1:5:4,0,-1,108129,91871
6:5:5,0,-1,108130,91870
4:4:4,0,-1,108131,91869
1:4:4,0,-1,108132,91868
4:3:4,0,-1,108133,91867
4:6:1,0,-1,108134,91866
5:2:6,1,1,108133,91867
4:1:4,0,-1,108134,91866
2:3:2,2,2,108132,91868
4:6:1,0,-1,108133,91867
1:6:1,0,-1,108134,91866
4:1:6,0,-1,108135,91865
4:2:1,1,1,108134,91866
4:5:2,1,1,108133,91867
2:1:3,1,1,108132,91868
6:2:6,1,1,108131,91869
4:6:2,1,1,108130,91870
1:3:6,0,-1,108131,91869
5:6:5,0,-1,108132,91868
4:2:6,1,1,108131,91869
4:4:5,0,-1,108132,91868
3:5:6,0,-1,108133,91867
5:2:3,1,1,108132,91868
1:2:6,1,1,108131,91869
2:5:5,1,1,108130,91870
1:3:5,0,-1,108131,91869
6:1:3,0,-1,108132,91868
6:2:4,1,1,108131,91869
2:2:2,3,3,108128,91872
4:1:2,1,1,108127,91873
2:3:5,1,1,108126,91874
3:3:4,0,-1,108127,91873
3:4:4,0,-1,108128,91872
5:3:4,0,-1,108129,91871
3:6:4,0,-1,108130,91870
6:5:6,0,-1,108131,91869
2:2:2,3,3,108128,91872
6:2:3,1,1,108127,91873
4:4:5,0,-1,108128,91872
5:2:4,1,1,108127,91873
4:3:5,0,-1,108128,91872
2:2:3,2,2,108126,91874
6:2:2,2,2,108124,91876
5:5:3,0,-1,108125,91875
3:2:6,1,1,108124,91876
2:1:4,1,1,108123,91877
4:2:5,1,1,108122,91878
5:4:6,0,-1,108123,91877
6:6:2,1,1,108122,91878
3:2:3,1,1,108121,91879
1:3:3,0,-1,108122,91878
1:2:5,1,1,108121,91879
3:6:4,0,-1,108122,91878
3:5:2,1,1,108121,91879
6:1:1,0,-1,108122,91878
2:5:1,1,1,108121,91879
2:5:4,1,1,108120,91880
4:6:2,1,1,108119,91881
5:4:3,0,-1,108120,91880
3:5:3,0,-1,108121,91879
3:6:2,1,1,108120,91880
3:3:3,0,-1,108121,91879
2:2:6,2,2,108119,91881
6:6:2,1,1,108118,91882
5:5:3,0,-1,108119,91881
2:2:6,2,2,108117,91883
4:4:1,0,-1,108118,91882
1:4:4,0,-1,108119,91881
5:4:5,0,-1,108120,91880
5:6:2,1,1,108119,91881
4:5:6,0,-1,108120,91880
4:1:4,0,-1,108121,91879
2:1:1,1,1,108120,91880
3:2:2,2,2,108118,91882
1:6:5,0,-1,108119,91881
6:6:2,1,1,108118,91882
4:3:5,0,-1,108119,91881
4:1:3,0,-1,108120,91880
5:2:4,1,1,108119,91881
1:4:2,1,1,108118,91882
2:5:6,1,1,108117,91883
4:5:5,0,-1,108118,91882
5:2:5,1,1,108117,91883
2:1:1,1,1,108116,91884
1:3:2,1,1,108115,91885
4:1:5,0,-1,108116,91884
6:2:5,1,1,108115,91885
2:5:5,1,1,108114,91886
2:2:4,2,2,108112,91888
3:4:4,0,-1,108113,91887
4:2:1,1,1,108112,91888
5:4:1,0,-1,108113,91887
4:2:4,1,1,108112,91888
2:4:2,2,2,108110,91890
2:3:6,1,1,108109,91891
3:5:3,0,-1,108110,91890
5:2:4,1,1,108109,91891
5:6:6,0,-1,108110,91890
1:5:4,0,-1,108111,91889
5:2:3,1,1,108110,91890
5:5:5,0,-1,108111,91889
6:2:6,1,1,108110,91890
4:5:1,0,-1,108111,91889
1:4:5,0,-1,108112,91888
4:5:4,0,-1,108113,91887
4:2:1,1,1,108112,91888
3:4:4,0,-1,108113,91887
5:3:4,0,-1,108114,91886
6:4:3,0,-1,108115,91885
1:5:5,0,-1,108116,91884
2:3:2,2,2,108114,91886
6:1:5,0,-1,108115,91885
4:2:3,1,1,108114,91886
1:6:4,0,-1,108115,91885
6:5:1,0,-1,108116,91884
1:5:3,0,-1,108117,91883
2:4:2,2,2,108115,91885
6:1:1,0,-1,108116,91884
5:2:6,1,1,108115,91885
4:5:4,0,-1,108116,91884
3:3:2,1,1,108115,91885
3:1:5,0,-1,108116,91884
6:5:6,0,-1,108117,91883
2:4:5,1,1,108116,91884
2:3:1,1,1,108115,91885
4:4:5,0,-1,108116,91884
6:4:6,0,-1,108117,91883
6:3:3,0,-1,108118,91882
4:6:4,0,-1,108119,91881
1:2:2,2,2,108117,91883
2:1:5,1,1,108116,91884
5:3:3,0,-1,108117,91883
4:5:6,0,-1,108118,91882
4:1:2,1,1,108117,91883
6:6:3,0,-1,108118,91882
1:4:5,0,-1,108119,91881
2:6:3,1,1,108118,91882
1:5:1,0,-1,108119,91881
4:5:1,0,-1,108120,91880
3:2:5,1,1,108119,91881
3:5:3,0,-1,108120,91880
5:5:5,0,-1,108121,91879
4:5:1,0,-1,108122,91878
3:5:1,0,-1,108123,91877
3:3:3,0,-1,108124,91876
5:4:4,0,-1,108125,91875
4:2:4,1,1,108124,91876
2:4:6,1,1,108123,91877
1:2:2,2,2,108121,91879
6:2:1,1,1,108120,91880
1:3:1,0,-1,108121,91879
6:5:3,0,-1,108122,91878
1:6:4,0,-1,108123,91877
2:3:2,2,2,108121,91879
3:2:5,1,1,108120,91880
3:1:6,0,-1,108121,91879
6:5:5,0,-1,108122,91878
2:6:5,1,1,108121,91879
6:3:2,1,1,108120,91880
5:4:4,0,-1,108121,91879
1:3:3,0,-1,108122,91878
4:6:5,0,-1,108123,91877
2:6:2,2,2,108121,91879
3:2:1,1,1,108120,91880
6:2:3,1,1,108119,91881
4:5:6,0,-1,108120,91880
5:2:1,1,1,108119,91881
2:1:5,1,1,108118,91882
3:4:6,0,-1,108119,91881
6:1:5,0,-1,108120,91880
6:2:5,1,1,108119,91881
6:6:1,0,-1,108120,91880
2:5:2,2,2,108118,91882
1:5:2,1,1,108117,91883
5:6:4,0,-1,108118,91882
1:5:5,0,-1,108119,91881
4:4:4,0,-1,108120,91880
1:1:5,0,-1,108121,91879
5:6:4,0,-1,108122,91878
1:6:4,0,-1,108123,91877
5:5:5,0,-1,108124,91876
6:1:5,0,-1,108125,91875
5:2:4,1,1,108124,91876
4:4:4,0,-1,108125,91875
6:2:1,1,1,108124,91876
1:6:6,0,-1,108125,91875
1:2:6,1,1,108124,91876
1:6:3,0,-1,108125,91875
5:2:1,1,1,108124,91876
6:1:4,0,-1,108125,91875
1:6:1,0,-1,108126,91874
5:4:6,0,-1,108127,91873
2:4:1,1,1,108126,91874
5:4:1,0,-1,108127,91873
1:4:3,0,-1,108128,91872
1:3:6,0,-1,108129,91871
6:1:6,0,-1,108130,91870
5:6:4,0,-1,108131,91869
3:1:3,0,-1,108132,91868
1:1:6,0,-1,108133,91867
3:4:5,0,-1,108134,91866
5:4:6,0,-1,108135,91865
4:5:3,0,-1,108136,91864
6:3:3,0,-1,108137,91863
5:6:5,0,-1,108138,91862
2:3:2,2,2,108136,91864
4:5:4,0,-1,108137,91863
3:3:3,0,-1,108138,91862
6:3:5,0,-1,108139,91861
1:3:3,0,-1,108140,91860
5:1:3,0,-1,108141,91859
1:6:4,0,-1,108142,91858
1:5:1,0,-1,108143,91857
3:1:1,0,-1,108144,91856
1:5:5,0,-1,108145,91855
5:4:5,0,-1,108146,91854
6:5:4,0,-1,108147,91853
1:4:5,0,-1,108148,91852
4:3:6,0,-1,108149,91851
6:3:6,0,-1,108150,91850
4:4:5,0,-1,108151,91849
6:1:5,0,-1,108152,91848
5:6:5,0,-1,108153,91847
6:3:3,0,-1,108154,91846
6:6:1,0,-1,108155,91845
5:3:5,0,-1,108156,91844
5:6:1,0,-1,108157,91843
2:6:2,2,2,108155,91845
6:2:1,1,1,108154,91846
3:6:3,0,-1,108155,91845
2:3:1,1,1,108154,91846
3:1:3,0,-1,108155,91845
1:2:3,1,1,108154,91846
4:4:1,0,-1,108155,91845
2:5:3,1,1,108154,91846
5:2:2,2,2,108152,91848
2:2:2,3,3,108149,91851
2:6:3,1,1,108148,91852
6:3:3,0,-1,108149,91851
2:5:4,1,1,108148,91852
5:1:3,0,-1,108149,91851
5:2:6,1,1,108148,91852
1:6:4,0,-1,108149,91851
4:1:1,0,-1,108150,91850
2:1:5,1,1,108149,91851
4:5:5,0,-1,108150,91850
1:5:6,0,-1,108151,91849
5:6:3,0,-1,108152,91848
5:1:1,0,-1,108153,91847
2:5:4,1,1,108152,91848
4:2:2,2,2,108150,91850
6:3:6,0,-1,108151,91849
4:3:5,0,-1,108152,91848
5:1:4,0,-1,108153,91847
6:2:4,1,1,108152,91848
4:2:5,1,1,108151,91849
6:2:2,2,2,108149,91851
4:2:4,1,1,108148,91852
2:2:5,2,2,108146,91854
5:2:6,1,1,108145,91855
5:6:6,0,-1,108146,91854
4:1:1,0,-1,108147,91853
4:6:6,0,-1,108148,91852
6:6:3,0,-1,108149,91851
2:1:4,1,1,108148,91852
3:6:1,0,-1,108149,91851
4:6:1,0,-1,108150,91850
6:2:2,2,2,108148,91852
5:1:5,0,-1,108149,91851
6:6:1,0,-1,108150,91850
4:1:1,0,-1,108151,91849
6:5:4,0,-1,108152,91848
3:6:4,0,-1,108153,91847
3:2:2,2,2,108151,91849
4:2:6,1,1,108150,91850
6:4:5,0,-1,108151,91849
6:4:1,0,-1,108152,91848
5:1:4,0,-1,108153,91847
1:3:3,0,-1,108154,91846
6:3:4,0,-1,108155,91845
4:5:5,0,-1,108156,91844
4:1:1,0,-1,108157,91843
3:6:1,0,-1,108158,91842
6:5:6,0,-1,108159,91841
6:3:4,0,-1,108160,91840
5:5:4,0,-1,108161,91839
2:5:5,1,1,108160,91840
6:3:3,0,-1,108161,91839
4:1:4,0,-1,108162,91838
6:1:2,1,1,108161,91839
3:2:2,2,2,108159,91841
1:5:3,0,-1,108160,91840
3:3:1,0,-1,108161,91839
5:3:1,0,-1,108162,91838
6:2:6,1,1,108161,91839
5:6:6,0,-1,108162,91838
5:2:5,1,1,108161,91839
4:5:5,0,-1,108162,91838
3:3:2,1,1,108161,91839
3:6:2,1,1,108160,91840
6:4:1,0,-1,108161,91839
3:1:3,0,-1,108162,91838
5:6:4,0,-1,108163,91837
3:6:1,0,-1,108164,91836
1:6:5,0,-1,108165,91835
3:3:5,0,-1,108166,91834
5:5:1,0,-1,108167,91833
1:3:1,0,-1,108168,91832
1:4:5,0,-1,108169,91831
5:1:3,0,-1,108170,91830
4:2:4,1,1,108169,91831
6:3:5,0,-1,108170,91830
5:1:1,0,-1,108171,91829
2:4:4,1,1,108170,91830
2:6:6,1,1,108169,91831
6:2:2,2,2,108167,91833
6:4:6,0,-1,108168,91832
3:4:3,0,-1,108169,91831
2:4:1,1,1,108168,91832
3:3:4,0,-1,108169,91831
6:3:6,0,-1,108170,91830
2:5:3,1,1,108169,91831
5:6:2,1,1,108168,91832
5:2:1,1,1,108167,91833
5:3:3,0,-1,108168,91832
3:5:1,0,-1,108169,91831
5:2:2,2,2,108167,91833
5:4:4,0,-1,108168,91832
3:2:6,1,1,108167,91833
4:6:1,0,-1,108168,91832
4:5:6,0,-1,108169,91831
2:4:2,2,2,108167,91833
3:3:1,0,-1,108168,91832
2:2:6,2,2,108166,91834
4:4:1,0,-1,108167,91833
3:3:2,1,1,108166,91834
2:3:6,1,1,108165,91835
2:3:6,1,1,108164,91836
4:5:1,0,-1,108165,91835
3:6:5,0,-1,108166,91834
4:2:4,1,1,108165,91835
6:4:4,0,-1,108166,91834
3:6:4,0,-1,108167,91833
5:6:6,0,-1,108168,91832
2:4:1,1,1,108167,91833
3:6:1,0,-1,108168,91832
2:3:1,1,1,108167,91833
1:3:3,0,-1,108168,91832
4:4:5,0,-1,108169,91831
5:4:4,0,-1,108170,91830
4:1:2,1,1,108169,91831
3:2:2,2,2,108167,91833
5:3:6,0,-1,108168,91832
1:6:2,1,1,108167,91833
2:1:2,2,2,108165,91835
1:5:3,0,-1,108166,91834
1:4:1,0,-1,108167,91833
1:6:1,0,-1,108168,91832
2:2:3,2,2,108166,91834
1:1:5,0,-1,108167,91833
3:6:6,0,-1,108168,91832
5:5:4,0,-1,108169,91831
5:4:1,0,-1,108170,91830
4:6:2,1,1,108169,91831
6:1:5,0,-1,108170,91830
2:5:6,1,1,108169,91831
5:5:3,0,-1,108170,91830
4:2:5,1,1,108169,91831
5:5:1,0,-1,108170,91830
3:6:3,0,-1,108171,91829
1:1:4,0,-1,108172,91828
5:4:1,0,-1,108173,91827
5:5:3,0,-1,108174,91826
5:5:5,0,-1,108175,91825
4:3:5,0,-1,108176,91824
2:5:6,1,1,108175,91825
5:6:1,0,-1,108176,91824
5:4:6,0,-1,108177,91823
3:4:5,0,-1,108178,91822
1:5:5,0,-1,108179,91821
1:2:3,1,1,108178,91822
5:5:2,1,1,108177,91823
5:3:1,0,-1,108178,91822
3:3:2,1,1,108177,91823
2:1:5,1,1,108176,91824
4:2:3,1,1,108175,91825
3:4:4,0,-1,108176,91824
3:1:2,1,1,108175,91825
6:1:2,1,1,108174,91826
6:4:3,0,-1,108175,91825
6:6:3,0,-1,108176,91824
4:6:2,1,1,108175,91825
5:5:6,0,-1,108176,91824
5:4:6,0,-1,108177,91823
1:6:4,0,-1,108178,91822
4:4:4,0,-1,108179,91821
4:4:2,1,1,108178,91822
5:4:2,1,1,108177,91823
2:3:6,1,1,108176,91824
1:1:6,0,-1,108177,91823
3:6:5,0,-1,108178,91822
1:1:6,0,-1,108179,91821
1:1:4,0,-1,108180,91820
6:3:3,0,-1,108181,91819
6:6:5,0,-1,108182,91818
5:4:2,1,1,108181,91819
4:2:2,2,2,108179,91821
6:5:4,0,-1,108180,91820
4:3:2,1,1,108179,91821
2:6:2,2,2,108177,91823
3:4:4,0,-1,108178,91822
4:3:5,0,-1,108179,91821
5:4:2,1,1,108178,91822
5:4:5,0,-1,108179,91821
3:5:4,0,-1,108180,91820
5:6:5,0,-1,108181,91819
3:3:2,1,1,108180,91820
6:4:2,1,1,108179,91821
2:6:4,1,1,108178,91822
6:2:5,1,1,108177,91823
6:2:1,1,1,108176,91824
1:2:4,1,1,108175,91825
2:1:5,1,1,108174,91826
6:4:5,0,-1,108175,91825
3:3:6,0,-1,108176,91824
4:5:3,0,-1,108177,91823
3:2:4,1,1,108176,91824
5:4:6,0,-1,108177,91823
1:6:6,0,-1,108178,91822
4:4:1,0,-1,108179,91821
4:4:1,0,-1,108180,91820
2:6:6,1,1,108179,91821
5:1:3,0,-1,108180,91820
3:1:2,1,1,108179,91821
2:4:1,1,1,108178,91822
6:3:5,0,-1,108179,91821
6:6:2,1,1,108178,91822
6:4:3,0,-1,108179,91821
3:1:2,1,1,108178,91822
1:1:1,0,-1,108179,91821
4:5:5,0,-1,108180,91820
2:5:5,1,1,108179,91821
5:3:1,0,-1,108180,91820
3:6:6,0,-1,108181,91819
2:2:3,2,2,108179,91821
1:1:2,1,1,108178,91822
5:1:4,0,-1,108179,91821
1:5:5,0,-1,108180,91820
2:5:4,1,1,108179,91821
5:2:5,1,1,108178,91822
1:3:3,0,-1,108179,91821
5:1:3,0,-1,108180,91820
5:3:3,0,-1,108181,91819
1:4:4,0,-1,108182,91818
3:3:4,0,-1,108183,91817
3:5:2,1,1,108182,91818
5:4:4,0,-1,108183,91817
3:1:6,0,-1,108184,91816
5:4:3,0,-1,108185,91815
5:6:4,0,-1,108186,91814
5:3:5,0,-1,108187,91813
5:6:5,0,-1,108188,91812
4:6:4,0,-1,108189,91811
6:3:5,0,-1,108190,91810
2:6:5,1,1,108189,91811
5:3:5,0,-1,108190,91810
5:1:6,0,-1,108191,91809
3:1:3,0,-1,108192,91808
2:4:6,1,1,108191,91809
3:1:6,0,-1,108192,91808
6:1:2,1,1,108191,91809
5:2:4,1,1,108190,91810
1:3:6,0,-1,108191,91809
4:1:4,0,-1,108192,91808
6:3:5,0,-1,108193,91807
4:5:4,0,-1,108194,91806
6:5:4,0,-1,108195,91805
4:2:1,1,1,108194,91806
6:6:2,1,1,108193,91807
3:5:4,0,-1,108194,91806
5:1:1,0,-1,108195,91805
1:1:5,0,-1,108196,91804
3:3:3,0,-1,108197,91803
5:6:6,0,-1,108198,91802
5:3:4,0,-1,108199,91801
1:4:4,0,-1,108200,91800
1:5:5,0,-1,108201,91799
6:5:3,0,-1,108202,91798
1:2:6,1,1,108201,91799
3:1:4,0,-1,108202,91798
6:3:6,0,-1,108203,91797
5:2:1,1,1,108202,91798
4:6:4,0,-1,108203,91797
4:3:5,0,-1,108204,91796
2:2:6,2,2,108202,91798
3:6:4,0,-1,108203,91797
4:3:6,0,-1,108204,91796
1:5:5,0,-1,108205,91795
1:3:2,1,1,108204,91796
5:3:3,0,-1,108205,91795
2:1:3,1,1,108204,91796
5:4:3,0,-1,108205,91795
3:2:3,1,1,108204,91796
5:2:2,2,2,108202,91798
1:4:2,1,1,108201,91799
3:6:6,0,-1,108202,91798
4:2:1,1,1,108201,91799
2:4:4,1,1,108200,91800
2:1:1,1,1,108199,91801
6:5:6,0,-1,108200,91800
2:5:1,1,1,108199,91801
1:4:6,0,-1,108200,91800
1:2:6,1,1,108199,91801
4:5:3,0,-1,108200,91800
5:1:4,0,-1,108201,91799
1:1:6,0,-1,108202,91798
5:5:3,0,-1,108203,91797
1:1:2,1,1,108202,91798
3:2:5,1,1,108201,91799
2:3:4,1,1,108200,91800
6:6:5,0,-1,108201,91799
2:1:6,1,1,108200,91800
4:4:2,1,1,108199,91801
3:6:3,0,-1,108200,91800
4:2:1,1,1,108199,91801
1:5:4,0,-1,108200,91800
5:5:1,0,-1,108201,91799
1:2:6,1,1,108200,91800
1:2:3,1,1,108199,91801
5:2:3,1,1,108198,91802
1:2:6,1,1,108197,91803
1:5:5,0,-1,108198,91802
5:3:4,0,-1,108199,91801
3:1:6,0,-1,108200,91800
2:1:6,1,1,108199,91801
4:3:5,0,-1,108200,91800
1:2:4,1,1,108199,91801
4:2:6,1,1,108198,91802
2:5:2,2,2,108196,91804
3:5:2,1,1,108195,91805
2:6:2,2,2,108193,91807
6:2:1,1,1,108192,91808
3:6:6,0,-1,108193,91807
6:6:1,0,-1,108194,91806
6:5:4,0,-1,108195,91805
3:1:2,1,1,108194,91806
1:1:2,1,1,108193,91807
6:4:1,0,-1,108194,91806
6:1:6,0,-1,108195,91805
6:3:5,0,-1,108196,91804
1:6:1,0,-1,108197,91803
6:1:5,0,-1,108198,91802
5:2:3,1,1,108197,91803
5:3:1,0,-1,108198,91802
6:1:5,0,-1,108199,91801
6:5:1,0,-1,108200,91800
1:3:3,0,-1,108201,91799
2:3:1,1,1,108200,91800
1:2:2,2,2,108198,91802
5:3:5,0,-1,108199,91801
5:4:5,0,-1,108200,91800
2:4:2,2,2,108198,91802
1:2:3,1,1,108197,91803
6:3:5,0,-1,108198,91802
3:3:5,0,-1,108199,91801
5:4:2,1,1,108198,91802
4:3:5,0,-1,108199,91801
5:4:3,0,-1,108200,91800
1:1:2,1,1,108199,91801
6:1:6,0,-1,108200,91800
2:3:6,1,1,108199,91801
5:3:3,0,-1,108200,91800
1:3:2,1,1,108199,91801
6:3:6,0,-1,108200,91800
3:6:4,0,-1,108201,91799
3:6:5,0,-1,108202,91798
4:2:1,1,1,108201,91799
5:6:5,0,-1,108202,91798
6:2:1,1,1,108201,91799
4:6:4,0,-1,108202,91798
2:4:4,1,1,108201,91799
4:4:4,0,-1,108202,91798
5:3:3,0,-1,108203,91797
4:3:6,0,-1,108204,91796
1:6:6,0,-1,108205,91795
2:2:3,2,2,108203,91797
2:2:6,2,2,108201,91799
6:6:1,0,-1,108202,91798
2:2:4,2,2,108200,91800
2:1:5,1,1,108199,91801
3:4:6,0,-1,108200,91800
5:3:3,0,-1,108201,91799
4:4:2,1,1,108200,91800
3:3:4,0,-1,108201,91799
5:1:4,0,-1,108202,91798
6:5:6,0,-1,108203,91797
4:6:5,0,-1,108204,91796
5:3:3,0,-1,108205,91795
2:6:5,1,1,108204,91796
3:4:4,0,-1,108205,91795
6:3:6,0,-1,108206,91794
2:2:2,3,3,108203,91797
3:4:1,0,-1,108204,91796
6:4:2,1,1,108203,91797
4:4:1,0,-1,108204,91796
2:6:4,1,1,108203,91797
5:1:1,0,-1,108204,91796
2:3:1,1,1,108203,91797
6:3:2,1,1,108202,91798
4:5:3,0,-1,108203,91797
4:1:3,0,-1,108204,91796
2:1:6,1,1,108203,91797
5:6:4,0,-1,108204,91796
5:6:1,0,-1,108205,91795
1:3:6,0,-1,108206,91794
6:3:6,0,-1,108207,91793
2:4:3,1,1,108206,91794
1:2:6,1,1,108205,91795
6:4:1,0,-1,108206,91794
2:2:6,2,2,108204,91796
5:2:5,1,1,108203,91797
6:2:2,2,2,108201,91799
5:3:1,0,-1,108202,91798
5:6:4,0,-1,108203,91797
2:6:4,1,1,108202,91798
4:1:5,0,-1,108203,91797
2:1:2,2,2,108201,91799
6:3:3,0,-1,108202,91798
3:4:6,0,-1,108203,91797
2:5:6,1,1,108202,91798
3:6:2,1,1,108201,91799
5:1:3,0,-1,108202,91798
4:5:3,0,-1,108203,91797
3:2:2,2,2,108201,91799
3:4:4,0,-1,108202,91798
2:3:4,1,1,108201,91799
1:2:4,1,1,108200,91800
1:3:2,1,1,108199,91801
6:4:2,1,1,108198,91802
4:3:4,0,-1,108199,91801
3:4:5,0,-1,108200,91800
2:4:6,1,1,108199,91801
1:4:3,0,-1,108200,91800
1:6:5,0,-1,108201,91799
2:1:3,1,1,108200,91800
3:3:4,0,-1,108201,91799
4:4:6,0,-1,108202,91798
3:4:1,0,-1,108203,91797
3:2:3,1,1,108202,91798
4:1:2,1,1,108201,91799
4:3:5,0,-1,108202,91798
6:5:1,0,-1,108203,91797
6:2:1,1,1,108202,91798
6:1:4,0,-1,108203,91797
4:2:1,1,1,108202,91798
2:5:2,2,2,108200,91800
6:4:6,0,-1,108201,91799
3:6:6,0,-1,108202,91798
3:4:1,0,-1,108203,91797
1:1:3,0,-1,108204,91796
6:6:4,0,-1,108205,91795
2:2:2,3,3,108202,91798
2:3:4,1,1,108201,91799
3:5:1,0,-1,108202,91798
3:4:4,0,-1,108203,91797
4:2:5,1,1,108202,91798
6:2:1,1,1,108201,91799
6:5:6,0,-1,108202,91798
4:4:2,1,1,108201,91799
4:5:2,1,1,108200,91800
1:4:1,0,-1,108201,91799
1:4:6,0,-1,108202,91798
4:4:3,0,-1,108203,91797
1:2:5,1,1,108202,91798
1:3:1,0,-1,108203,91797
5:4:1,0,-1,108204,91796
2:4:6,1,1,108203,91797
2:2:4,2,2,108201,91799
5:2:3,1,1,108200,91800
3:6:3,0,-1,108201,91799
2:4:2,2,2,108199,91801
2:1:5,1,1,108198,91802
6:4:2,1,1,108197,91803
1:5:3,0,-1,108198,91802
5:5:4,0,-1,108199,91801
6:2:6,1,1,108198,91802
2:2:5,2,2,108196,91804
2:4:4,1,1,108195,91805
5:2:2,2,2,108193,91807
4:2:1,1,1,108192,91808
3:1:6,0,-1,108193,91807
6:3:6,0,-1,108194,91806
3:3:6,0,-1,108195,91805
3:5:3,0,-1,108196,91804
6:4:1,0,-1,108197,91803
5:4:3,0,-1,108198,91802
2:5:1,1,1,108197,91803
5:5:1,0,-1,108198,91802
4:2:1,1,1,108197,91803
6:5:2,1,1,108196,91804
5:2:4,1,1,108195,91805
3:4:2,1,1,108194,91806
2:1:4,1,1,108193,91807
6:1:4,0,-1,108194,91806
6:3:4,0,-1,108195,91805
3:5:4,0,-1,108196,91804
3:6:6,0,-1,108197,91803
3:4:4,0,-1,108198,91802
6:5:2,1,1,108197,91803
1:2:2,2,2,108195,91805
2:3:2,2,2,108193,91807
3:4:5,0,-1,108194,91806
5:3:3,0,-1,108195,91805
4:1:4,0,-1,108196,91804
6:6:5,0,-1,108197,91803
3:3:6,0,-1,108198,91802
3:5:1,0,-1,108199,91801
5:4:2,1,1,108198,91802
3:6:1,0,-1,108199,91801
5:2:3,1,1,108198,91802
6:1:3,0,-1,108199,91801
6:6:1,0,-1,108200,91800
2:1:5,1,1,108199,91801
2:4:4,1,1,108198,91802
4:3:1,0,-1,108199,91801
5:4:1,0,-1,108200,91800
1:5:2,1,1,108199,91801
1:6:5,0,-1,108200,91800
2:1:5,1,1,108199,91801
5:6:5,0,-1,108200,91800
6:2:2,2,2,108198,91802
1:1:1,0,-1,108199,91801
6:2:3,1,1,108198,91802
4:1:5,0,-1,108199,91801
5:4:1,0,-1,108200,91800
5:4:3,0,-1,108201,91799
1:4:2,1,1,108200,91800
1:4:3,0,-1,108201,91799
2:3:3,1,1,108200,91800
3:2:4,1,1,108199,91801
6:4:6,0,-1,108200,91800
4:2:5,1,1,108199,91801
2:6:2,2,2,108197,91803
6:2:5,1,1,108196,91804
3:3:3,0,-1,108197,91803
3:1:5,0,-1,108198,91802
6:4:1,0,-1,108199,91801
1:4:4,0,-1,108200,91800
2:4:1,1,1,108199,91801
2:1:2,2,2,108197,91803
2:3:6,1,1,108196,91804
2:2:1,2,2,108194,91806
6:1:1,0,-1,108195,91805
1:6:6,0,-1,108196,91804
6:1:2,1,1,108195,91805
2:5:1,1,1,108194,91806
3:6:2,1,1,108193,91807
4:5:1,0,-1,108194,91806
5:1:4,0,-1,108195,91805
2:4:4,1,1,108194,91806
6:2:5,1,1,108193,91807
1:3:1,0,-1,108194,91806
6:2:2,2,2,108192,91808
3:2:6,1,1,108191,91809
3:6:5,0,-1,108192,91808
5:5:5,0,-1,108193,91807
5:2:1,1,1,108192,91808
6:2:3,1,1,108191,91809
2:5:2,2,2,108189,91811
1:1:5,0,-1,108190,91810
2:5:6,1,1,108189,91811
5:3:3,0,-1,108190,91810
1:3:5,0,-1,108191,91809
2:5:5,1,1,108190,91810
1:3:1,0,-1,108191,91809
6:1:2,1,1,108190,91810
4:4:5,0,-1,108191,91809
1:3:1,0,-1,108192,91808
2:6:1,1,1,108191,91809
5:2:5,1,1,108190,91810
3:3:3,0,-1,108191,91809
1:3:6,0,-1,108192,91808
3:5:6,0,-1,108193,91807
6:4:2,1,1,108192,91808
4:1:6,0,-1,108193,91807
1:5:6,0,-1,108194,91806
6:6:3,0,-1,108195,91805
4:4:6,0,-1,108196,91804
4:4:5,0,-1,108197,91803
2:3:4,1,1,108196,91804
6:6:3,0,-1,108197,91803
3:5:3,0,-1,108198,91802
6:3:2,1,1,108197,91803
6:3:5,0,-1,108198,91802
1:4:5,0,-1,108199,91801
2:6:3,1,1,108198,91802
6:3:5,0,-1,108199,91801
3:3:4,0,-1,108200,91800
5:6:3,0,-1,108201,91799
4:3:1,0,-1,108202,91798
1:3:4,0,-1,108203,91797
6:2:2,2,2,108201,91799
3:5:4,0,-1,108202,91798
1:3:3,0,-1,108203,91797
4:5:4,0,-1,108204,91796
1:6:1,0,-1,108205,91795
6:4:5,0,-1,108206,91794
4:6:4,0,-1,108207,91793
4:4:1,0,-1,108208,91792
5:3:5,0,-1,108209,91791
5:3:3,0,-1,108210,91790
4:6:4,0,-1,108211,91789
2:4:4,1,1,108210,91790
1:6:6,0,-1,108211,91789
3:2:3,1,1,108210,91790
1:2:5,1,1,108209,91791
6:4:1,0,-1,108210,91790
4:5:3,0,-1,108211,91789
3:3:3,0,-1,108212,91788
3:1:4,0,-1,108213,91787
5:1:1,0,-1,108214,91786
3:4:5,0,-1,108215,91785
3:5:4,0,-1,108216,91784
5:6:4,0,-1,108217,91783
1:4:5,0,-1,108218,91782
1:6:5,0,-1,108219,91781
3:3:1,0,-1,108220,91780
6:6:2,1,1,108219,91781
3:1:5,0,-1,108220,91780
6:2:2,2,2,108218,91782
5:1:4,0,-1,108219,91781
2:1:3,1,1,108218,91782
4:2:6,1,1,108217,91783
6:5:4,0,-1,108218,91782
2:4:2,2,2,108216,91784
1:3:3,0,-1,108217,91783
1:1:6,0,-1,108218,91782
4:6:6,0,-1,108219,91781
6:3:4,0,-1,108220,91780
3:6:6,0,-1,108221,91779
3:4:2,1,1,108220,91780
1:6:5,0,-1,108221,91779
5:6:4,0,-1,108222,91778
4:2:1,1,1,108221,91779
4:1:2,1,1,108220,91780
2:3:3,1,1,108219,91781
4:2:3,1,1,108218,91782
4:1:4,0,-1,108219,91781
6:4:4,0,-1,108220,91780
2:5:1,1,1,108219,91781
3:6:4,0,-1,108220,91780
3:1:5,0,-1,108221,91779
4:3:1,0,-1,108222,91778
1:6:6,0,-1,108223,91777
2:6:4,1,1,108222,91778
4:1:3,0,-1,108223,91777
6:6:1,0,-1,108224,91776
3:6:1,0,-1,108225,91775
5:4:3,0,-1,108226,91774
3:5:1,0,-1,108227,91773
3:6:2,1,1,108226,91774
5:6:4,0,-1,108227,91773
2:4:2,2,2,108225,91775
6:4:6,0,-1,108226,91774
3:2:1,1,1,108225,91775
6:3:4,0,-1,108226,91774
6:1:1,0,-1,108227,91773
5:5:2,1,1,108226,91774
4:3:3,0,-1,108227,91773
6:6:1,0,-1,108228,91772
6:4:4,0,-1,108229,91771
3:4:2,1,1,108228,91772
6:1:1,0,-1,108229,91771
3:6:2,1,1,108228,91772
1:1:5,0,-1,108229,91771
5:4:6,0,-1,108230,91770
5:6:1,0,-1,108231,91769
4:2:3,1,1,108230,91770
2:4:6,1,1,108229,91771
6:3:5,0,-1,108230,91770
1:6:6,0,-1,108231,91769
3:5:5,0,-1,108232,91768
4:4:1,0,-1,108233,91767
4:5:6,0,-1,108234,91766
3:6:6,0,-1,108235,91765
1:6:1,0,-1,108236,91764
4:1:2,1,1,108235,91765
4:4:3,0,-1,108236,91764
6:2:1,1,1,108235,91765
3:5:5,0,-1,108236,91764
5:4:3,0,-1,108237,91763
5:4:1,0,-1,108238,91762
1:1:1,0,-1,108239,91761
2:2:1,2,2,108237,91763
2:4:4,1,1,108236,91764
3:1:4,0,-1,108237,91763
2:4:5,1,1,108236,91764
3:3:6,0,-1,108237,91763
5:2:5,1,1,108236,91764
5:5:3,0,-1,108237,91763
1:5:5,0,-1,108238,91762
3:1:3,0,-1,108239,91761
2:1:2,2,2,108237,91763
4:2:3,1,1,108236,91764
1:1:4,0,-1,108237,91763
5:1:3,0,-1,108238,91762
5:3:3,0,-1,108239,91761
3:1:4,0,-1,108240,91760
3:4:4,0,-1,108241,91759
5:2:2,2,2,108239,91761
6:4:1,0,-1,108240,91760
6:2:2,2,2,108238,91762
2:1:2,2,2,108236,91764
6:6:1,0,-1,108237,91763
4:6:3,0,-1,108238,91762
4:1:4,0,-1,108239,91761
2:3:3,1,1,108238,91762
1:5:6,0,-1,108239,91761
6:1:2,1,1,108238,91762
5:5:4,0,-1,108239,91761
1:2:5,1,1,108238,91762
4:3:1,0,-1,108239,91761
5:6:4,0,-1,108240,91760
5:1:4,0,-1,108241,91759
6:4:2,1,1,108240,91760
5:6:5,0,-1,108241,91759
6:1:4,0,-1,108242,91758
6:4:2,1,1,108241,91759
6:1:2,1,1,108240,91760
5:4:5,0,-1,108241,91759
3:4:1,0,-1,108242,91758
6:3:3,0,-1,108243,91757
1:1:1,0,-1,108244,91756
5:4:1,0,-1,108245,91755
4:1:1,0,-1,108246,91754
3:1:6,0,-1,108247,91753
3:5:4,0,-1,108248,91752
2:4:5,1,1,108247,91753
1:1:2,1,1,108246,91754
4:6:4,0,-1,108247,91753
5:6:1,0,-1,108248,91752
4:5:6,0,-1,108249,91751
6:1:6,0,-1,108250,91750
6:6:4,0,-1,108251,91749
1:4:5,0,-1,108252,91748
2:4:3,1,1,108251,91749
2:3:3,1,1,108250,91750
3:6:3,0,-1,108251,91749
1:1:5,0,-1,108252,91748
5:3:3,0,-1,108253,91747
3:1:5,0,-1,108254,91746
3:5:4,0,-1,108255,91745
6:2:2,2,2,108253,91747
5:5:1,0,-1,108254,91746
4:3:6,0,-1,108255,91745
6:3:3,0,-1,108256,91744
1:5:4,0,-1,108257,91743
6:6:6,0,-1,108258,91742
1:3:6,0,-1,108259,91741
4:4:5,0,-1,108260,91740
1:5:4,0,-1,108261,91739
4:6:5,0,-1,108262,91738
4:2:4,1,1,108261,91739
1:6:1,0,-1,108262,91738
1:1:3,0,-1,108263,91737
3:1:3,0,-1,108264,91736
5:3:6,0,-1,108265,91735
4:6:1,0,-1,108266,91734
3:4:4,0,-1,108267,91733
6:5:3,0,-1,108268,91732
2:6:3,1,1,108267,91733
4:1:6,0,-1,108268,91732
1:1:4,0,-1,108269,91731
2:5:4,1,1,108268,91732
5:5:4,0,-1,108269,91731
2:3:3,1,1,108268,91732
5:4:4,0,-1,108269,91731
1:5:5,0,-1,108270,91730
6:2:5,1,1,108269,91731
5:1:6,0,-1,108270,91730
2:1:6,1,1,108269,91731
1:2:6,1,1,108268,91732
2:3:6,1,1,108267,91733
6:2:3,1,1,108266,91734
2:1:5,1,1,108265,91735
6:1:5,0,-1,108266,91734
1:4:1,0,-1,108267,91733
5:3:2,1,1,108266,91734
5:1:6,0,-1,108267,91733
3:3:6,0,-1,108268,91732
6:6:6,0,-1,108269,91731
6:1:4,0,-1,108270,91730
3:6:6,0,-1,108271,91729
6:3:5,0,-1,108272,91728
3:6:3,0,-1,108273,91727
1:6:4,0,-1,108274,91726
3:3:3,0,-1,108275,91725
4:4:4,0,-1,108276,91724
1:3:6,0,-1,108277,91723
5:4:2,1,1,108276,91724
4:3:1,0,-1,108277,91723
2:1:1,1,1,108276,91724
6:6:5,0,-1,108277,91723
6:4:5,0,-1,108278,91722
2:6:3,1,1,108277,91723
6:3:2,1,1,108276,91724
6:2:6,1,1,108275,91725
3:1:3,0,-1,108276,91724
6:3:1,0,-1,108277,91723
3:2:6,1,1,108276,91724
2:5:1,1,1,108275,91725
3:3:2,1,1,108274,91726
1:5:5,0,-1,108275,91725
1:5:1,0,-1,108276,91724
6:1:5,0,-1,108277,91723
3:3:5,0,-1,108278,91722
5:5:5,0,-1,108279,91721
5:5:6,0,-1,108280,91720
3:5:5,0,-1,108281,91719
2:2:2,3,3,108278,91722
5:1:2,1,1,108277,91723
2:1:4,1,1,108276,91724
5:6:2,1,1,108275,91725
1:6:1,0,-1,108276,91724
1:6:6,0,-1,108277,91723
6:3:4,0,-1,108278,91722
1:6:6,0,-1,108279,91721
5:5:6,0,-1,108280,91720
6:4:6,0,-1,108281,91719
4:6:4,0,-1,108282,91718
3:1:5,0,-1,108283,91717
6:4:2,1,1,108282,91718
5:5:1,0,-1,108283,91717
6:5:5,0,-1,108284,91716
2:5:2,2,2,108282,91718
2:2:2,3,3,108279,91721
5:6:6,0,-1,108280,91720
5:1:6,0,-1,108281,91719
5:6:2,1,1,108280,91720
3:2:4,1,1,108279,91721
1:6:5,0,-1,108280,91720
2:3:3,1,1,108279,91721
6:6:4,0,-1,108280,91720
2:6:3,1,1,108279,91721
2:5:1,1,1,108278,91722
1:4:6,0,-1,108279,91721
2:5:5,1,1,108278,91722
2:4:1,1,1,108277,91723
1:4:1,0,-1,108278,91722
6:4:3,0,-1,108279,91721
3:5:2,1,1,108278,91722
4:6:4,0,-1,108279,91721
3:3:1,0,-1,108280,91720
3:6:5,0,-1,108281,91719
1:4:3,0,-1,108282,91718
6:4:2,1,1,108281,91719
5:1:4,0,-1,108282,91718
6:6:5,0,-1,108283,91717
5:1:5,0,-1,108284,91716
6:5:1,0,-1,108285,91715
4:2:4,1,1,108284,91716
5:6:5,0,-1,108285,91715
6:6:3,0,-1,108286,91714
5:3:4,0,-1,108287,91713
2:2:2,3,3,108284,91716
5:1:4,0,-1,108285,91715
2:2:6,2,2,108283,91717
3:1:3,0,-1,108284,91716
1:5:4,0,-1,108285,91715
4:4:4,0,-1,108286,91714
1:5:2,1,1,108285,91715
2:3:5,1,1,108284,91716
5:2:3,1,1,108283,91717
5:6:3,0,-1,108284,91716
5:4:5,0,-1,108285,91715
6:6:4,0,-1,108286,91714
1:1:4,0,-1,108287,91713
6:3:4,0,-1,108288,91712
3:5:3,0,-1,108289,91711
3:4:5,0,-1,108290,91710
3:4:1,0,-1,108291,91709
3:1:6,0,-1,108292,91708
6:6:2,1,1,108291,91709
2:4:4,1,1,108290,91710
5:3:2,1,1,108289,91711
2:2:6,2,2,108287,91713
1:3:3,0,-1,108288,91712
1:1:5,0,-1,108289,91711
5:1:2,1,1,108288,91712
5:5:5,0,-1,108289,91711
3:3:6,0,-1,108290,91710
6:2:6,1,1,108289,91711
4:6:4,0,-1,108290,91710
3:2:3,1,1,108289,91711
2:3:6,1,1,108288,91712
1:4:5,0,-1,108289,91711
6:1:2,1,1,108288,91712
2:5:1,1,1,108287,91713
5:3:3,0,-1,108288,91712
3:5:2,1,1,108287,91713
6:2:5,1,1,108286,91714
3:3:4,0,-1,108287,91713
2:1:6,1,1,108286,91714
1:5:6,0,-1,108287,91713
1:3:4,0,-1,108288,91712
4:5:6,0,-1,108289,91711
5:3:6,0,-1,108290,91710
5:1:1,0,-1,108291,91709
5:4:4,0,-1,108292,91708
4:6:3,0,-1,108293,91707
3:1:2,1,1,108292,91708
6:2:4,1,1,108291,91709
3:2:2,2,2,108289,91711
3:5:6,0,-1,108290,91710
1:5:3,0,-1,108291,91709
2:5:6,1,1,108290,91710
2:4:1,1,1,108289,91711
1:6:5,0,-1,108290,91710
5:2:4,1,1,108289,91711
5:2:2,2,2,108287,91713
4:4:2,1,1,108286,91714
3:4:3,0,-1,108287,91713
4:2:6,1,1,108286,91714
1:4:6,0,-1,108287,91713
5:1:2,1,1,108286,91714
3:2:1,1,1,108285,91715
5:5:4,0,-1,108286,91714
5:5:6,0,-1,108287,91713
4:5:4,0,-1,108288,91712
1:5:5,0,-1,108289,91711
6:6:6,0,-1,108290,91710
4:5:3,0,-1,108291,91709
6:5:3,0,-1,108292,91708
3:1:1,0,-1,108293,91707
3:2:4,1,1,108292,91708
4:5:6,0,-1,108293,91707
4:2:5,1,1,108292,91708
1:2:2,2,2,108290,91710
4:1:3,0,-1,108291,91709
4:6:6,0,-1,108292,91708
6:6:2,1,1,108291,91709
6:1:6,0,-1,108292,91708
2:5:5,1,1,108291,91709
4:3:4,0,-1,108292,91708
2:3:6,1,1,108291,91709
2:1:1,1,1,108290,91710
1:4:3,0,-1,108291,91709
3:5:1,0,-1,108292,91708
4:3:2,1,1,108291,91709
6:5:1,0,-1,108292,91708
4:2:4,1,1,108291,91709
3:1:5,0,-1,108292,91708
3:3:3,0,-1,108293,91707
6:5:6,0,-1,108294,91706
2:1:4,1,1,108293,91707
1:5:4,0,-1,108294,91706
6:2:4,1,1,108293,91707
3:6:5,0,-1,108294,91706
2:5:5,1,1,108293,91707
5:2:3,1,1,108292,91708
1:4:3,0,-1,108293,91707
5:1:3,0,-1,108294,91706
5:4:3,0,-1,108295,91705
1:6:4,0,-1,108296,91704
1:1:4,0,-1,108297,91703
1:1:4,0,-1,108298,91702
1:6:2,1,1,108297,91703
2:3:2,2,2,108295,91705
5:1:1,0,-1,108296,91704
1:6:2,1,1,108295,91705
3:2:4,1,1,108294,91706
2:5:1,1,1,108293,91707
5:5:6,0,-1,108294,91706
4:6:5,0,-1,108295,91705
2:4:1,1,1,108294,91706
6:2:2,2,2,108292,91708
1:1:2,1,1,108291,91709
5:1:3,0,-1,108292,91708
6:6:4,0,-1,108293,91707
3:3:5,0,-1,108294,91706
6:1:3,0,-1,108295,91705
4:4:3,0,-1,108296,91704
6:2:5,1,1,108295,91705
1:6:5,0,-1,108296,91704
3:1:3,0,-1,108297,91703
4:6:4,0,-1,108298,91702
6:6:1,0,-1,108299,91701
5:1:6,0,-1,108300,91700
3:6:1,0,-1,108301,91699
5:1:4,0,-1,108302,91698
4:5:4,0,-1,108303,91697
4:2:4,1,1,108302,91698
4:1:2,1,1,108301,91699
1:4:2,1,1,108300,91700
4:2:6,1,1,108299,91701
6:4:4,0,-1,108300,91700
1:6:6,0,-1,108301,91699
1:1:1,0,-1,108302,91698
3:5:5,0,-1,108303,91697
4:2:6,1,1,108302,91698
2:6:6,1,1,108301,91699
6:3:4,0,-1,108302,91698
3:5:2,1,1,108301,91699
5:6:5,0,-1,108302,91698
5:1:4,0,-1,108303,91697
5:3:2,1,1,108302,91698
6:5:2,1,1,108301,91699
1:1:2,1,1,108300,91700
3:1:1,0,-1,108301,91699
1:2:3,1,1,108300,91700
2:4:4,1,1,108299,91701
4:4:6,0,-1,108300,91700
2:1:2,2,2,108298,91702
4:2:2,2,2,108296,91704
6:3:4,0,-1,108297,91703
3:3:3,0,-1,108298,91702
6:1:3,0,-1,108299,91701
3:4:6,0,-1,108300,91700
1:6:5,0,-1,108301,91699
1:5:1,0,-1,108302,91698
6:5:6,0,-1,108303,91697
5:3:6,0,-1,108304,91696
1:2:5,1,1,108303,91697
4:1:2,1,1,108302,91698
4:6:3,0,-1,108303,91697
6:4:2,1,1,108302,91698
4:1:1,0,-1,108303,91697
2:4:3,1,1,108302,91698
2:6:1,1,1,108301,91699
2:3:2,2,2,108299,91701
6:3:2,1,1,108298,91702
5:4:3,0,-1,108299,91701
1:5:2,1,1,108298,91702
2:3:1,1,1,108297,91703
4:4:5,0,-1,108298,91702
4:3:4,0,-1,108299,91701
1:1:1,0,-1,108300,91700
1:5:3,0,-1,108301,91699
6:2:2,2,2,108299,91701
2:4:5,1,1,108298,91702
4:2:5,1,1,108297,91703
5:4:5,0,-1,108298,91702
6:2:5,1,1,108297,91703
3:3:2,1,1,108296,91704
1:2:2,2,2,108294,91706
3:4:5,0,-1,108295,91705
5:2:3,1,1,108294,91706
3:1:5,0,-1,108295,91705
5:4:2,1,1,108294,91706
6:6:3,0,-1,108295,91705
5:3:2,1,1,108294,91706
4:5:3,0,-1,108295,91705
2:4:2,2,2,108293,91707
2:3:1,1,1,108292,91708
5:6:3,0,-1,108293,91707
6:6:5,0,-1,108294,91706
2:5:3,1,1,108293,91707
6:6:5,0,-1,108294,91706
3:2:2,2,2,108292,91708
2:2:1,2,2,108290,91710
3:3:6,0,-1,108291,91709
5:4:1,0,-1,108292,91708
6:5:2,1,1,108291,91709
3:5:4,0,-1,108292,91708
4:4:5,0,-1,108293,91707
6:4:5,0,-1,108294,91706
6:1:3,0,-1,108295,91705
4:2:1,1,1,108294,91706
1:5:4,0,-1,108295,91705
5:6:4,0,-1,108296,91704
2:3:4,1,1,108295,91705
5:2:1,1,1,108294,91706
6:6:4,0,-1,108295,91705
2:2:4,2,2,108293,91707
5:5:3,0,-1,108294,91706
2:4:2,2,2,108292,91708
6:2:4,1,1,108291,91709
3:5:6,0,-1,108292,91708
5:1:1,0,-1,108293,91707
6:5:1,0,-1,108294,91706
5:3:5,0,-1,108295,91705
4:3:2,1,1,108294,91706
6:4:6,0,-1,108295,91705
1:5:6,0,-1,108296,91704
6:3:4,0,-1,108297,91703
6:6:6,0,-1,108298,91702
2:3:3,1,1,108297,91703
6:4:1,0,-1,108298,91702
5:6:1,0,-1,108299,91701
5:2:2,2,2,108297,91703
3:6:6,0,-1,108298,91702
1:6:2,1,1,108297,91703
3:4:6,0,-1,108298,91702
5:2:4,1,1,108297,91703
5:6:1,0,-1,108298,91702
6:4:6,0,-1,108299,91701
2:1:3,1,1,108298,91702
3:2:2,2,2,108296,91704
6:6:6,0,-1,108297,91703
3:2:3,1,1,108296,91704
1:5:5,0,-1,108297,91703
1:6:6,0,-1,108298,91702
3:4:6,0,-1,108299,91701
3:1:3,0,-1,108300,91700
1:6:3,0,-1,108301,91699
5:1:2,1,1,108300,91700
6:4:6,0,-1,108301,91699
1:2:4,1,1,108300,91700
5:1:3,0,-1,108301,91699
2:6:6,1,1,108300,91700
5:4:3,0,-1,108301,91699
5:4:5,0,-1,108302,91698
4:5:6,0,-1,108303,91697
2:5:1,1,1,108302,91698
2:2:1,2,2,108300,91700
4:5:3,0,-1,108301,91699
4:6:2,1,1,108300,91700
2:3:2,2,2,108298,91702
4:4:3,0,-1,108299,91701
2:5:3,1,1,108298,91702
4:5:5,0,-1,108299,91701
6:6:4,0,-1,108300,91700
3:3:3,0,-1,108301,91699
6:3:4,0,-1,108302,91698
4:6:6,0,-1,108303,91697
5:1:4,0,-1,108304,91696
1:1:4,0,-1,108305,91695
6:5:3,0,-1,108306,91694
6:2:6,1,1,108305,91695
4:2:1,1,1,108304,91696
4:1:3,0,-1,108305,91695
6:6:6,0,-1,108306,91694
2:1:4,1,1,108305,91695
1:4:3,0,-1,108306,91694
5:6:4,0,-1,108307,91693
5:4:5,0,-1,108308,91692
3:2:1,1,1,108307,91693
4:5:2,1,1,108306,91694
4:2:2,2,2,108304,91696
2:5:6,1,1,108303,91697
3:1:4,0,-1,108304,91696
5:2:5,1,1,108303,91697
4:2:4,1,1,108302,91698
6:4:5,0,-1,108303,91697
3:1:1,0,-1,108304,91696
5:3:3,0,-1,108305,91695
1:4:6,0,-1,108306,91694
6:6:2,1,1,108305,91695
2:2:1,2,2,108303,91697
5:4:6,0,-1,108304,91696
6:6:2,1,1,108303,91697
5:1:6,0,-1,108304,91696
5:5:6,0,-1,108305,91695
6:3:5,0,-1,108306,91694
4:1:3,0,-1,108307,91693
2:4:3,1,1,108306,91694
6:3:3,0,-1,108307,91693
3:3:3,0,-1,108308,91692
5:3:1,0,-1,108309,91691
2:1:5,1,1,108308,91692
4:2:3,1,1,108307,91693
4:5:1,0,-1,108308,91692
5:6:5,0,-1,108309,91691
5:1:5,0,-1,108310,91690
6:1:2,1,1,108309,91691
4:5:3,0,-1,108310,91690
4:5:3,0,-1,108311,91689
2:3:4,1,1,108310,91690
4:5:5,0,-1,108311,91689
2:4:3,1,1,108310,91690
5:2:3,1,1,108309,91691
4:3:4,0,-1,108310,91690
4:3:6,0,-1,108311,91689
2:4:1,1,1,108310,91690
1:2:5,1,1,108309,91691
2:6:1,1,1,108308,91692
6:3:6,0,-1,108309,91691
1:4:5,0,-1,108310,91690
3:3:3,0,-1,108311,91689
1:5:6,0,-1,108312,91688
6:4:1,0,-1,108313,91687
6:2:2,2,2,108311,91689
3:5:5,0,-1,108312,91688
5:3:4,0,-1,108313,91687
6:6:3,0,-1,108314,91686
4:3:6,0,-1,108315,91685
4:2:6,1,1,108314,91686
4:5:6,0,-1,108315,91685
2:3:3,1,1,108314,91686
6:2:6,1,1,108313,91687
2:6:1,1,1,108312,91688
2:6:3,1,1,108311,91689
5:3:3,0,-1,108312,91688
6:2:4,1,1,108311,91689
2:1:6,1,1,108310,91690
2:6:1,1,1,108309,91691
3:1:6,0,-1,108310,91690
2:1:3,1,1,108309,91691
6:1:3,0,-1,108310,91690
6:1:6,0,-1,108311,91689
6:1:4,0,-1,108312,91688
4:2:6,1,1,108311,91689
1:1:5,0,-1,108312,91688
1:2:5,1,1,108311,91689
4:5:3,0,-1,108312,91688
3:3:2,1,1,108311,91689
4:4:1,0,-1,108312,91688
6:4:1,0,-1,108313,91687
1:3:1,0,-1,108314,91686
3:2:3,1,1,108313,91687
5:5:5,0,-1,108314,91686
3:3:3,0,-1,108315,91685
1:4:1,0,-1,108316,91684
2:4:2,2,2,108314,91686
2:5:5,1,1,108313,91687
2:6:2,2,2,108311,91689
4:1:6,0,-1,108312,91688
6:4:1,0,-1,108313,91687
3:6:4,0,-1,108314,91686
2:5:3,1,1,108313,91687
3:1:4,0,-1,108314,91686
4:3:1,0,-1,108315,91685
1:6:6,0,-1,108316,91684
6:4:5,0,-1,108317,91683
1:3:5,0,-1,108318,91682
3:1:2,1,1,108317,91683
4:4:3,0,-1,108318,91682
2:6:4,1,1,108317,91683
5:4:6,0,-1,108318,91682
5:6:3,0,-1,108319,91681
2:1:1,1,1,108318,91682
1:3:5,0,-1,108319,91681
3:1:5,0,-1,108320,91680
6:6:6,0,-1,108321,91679
1:2:5,1,1,108320,91680
4:2:3,1,1,108319,91681
1:4:1,0,-1,108320,91680
6:1:6,0,-1,108321,91679
1:6:4,0,-1,108322,91678
3:3:4,0,-1,108323,91677
1:3:1,0,-1,108324,91676
2:5:6,1,1,108323,91677
4:6:5,0,-1,108324,91676
4:3:4,0,-1,108325,91675
2:1:1,1,1,108324,91676
2:5:3,1,1,108323,91677
5:3:1,0,-1,108324,91676
5:4:2,1,1,108323,91677
4:6:2,1,1,108322,91678
1:2:3,1,1,108321,91679
5:6:1,0,-1,108322,91678
1:5:1,0,-1,108323,91677
2:1:4,1,1,108322,91678
2:6:1,1,1,108321,91679
5:3:6,0,-1,108322,91678
6:6:6,0,-1,108323,91677
5:1:5,0,-1,108324,91676
4:3:3,0,-1,108325,91675
1:3:6,0,-1,108326,91674
6:5:3,0,-1,108327,91673
2:4:6,1,1,108326,91674
5:2:4,1,1,108325,91675
4:1:6,0,-1,108326,91674
4:3:1,0,-1,108327,91673
5:4:5,0,-1,108328,91672
4:2:2,2,2,108326,91674
3:6:2,1,1,108325,91675
2:4:2,2,2,108323,91677
1:3:5,0,-1,108324,91676
1:2:6,1,1,108323,91677
5:1:2,1,1,108322,91678
1:5:2,1,1,108321,91679
2:3:1,1,1,108320,91680
2:2:4,2,2,108318,91682
4:2:4,1,1,108317,91683
5:5:1,0,-1,108318,91682
1:6:5,0,-1,108319,91681
1:1:2,1,1,108318,91682
3:2:1,1,1,108317,91683
5:4:4,0,-1,108318,91682
6:5:5,0,-1,108319,91681
1:6:3,0,-1,108320,91680
5:5:4,0,-1,108321,91679
4:2:3,1,1,108320,91680
2:2:1,2,2,108318,91682
5:5:5,0,-1,108319,91681
4:1:2,1,1,108318,91682
1:5:1,0,-1,108319,91681
1:5:1,0,-1,108320,91680
4:5:1,0,-1,108321,91679
6:4:6,0,-1,108322,91678
